"gene","id","snp","ref_count","total_count","alt_count"
"CENPN","s1639_F_VTA_03_ASEReadCounter.table","NW_015090842.1:5801655",1,1,0
"CENPN","s1639_F_VTA_03_ASEReadCounter.table","NW_015090842.1:5801670",1,1,0
"CENPN","s1639_F_VTA_03_ASEReadCounter.table","NW_015090842.1:5801674",1,1,0
"CENPN","s1639_F_VTA_03_ASEReadCounter.table","NW_015090842.1:5801692",1,1,0
"CENPN","s1639_F_VTA_03_ASEReadCounter.table","NW_015090842.1:5801697",1,1,0
"CENPN","s1639_F_VTA_03_ASEReadCounter.table","NW_015090842.1:5802008",0,1,1
"CENPN","s1639_F_VTA_03_ASEReadCounter.table","NW_015090842.1:5802012",0,1,1
"CENPN","s1639_F_VTA_03_ASEReadCounter.table","NW_015090842.1:5802087",1,4,3
"CENPN","s1639_F_VTA_03_ASEReadCounter.table","NW_015090842.1:5810113",6,6,0
"CENPN","s1639_F_VTA_03_ASEReadCounter.table","NW_015090842.1:5810147",8,8,0
"CENPN","s1639_F_VTA_03_ASEReadCounter.table","NW_015090842.1:5810148",8,8,0
"ATMIN","s1639_F_VTA_03_ASEReadCounter.table","NW_015090842.1:5818789",1,3,2
"ATMIN","s1639_F_VTA_03_ASEReadCounter.table","NW_015090842.1:5819958",1,3,2
"ATMIN","s1639_F_VTA_03_ASEReadCounter.table","NW_015090842.1:5820004",2,3,1
"ATMIN","s1639_F_VTA_03_ASEReadCounter.table","NW_015090842.1:5820217",1,4,3
"ATMIN","s1639_F_VTA_03_ASEReadCounter.table","NW_015090842.1:5820250",2,6,4
"ATMIN","s1639_F_VTA_03_ASEReadCounter.table","NW_015090842.1:5820298",2,9,7
"ATMIN","s1639_F_VTA_03_ASEReadCounter.table","NW_015090842.1:5820417",1,5,4
"ATMIN","s1639_F_VTA_03_ASEReadCounter.table","NW_015090842.1:5820421",1,5,4
"ATMIN","s1639_F_VTA_03_ASEReadCounter.table","NW_015090842.1:5820448",1,4,3
"ATMIN","s1639_F_VTA_03_ASEReadCounter.table","NW_015090842.1:5820457",0,2,2
"ATMIN","s1639_F_VTA_03_ASEReadCounter.table","NW_015090842.1:5820673",0,2,2
"ATMIN","s1639_F_VTA_03_ASEReadCounter.table","NW_015090842.1:5820754",0,5,5
"ATMIN","s1639_F_VTA_03_ASEReadCounter.table","NW_015090842.1:5820820",0,4,4
"ATMIN","s1639_F_VTA_03_ASEReadCounter.table","NW_015090842.1:5820865",2,8,6
"ATMIN","s1639_F_VTA_03_ASEReadCounter.table","NW_015090842.1:5820889",2,8,6
"ATMIN","s1639_F_VTA_03_ASEReadCounter.table","NW_015090842.1:5820891",2,9,7
"ATMIN","s1639_F_VTA_03_ASEReadCounter.table","NW_015090842.1:5820997",1,2,1
"ATMIN","s1639_F_VTA_03_ASEReadCounter.table","NW_015090842.1:5821063",1,1,0
"ATMIN","s1639_F_VTA_03_ASEReadCounter.table","NW_015090842.1:5821132",2,4,2
"ATMIN","s1639_F_VTA_03_ASEReadCounter.table","NW_015090842.1:5821645",8,12,4
"ATMIN","s1639_F_VTA_03_ASEReadCounter.table","NW_015090842.1:5825066",13,21,8
"ATMIN","s1639_F_VTA_03_ASEReadCounter.table","NW_015090842.1:5825106",12,22,10
"ATMIN","s1639_F_VTA_03_ASEReadCounter.table","NW_015090842.1:5825122",7,18,11
"ATMIN","s1639_F_VTA_03_ASEReadCounter.table","NW_015090842.1:5825178",10,19,9
"ATMIN","s1639_F_VTA_03_ASEReadCounter.table","NW_015090842.1:5825194",10,18,8
"ATMIN","s1639_F_VTA_03_ASEReadCounter.table","NW_015090842.1:5825195",10,18,8
"ATMIN","s1639_F_VTA_03_ASEReadCounter.table","NW_015090842.1:5825220",10,18,8
"ATMIN","s1639_F_VTA_03_ASEReadCounter.table","NW_015090842.1:5825240",7,13,6
"ATMIN","s1639_F_VTA_03_ASEReadCounter.table","NW_015090842.1:5825303",8,20,12
"ATMIN","s1639_F_VTA_03_ASEReadCounter.table","NW_015090842.1:5825304",8,20,12
"ATMIN","s1639_F_VTA_03_ASEReadCounter.table","NW_015090842.1:5825310",9,20,11
"ATMIN","s1639_F_VTA_03_ASEReadCounter.table","NW_015090842.1:5825406",13,26,13
"ATMIN","s1639_F_VTA_03_ASEReadCounter.table","NW_015090842.1:5825415",11,26,15
"ATMIN","s1639_F_VTA_03_ASEReadCounter.table","NW_015090842.1:5825438",10,26,16
"ATMIN","s1639_F_VTA_03_ASEReadCounter.table","NW_015090842.1:5825485",9,20,11
"ATMIN","s1639_F_VTA_03_ASEReadCounter.table","NW_015090842.1:5825524",10,23,13
"ATMIN","s1639_F_VTA_03_ASEReadCounter.table","NW_015090842.1:5825557",9,26,17
"ATMIN","s1639_F_VTA_03_ASEReadCounter.table","NW_015090842.1:5825571",11,29,18
"ATMIN","s1639_F_VTA_03_ASEReadCounter.table","NW_015090842.1:5825579",12,32,20
"ATMIN","s1639_F_VTA_03_ASEReadCounter.table","NW_015090842.1:5825590",10,28,18
"ATMIN","s1639_F_VTA_03_ASEReadCounter.table","NW_015090842.1:5825689",15,34,19
"ATMIN","s1639_F_VTA_03_ASEReadCounter.table","NW_015090842.1:5825703",17,36,19
"ATMIN","s1639_F_VTA_03_ASEReadCounter.table","NW_015090842.1:5825787",9,21,12
"ATMIN","s1639_F_VTA_03_ASEReadCounter.table","NW_015090842.1:5825833",12,24,12
"ATMIN","s1639_F_VTA_03_ASEReadCounter.table","NW_015090842.1:5825841",12,26,14
"ATMIN","s1639_F_VTA_03_ASEReadCounter.table","NW_015090842.1:5825895",20,35,15
"ATMIN","s1639_F_VTA_03_ASEReadCounter.table","NW_015090842.1:5825984",9,25,16
"ATMIN","s1639_F_VTA_03_ASEReadCounter.table","NW_015090842.1:5826162",16,35,19
"ATMIN","s1639_F_VTA_03_ASEReadCounter.table","NW_015090842.1:5826194",19,43,24
"ATMIN","s1639_F_VTA_03_ASEReadCounter.table","NW_015090842.1:5826235",24,50,26
"ATMIN","s1639_F_VTA_03_ASEReadCounter.table","NW_015090842.1:5826245",22,50,28
"ATMIN","s1639_F_VTA_03_ASEReadCounter.table","NW_015090842.1:5826335",14,32,18
"ATMIN","s1639_F_VTA_03_ASEReadCounter.table","NW_015090842.1:5826417",14,36,22
"ATMIN","s1639_F_VTA_03_ASEReadCounter.table","NW_015090842.1:5826431",10,39,29
"ATMIN","s1639_F_VTA_03_ASEReadCounter.table","NW_015090842.1:5826438",14,40,26
"ATMIN","s1639_F_VTA_03_ASEReadCounter.table","NW_015090842.1:5826463",20,53,33
"ATMIN","s1639_F_VTA_03_ASEReadCounter.table","NW_015090842.1:5826502",18,45,27
"ATMIN","s1639_F_VTA_03_ASEReadCounter.table","NW_015090842.1:5826511",20,49,29
"ATMIN","s1639_F_VTA_03_ASEReadCounter.table","NW_015090842.1:5826659",17,41,24
"ATMIN","s1639_F_VTA_03_ASEReadCounter.table","NW_015090842.1:5826701",19,45,26
"ATMIN","s1639_F_VTA_03_ASEReadCounter.table","NW_015090842.1:5826702",19,45,26
"ATMIN","s1639_F_VTA_03_ASEReadCounter.table","NW_015090842.1:5826732",17,50,33
"ATMIN","s1639_F_VTA_03_ASEReadCounter.table","NW_015090842.1:5826745",21,55,34
"ATMIN","s1639_F_VTA_03_ASEReadCounter.table","NW_015090842.1:5826835",31,65,34
"ATMIN","s1639_F_VTA_03_ASEReadCounter.table","NW_015090842.1:5826942",25,64,39
"ATMIN","s1639_F_VTA_03_ASEReadCounter.table","NW_015090842.1:5827193",38,95,57
"ATMIN","s1639_F_VTA_03_ASEReadCounter.table","NW_015090842.1:5827196",38,97,59
"ATMIN","s1639_F_VTA_03_ASEReadCounter.table","NW_015090842.1:5827269",40,104,64
"ATMIN","s1639_F_VTA_03_ASEReadCounter.table","NW_015090842.1:5827315",31,77,46
"ATMIN","s1639_F_VTA_03_ASEReadCounter.table","NW_015090842.1:5827316",32,77,45
"ATMIN","s1639_F_VTA_03_ASEReadCounter.table","NW_015090842.1:5827333",33,76,43
"PPP1R3E","s1639_F_VTA_03_ASEReadCounter.table","NW_015090842.1:5837733",1,2,1
"PPP1R3E","s1639_F_VTA_03_ASEReadCounter.table","NW_015090842.1:5837947",4,4,0
"PKD1L2","s1639_F_VTA_03_ASEReadCounter.table","NW_015090842.1:5867660",1,1,0
"PKD1L2","s1639_F_VTA_03_ASEReadCounter.table","NW_015090842.1:5867675",2,3,1
"PKD1L2","s1639_F_VTA_03_ASEReadCounter.table","NW_015090842.1:5867788",0,1,1
"PKD1L2","s1639_F_VTA_03_ASEReadCounter.table","NW_015090842.1:5867843",1,1,0
"PKD1L2","s1639_F_VTA_03_ASEReadCounter.table","NW_015090842.1:5871422",0,1,1
"BCO1","s1639_F_VTA_03_ASEReadCounter.table","NW_015090842.1:5915610",0,2,2
"BCO1","s1639_F_VTA_03_ASEReadCounter.table","NW_015090842.1:5915646",0,2,2
"BCO1","s1639_F_VTA_03_ASEReadCounter.table","NW_015090842.1:5917836",1,1,0
"BCO1","s1639_F_VTA_03_ASEReadCounter.table","NW_015090842.1:5917912",2,4,2
"BCO1","s1639_F_VTA_03_ASEReadCounter.table","NW_015090842.1:5917941",3,6,3
"BCO1","s1639_F_VTA_03_ASEReadCounter.table","NW_015090842.1:5917971",2,5,3
"BCO1","s1639_F_VTA_03_ASEReadCounter.table","NW_015090842.1:5921679",4,6,2
"BCO1","s1639_F_VTA_03_ASEReadCounter.table","NW_015090842.1:5921726",5,8,3
"BCO1","s1639_F_VTA_03_ASEReadCounter.table","NW_015090842.1:5925669",2,3,1
"BCO1","s1639_F_VTA_03_ASEReadCounter.table","NW_015090842.1:5926937",5,5,0
"BCO1","s1639_F_VTA_03_ASEReadCounter.table","NW_015090842.1:5927921",7,12,5
"BCO1","s1639_F_VTA_03_ASEReadCounter.table","NW_015090842.1:5927948",7,11,4
"BCO1","s1639_F_VTA_03_ASEReadCounter.table","NW_015090842.1:5927968",5,8,3
"BCO1","s1639_F_VTA_03_ASEReadCounter.table","NW_015090842.1:5928052",1,4,3
"BCO1","s1639_F_VTA_03_ASEReadCounter.table","NW_015090842.1:5932726",5,10,5
"BCO1","s1639_F_VTA_03_ASEReadCounter.table","NW_015090842.1:5932801",3,6,3
"BCO1","s1639_F_VTA_03_ASEReadCounter.table","NW_015090842.1:5934558",15,19,4
"BCO1","s1639_F_VTA_03_ASEReadCounter.table","NW_015090842.1:5934575",16,21,5
"BCO1","s1639_F_VTA_03_ASEReadCounter.table","NW_015090842.1:5934608",15,19,4
"BCO1","s1639_F_VTA_03_ASEReadCounter.table","NW_015090842.1:5934647",15,21,6
"BCO1","s1639_F_VTA_03_ASEReadCounter.table","NW_015090842.1:5934725",12,16,4
"BCO1","s1639_F_VTA_03_ASEReadCounter.table","NW_015090842.1:5934726",12,16,4
"BCO1","s1639_F_VTA_03_ASEReadCounter.table","NW_015090842.1:5934733",11,15,4
"BCO1","s1639_F_VTA_03_ASEReadCounter.table","NW_015090842.1:5934821",12,17,5
"BCO1","s1639_F_VTA_03_ASEReadCounter.table","NW_015090842.1:5934826",11,17,6
"BCO1","s1639_F_VTA_03_ASEReadCounter.table","NW_015090842.1:5934844",9,13,4
"BCO1","s1639_F_VTA_03_ASEReadCounter.table","NW_015090842.1:5934958",12,17,5
"BCO1","s1639_F_VTA_03_ASEReadCounter.table","NW_015090842.1:5934976",12,15,3
"GAN","s1639_F_VTA_03_ASEReadCounter.table","NW_015090842.1:5939249",0,6,6
"GAN","s1639_F_VTA_03_ASEReadCounter.table","NW_015090842.1:5953759",6,12,6
"GAN","s1639_F_VTA_03_ASEReadCounter.table","NW_015090842.1:5957502",8,26,18
"GAN","s1639_F_VTA_03_ASEReadCounter.table","NW_015090842.1:5957578",7,27,20
"GAN","s1639_F_VTA_03_ASEReadCounter.table","NW_015090842.1:5966047",20,45,25
"GAN","s1639_F_VTA_03_ASEReadCounter.table","NW_015090842.1:5966126",9,33,24
"GAN","s1639_F_VTA_03_ASEReadCounter.table","NW_015090842.1:5966127",9,33,24
"GAN","s1639_F_VTA_03_ASEReadCounter.table","NW_015090842.1:5966162",22,55,33
"GAN","s1639_F_VTA_03_ASEReadCounter.table","NW_015090842.1:5966483",29,84,55
"CMIP","s1639_F_VTA_03_ASEReadCounter.table","NW_015090842.1:6109159",20,28,8
"CMIP","s1639_F_VTA_03_ASEReadCounter.table","NW_015090842.1:6109166",15,22,7
"CMIP","s1639_F_VTA_03_ASEReadCounter.table","NW_015090842.1:6114641",23,42,19
"CMIP","s1639_F_VTA_03_ASEReadCounter.table","NW_015090842.1:6114751",20,42,22
"CMIP","s1639_F_VTA_03_ASEReadCounter.table","NW_015090842.1:6114824",16,40,24
"CMIP","s1639_F_VTA_03_ASEReadCounter.table","NW_015090842.1:6126295",63,65,2
"CMIP","s1639_F_VTA_03_ASEReadCounter.table","NW_015090842.1:6128998",39,83,44
"CMIP","s1639_F_VTA_03_ASEReadCounter.table","NW_015090842.1:6130562",56,140,84
"CMIP","s1639_F_VTA_03_ASEReadCounter.table","NW_015090842.1:6132522",56,122,66
"CMIP","s1639_F_VTA_03_ASEReadCounter.table","NW_015090842.1:6138265",128,285,157
"CMIP","s1639_F_VTA_03_ASEReadCounter.table","NW_015090842.1:6138300",130,305,175
"CMIP","s1639_F_VTA_03_ASEReadCounter.table","NW_015090842.1:6138342",83,228,145
"CMIP","s1639_F_VTA_03_ASEReadCounter.table","NW_015090842.1:6138343",82,226,144
"CMIP","s1639_F_VTA_03_ASEReadCounter.table","NW_015090842.1:6138345",82,228,146
"CMIP","s1639_F_VTA_03_ASEReadCounter.table","NW_015090842.1:6138647",70,169,99
"CMIP","s1639_F_VTA_03_ASEReadCounter.table","NW_015090842.1:6138745",84,207,123
"CMIP","s1639_F_VTA_03_ASEReadCounter.table","NW_015090842.1:6138832",19,79,60
"CMIP","s1639_F_VTA_03_ASEReadCounter.table","NW_015090842.1:6138967",86,183,97
"CMIP","s1639_F_VTA_03_ASEReadCounter.table","NW_015090842.1:6139131",27,80,53
"CMIP","s1639_F_VTA_03_ASEReadCounter.table","NW_015090842.1:6139163",6,61,55
"CMIP","s1639_F_VTA_03_ASEReadCounter.table","NW_015090842.1:6139212",140,152,12
"CMIP","s1639_F_VTA_03_ASEReadCounter.table","NW_015090842.1:6139360",41,80,39
"CMIP","s1639_F_VTA_03_ASEReadCounter.table","NW_015090842.1:6139572",20,41,21
"PLCG2","s1639_F_VTA_03_ASEReadCounter.table","NW_015090842.1:6179613",2,3,1
"PLCG2","s1639_F_VTA_03_ASEReadCounter.table","NW_015090842.1:6179658",7,9,2
"PLCG2","s1639_F_VTA_03_ASEReadCounter.table","NW_015090842.1:6203766",0,1,1
"PLCG2","s1639_F_VTA_03_ASEReadCounter.table","NW_015090842.1:6203775",0,1,1
"PLCG2","s1639_F_VTA_03_ASEReadCounter.table","NW_015090842.1:6203787",0,1,1
"PLCG2","s1639_F_VTA_03_ASEReadCounter.table","NW_015090842.1:6209741",0,1,1
"PLCG2","s1639_F_VTA_03_ASEReadCounter.table","NW_015090842.1:6209798",1,1,0
"PLCG2","s1639_F_VTA_03_ASEReadCounter.table","NW_015090842.1:6209816",1,2,1
"PLCG2","s1639_F_VTA_03_ASEReadCounter.table","NW_015090842.1:6217547",2,3,1
"PLCG2","s1639_F_VTA_03_ASEReadCounter.table","NW_015090842.1:6218641",0,4,4
"PLCG2","s1639_F_VTA_03_ASEReadCounter.table","NW_015090842.1:6220552",4,6,2
"PLCG2","s1639_F_VTA_03_ASEReadCounter.table","NW_015090842.1:6221969",3,5,2
"PLCG2","s1639_F_VTA_03_ASEReadCounter.table","NW_015090842.1:6228672",2,2,0
"PLCG2","s1639_F_VTA_03_ASEReadCounter.table","NW_015090842.1:6228694",2,2,0
"PLCG2","s1639_F_VTA_03_ASEReadCounter.table","NW_015090842.1:6228722",3,3,0
"PLCG2","s1639_F_VTA_03_ASEReadCounter.table","NW_015090842.1:6228747",1,1,0
"PLCG2","s1639_F_VTA_03_ASEReadCounter.table","NW_015090842.1:6228835",2,2,0
"PLCG2","s1639_F_VTA_03_ASEReadCounter.table","NW_015090842.1:6228841",2,2,0
"PLCG2","s1639_F_VTA_03_ASEReadCounter.table","NW_015090842.1:6228865",3,3,0
"PLCG2","s1639_F_VTA_03_ASEReadCounter.table","NW_015090842.1:6228917",3,3,0
"PLCG2","s1639_F_VTA_03_ASEReadCounter.table","NW_015090842.1:6228926",2,2,0
"PLCG2","s1639_F_VTA_03_ASEReadCounter.table","NW_015090842.1:6228954",1,1,0
"PLCG2","s1639_F_VTA_03_ASEReadCounter.table","NW_015090842.1:6229002",3,3,0
"PLCG2","s1639_F_VTA_03_ASEReadCounter.table","NW_015090842.1:6229006",3,3,0
"PLCG2","s1639_F_VTA_03_ASEReadCounter.table","NW_015090842.1:6229081",5,5,0
"PLCG2","s1639_F_VTA_03_ASEReadCounter.table","NW_015090842.1:6229097",5,6,1
"PLCG2","s1639_F_VTA_03_ASEReadCounter.table","NW_015090842.1:6229160",4,5,1
"PLCG2","s1639_F_VTA_03_ASEReadCounter.table","NW_015090842.1:6229213",4,6,2
"PLCG2","s1639_F_VTA_03_ASEReadCounter.table","NW_015090842.1:6229231",3,5,2
"PLCG2","s1639_F_VTA_03_ASEReadCounter.table","NW_015090842.1:6229663",2,4,2
"PLCG2","s1639_F_VTA_03_ASEReadCounter.table","NW_015090842.1:6229748",4,5,1
"PLCG2","s1639_F_VTA_03_ASEReadCounter.table","NW_015090842.1:6230248",4,4,0
"PLCG2","s1639_F_VTA_03_ASEReadCounter.table","NW_015090842.1:6230255",4,4,0
"PLCG2","s1639_F_VTA_03_ASEReadCounter.table","NW_015090842.1:6230276",3,3,0
"PLCG2","s1639_F_VTA_03_ASEReadCounter.table","NW_015090842.1:6230296",2,2,0
"PLCG2","s1639_F_VTA_03_ASEReadCounter.table","NW_015090842.1:6230349",2,2,0
"PLCG2","s1639_F_VTA_03_ASEReadCounter.table","NW_015090842.1:6230408",4,4,0
"PLCG2","s1639_F_VTA_03_ASEReadCounter.table","NW_015090842.1:6230439",5,5,0
"PLCG2","s1639_F_VTA_03_ASEReadCounter.table","NW_015090842.1:6230757",1,3,2
"PLCG2","s1639_F_VTA_03_ASEReadCounter.table","NW_015090842.1:6230758",0,2,2
"PLCG2","s1639_F_VTA_03_ASEReadCounter.table","NW_015090842.1:6230898",3,3,0
"PLCG2","s1639_F_VTA_03_ASEReadCounter.table","NW_015090842.1:6230976",4,6,2
"PLCG2","s1639_F_VTA_03_ASEReadCounter.table","NW_015090842.1:6231078",4,4,0
"PLCG2","s1639_F_VTA_03_ASEReadCounter.table","NW_015090842.1:6231138",6,7,1
"PLCG2","s1639_F_VTA_03_ASEReadCounter.table","NW_015090842.1:6231177",6,7,1
"PLCG2","s1639_F_VTA_03_ASEReadCounter.table","NW_015090842.1:6231263",5,5,0
"SDR42E1","s1639_F_VTA_03_ASEReadCounter.table","NW_015090842.1:6235292",0,3,3
"SDR42E1","s1639_F_VTA_03_ASEReadCounter.table","NW_015090842.1:6235315",0,4,4
"SDR42E1","s1639_F_VTA_03_ASEReadCounter.table","NW_015090842.1:6235348",0,6,6
"SDR42E1","s1639_F_VTA_03_ASEReadCounter.table","NW_015090842.1:6235355",0,6,6
"SDR42E1","s1639_F_VTA_03_ASEReadCounter.table","NW_015090842.1:6235417",0,4,4
"SDR42E1","s1639_F_VTA_03_ASEReadCounter.table","NW_015090842.1:6235558",3,9,6
"SDR42E1","s1639_F_VTA_03_ASEReadCounter.table","NW_015090842.1:6235741",3,10,7
"SDR42E1","s1639_F_VTA_03_ASEReadCounter.table","NW_015090842.1:6235777",4,14,10
"SDR42E1","s1639_F_VTA_03_ASEReadCounter.table","NW_015090842.1:6235806",6,19,13
"SDR42E1","s1639_F_VTA_03_ASEReadCounter.table","NW_015090842.1:6235809",6,19,13
"SDR42E1","s1639_F_VTA_03_ASEReadCounter.table","NW_015090842.1:6235816",6,18,12
"SDR42E1","s1639_F_VTA_03_ASEReadCounter.table","NW_015090842.1:6235914",3,10,7
"SDR42E1","s1639_F_VTA_03_ASEReadCounter.table","NW_015090842.1:6235935",2,9,7
"SDR42E1","s1639_F_VTA_03_ASEReadCounter.table","NW_015090842.1:6235957",2,9,7
"SDR42E1","s1639_F_VTA_03_ASEReadCounter.table","NW_015090842.1:6236040",1,6,5
"SDR42E1","s1639_F_VTA_03_ASEReadCounter.table","NW_015090842.1:6236260",0,3,3
"SDR42E1","s1639_F_VTA_03_ASEReadCounter.table","NW_015090842.1:6236281",0,3,3
"SDR42E1","s1639_F_VTA_03_ASEReadCounter.table","NW_015090842.1:6236305",0,3,3
"SDR42E1","s1639_F_VTA_03_ASEReadCounter.table","NW_015090842.1:6236458",1,6,5
"SDR42E1","s1639_F_VTA_03_ASEReadCounter.table","NW_015090842.1:6236476",1,7,6
"SDR42E1","s1639_F_VTA_03_ASEReadCounter.table","NW_015090842.1:6236608",4,12,8
"SDR42E1","s1639_F_VTA_03_ASEReadCounter.table","NW_015090842.1:6238244",4,9,5
"SDR42E1","s1639_F_VTA_03_ASEReadCounter.table","NW_015090842.1:6238829",1,1,0
"HSD17B2","s1639_F_VTA_03_ASEReadCounter.table","NW_015090842.1:6257758",0,1,1
"HSD17B2","s1639_F_VTA_03_ASEReadCounter.table","NW_015090842.1:6257767",0,1,1
"HSD17B2","s1639_F_VTA_03_ASEReadCounter.table","NW_015090842.1:6257829",0,1,1
"HSD17B2","s1639_F_VTA_03_ASEReadCounter.table","NW_015090842.1:6257851",0,1,1
"HSD17B2","s1639_F_VTA_03_ASEReadCounter.table","NW_015090842.1:6266795",0,2,2
"HSD17B2","s1639_F_VTA_03_ASEReadCounter.table","NW_015090842.1:6266944",0,2,2
"HSD17B2","s1639_F_VTA_03_ASEReadCounter.table","NW_015090842.1:6267053",0,1,1
"HSD17B2","s1639_F_VTA_03_ASEReadCounter.table","NW_015090842.1:6267196",0,2,2
"HSD17B2","s1639_F_VTA_03_ASEReadCounter.table","NW_015090842.1:6267273",0,2,2
"HSD17B2","s1639_F_VTA_03_ASEReadCounter.table","NW_015090842.1:6267674",0,2,2
"HSD17B2","s1639_F_VTA_03_ASEReadCounter.table","NW_015090842.1:6267913",0,2,2
"HSD17B2","s1639_F_VTA_03_ASEReadCounter.table","NW_015090842.1:6268098",0,2,2
"ARY2","s1639_F_VTA_03_ASEReadCounter.table","NW_015090842.1:6303922",15,20,5
"ARY2","s1639_F_VTA_03_ASEReadCounter.table","NW_015090842.1:6303954",15,25,10
"ARY2","s1639_F_VTA_03_ASEReadCounter.table","NW_015090842.1:6303979",13,27,14
"ARY2","s1639_F_VTA_03_ASEReadCounter.table","NW_015090842.1:6305848",20,27,7
"ARY2","s1639_F_VTA_03_ASEReadCounter.table","NW_015090842.1:6305856",19,27,8
"ARY2","s1639_F_VTA_03_ASEReadCounter.table","NW_015090842.1:6305857",19,26,7
"ARY2","s1639_F_VTA_03_ASEReadCounter.table","NW_015090842.1:6306017",16,32,16
"ARY2","s1639_F_VTA_03_ASEReadCounter.table","NW_015090842.1:6306052",13,25,12
"ARY2","s1639_F_VTA_03_ASEReadCounter.table","NW_015090842.1:6306094",15,30,15
"ARY2","s1639_F_VTA_03_ASEReadCounter.table","NW_015090842.1:6306100",14,29,15
"ARY2","s1639_F_VTA_03_ASEReadCounter.table","NW_015090842.1:6306146",12,23,11
"ARY2","s1639_F_VTA_03_ASEReadCounter.table","NW_015090842.1:6306147",12,23,11
"ARY2","s1639_F_VTA_03_ASEReadCounter.table","NW_015090842.1:6306390",20,40,20
"ARY2","s1639_F_VTA_03_ASEReadCounter.table","NW_015090842.1:6306567",17,30,13
"ARY2","s1639_F_VTA_03_ASEReadCounter.table","NW_015090842.1:6306705",17,19,2
"ARY2","s1639_F_VTA_03_ASEReadCounter.table","NW_015090842.1:6306773",19,25,6
"ARY2","s1639_F_VTA_03_ASEReadCounter.table","NW_015090842.1:6307039",29,35,6
"ARY2","s1639_F_VTA_03_ASEReadCounter.table","NW_015090842.1:6307043",27,34,7
"ARY2","s1639_F_VTA_03_ASEReadCounter.table","NW_015090842.1:6307093",20,27,7
"ARY2","s1639_F_VTA_03_ASEReadCounter.table","NW_015090842.1:6307138",22,31,9
"ARY2","s1639_F_VTA_03_ASEReadCounter.table","NW_015090842.1:6307157",22,31,9
"ARY2","s1639_F_VTA_03_ASEReadCounter.table","NW_015090842.1:6307187",26,33,7
"ARY2","s1639_F_VTA_03_ASEReadCounter.table","NW_015090842.1:6307204",25,32,7
"ARY2","s1639_F_VTA_03_ASEReadCounter.table","NW_015090842.1:6307278",31,36,5
"ARY2","s1639_F_VTA_03_ASEReadCounter.table","NW_015090842.1:6307305",34,42,8
"ARY2","s1639_F_VTA_03_ASEReadCounter.table","NW_015090842.1:6307318",38,46,8
"ARY2","s1639_F_VTA_03_ASEReadCounter.table","NW_015090842.1:6307429",39,46,7
"ARY2","s1639_F_VTA_03_ASEReadCounter.table","NW_015090842.1:6307487",23,32,9
"ARY2","s1639_F_VTA_03_ASEReadCounter.table","NW_015090842.1:6307670",17,21,4
"ARYL","s1639_F_VTA_03_ASEReadCounter.table","NW_015090842.1:6313360",3,3,0
"ARYL","s1639_F_VTA_03_ASEReadCounter.table","NW_015090842.1:6313377",1,1,0
"ARYL","s1639_F_VTA_03_ASEReadCounter.table","NW_015090842.1:6313767",3,7,4
"ARY1","s1639_F_VTA_03_ASEReadCounter.table","NW_015090842.1:6314296",3,5,2
"ARY1","s1639_F_VTA_03_ASEReadCounter.table","NW_015090842.1:6314541",2,4,2
"ARY1","s1639_F_VTA_03_ASEReadCounter.table","NW_015090842.1:6314597",0,4,4
"ARY1","s1639_F_VTA_03_ASEReadCounter.table","NW_015090842.1:6314750",3,5,2
"ARY1","s1639_F_VTA_03_ASEReadCounter.table","NW_015090842.1:6314794",1,4,3
"ARY1","s1639_F_VTA_03_ASEReadCounter.table","NW_015090842.1:6314827",3,7,4
"ARY1","s1639_F_VTA_03_ASEReadCounter.table","NW_015090842.1:6314859",5,9,4
"ARY1","s1639_F_VTA_03_ASEReadCounter.table","NW_015090842.1:6314886",6,13,7
"ARY1","s1639_F_VTA_03_ASEReadCounter.table","NW_015090842.1:6315022",5,10,5
"ARY1","s1639_F_VTA_03_ASEReadCounter.table","NW_015090842.1:6315026",5,10,5
"ARY1","s1639_F_VTA_03_ASEReadCounter.table","NW_015090842.1:6315043",3,8,5
"ARY1","s1639_F_VTA_03_ASEReadCounter.table","NW_015090842.1:6315065",3,8,5
"ARY1","s1639_F_VTA_03_ASEReadCounter.table","NW_015090842.1:6315409",2,5,3
"ARY1","s1639_F_VTA_03_ASEReadCounter.table","NW_015090842.1:6315479",3,6,3
"ARY1","s1639_F_VTA_03_ASEReadCounter.table","NW_015090842.1:6318342",7,13,6
"ARY1","s1639_F_VTA_03_ASEReadCounter.table","NW_015090842.1:6318427",7,15,8
"ARY1","s1639_F_VTA_03_ASEReadCounter.table","NW_015090842.1:6318603",9,16,7
"ARY1","s1639_F_VTA_03_ASEReadCounter.table","NW_015090842.1:6318708",12,18,6
"ARY1","s1639_F_VTA_03_ASEReadCounter.table","NW_015090842.1:6318858",12,15,3
"ARY1","s1639_F_VTA_03_ASEReadCounter.table","NW_015090842.1:6318952",13,19,6
"MPHOSPH6","s1639_F_VTA_03_ASEReadCounter.table","NW_015090842.1:6324063",45,90,45
"MPHOSPH6","s1639_F_VTA_03_ASEReadCounter.table","NW_015090842.1:6324174",71,155,84
"MPHOSPH6","s1639_F_VTA_03_ASEReadCounter.table","NW_015090842.1:6324270",84,176,92
"MPHOSPH6","s1639_F_VTA_03_ASEReadCounter.table","NW_015090842.1:6324762",67,142,75
"MPHOSPH6","s1639_F_VTA_03_ASEReadCounter.table","NW_015090842.1:6324780",60,128,68
"MPHOSPH6","s1639_F_VTA_03_ASEReadCounter.table","NW_015090842.1:6324902",76,153,77
"MPHOSPH6","s1639_F_VTA_03_ASEReadCounter.table","NW_015090842.1:6325066",64,133,69
"MPHOSPH6","s1639_F_VTA_03_ASEReadCounter.table","NW_015090842.1:6325089",77,164,87
"MPHOSPH6","s1639_F_VTA_03_ASEReadCounter.table","NW_015090842.1:6325877",60,120,60
"MPHOSPH6","s1639_F_VTA_03_ASEReadCounter.table","NW_015090842.1:6326976",31,68,37
"CDH13","s1639_F_VTA_03_ASEReadCounter.table","NW_015090842.1:6662283",10,17,7
"CDH13","s1639_F_VTA_03_ASEReadCounter.table","NW_015090842.1:6693665",7,13,6
"CDH13","s1639_F_VTA_03_ASEReadCounter.table","NW_015090842.1:6693697",10,15,5
"CDH13","s1639_F_VTA_03_ASEReadCounter.table","NW_015090842.1:6693712",7,13,6
"CDH13","s1639_F_VTA_03_ASEReadCounter.table","NW_015090842.1:6693723",7,14,7
"CDH13","s1639_F_VTA_03_ASEReadCounter.table","NW_015090842.1:6693738",8,15,7
"CDH13","s1639_F_VTA_03_ASEReadCounter.table","NW_015090842.1:6823730",6,17,11
"CDH13","s1639_F_VTA_03_ASEReadCounter.table","NW_015090842.1:6889713",8,18,10
"CDH13","s1639_F_VTA_03_ASEReadCounter.table","NW_015090842.1:6955167",16,27,11
"MLYCD","s1639_F_VTA_03_ASEReadCounter.table","NW_015090842.1:7150054",63,119,56
"MLYCD","s1639_F_VTA_03_ASEReadCounter.table","NW_015090842.1:7150131",81,181,100
"MLYCD","s1639_F_VTA_03_ASEReadCounter.table","NW_015090842.1:7150585",50,109,59
"MLYCD","s1639_F_VTA_03_ASEReadCounter.table","NW_015090842.1:7150686",35,84,49
"MLYCD","s1639_F_VTA_03_ASEReadCounter.table","NW_015090842.1:7150696",38,93,55
"MLYCD","s1639_F_VTA_03_ASEReadCounter.table","NW_015090842.1:7150869",39,95,56
"MLYCD","s1639_F_VTA_03_ASEReadCounter.table","NW_015090842.1:7151100",46,84,38
"MLYCD","s1639_F_VTA_03_ASEReadCounter.table","NW_015090842.1:7151127",48,90,42
"MLYCD","s1639_F_VTA_03_ASEReadCounter.table","NW_015090842.1:7157538",26,61,35
"MLYCD","s1639_F_VTA_03_ASEReadCounter.table","NW_015090842.1:7167662",7,18,11
"MLYCD","s1639_F_VTA_03_ASEReadCounter.table","NW_015090842.1:7167675",8,19,11
"MLYCD","s1639_F_VTA_03_ASEReadCounter.table","NW_015090842.1:7167710",8,17,9
"MLYCD","s1639_F_VTA_03_ASEReadCounter.table","NW_015090842.1:7167781",10,19,9
"MLYCD","s1639_F_VTA_03_ASEReadCounter.table","NW_015090842.1:7167803",7,12,5
"MLYCD","s1639_F_VTA_03_ASEReadCounter.table","NW_015090842.1:7167812",7,12,5
"MLYCD","s1639_F_VTA_03_ASEReadCounter.table","NW_015090842.1:7167845",7,12,5
"MLYCD","s1639_F_VTA_03_ASEReadCounter.table","NW_015090842.1:7167862",7,8,1
"MLYCD","s1639_F_VTA_03_ASEReadCounter.table","NW_015090842.1:7167929",4,6,2
"MLYCD","s1639_F_VTA_03_ASEReadCounter.table","NW_015090842.1:7167995",3,5,2
"MLYCD","s1639_F_VTA_03_ASEReadCounter.table","NW_015090842.1:7168005",2,4,2
"MLYCD","s1639_F_VTA_03_ASEReadCounter.table","NW_015090842.1:7168037",3,7,4
"HSBP1","s1639_F_VTA_03_ASEReadCounter.table","NW_015090842.1:7245192",285,489,204
"HSBP1","s1639_F_VTA_03_ASEReadCounter.table","NW_015090842.1:7245226",302,565,263
"HSBP1","s1639_F_VTA_03_ASEReadCounter.table","NW_015090842.1:7245257",261,483,222
"HSBP1","s1639_F_VTA_03_ASEReadCounter.table","NW_015090842.1:7245296",257,507,250
"HSBP1","s1639_F_VTA_03_ASEReadCounter.table","NW_015090842.1:7245389",360,644,284
"HSBP1","s1639_F_VTA_03_ASEReadCounter.table","NW_015090842.1:7245400",369,608,239
"HSBP1","s1639_F_VTA_03_ASEReadCounter.table","NW_015090842.1:7245445",348,604,256
"HSBP1","s1639_F_VTA_03_ASEReadCounter.table","NW_015090842.1:7245495",328,569,241
"HSBP1","s1639_F_VTA_03_ASEReadCounter.table","NW_015090842.1:7245733",193,387,194
"HSBP1","s1639_F_VTA_03_ASEReadCounter.table","NW_015090842.1:7245771",200,375,175
"HSBP1","s1639_F_VTA_03_ASEReadCounter.table","NW_015090842.1:7245813",216,366,150
"HSBP1","s1639_F_VTA_03_ASEReadCounter.table","NW_015090842.1:7245926",247,454,207
"HSBP1","s1639_F_VTA_03_ASEReadCounter.table","NW_015090842.1:7245927",248,452,204
"HSBP1","s1639_F_VTA_03_ASEReadCounter.table","NW_015090842.1:7245933",245,442,197
"HSBP1","s1639_F_VTA_03_ASEReadCounter.table","NW_015090842.1:7246002",161,325,164
"HSBP1","s1639_F_VTA_03_ASEReadCounter.table","NW_015090842.1:7246094",222,385,163
"HSBP1","s1639_F_VTA_03_ASEReadCounter.table","NW_015090842.1:7246167",221,371,150
"HSBP1","s1639_F_VTA_03_ASEReadCounter.table","NW_015090842.1:7246183",212,376,164
"HSBP1","s1639_F_VTA_03_ASEReadCounter.table","NW_015090842.1:7247285",31,42,11
"HSBP1","s1639_F_VTA_03_ASEReadCounter.table","NW_015090842.1:7247651",260,523,263
"HSBP1","s1639_F_VTA_03_ASEReadCounter.table","NW_015090842.1:7247657",247,515,268
"HSBP1","s1639_F_VTA_03_ASEReadCounter.table","NW_015090842.1:7248520",175,346,171
"HSBP1","s1639_F_VTA_03_ASEReadCounter.table","NW_015090842.1:7248535",149,288,139
"KCNG4","s1639_F_VTA_03_ASEReadCounter.table","NW_015090842.1:7282481",5,10,5
"KCNG4","s1639_F_VTA_03_ASEReadCounter.table","NW_015090842.1:7282500",6,10,4
"KCNG4","s1639_F_VTA_03_ASEReadCounter.table","NW_015090842.1:7282542",7,10,3
"KCNG4","s1639_F_VTA_03_ASEReadCounter.table","NW_015090842.1:7282579",5,7,2
"KCNG4","s1639_F_VTA_03_ASEReadCounter.table","NW_015090842.1:7282630",3,9,6
"KCNG4","s1639_F_VTA_03_ASEReadCounter.table","NW_015090842.1:7283056",2,4,2
"KCNG4","s1639_F_VTA_03_ASEReadCounter.table","NW_015090842.1:7283245",1,3,2
"WFDC1","s1639_F_VTA_03_ASEReadCounter.table","NW_015090842.1:7366517",0,5,5
"WFDC1","s1639_F_VTA_03_ASEReadCounter.table","NW_015090842.1:7373367",0,5,5
"WFDC1","s1639_F_VTA_03_ASEReadCounter.table","NW_015090842.1:7375828",3,7,4
"WFDC1","s1639_F_VTA_03_ASEReadCounter.table","NW_015090842.1:7378036",2,5,3
"WFDC1","s1639_F_VTA_03_ASEReadCounter.table","NW_015090842.1:7379125",3,9,6
"WFDC1","s1639_F_VTA_03_ASEReadCounter.table","NW_015090842.1:7379451",2,6,4
"WFDC1","s1639_F_VTA_03_ASEReadCounter.table","NW_015090842.1:7379471",1,5,4
"WFDC1","s1639_F_VTA_03_ASEReadCounter.table","NW_015090842.1:7379576",2,8,6
"WFDC1","s1639_F_VTA_03_ASEReadCounter.table","NW_015090842.1:7379596",1,7,6
"WFDC1","s1639_F_VTA_03_ASEReadCounter.table","NW_015090842.1:7379605",1,8,7
"WFDC1","s1639_F_VTA_03_ASEReadCounter.table","NW_015090842.1:7379626",0,7,7
"WFDC1","s1639_F_VTA_03_ASEReadCounter.table","NW_015090842.1:7379631",0,6,6
"WFDC1","s1639_F_VTA_03_ASEReadCounter.table","NW_015090842.1:7379632",0,6,6
"WFDC1","s1639_F_VTA_03_ASEReadCounter.table","NW_015090842.1:7379652",1,5,4
"WFDC1","s1639_F_VTA_03_ASEReadCounter.table","NW_015090842.1:7379669",1,4,3
"WFDC1","s1639_F_VTA_03_ASEReadCounter.table","NW_015090842.1:7379674",1,4,3
"WFDC1","s1639_F_VTA_03_ASEReadCounter.table","NW_015090842.1:7379719",1,4,3
"WFDC1","s1639_F_VTA_03_ASEReadCounter.table","NW_015090842.1:7379735",1,1,0
"WFDC1","s1639_F_VTA_03_ASEReadCounter.table","NW_015090842.1:7379739",0,1,1
"WFDC1","s1639_F_VTA_03_ASEReadCounter.table","NW_015090842.1:7379821",5,5,0
"WFDC1","s1639_F_VTA_03_ASEReadCounter.table","NW_015090842.1:7379840",5,6,1
"WFDC1","s1639_F_VTA_03_ASEReadCounter.table","NW_015090842.1:7379933",2,4,2
"WFDC1","s1639_F_VTA_03_ASEReadCounter.table","NW_015090842.1:7379935",2,4,2
"WFDC1","s1639_F_VTA_03_ASEReadCounter.table","NW_015090842.1:7379983",4,6,2
"WFDC1","s1639_F_VTA_03_ASEReadCounter.table","NW_015090842.1:7380060",2,5,3
"WFDC1","s1639_F_VTA_03_ASEReadCounter.table","NW_015090842.1:7380136",0,3,3
"WFDC1","s1639_F_VTA_03_ASEReadCounter.table","NW_015090842.1:7380150",0,5,5
"WFDC1","s1639_F_VTA_03_ASEReadCounter.table","NW_015090842.1:7380164",1,6,5
"WFDC1","s1639_F_VTA_03_ASEReadCounter.table","NW_015090842.1:7380237",3,9,6
"WFDC1","s1639_F_VTA_03_ASEReadCounter.table","NW_015090842.1:7380261",3,7,4
"WFDC1","s1639_F_VTA_03_ASEReadCounter.table","NW_015090842.1:7380322",1,5,4
"WFDC1","s1639_F_VTA_03_ASEReadCounter.table","NW_015090842.1:7380491",0,5,5
"WFDC1","s1639_F_VTA_03_ASEReadCounter.table","NW_015090842.1:7380567",1,7,6
"WFDC1","s1639_F_VTA_03_ASEReadCounter.table","NW_015090842.1:7380672",2,7,5
"WFDC1","s1639_F_VTA_03_ASEReadCounter.table","NW_015090842.1:7380721",3,11,8
"WFDC1","s1639_F_VTA_03_ASEReadCounter.table","NW_015090842.1:7380743",2,14,12
"WFDC1","s1639_F_VTA_03_ASEReadCounter.table","NW_015090842.1:7380852",3,9,6
"WFDC1","s1639_F_VTA_03_ASEReadCounter.table","NW_015090842.1:7380878",3,8,5
"WFDC1","s1639_F_VTA_03_ASEReadCounter.table","NW_015090842.1:7381081",2,12,10
"WFDC1","s1639_F_VTA_03_ASEReadCounter.table","NW_015090842.1:7381127",4,13,9
"WFDC1","s1639_F_VTA_03_ASEReadCounter.table","NW_015090842.1:7381195",4,12,8
"WFDC1","s1639_F_VTA_03_ASEReadCounter.table","NW_015090842.1:7381253",6,16,10
"WFDC1","s1639_F_VTA_03_ASEReadCounter.table","NW_015090842.1:7381378",8,16,8
"WFDC1","s1639_F_VTA_03_ASEReadCounter.table","NW_015090842.1:7381433",8,20,12
"WFDC1","s1639_F_VTA_03_ASEReadCounter.table","NW_015090842.1:7381434",8,20,12
"WFDC1","s1639_F_VTA_03_ASEReadCounter.table","NW_015090842.1:7381442",8,22,14
"WFDC1","s1639_F_VTA_03_ASEReadCounter.table","NW_015090842.1:7381517",6,11,5
"WFDC1","s1639_F_VTA_03_ASEReadCounter.table","NW_015090842.1:7381520",6,12,6
"WFDC1","s1639_F_VTA_03_ASEReadCounter.table","NW_015090842.1:7381677",3,9,6
"WFDC1","s1639_F_VTA_03_ASEReadCounter.table","NW_015090842.1:7381709",0,5,5
"ATP2C2","s1639_F_VTA_03_ASEReadCounter.table","NW_015090842.1:7392613",1,1,0
"ATP2C2","s1639_F_VTA_03_ASEReadCounter.table","NW_015090842.1:7395230",1,1,0
"ATP2C2","s1639_F_VTA_03_ASEReadCounter.table","NW_015090842.1:7396756",2,2,0
"ATP2C2","s1639_F_VTA_03_ASEReadCounter.table","NW_015090842.1:7397049",3,3,0
"ATP2C2","s1639_F_VTA_03_ASEReadCounter.table","NW_015090842.1:7398395",1,1,0
"ATP2C2","s1639_F_VTA_03_ASEReadCounter.table","NW_015090842.1:7405621",1,1,0
"ATP2C2","s1639_F_VTA_03_ASEReadCounter.table","NW_015090842.1:7413855",20,35,15
"ATP2C2","s1639_F_VTA_03_ASEReadCounter.table","NW_015090842.1:7413869",2,18,16
"ATP2C2","s1639_F_VTA_03_ASEReadCounter.table","NW_015090842.1:7413875",1,19,18
"TLDC1","s1639_F_VTA_03_ASEReadCounter.table","NW_015090842.1:7421137",34,69,35
"TLDC1","s1639_F_VTA_03_ASEReadCounter.table","NW_015090842.1:7421155",28,64,36
"TLDC1","s1639_F_VTA_03_ASEReadCounter.table","NW_015090842.1:7421218",27,54,27
"TLDC1","s1639_F_VTA_03_ASEReadCounter.table","NW_015090842.1:7421399",29,48,19
"TLDC1","s1639_F_VTA_03_ASEReadCounter.table","NW_015090842.1:7421402",31,50,19
"TLDC1","s1639_F_VTA_03_ASEReadCounter.table","NW_015090842.1:7421528",22,44,22
"TLDC1","s1639_F_VTA_03_ASEReadCounter.table","NW_015090842.1:7421532",21,42,21
"TLDC1","s1639_F_VTA_03_ASEReadCounter.table","NW_015090842.1:7421621",26,48,22
"TLDC1","s1639_F_VTA_03_ASEReadCounter.table","NW_015090842.1:7421647",22,45,23
"TLDC1","s1639_F_VTA_03_ASEReadCounter.table","NW_015090842.1:7421657",20,39,19
"TLDC1","s1639_F_VTA_03_ASEReadCounter.table","NW_015090842.1:7421693",28,47,19
"TLDC1","s1639_F_VTA_03_ASEReadCounter.table","NW_015090842.1:7421796",21,46,25
"TLDC1","s1639_F_VTA_03_ASEReadCounter.table","NW_015090842.1:7421810",22,44,22
"TLDC1","s1639_F_VTA_03_ASEReadCounter.table","NW_015090842.1:7421833",26,49,23
"TLDC1","s1639_F_VTA_03_ASEReadCounter.table","NW_015090842.1:7421879",29,49,20
"TLDC1","s1639_F_VTA_03_ASEReadCounter.table","NW_015090842.1:7421914",35,55,20
"TLDC1","s1639_F_VTA_03_ASEReadCounter.table","NW_015090842.1:7421969",26,44,18
"TLDC1","s1639_F_VTA_03_ASEReadCounter.table","NW_015090842.1:7422015",14,35,21
"TLDC1","s1639_F_VTA_03_ASEReadCounter.table","NW_015090842.1:7422042",19,42,23
"TLDC1","s1639_F_VTA_03_ASEReadCounter.table","NW_015090842.1:7422230",23,40,17
"TLDC1","s1639_F_VTA_03_ASEReadCounter.table","NW_015090842.1:7423349",30,50,20
"TLDC1","s1639_F_VTA_03_ASEReadCounter.table","NW_015090842.1:7423362",25,45,20
"TLDC1","s1639_F_VTA_03_ASEReadCounter.table","NW_015090842.1:7426091",13,23,10
"TLDC1","s1639_F_VTA_03_ASEReadCounter.table","NW_015090842.1:7426485",16,27,11
"TLDC1","s1639_F_VTA_03_ASEReadCounter.table","NW_015090842.1:7427211",20,31,11
"TLDC1","s1639_F_VTA_03_ASEReadCounter.table","NW_015090842.1:7428179",10,21,11
"COTL1","s1639_F_VTA_03_ASEReadCounter.table","NW_015090842.1:7490744",412,920,508
"COTL1","s1639_F_VTA_03_ASEReadCounter.table","NW_015090842.1:7491051",310,662,352
"COTL1","s1639_F_VTA_03_ASEReadCounter.table","NW_015090842.1:7491124",304,672,368
"COTL1","s1639_F_VTA_03_ASEReadCounter.table","NW_015090842.1:7491418",165,361,196
"COTL1","s1639_F_VTA_03_ASEReadCounter.table","NW_015090842.1:7491539",147,302,155
"COTL1","s1639_F_VTA_03_ASEReadCounter.table","NW_015090842.1:7491585",239,470,231
"COTL1","s1639_F_VTA_03_ASEReadCounter.table","NW_015090842.1:7491586",237,486,249
"COTL1","s1639_F_VTA_03_ASEReadCounter.table","NW_015090842.1:7491646",253,568,315
"COTL1","s1639_F_VTA_03_ASEReadCounter.table","NW_015090842.1:7491747",204,427,223
"COTL1","s1639_F_VTA_03_ASEReadCounter.table","NW_015090842.1:7491803",184,391,207
"COTL1","s1639_F_VTA_03_ASEReadCounter.table","NW_015090842.1:7513196",1,2,1
"COTL1","s1639_F_VTA_03_ASEReadCounter.table","NW_015090842.1:7513223",1,1,0
"COTL1","s1639_F_VTA_03_ASEReadCounter.table","NW_015090842.1:7513239",1,1,0
"KLHL36","s1639_F_VTA_03_ASEReadCounter.table","NW_015090842.1:7514700",18,26,8
"KLHL36","s1639_F_VTA_03_ASEReadCounter.table","NW_015090842.1:7519691",2,4,2
"KLHL36","s1639_F_VTA_03_ASEReadCounter.table","NW_015090842.1:7519696",2,4,2
"KLHL36","s1639_F_VTA_03_ASEReadCounter.table","NW_015090842.1:7526160",6,15,9
"KLHL36","s1639_F_VTA_03_ASEReadCounter.table","NW_015090842.1:7526469",4,10,6
"KLHL36","s1639_F_VTA_03_ASEReadCounter.table","NW_015090842.1:7526587",4,14,10
"KLHL36","s1639_F_VTA_03_ASEReadCounter.table","NW_015090842.1:7526997",7,18,11
"KLHL36","s1639_F_VTA_03_ASEReadCounter.table","NW_015090842.1:7527142",7,16,9
"KLHL36","s1639_F_VTA_03_ASEReadCounter.table","NW_015090842.1:7535174",18,47,29
"KLHL36","s1639_F_VTA_03_ASEReadCounter.table","NW_015090842.1:7535384",13,26,13
"KLHL36","s1639_F_VTA_03_ASEReadCounter.table","NW_015090842.1:7535420",14,29,15
"KLHL36","s1639_F_VTA_03_ASEReadCounter.table","NW_015090842.1:7535545",12,22,10
"KLHL36","s1639_F_VTA_03_ASEReadCounter.table","NW_015090842.1:7535829",29,44,15
"KLHL36","s1639_F_VTA_03_ASEReadCounter.table","NW_015090842.1:7535977",14,24,10
"KLHL36","s1639_F_VTA_03_ASEReadCounter.table","NW_015090842.1:7536010",19,29,10
"KLHL36","s1639_F_VTA_03_ASEReadCounter.table","NW_015090842.1:7536051",27,40,13
"KLHL36","s1639_F_VTA_03_ASEReadCounter.table","NW_015090842.1:7536096",28,40,12
"KLHL36","s1639_F_VTA_03_ASEReadCounter.table","NW_015090842.1:7536135",26,32,6
"KLHL36","s1639_F_VTA_03_ASEReadCounter.table","NW_015090842.1:7536136",27,33,6
"KLHL36","s1639_F_VTA_03_ASEReadCounter.table","NW_015090842.1:7536160",32,40,8
"KLHL36","s1639_F_VTA_03_ASEReadCounter.table","NW_015090842.1:7536336",23,42,19
"KLHL36","s1639_F_VTA_03_ASEReadCounter.table","NW_015090842.1:7536352",19,37,18
"KLHL36","s1639_F_VTA_03_ASEReadCounter.table","NW_015090842.1:7536412",9,26,17
"KLHL36","s1639_F_VTA_03_ASEReadCounter.table","NW_015090842.1:7536418",7,23,16
"KLHL36","s1639_F_VTA_03_ASEReadCounter.table","NW_015090842.1:7536465",14,31,17
"KLHL36","s1639_F_VTA_03_ASEReadCounter.table","NW_015090842.1:7536466",16,32,16
"KLHL36","s1639_F_VTA_03_ASEReadCounter.table","NW_015090842.1:7536553",19,40,21
"KLHL36","s1639_F_VTA_03_ASEReadCounter.table","NW_015090842.1:7536698",15,48,33
"KLHL36","s1639_F_VTA_03_ASEReadCounter.table","NW_015090842.1:7536713",7,43,36
"KLHL36","s1639_F_VTA_03_ASEReadCounter.table","NW_015090842.1:7536720",16,44,28
"KLHL36","s1639_F_VTA_03_ASEReadCounter.table","NW_015090842.1:7536791",24,56,32
"KLHL36","s1639_F_VTA_03_ASEReadCounter.table","NW_015090842.1:7536849",14,45,31
"KLHL36","s1639_F_VTA_03_ASEReadCounter.table","NW_015090842.1:7536872",14,46,32
"KLHL36","s1639_F_VTA_03_ASEReadCounter.table","NW_015090842.1:7536878",19,46,27
"KLHL36","s1639_F_VTA_03_ASEReadCounter.table","NW_015090842.1:7536916",26,55,29
"KLHL36","s1639_F_VTA_03_ASEReadCounter.table","NW_015090842.1:7536927",27,70,43
"KLHL36","s1639_F_VTA_03_ASEReadCounter.table","NW_015090842.1:7537315",42,88,46
"KLHL36","s1639_F_VTA_03_ASEReadCounter.table","NW_015090842.1:7537352",36,77,41
"KLHL36","s1639_F_VTA_03_ASEReadCounter.table","NW_015090842.1:7537631",48,93,45
"KLHL36","s1639_F_VTA_03_ASEReadCounter.table","NW_015090842.1:7537830",71,116,45
"KLHL36","s1639_F_VTA_03_ASEReadCounter.table","NW_015090842.1:7537838",61,108,47
"KLHL36","s1639_F_VTA_03_ASEReadCounter.table","NW_015090842.1:7538153",43,89,46
"KLHL36","s1639_F_VTA_03_ASEReadCounter.table","NW_015090842.1:7538256",29,72,43
"KLHL36","s1639_F_VTA_03_ASEReadCounter.table","NW_015090842.1:7538265",30,68,38
"KLHL36","s1639_F_VTA_03_ASEReadCounter.table","NW_015090842.1:7538300",28,64,36
"USP10","s1639_F_VTA_03_ASEReadCounter.table","NW_015090842.1:7563972",7,11,4
"USP10","s1639_F_VTA_03_ASEReadCounter.table","NW_015090842.1:7571816",12,31,19
"USP10","s1639_F_VTA_03_ASEReadCounter.table","NW_015090842.1:7571993",11,32,21
"USP10","s1639_F_VTA_03_ASEReadCounter.table","NW_015090842.1:7572580",19,44,25
"USP10","s1639_F_VTA_03_ASEReadCounter.table","NW_015090842.1:7587372",63,126,63
"CRISPLD2","s1639_F_VTA_03_ASEReadCounter.table","NW_015090842.1:7604605",0,1,1
"CRISPLD2","s1639_F_VTA_03_ASEReadCounter.table","NW_015090842.1:7609844",1,2,1
"CRISPLD2","s1639_F_VTA_03_ASEReadCounter.table","NW_015090842.1:7609845",1,2,1
"CRISPLD2","s1639_F_VTA_03_ASEReadCounter.table","NW_015090842.1:7609883",1,2,1
"CRISPLD2","s1639_F_VTA_03_ASEReadCounter.table","NW_015090842.1:7610084",2,2,0
"CRISPLD2","s1639_F_VTA_03_ASEReadCounter.table","NW_015090842.1:7617757",2,4,2
"CRISPLD2","s1639_F_VTA_03_ASEReadCounter.table","NW_015090842.1:7617781",1,2,1
"CRISPLD2","s1639_F_VTA_03_ASEReadCounter.table","NW_015090842.1:7617790",1,2,1
"CRISPLD2","s1639_F_VTA_03_ASEReadCounter.table","NW_015090842.1:7621452",1,2,1
"CRISPLD2","s1639_F_VTA_03_ASEReadCounter.table","NW_015090842.1:7625451",11,11,0
"CRISPLD2","s1639_F_VTA_03_ASEReadCounter.table","NW_015090842.1:7626214",5,6,1
"CRISPLD2","s1639_F_VTA_03_ASEReadCounter.table","NW_015090842.1:7630784",4,6,2
"CRISPLD2","s1639_F_VTA_03_ASEReadCounter.table","NW_015090842.1:7630823",3,5,2
"CRISPLD2","s1639_F_VTA_03_ASEReadCounter.table","NW_015090842.1:7633172",6,6,0
"CRISPLD2","s1639_F_VTA_03_ASEReadCounter.table","NW_015090842.1:7633326",6,7,1
"CRISPLD2","s1639_F_VTA_03_ASEReadCounter.table","NW_015090842.1:7633336",6,7,1
"CRISPLD2","s1639_F_VTA_03_ASEReadCounter.table","NW_015090842.1:7633381",4,5,1
"CRISPLD2","s1639_F_VTA_03_ASEReadCounter.table","NW_015090842.1:7633388",4,5,1
"CRISPLD2","s1639_F_VTA_03_ASEReadCounter.table","NW_015090842.1:7633400",3,4,1
"CRISPLD2","s1639_F_VTA_03_ASEReadCounter.table","NW_015090842.1:7633486",9,9,0
"CRISPLD2","s1639_F_VTA_03_ASEReadCounter.table","NW_015090842.1:7633503",9,9,0
"CRISPLD2","s1639_F_VTA_03_ASEReadCounter.table","NW_015090842.1:7633504",8,8,0
"CRISPLD2","s1639_F_VTA_03_ASEReadCounter.table","NW_015090842.1:7633557",8,8,0
"CRISPLD2","s1639_F_VTA_03_ASEReadCounter.table","NW_015090842.1:7633571",6,6,0
"CRISPLD2","s1639_F_VTA_03_ASEReadCounter.table","NW_015090842.1:7633588",7,7,0
"CRISPLD2","s1639_F_VTA_03_ASEReadCounter.table","NW_015090842.1:7633617",8,8,0
"CRISPLD2","s1639_F_VTA_03_ASEReadCounter.table","NW_015090842.1:7633695",9,11,2
"CRISPLD2","s1639_F_VTA_03_ASEReadCounter.table","NW_015090842.1:7633721",9,11,2
"CRISPLD2","s1639_F_VTA_03_ASEReadCounter.table","NW_015090842.1:7633888",7,7,0
"CRISPLD2","s1639_F_VTA_03_ASEReadCounter.table","NW_015090842.1:7633910",7,8,1
"CRISPLD2","s1639_F_VTA_03_ASEReadCounter.table","NW_015090842.1:7634142",3,3,0
"CRISPLD2","s1639_F_VTA_03_ASEReadCounter.table","NW_015090842.1:7634417",4,6,2
"CRISPLD2","s1639_F_VTA_03_ASEReadCounter.table","NW_015090842.1:7634825",8,8,0
"CRISPLD2","s1639_F_VTA_03_ASEReadCounter.table","NW_015090842.1:7634852",6,6,0
"CRISPLD2","s1639_F_VTA_03_ASEReadCounter.table","NW_015090842.1:7635009",4,4,0
"CRISPLD2","s1639_F_VTA_03_ASEReadCounter.table","NW_015090842.1:7635208",7,10,3
"CRISPLD2","s1639_F_VTA_03_ASEReadCounter.table","NW_015090842.1:7635373",5,7,2
"CRISPLD2","s1639_F_VTA_03_ASEReadCounter.table","NW_015090842.1:7635525",4,5,1
"CRISPLD2","s1639_F_VTA_03_ASEReadCounter.table","NW_015090842.1:7635583",4,5,1
"CRISPLD2","s1639_F_VTA_03_ASEReadCounter.table","NW_015090842.1:7635924",4,8,4
"LOC106888312","s1639_F_VTA_03_ASEReadCounter.table","NW_015090842.1:7727001",1,2,1
"LOC106888312","s1639_F_VTA_03_ASEReadCounter.table","NW_015090842.1:7727036",0,1,1
"LOC106888312","s1639_F_VTA_03_ASEReadCounter.table","NW_015090842.1:7731961",0,1,1
"LOC106888312","s1639_F_VTA_03_ASEReadCounter.table","NW_015090842.1:7732244",1,2,1
"LOC106888312","s1639_F_VTA_03_ASEReadCounter.table","NW_015090842.1:7732443",0,2,2
"LOC106888312","s1639_F_VTA_03_ASEReadCounter.table","NW_015090842.1:7732444",0,2,2
"LOC106888312","s1639_F_VTA_03_ASEReadCounter.table","NW_015090842.1:7732538",0,1,1
"LOC106888312","s1639_F_VTA_03_ASEReadCounter.table","NW_015090842.1:7732548",0,1,1
"LOC106888312","s1639_F_VTA_03_ASEReadCounter.table","NW_015090842.1:7732576",0,1,1
"LOC106888312","s1639_F_VTA_03_ASEReadCounter.table","NW_015090842.1:7732580",0,1,1
"LOC106888312","s1639_F_VTA_03_ASEReadCounter.table","NW_015090842.1:7732782",0,1,1
"LOC106888312","s1639_F_VTA_03_ASEReadCounter.table","NW_015090842.1:7732796",0,1,1
"LOC106888312","s1639_F_VTA_03_ASEReadCounter.table","NW_015090842.1:7732860",0,1,1
"LOC106888312","s1639_F_VTA_03_ASEReadCounter.table","NW_015090842.1:7732861",0,1,1
"LOC106888312","s1639_F_VTA_03_ASEReadCounter.table","NW_015090842.1:7732918",0,1,1
"LOC106888312","s1639_F_VTA_03_ASEReadCounter.table","NW_015090842.1:7732997",0,3,3
"LOC106888312","s1639_F_VTA_03_ASEReadCounter.table","NW_015090842.1:7733011",0,2,2
"LOC106888312","s1639_F_VTA_03_ASEReadCounter.table","NW_015090842.1:7733046",0,1,1
"LOC106888312","s1639_F_VTA_03_ASEReadCounter.table","NW_015090842.1:7733068",0,1,1
"LOC106888312","s1639_F_VTA_03_ASEReadCounter.table","NW_015090842.1:7733077",0,1,1
"LOC106888312","s1639_F_VTA_03_ASEReadCounter.table","NW_015090842.1:7733142",0,2,2
"LOC106888312","s1639_F_VTA_03_ASEReadCounter.table","NW_015090842.1:7733196",0,2,2
"LOC106888312","s1639_F_VTA_03_ASEReadCounter.table","NW_015090842.1:7733299",1,2,1
"LOC106888312","s1639_F_VTA_03_ASEReadCounter.table","NW_015090842.1:7733470",0,1,1
"LOC106888312","s1639_F_VTA_03_ASEReadCounter.table","NW_015090842.1:7733471",0,1,1
"LOC106888312","s1639_F_VTA_03_ASEReadCounter.table","NW_015090842.1:7733472",0,1,1
"LOC106888312","s1639_F_VTA_03_ASEReadCounter.table","NW_015090842.1:7733507",0,1,1
"LOC106888312","s1639_F_VTA_03_ASEReadCounter.table","NW_015090842.1:7733508",0,1,1
"LOC106888312","s1639_F_VTA_03_ASEReadCounter.table","NW_015090842.1:7733518",0,1,1
"LOC106888312","s1639_F_VTA_03_ASEReadCounter.table","NW_015090842.1:7733609",1,3,2
"LOC106888312","s1639_F_VTA_03_ASEReadCounter.table","NW_015090842.1:7733631",1,2,1
"LOC106888312","s1639_F_VTA_03_ASEReadCounter.table","NW_015090842.1:7733674",0,2,2
"ZDHHC7","s1639_F_VTA_03_ASEReadCounter.table","NW_015090842.1:7737199",24,68,44
"ZDHHC7","s1639_F_VTA_03_ASEReadCounter.table","NW_015090842.1:7737332",25,49,24
"ZDHHC7","s1639_F_VTA_03_ASEReadCounter.table","NW_015090842.1:7737553",37,70,33
"ZDHHC7","s1639_F_VTA_03_ASEReadCounter.table","NW_015090842.1:7737920",15,34,19
"ZDHHC7","s1639_F_VTA_03_ASEReadCounter.table","NW_015090842.1:7737953",15,33,18
"ZDHHC7","s1639_F_VTA_03_ASEReadCounter.table","NW_015090842.1:7737987",22,39,17
"ZDHHC7","s1639_F_VTA_03_ASEReadCounter.table","NW_015090842.1:7738068",16,27,11
"ZDHHC7","s1639_F_VTA_03_ASEReadCounter.table","NW_015090842.1:7738204",15,30,15
"LOC106888097","s1639_F_VTA_03_ASEReadCounter.table","NW_015090842.1:7767178",10,20,10
"LOC106888097","s1639_F_VTA_03_ASEReadCounter.table","NW_015090842.1:7767187",9,19,10
"LOC106888097","s1639_F_VTA_03_ASEReadCounter.table","NW_015090842.1:7768144",11,29,18
"LOC106888097","s1639_F_VTA_03_ASEReadCounter.table","NW_015090842.1:7768196",13,30,17
"LOC106888097","s1639_F_VTA_03_ASEReadCounter.table","NW_015090842.1:7769884",10,26,16
"LOC106888097","s1639_F_VTA_03_ASEReadCounter.table","NW_015090842.1:7769893",7,21,14
"LOC106888097","s1639_F_VTA_03_ASEReadCounter.table","NW_015090842.1:7770245",12,30,18
"LOC106888097","s1639_F_VTA_03_ASEReadCounter.table","NW_015090842.1:7772402",14,38,24
"LOC106888097","s1639_F_VTA_03_ASEReadCounter.table","NW_015090842.1:7772483",15,40,25
"LOC106888097","s1639_F_VTA_03_ASEReadCounter.table","NW_015090842.1:7772490",14,38,24
"LOC106888097","s1639_F_VTA_03_ASEReadCounter.table","NW_015090842.1:7774281",26,55,29
"LOC106888097","s1639_F_VTA_03_ASEReadCounter.table","NW_015090842.1:7774552",32,92,60
"LOC106888097","s1639_F_VTA_03_ASEReadCounter.table","NW_015090842.1:7774564",31,89,58
"LOC106888097","s1639_F_VTA_03_ASEReadCounter.table","NW_015090842.1:7774611",15,78,63
"LOC106888097","s1639_F_VTA_03_ASEReadCounter.table","NW_015090842.1:7774681",21,70,49
"LOC106888097","s1639_F_VTA_03_ASEReadCounter.table","NW_015090842.1:7774698",18,56,38
"LOC106888097","s1639_F_VTA_03_ASEReadCounter.table","NW_015090842.1:7774730",10,35,25
"LOC106888097","s1639_F_VTA_03_ASEReadCounter.table","NW_015090842.1:7774778",2,3,1
"LOC106888097","s1639_F_VTA_03_ASEReadCounter.table","NW_015090842.1:7774793",3,4,1
"FOXC2","s1639_F_VTA_03_ASEReadCounter.table","NW_015090842.1:8129599",5,14,9
"FOXC2","s1639_F_VTA_03_ASEReadCounter.table","NW_015090842.1:8129616",6,17,11
"FOXC2","s1639_F_VTA_03_ASEReadCounter.table","NW_015090842.1:8129715",8,18,10
"FOXC2","s1639_F_VTA_03_ASEReadCounter.table","NW_015090842.1:8129719",8,18,10
"FOXC2","s1639_F_VTA_03_ASEReadCounter.table","NW_015090842.1:8130244",5,11,6
"FOXC2","s1639_F_VTA_03_ASEReadCounter.table","NW_015090842.1:8130472",4,8,4
"FOXC2","s1639_F_VTA_03_ASEReadCounter.table","NW_015090842.1:8130490",4,8,4
"FOXC2","s1639_F_VTA_03_ASEReadCounter.table","NW_015090842.1:8130547",2,4,2
"FOXC2","s1639_F_VTA_03_ASEReadCounter.table","NW_015090842.1:8130550",2,4,2
"FOXC2","s1639_F_VTA_03_ASEReadCounter.table","NW_015090842.1:8130573",3,5,2
"FOXC2","s1639_F_VTA_03_ASEReadCounter.table","NW_015090842.1:8130575",3,5,2
"MTHFSD","s1639_F_VTA_03_ASEReadCounter.table","NW_015090842.1:8140051",9,18,9
"MTHFSD","s1639_F_VTA_03_ASEReadCounter.table","NW_015090842.1:8142923",18,35,17
"MTHFSD","s1639_F_VTA_03_ASEReadCounter.table","NW_015090842.1:8143029",16,35,19
"MTHFSD","s1639_F_VTA_03_ASEReadCounter.table","NW_015090842.1:8152035",13,32,19
"MTHFSD","s1639_F_VTA_03_ASEReadCounter.table","NW_015090842.1:8152315",9,30,21
"MTHFSD","s1639_F_VTA_03_ASEReadCounter.table","NW_015090842.1:8152511",11,29,18
"MTHFSD","s1639_F_VTA_03_ASEReadCounter.table","NW_015090842.1:8152518",10,27,17
"MTHFSD","s1639_F_VTA_03_ASEReadCounter.table","NW_015090842.1:8152553",12,21,9
"MTHFSD","s1639_F_VTA_03_ASEReadCounter.table","NW_015090842.1:8152773",17,35,18
"MTHFSD","s1639_F_VTA_03_ASEReadCounter.table","NW_015090842.1:8152805",18,37,19
"FOXF1","s1639_F_VTA_03_ASEReadCounter.table","NW_015090842.1:8167113",0,1,1
"IRF8","s1639_F_VTA_03_ASEReadCounter.table","NW_015090842.1:8406652",15,31,16
"IRF8","s1639_F_VTA_03_ASEReadCounter.table","NW_015090842.1:8406703",15,26,11
"IRF8","s1639_F_VTA_03_ASEReadCounter.table","NW_015090842.1:8406704",15,26,11
"IRF8","s1639_F_VTA_03_ASEReadCounter.table","NW_015090842.1:8406757",16,30,14
"IRF8","s1639_F_VTA_03_ASEReadCounter.table","NW_015090842.1:8406778",18,29,11
"IRF8","s1639_F_VTA_03_ASEReadCounter.table","NW_015090842.1:8406819",13,28,15
"IRF8","s1639_F_VTA_03_ASEReadCounter.table","NW_015090842.1:8406941",10,31,21
"IRF8","s1639_F_VTA_03_ASEReadCounter.table","NW_015090842.1:8407008",9,19,10
"IRF8","s1639_F_VTA_03_ASEReadCounter.table","NW_015090842.1:8407057",11,18,7
"IRF8","s1639_F_VTA_03_ASEReadCounter.table","NW_015090842.1:8407064",11,19,8
"IRF8","s1639_F_VTA_03_ASEReadCounter.table","NW_015090842.1:8407069",13,22,9
"IRF8","s1639_F_VTA_03_ASEReadCounter.table","NW_015090842.1:8407120",15,24,9
"IRF8","s1639_F_VTA_03_ASEReadCounter.table","NW_015090842.1:8407157",12,24,12
"IRF8","s1639_F_VTA_03_ASEReadCounter.table","NW_015090842.1:8407203",10,21,11
"IRF8","s1639_F_VTA_03_ASEReadCounter.table","NW_015090842.1:8407272",10,21,11
"IRF8","s1639_F_VTA_03_ASEReadCounter.table","NW_015090842.1:8407276",10,19,9
"IRF8","s1639_F_VTA_03_ASEReadCounter.table","NW_015090842.1:8407303",16,29,13
"IRF8","s1639_F_VTA_03_ASEReadCounter.table","NW_015090842.1:8407451",21,27,6
"IRF8","s1639_F_VTA_03_ASEReadCounter.table","NW_015090842.1:8407456",18,23,5
"IRF8","s1639_F_VTA_03_ASEReadCounter.table","NW_015090842.1:8408564",13,23,10
"IRF8","s1639_F_VTA_03_ASEReadCounter.table","NW_015090842.1:8408585",19,19,0
"IRF8","s1639_F_VTA_03_ASEReadCounter.table","NW_015090842.1:8408973",11,18,7
"IRF8","s1639_F_VTA_03_ASEReadCounter.table","NW_015090842.1:8409060",7,16,9
"IRF8","s1639_F_VTA_03_ASEReadCounter.table","NW_015090842.1:8409065",7,16,9
"IRF8","s1639_F_VTA_03_ASEReadCounter.table","NW_015090842.1:8409254",7,13,6
"IRF8","s1639_F_VTA_03_ASEReadCounter.table","NW_015090842.1:8409255",7,13,6
"IRF8","s1639_F_VTA_03_ASEReadCounter.table","NW_015090842.1:8409258",7,14,7
"IRF8","s1639_F_VTA_03_ASEReadCounter.table","NW_015090842.1:8409312",6,16,10
"IRF8","s1639_F_VTA_03_ASEReadCounter.table","NW_015090842.1:8410216",3,9,6
"IRF8","s1639_F_VTA_03_ASEReadCounter.table","NW_015090842.1:8410237",5,10,5
"IRF8","s1639_F_VTA_03_ASEReadCounter.table","NW_015090842.1:8410276",16,16,0
"IRF8","s1639_F_VTA_03_ASEReadCounter.table","NW_015090842.1:8410813",23,34,11
"IRF8","s1639_F_VTA_03_ASEReadCounter.table","NW_015090842.1:8410861",21,31,10
"IRF8","s1639_F_VTA_03_ASEReadCounter.table","NW_015090842.1:8411940",16,24,8
"IRF8","s1639_F_VTA_03_ASEReadCounter.table","NW_015090842.1:8412006",6,11,5
"IRF8","s1639_F_VTA_03_ASEReadCounter.table","NW_015090842.1:8412042",5,12,7
"DUSP15","s1639_F_VTA_03_ASEReadCounter.table","NW_015090842.1:8422787",3,3,0
"DUSP15","s1639_F_VTA_03_ASEReadCounter.table","NW_015090842.1:8422832",4,4,0
"DUSP15","s1639_F_VTA_03_ASEReadCounter.table","NW_015090842.1:8422898",1,1,0
"DUSP15","s1639_F_VTA_03_ASEReadCounter.table","NW_015090842.1:8422909",1,1,0
"COX4I1","s1639_F_VTA_03_ASEReadCounter.table","NW_015090842.1:8442258",1289,2480,1191
"COX4I1","s1639_F_VTA_03_ASEReadCounter.table","NW_015090842.1:8442333",982,1884,902
"EMC8","s1639_F_VTA_03_ASEReadCounter.table","NW_015090842.1:8444046",50,96,46
"EMC8","s1639_F_VTA_03_ASEReadCounter.table","NW_015090842.1:8444064",47,76,29
"EMC8","s1639_F_VTA_03_ASEReadCounter.table","NW_015090842.1:8452029",21,53,32
"EMC8","s1639_F_VTA_03_ASEReadCounter.table","NW_015090842.1:8452116",33,64,31
"EMC8","s1639_F_VTA_03_ASEReadCounter.table","NW_015090842.1:8452121",31,67,36
"EMC8","s1639_F_VTA_03_ASEReadCounter.table","NW_015090842.1:8452222",23,56,33
"EMC8","s1639_F_VTA_03_ASEReadCounter.table","NW_015090842.1:8452244",27,62,35
"EMC8","s1639_F_VTA_03_ASEReadCounter.table","NW_015090842.1:8452477",2,14,12
"EMC8","s1639_F_VTA_03_ASEReadCounter.table","NW_015090842.1:8452498",1,13,12
"EMC8","s1639_F_VTA_03_ASEReadCounter.table","NW_015090842.1:8452535",1,8,7
"EMC8","s1639_F_VTA_03_ASEReadCounter.table","NW_015090842.1:8452575",1,8,7
"EMC8","s1639_F_VTA_03_ASEReadCounter.table","NW_015090842.1:8452600",2,7,5
"EMC8","s1639_F_VTA_03_ASEReadCounter.table","NW_015090842.1:8452616",1,4,3
"EMC8","s1639_F_VTA_03_ASEReadCounter.table","NW_015090842.1:8452630",2,3,1
"EMC8","s1639_F_VTA_03_ASEReadCounter.table","NW_015090842.1:8452650",3,4,1
"EMC8","s1639_F_VTA_03_ASEReadCounter.table","NW_015090842.1:8452678",7,10,3
"EMC8","s1639_F_VTA_03_ASEReadCounter.table","NW_015090842.1:8452724",5,10,5
"EMC8","s1639_F_VTA_03_ASEReadCounter.table","NW_015090842.1:8452731",5,10,5
"EMC8","s1639_F_VTA_03_ASEReadCounter.table","NW_015090842.1:8452743",5,10,5
"EMC8","s1639_F_VTA_03_ASEReadCounter.table","NW_015090842.1:8452750",3,9,6
"EMC8","s1639_F_VTA_03_ASEReadCounter.table","NW_015090842.1:8452778",4,9,5
"EMC8","s1639_F_VTA_03_ASEReadCounter.table","NW_015090842.1:8452783",4,12,8
"EMC8","s1639_F_VTA_03_ASEReadCounter.table","NW_015090842.1:8452800",10,16,6
"EMC8","s1639_F_VTA_03_ASEReadCounter.table","NW_015090842.1:8452804",12,18,6
"EMC8","s1639_F_VTA_03_ASEReadCounter.table","NW_015090842.1:8452812",11,17,6
"EMC8","s1639_F_VTA_03_ASEReadCounter.table","NW_015090842.1:8452858",11,20,9
"EMC8","s1639_F_VTA_03_ASEReadCounter.table","NW_015090842.1:8452906",16,24,8
"EMC8","s1639_F_VTA_03_ASEReadCounter.table","NW_015090842.1:8452913",15,25,10
"EMC8","s1639_F_VTA_03_ASEReadCounter.table","NW_015090842.1:8453000",18,37,19
"EMC8","s1639_F_VTA_03_ASEReadCounter.table","NW_015090842.1:8453007",20,40,20
"EMC8","s1639_F_VTA_03_ASEReadCounter.table","NW_015090842.1:8453058",18,42,24
"EMC8","s1639_F_VTA_03_ASEReadCounter.table","NW_015090842.1:8453106",15,36,21
"GINS2","s1639_F_VTA_03_ASEReadCounter.table","NW_015090842.1:8466420",9,10,1
"GINS2","s1639_F_VTA_03_ASEReadCounter.table","NW_015090842.1:8466424",10,11,1
"GINS2","s1639_F_VTA_03_ASEReadCounter.table","NW_015090842.1:8466518",6,7,1
"GINS2","s1639_F_VTA_03_ASEReadCounter.table","NW_015090842.1:8468482",16,20,4
"GINS2","s1639_F_VTA_03_ASEReadCounter.table","NW_015090842.1:8470290",19,28,9
"GINS2","s1639_F_VTA_03_ASEReadCounter.table","NW_015090842.1:8470305",23,30,7
"GINS2","s1639_F_VTA_03_ASEReadCounter.table","NW_015090842.1:8470381",28,30,2
"GINS2","s1639_F_VTA_03_ASEReadCounter.table","NW_015090842.1:8470418",22,26,4
"GINS2","s1639_F_VTA_03_ASEReadCounter.table","NW_015090842.1:8470421",19,23,4
"GINS2","s1639_F_VTA_03_ASEReadCounter.table","NW_015090842.1:8470430",15,19,4
"GINS2","s1639_F_VTA_03_ASEReadCounter.table","NW_015090842.1:8470433",14,19,5
"GINS2","s1639_F_VTA_03_ASEReadCounter.table","NW_015090842.1:8470457",7,13,6
"GINS2","s1639_F_VTA_03_ASEReadCounter.table","NW_015090842.1:8470491",12,19,7
"GINS2","s1639_F_VTA_03_ASEReadCounter.table","NW_015090842.1:8470548",14,23,9
"GINS2","s1639_F_VTA_03_ASEReadCounter.table","NW_015090842.1:8470649",10,14,4
"GSE1","s1639_F_VTA_03_ASEReadCounter.table","NW_015090842.1:8475362",47,96,49
"GSE1","s1639_F_VTA_03_ASEReadCounter.table","NW_015090842.1:8475961",27,40,13
"GSE1","s1639_F_VTA_03_ASEReadCounter.table","NW_015090842.1:8476027",11,26,15
"GSE1","s1639_F_VTA_03_ASEReadCounter.table","NW_015090842.1:8476159",6,9,3
"GSE1","s1639_F_VTA_03_ASEReadCounter.table","NW_015090842.1:8477442",0,10,10
"GSE1","s1639_F_VTA_03_ASEReadCounter.table","NW_015090842.1:8477448",0,10,10
"GSE1","s1639_F_VTA_03_ASEReadCounter.table","NW_015090842.1:8477662",1,13,12
"GSE1","s1639_F_VTA_03_ASEReadCounter.table","NW_015090842.1:8477933",9,23,14
"GSE1","s1639_F_VTA_03_ASEReadCounter.table","NW_015090842.1:8477945",8,23,15
"GSE1","s1639_F_VTA_03_ASEReadCounter.table","NW_015090842.1:8483272",0,11,11
"GSE1","s1639_F_VTA_03_ASEReadCounter.table","NW_015090842.1:8483367",0,4,4
"GSE1","s1639_F_VTA_03_ASEReadCounter.table","NW_015090842.1:8483411",1,4,3
"GSE1","s1639_F_VTA_03_ASEReadCounter.table","NW_015090842.1:8483756",3,7,4
"GSE1","s1639_F_VTA_03_ASEReadCounter.table","NW_015090842.1:8486867",12,28,16
"GSE1","s1639_F_VTA_03_ASEReadCounter.table","NW_015090842.1:8486939",11,32,21
"GSE1","s1639_F_VTA_03_ASEReadCounter.table","NW_015090842.1:8486945",12,34,22
"GSE1","s1639_F_VTA_03_ASEReadCounter.table","NW_015090842.1:8486993",5,17,12
"GSE1","s1639_F_VTA_03_ASEReadCounter.table","NW_015090842.1:8487062",10,21,11
"GSE1","s1639_F_VTA_03_ASEReadCounter.table","NW_015090842.1:8488065",15,23,8
"GSE1","s1639_F_VTA_03_ASEReadCounter.table","NW_015090842.1:8488457",11,20,9
"GSE1","s1639_F_VTA_03_ASEReadCounter.table","NW_015090842.1:8488463",12,22,10
"GSE1","s1639_F_VTA_03_ASEReadCounter.table","NW_015090842.1:8488490",21,21,0
"GSE1","s1639_F_VTA_03_ASEReadCounter.table","NW_015090842.1:8488505",13,23,10
"GSE1","s1639_F_VTA_03_ASEReadCounter.table","NW_015090842.1:8490180",0,12,12
"KIAA0513","s1639_F_VTA_03_ASEReadCounter.table","NW_015090842.1:8668363",65,133,68
"KIAA0513","s1639_F_VTA_03_ASEReadCounter.table","NW_015090842.1:8668387",64,124,60
"KIAA0513","s1639_F_VTA_03_ASEReadCounter.table","NW_015090842.1:8668390",68,129,61
"KIAA0513","s1639_F_VTA_03_ASEReadCounter.table","NW_015090842.1:8673107",66,137,71
"KIAA0513","s1639_F_VTA_03_ASEReadCounter.table","NW_015090842.1:8673147",65,129,64
"KIAA0513","s1639_F_VTA_03_ASEReadCounter.table","NW_015090842.1:8674661",40,82,42
"KIAA0513","s1639_F_VTA_03_ASEReadCounter.table","NW_015090842.1:8674685",40,79,39
"KIAA0513","s1639_F_VTA_03_ASEReadCounter.table","NW_015090842.1:8674730",34,65,31
"KIAA0513","s1639_F_VTA_03_ASEReadCounter.table","NW_015090842.1:8675525",35,71,36
"KIAA0513","s1639_F_VTA_03_ASEReadCounter.table","NW_015090842.1:8675561",37,75,38
"KIAA0513","s1639_F_VTA_03_ASEReadCounter.table","NW_015090842.1:8678608",0,13,13
"KIAA0513","s1639_F_VTA_03_ASEReadCounter.table","NW_015090842.1:8686455",0,8,8
"KIAA0513","s1639_F_VTA_03_ASEReadCounter.table","NW_015090842.1:8686508",0,14,14
"KIAA0513","s1639_F_VTA_03_ASEReadCounter.table","NW_015090842.1:8686521",0,13,13
"KIAA0513","s1639_F_VTA_03_ASEReadCounter.table","NW_015090842.1:8693642",2,7,5
"KIAA0513","s1639_F_VTA_03_ASEReadCounter.table","NW_015090842.1:8693712",1,7,6
"KIAA0513","s1639_F_VTA_03_ASEReadCounter.table","NW_015090842.1:8695794",1,1,0
"FBXO31","s1639_F_VTA_03_ASEReadCounter.table","NW_015090842.1:8710240",23,47,24
"FBXO31","s1639_F_VTA_03_ASEReadCounter.table","NW_015090842.1:8710372",18,32,14
"FBXO31","s1639_F_VTA_03_ASEReadCounter.table","NW_015090842.1:8711239",30,47,17
"FBXO31","s1639_F_VTA_03_ASEReadCounter.table","NW_015090842.1:8714565",22,46,24
"FBXO31","s1639_F_VTA_03_ASEReadCounter.table","NW_015090842.1:8716001",20,27,7
"ZCCHC14","s1639_F_VTA_03_ASEReadCounter.table","NW_015090842.1:8750174",23,31,8
"ZCCHC14","s1639_F_VTA_03_ASEReadCounter.table","NW_015090842.1:8750189",26,32,6
"ZCCHC14","s1639_F_VTA_03_ASEReadCounter.table","NW_015090842.1:8750365",28,42,14
"ZCCHC14","s1639_F_VTA_03_ASEReadCounter.table","NW_015090842.1:8750433",22,32,10
"ZCCHC14","s1639_F_VTA_03_ASEReadCounter.table","NW_015090842.1:8750449",18,29,11
"ZCCHC14","s1639_F_VTA_03_ASEReadCounter.table","NW_015090842.1:8750456",18,29,11
"ZCCHC14","s1639_F_VTA_03_ASEReadCounter.table","NW_015090842.1:8750497",19,32,13
"ZCCHC14","s1639_F_VTA_03_ASEReadCounter.table","NW_015090842.1:8750547",20,32,12
"ZCCHC14","s1639_F_VTA_03_ASEReadCounter.table","NW_015090842.1:8751100",6,11,5
"ZCCHC14","s1639_F_VTA_03_ASEReadCounter.table","NW_015090842.1:8751374",21,30,9
"ZCCHC14","s1639_F_VTA_03_ASEReadCounter.table","NW_015090842.1:8751403",24,35,11
"ZCCHC14","s1639_F_VTA_03_ASEReadCounter.table","NW_015090842.1:8751517",15,20,5
"ZCCHC14","s1639_F_VTA_03_ASEReadCounter.table","NW_015090842.1:8752060",16,31,15
"ZCCHC14","s1639_F_VTA_03_ASEReadCounter.table","NW_015090842.1:8752172",12,35,23
"ZCCHC14","s1639_F_VTA_03_ASEReadCounter.table","NW_015090842.1:8752183",10,32,22
"ZCCHC14","s1639_F_VTA_03_ASEReadCounter.table","NW_015090842.1:8752198",8,28,20
"ZCCHC14","s1639_F_VTA_03_ASEReadCounter.table","NW_015090842.1:8752248",12,32,20
"ZCCHC14","s1639_F_VTA_03_ASEReadCounter.table","NW_015090842.1:8752326",20,36,16
"ZCCHC14","s1639_F_VTA_03_ASEReadCounter.table","NW_015090842.1:8752393",19,34,15
"ZCCHC14","s1639_F_VTA_03_ASEReadCounter.table","NW_015090842.1:8752914",11,30,19
"ZCCHC14","s1639_F_VTA_03_ASEReadCounter.table","NW_015090842.1:8753528",7,12,5
"ZCCHC14","s1639_F_VTA_03_ASEReadCounter.table","NW_015090842.1:8753892",5,8,3
"ZCCHC14","s1639_F_VTA_03_ASEReadCounter.table","NW_015090842.1:8753910",8,13,5
"ZCCHC14","s1639_F_VTA_03_ASEReadCounter.table","NW_015090842.1:8755096",2,6,4
"ZCCHC14","s1639_F_VTA_03_ASEReadCounter.table","NW_015090842.1:8755327",4,6,2
"ZCCHC14","s1639_F_VTA_03_ASEReadCounter.table","NW_015090842.1:8755723",5,9,4
"ZCCHC14","s1639_F_VTA_03_ASEReadCounter.table","NW_015090842.1:8755739",5,8,3
"ZCCHC14","s1639_F_VTA_03_ASEReadCounter.table","NW_015090842.1:8756149",3,6,3
"ZCCHC14","s1639_F_VTA_03_ASEReadCounter.table","NW_015090842.1:8756347",3,7,4
"ZCCHC14","s1639_F_VTA_03_ASEReadCounter.table","NW_015090842.1:8756361",2,6,4
"ZCCHC14","s1639_F_VTA_03_ASEReadCounter.table","NW_015090842.1:8756388",2,4,2
"ZCCHC14","s1639_F_VTA_03_ASEReadCounter.table","NW_015090842.1:8756389",2,4,2
"ZCCHC14","s1639_F_VTA_03_ASEReadCounter.table","NW_015090842.1:8757160",3,7,4
"ZCCHC14","s1639_F_VTA_03_ASEReadCounter.table","NW_015090842.1:8804511",0,2,2
"JPH3","s1639_F_VTA_03_ASEReadCounter.table","NW_015090842.1:8845375",16,39,23
"JPH3","s1639_F_VTA_03_ASEReadCounter.table","NW_015090842.1:8845640",17,43,26
"JPH3","s1639_F_VTA_03_ASEReadCounter.table","NW_015090842.1:8845654",14,43,29
"JPH3","s1639_F_VTA_03_ASEReadCounter.table","NW_015090842.1:8872283",29,66,37
"JPH3","s1639_F_VTA_03_ASEReadCounter.table","NW_015090842.1:8872294",31,68,37
"JPH3","s1639_F_VTA_03_ASEReadCounter.table","NW_015090842.1:8872730",46,89,43
"JPH3","s1639_F_VTA_03_ASEReadCounter.table","NW_015090842.1:8885260",80,159,79
"JPH3","s1639_F_VTA_03_ASEReadCounter.table","NW_015090842.1:8885315",46,114,68
"JPH3","s1639_F_VTA_03_ASEReadCounter.table","NW_015090842.1:8885328",40,102,62
"JPH3","s1639_F_VTA_03_ASEReadCounter.table","NW_015090842.1:8885438",56,119,63
"JPH3","s1639_F_VTA_03_ASEReadCounter.table","NW_015090842.1:8885525",22,70,48
"KLHDC4","s1639_F_VTA_03_ASEReadCounter.table","NW_015090842.1:8890729",29,60,31
"KLHDC4","s1639_F_VTA_03_ASEReadCounter.table","NW_015090842.1:8890749",32,60,28
"KLHDC4","s1639_F_VTA_03_ASEReadCounter.table","NW_015090842.1:8890761",33,62,29
"KLHDC4","s1639_F_VTA_03_ASEReadCounter.table","NW_015090842.1:8891123",56,94,38
"KLHDC4","s1639_F_VTA_03_ASEReadCounter.table","NW_015090842.1:8893124",45,74,29
"KLHDC4","s1639_F_VTA_03_ASEReadCounter.table","NW_015090842.1:8894542",27,43,16
"KLHDC4","s1639_F_VTA_03_ASEReadCounter.table","NW_015090842.1:8896726",20,31,11
"KLHDC4","s1639_F_VTA_03_ASEReadCounter.table","NW_015090842.1:8896767",19,27,8
"KLHDC4","s1639_F_VTA_03_ASEReadCounter.table","NW_015090842.1:8904174",26,32,6
"KLHDC4","s1639_F_VTA_03_ASEReadCounter.table","NW_015090842.1:8904231",18,23,5
"KLHDC4","s1639_F_VTA_03_ASEReadCounter.table","NW_015090842.1:8905251",14,26,12
"KLHDC4","s1639_F_VTA_03_ASEReadCounter.table","NW_015090842.1:8905263",13,28,15
"KLHDC4","s1639_F_VTA_03_ASEReadCounter.table","NW_015090842.1:8919626",6,7,1
"SLC7A5","s1639_F_VTA_03_ASEReadCounter.table","NW_015090842.1:8938782",234,536,302
"SLC7A5","s1639_F_VTA_03_ASEReadCounter.table","NW_015090842.1:8938943",164,374,210
"SLC7A5","s1639_F_VTA_03_ASEReadCounter.table","NW_015090842.1:8939611",88,198,110
"SLC7A5","s1639_F_VTA_03_ASEReadCounter.table","NW_015090842.1:8939738",103,241,138
"SLC7A5","s1639_F_VTA_03_ASEReadCounter.table","NW_015090842.1:8939739",105,238,133
"SLC7A5","s1639_F_VTA_03_ASEReadCounter.table","NW_015090842.1:8939740",98,232,134
"SLC7A5","s1639_F_VTA_03_ASEReadCounter.table","NW_015090842.1:8939795",114,233,119
"SLC7A5","s1639_F_VTA_03_ASEReadCounter.table","NW_015090842.1:8939815",95,237,142
"SLC7A5","s1639_F_VTA_03_ASEReadCounter.table","NW_015090842.1:8939816",94,237,143
"SLC7A5","s1639_F_VTA_03_ASEReadCounter.table","NW_015090842.1:8939817",95,249,154
"SLC7A5","s1639_F_VTA_03_ASEReadCounter.table","NW_015090842.1:8939845",102,252,150
"SLC7A5","s1639_F_VTA_03_ASEReadCounter.table","NW_015090842.1:8939894",83,215,132
"SLC7A5","s1639_F_VTA_03_ASEReadCounter.table","NW_015090842.1:8939895",85,213,128
"SLC7A5","s1639_F_VTA_03_ASEReadCounter.table","NW_015090842.1:8939997",384,384,0
"SLC7A5","s1639_F_VTA_03_ASEReadCounter.table","NW_015090842.1:8940172",115,262,147
"SLC7A5","s1639_F_VTA_03_ASEReadCounter.table","NW_015090842.1:8940331",58,124,66
"SLC7A5","s1639_F_VTA_03_ASEReadCounter.table","NW_015090842.1:8940696",74,141,67
"SLC7A5","s1639_F_VTA_03_ASEReadCounter.table","NW_015090842.1:8940719",47,139,92
"SLC7A5","s1639_F_VTA_03_ASEReadCounter.table","NW_015090842.1:8940737",44,137,93
"SLC7A5","s1639_F_VTA_03_ASEReadCounter.table","NW_015090842.1:8940743",56,147,91
"SLC7A5","s1639_F_VTA_03_ASEReadCounter.table","NW_015090842.1:8940766",62,166,104
"SLC7A5","s1639_F_VTA_03_ASEReadCounter.table","NW_015090842.1:8940769",64,168,104
"SLC7A5","s1639_F_VTA_03_ASEReadCounter.table","NW_015090842.1:8940861",52,127,75
"SLC7A5","s1639_F_VTA_03_ASEReadCounter.table","NW_015090842.1:8941068",60,164,104
"SLC7A5","s1639_F_VTA_03_ASEReadCounter.table","NW_015090842.1:8941467",49,127,78
"SLC7A5","s1639_F_VTA_03_ASEReadCounter.table","NW_015090842.1:8941531",50,116,66
"SLC7A5","s1639_F_VTA_03_ASEReadCounter.table","NW_015090842.1:8941588",66,145,79
"SLC7A5","s1639_F_VTA_03_ASEReadCounter.table","NW_015090842.1:8941698",37,82,45
"SLC7A5","s1639_F_VTA_03_ASEReadCounter.table","NW_015090842.1:8941717",45,98,53
"SLC7A5","s1639_F_VTA_03_ASEReadCounter.table","NW_015090842.1:8941745",46,110,64
"SLC7A5","s1639_F_VTA_03_ASEReadCounter.table","NW_015090842.1:8941781",45,133,88
"SLC7A5","s1639_F_VTA_03_ASEReadCounter.table","NW_015090842.1:8941887",42,94,52
"SLC7A5","s1639_F_VTA_03_ASEReadCounter.table","NW_015090842.1:8941968",27,91,64
"SLC7A5","s1639_F_VTA_03_ASEReadCounter.table","NW_015090842.1:8942025",31,103,72
"SLC7A5","s1639_F_VTA_03_ASEReadCounter.table","NW_015090842.1:8942069",40,101,61
"SLC7A5","s1639_F_VTA_03_ASEReadCounter.table","NW_015090842.1:8942170",44,117,73
"SLC7A5","s1639_F_VTA_03_ASEReadCounter.table","NW_015090842.1:8942241",50,118,68
"SLC7A5","s1639_F_VTA_03_ASEReadCounter.table","NW_015090842.1:8942283",53,129,76
"SLC7A5","s1639_F_VTA_03_ASEReadCounter.table","NW_015090842.1:8942717",92,235,143
"SLC7A5","s1639_F_VTA_03_ASEReadCounter.table","NW_015090842.1:8942756",127,325,198
"SLC7A5","s1639_F_VTA_03_ASEReadCounter.table","NW_015090842.1:8942766",124,325,201
"SLC7A5","s1639_F_VTA_03_ASEReadCounter.table","NW_015090842.1:8943271",55,148,93
"SLC7A5","s1639_F_VTA_03_ASEReadCounter.table","NW_015090842.1:8943524",34,96,62
"SLC7A5","s1639_F_VTA_03_ASEReadCounter.table","NW_015090842.1:8943530",38,103,65
"SLC7A5","s1639_F_VTA_03_ASEReadCounter.table","NW_015090842.1:8943602",35,108,73
"SLC7A5","s1639_F_VTA_03_ASEReadCounter.table","NW_015090842.1:8943622",32,96,64
"SLC7A5","s1639_F_VTA_03_ASEReadCounter.table","NW_015090842.1:8943661",38,100,62
"SLC7A5","s1639_F_VTA_03_ASEReadCounter.table","NW_015090842.1:8943686",37,89,52
"SLC7A5","s1639_F_VTA_03_ASEReadCounter.table","NW_015090842.1:8943788",44,98,54
"SLC7A5","s1639_F_VTA_03_ASEReadCounter.table","NW_015090842.1:8943814",42,93,51
"SLC7A5","s1639_F_VTA_03_ASEReadCounter.table","NW_015090842.1:8943876",29,75,46
"SLC7A5","s1639_F_VTA_03_ASEReadCounter.table","NW_015090842.1:8943892",29,77,48
"SLC7A5","s1639_F_VTA_03_ASEReadCounter.table","NW_015090842.1:8944097",32,70,38
"SLC7A5","s1639_F_VTA_03_ASEReadCounter.table","NW_015090842.1:8944104",27,66,39
"SLC7A5","s1639_F_VTA_03_ASEReadCounter.table","NW_015090842.1:8944293",14,44,30
"SLC7A5","s1639_F_VTA_03_ASEReadCounter.table","NW_015090842.1:8944297",15,46,31
"SLC7A5","s1639_F_VTA_03_ASEReadCounter.table","NW_015090842.1:8944397",20,49,29
"SLC7A5","s1639_F_VTA_03_ASEReadCounter.table","NW_015090842.1:8944552",22,57,35
"SLC7A5","s1639_F_VTA_03_ASEReadCounter.table","NW_015090842.1:8944629",24,62,38
"CA5A","s1639_F_VTA_03_ASEReadCounter.table","NW_015090842.1:8989479",73,139,66
"CA5A","s1639_F_VTA_03_ASEReadCounter.table","NW_015090842.1:8989562",110,186,76
"CA5A","s1639_F_VTA_03_ASEReadCounter.table","NW_015090842.1:8989609",113,209,96
"CA5A","s1639_F_VTA_03_ASEReadCounter.table","NW_015090842.1:8989693",136,260,124
"CA5A","s1639_F_VTA_03_ASEReadCounter.table","NW_015090842.1:8989702",131,248,117
"CA5A","s1639_F_VTA_03_ASEReadCounter.table","NW_015090842.1:8989746",111,219,108
"CA5A","s1639_F_VTA_03_ASEReadCounter.table","NW_015090842.1:8989880",103,208,105
"CA5A","s1639_F_VTA_03_ASEReadCounter.table","NW_015090842.1:8989885",108,210,102
"CA5A","s1639_F_VTA_03_ASEReadCounter.table","NW_015090842.1:8989929",102,212,110
"CA5A","s1639_F_VTA_03_ASEReadCounter.table","NW_015090842.1:8990002",96,195,99
"CA5A","s1639_F_VTA_03_ASEReadCounter.table","NW_015090842.1:8990004",96,195,99
"CA5A","s1639_F_VTA_03_ASEReadCounter.table","NW_015090842.1:8990005",96,196,100
"CA5A","s1639_F_VTA_03_ASEReadCounter.table","NW_015090842.1:8990017",88,173,85
"CA5A","s1639_F_VTA_03_ASEReadCounter.table","NW_015090842.1:8990043",58,127,69
"CA5A","s1639_F_VTA_03_ASEReadCounter.table","NW_015090842.1:8990060",132,132,0
"CA5A","s1639_F_VTA_03_ASEReadCounter.table","NW_015090842.1:8990080",49,117,68
"CA5A","s1639_F_VTA_03_ASEReadCounter.table","NW_015090842.1:8990084",49,118,69
"CA5A","s1639_F_VTA_03_ASEReadCounter.table","NW_015090842.1:8990090",48,119,71
"CA5A","s1639_F_VTA_03_ASEReadCounter.table","NW_015090842.1:8990095",53,121,68
"CA5A","s1639_F_VTA_03_ASEReadCounter.table","NW_015090842.1:8990111",49,114,65
"CA5A","s1639_F_VTA_03_ASEReadCounter.table","NW_015090842.1:8990112",48,112,64
"CA5A","s1639_F_VTA_03_ASEReadCounter.table","NW_015090842.1:8990115",54,117,63
"CA5A","s1639_F_VTA_03_ASEReadCounter.table","NW_015090842.1:8990166",64,119,55
"CA5A","s1639_F_VTA_03_ASEReadCounter.table","NW_015090842.1:8990169",68,126,58
"CA5A","s1639_F_VTA_03_ASEReadCounter.table","NW_015090842.1:8990193",130,130,0
"CA5A","s1639_F_VTA_03_ASEReadCounter.table","NW_015090842.1:8990222",64,129,65
"CA5A","s1639_F_VTA_03_ASEReadCounter.table","NW_015090842.1:8990289",68,136,68
"CA5A","s1639_F_VTA_03_ASEReadCounter.table","NW_015090842.1:8990314",65,140,75
"CA5A","s1639_F_VTA_03_ASEReadCounter.table","NW_015090842.1:8990361",56,116,60
"CA5A","s1639_F_VTA_03_ASEReadCounter.table","NW_015090842.1:8990368",56,116,60
"CA5A","s1639_F_VTA_03_ASEReadCounter.table","NW_015090842.1:8990429",62,130,68
"CA5A","s1639_F_VTA_03_ASEReadCounter.table","NW_015090842.1:8990466",59,121,62
"CA5A","s1639_F_VTA_03_ASEReadCounter.table","NW_015090842.1:8990663",65,117,52
"CA5A","s1639_F_VTA_03_ASEReadCounter.table","NW_015090842.1:8990797",48,96,48
"CA5A","s1639_F_VTA_03_ASEReadCounter.table","NW_015090842.1:8990836",50,98,48
"CA5A","s1639_F_VTA_03_ASEReadCounter.table","NW_015090842.1:8990842",47,95,48
"CA5A","s1639_F_VTA_03_ASEReadCounter.table","NW_015090842.1:8990851",51,96,45
"CA5A","s1639_F_VTA_03_ASEReadCounter.table","NW_015090842.1:8990918",38,67,29
"CA5A","s1639_F_VTA_03_ASEReadCounter.table","NW_015090842.1:8990921",34,67,33
"CA5A","s1639_F_VTA_03_ASEReadCounter.table","NW_015090842.1:8990942",47,83,36
"CA5A","s1639_F_VTA_03_ASEReadCounter.table","NW_015090842.1:8991001",63,113,50
"CA5A","s1639_F_VTA_03_ASEReadCounter.table","NW_015090842.1:8991038",62,108,46
"CA5A","s1639_F_VTA_03_ASEReadCounter.table","NW_015090842.1:8991149",68,110,42
"CA5A","s1639_F_VTA_03_ASEReadCounter.table","NW_015090842.1:8991176",70,111,41
"CA5A","s1639_F_VTA_03_ASEReadCounter.table","NW_015090842.1:8991241",63,115,52
"CA5A","s1639_F_VTA_03_ASEReadCounter.table","NW_015090842.1:8991262",59,108,49
"CA5A","s1639_F_VTA_03_ASEReadCounter.table","NW_015090842.1:8991316",63,67,4
"CA5A","s1639_F_VTA_03_ASEReadCounter.table","NW_015090842.1:8991319",65,70,5
"CA5A","s1639_F_VTA_03_ASEReadCounter.table","NW_015090842.1:8991330",63,64,1
"CA5A","s1639_F_VTA_03_ASEReadCounter.table","NW_015090842.1:8991334",57,59,2
"CA5A","s1639_F_VTA_03_ASEReadCounter.table","NW_015090842.1:8991362",56,82,26
"CA5A","s1639_F_VTA_03_ASEReadCounter.table","NW_015090842.1:8991368",55,82,27
"CA5A","s1639_F_VTA_03_ASEReadCounter.table","NW_015090842.1:8991390",52,82,30
"CA5A","s1639_F_VTA_03_ASEReadCounter.table","NW_015090842.1:8991395",51,84,33
"CA5A","s1639_F_VTA_03_ASEReadCounter.table","NW_015090842.1:8991422",43,84,41
"CA5A","s1639_F_VTA_03_ASEReadCounter.table","NW_015090842.1:8991467",43,77,34
"CA5A","s1639_F_VTA_03_ASEReadCounter.table","NW_015090842.1:8991576",30,64,34
"CA5A","s1639_F_VTA_03_ASEReadCounter.table","NW_015090842.1:8991587",37,70,33
"CA5A","s1639_F_VTA_03_ASEReadCounter.table","NW_015090842.1:8991655",38,70,32
"CA5A","s1639_F_VTA_03_ASEReadCounter.table","NW_015090842.1:8991717",32,69,37
"CA5A","s1639_F_VTA_03_ASEReadCounter.table","NW_015090842.1:8991726",34,71,37
"CA5A","s1639_F_VTA_03_ASEReadCounter.table","NW_015090842.1:8991799",33,59,26
"CA5A","s1639_F_VTA_03_ASEReadCounter.table","NW_015090842.1:8991809",28,54,26
"CA5A","s1639_F_VTA_03_ASEReadCounter.table","NW_015090842.1:8991848",23,55,32
"CA5A","s1639_F_VTA_03_ASEReadCounter.table","NW_015090842.1:8991849",25,56,31
"CA5A","s1639_F_VTA_03_ASEReadCounter.table","NW_015090842.1:8991927",29,54,25
"CA5A","s1639_F_VTA_03_ASEReadCounter.table","NW_015090842.1:8991941",27,48,21
"CA5A","s1639_F_VTA_03_ASEReadCounter.table","NW_015090842.1:8992121",26,67,41
"CA5A","s1639_F_VTA_03_ASEReadCounter.table","NW_015090842.1:8992224",36,66,30
"CA5A","s1639_F_VTA_03_ASEReadCounter.table","NW_015090842.1:9002570",24,46,22
"CA5A","s1639_F_VTA_03_ASEReadCounter.table","NW_015090842.1:9002600",19,40,21
"CA5A","s1639_F_VTA_03_ASEReadCounter.table","NW_015090842.1:9004312",12,29,17
"CA5A","s1639_F_VTA_03_ASEReadCounter.table","NW_015090842.1:9004506",2,3,1
"CA5A","s1639_F_VTA_03_ASEReadCounter.table","NW_015090842.1:9004523",2,2,0
"CA5A","s1639_F_VTA_03_ASEReadCounter.table","NW_015090842.1:9004530",2,2,0
"CA5A","s1639_F_VTA_03_ASEReadCounter.table","NW_015090842.1:9004556",2,2,0
"CA5A","s1639_F_VTA_03_ASEReadCounter.table","NW_015090842.1:9005116",2,4,2
"CA5A","s1639_F_VTA_03_ASEReadCounter.table","NW_015090842.1:9005120",2,4,2
"CA5A","s1639_F_VTA_03_ASEReadCounter.table","NW_015090842.1:9005140",2,5,3
"CA5A","s1639_F_VTA_03_ASEReadCounter.table","NW_015090842.1:9005152",3,6,3
"CA5A","s1639_F_VTA_03_ASEReadCounter.table","NW_015090842.1:9011011",1,2,1
"CA5A","s1639_F_VTA_03_ASEReadCounter.table","NW_015090842.1:9011189",1,1,0
"CA5A","s1639_F_VTA_03_ASEReadCounter.table","NW_015090842.1:9011194",1,1,0
"BANP","s1639_F_VTA_03_ASEReadCounter.table","NW_015090842.1:9033407",3,10,7
"BANP","s1639_F_VTA_03_ASEReadCounter.table","NW_015090842.1:9033409",3,10,7
"BANP","s1639_F_VTA_03_ASEReadCounter.table","NW_015090842.1:9033420",1,11,10
"BANP","s1639_F_VTA_03_ASEReadCounter.table","NW_015090842.1:9067974",0,9,9
"BANP","s1639_F_VTA_03_ASEReadCounter.table","NW_015090842.1:9102510",12,37,25
"BANP","s1639_F_VTA_03_ASEReadCounter.table","NW_015090842.1:9168534",15,47,32
"BANP","s1639_F_VTA_03_ASEReadCounter.table","NW_015090842.1:9168818",17,44,27
"ZNF469","s1639_F_VTA_03_ASEReadCounter.table","NW_015090842.1:9425108",1,2,1
"ZNF469","s1639_F_VTA_03_ASEReadCounter.table","NW_015090842.1:9425182",1,3,2
"ZNF469","s1639_F_VTA_03_ASEReadCounter.table","NW_015090842.1:9426367",0,2,2
"ZNF469","s1639_F_VTA_03_ASEReadCounter.table","NW_015090842.1:9426420",0,2,2
"ZNF469","s1639_F_VTA_03_ASEReadCounter.table","NW_015090842.1:9426585",0,1,1
"ZNF469","s1639_F_VTA_03_ASEReadCounter.table","NW_015090842.1:9427614",1,1,0
"ZNF469","s1639_F_VTA_03_ASEReadCounter.table","NW_015090842.1:9428122",0,1,1
"ZNF469","s1639_F_VTA_03_ASEReadCounter.table","NW_015090842.1:9428178",0,1,1
"ZNF469","s1639_F_VTA_03_ASEReadCounter.table","NW_015090842.1:9428419",0,1,1
"ZNF469","s1639_F_VTA_03_ASEReadCounter.table","NW_015090842.1:9429633",1,2,1
"ZNF469","s1639_F_VTA_03_ASEReadCounter.table","NW_015090842.1:9429758",0,1,1
"ZNF469","s1639_F_VTA_03_ASEReadCounter.table","NW_015090842.1:9429759",0,1,1
"ZNF469","s1639_F_VTA_03_ASEReadCounter.table","NW_015090842.1:9429794",2,3,1
"ZNF469","s1639_F_VTA_03_ASEReadCounter.table","NW_015090842.1:9430560",0,1,1
"ZNF469","s1639_F_VTA_03_ASEReadCounter.table","NW_015090842.1:9431031",3,5,2
"ZNF469","s1639_F_VTA_03_ASEReadCounter.table","NW_015090842.1:9431073",1,2,1
"ZNF469","s1639_F_VTA_03_ASEReadCounter.table","NW_015090842.1:9431091",1,2,1
"ZNF469","s1639_F_VTA_03_ASEReadCounter.table","NW_015090842.1:9431150",1,1,0
"ZNF469","s1639_F_VTA_03_ASEReadCounter.table","NW_015090842.1:9431162",1,1,0
"ZNF469","s1639_F_VTA_03_ASEReadCounter.table","NW_015090842.1:9432361",1,1,0
"ZNF469","s1639_F_VTA_03_ASEReadCounter.table","NW_015090842.1:9432374",1,1,0
"ZNF469","s1639_F_VTA_03_ASEReadCounter.table","NW_015090842.1:9432382",1,1,0
"ZNF469","s1639_F_VTA_03_ASEReadCounter.table","NW_015090842.1:9432481",0,1,1
"ZNF469","s1639_F_VTA_03_ASEReadCounter.table","NW_015090842.1:9433268",0,1,1
"ZNF469","s1639_F_VTA_03_ASEReadCounter.table","NW_015090842.1:9433678",2,3,1
"ZNF469","s1639_F_VTA_03_ASEReadCounter.table","NW_015090842.1:9433902",0,1,1
"ZNF469","s1639_F_VTA_03_ASEReadCounter.table","NW_015090842.1:9433980",0,2,2
"ZNF469","s1639_F_VTA_03_ASEReadCounter.table","NW_015090842.1:9434259",2,4,2
"ZNF469","s1639_F_VTA_03_ASEReadCounter.table","NW_015090842.1:9435221",0,1,1
"ZFPM1","s1639_F_VTA_03_ASEReadCounter.table","NW_015090842.1:9458862",4,8,4
"ZFPM1","s1639_F_VTA_03_ASEReadCounter.table","NW_015090842.1:9458888",4,9,5
"ZFPM1","s1639_F_VTA_03_ASEReadCounter.table","NW_015090842.1:9458904",4,9,5
"ZFPM1","s1639_F_VTA_03_ASEReadCounter.table","NW_015090842.1:9458916",4,9,5
"ZFPM1","s1639_F_VTA_03_ASEReadCounter.table","NW_015090842.1:9468568",4,9,5
"ZFPM1","s1639_F_VTA_03_ASEReadCounter.table","NW_015090842.1:9468593",4,9,5
"ZFPM1","s1639_F_VTA_03_ASEReadCounter.table","NW_015090842.1:9471561",5,10,5
"ZFPM1","s1639_F_VTA_03_ASEReadCounter.table","NW_015090842.1:9472557",2,10,8
"ZFPM1","s1639_F_VTA_03_ASEReadCounter.table","NW_015090842.1:9472565",3,9,6
"ZFPM1","s1639_F_VTA_03_ASEReadCounter.table","NW_015090842.1:9472608",2,7,5
"ZFPM1","s1639_F_VTA_03_ASEReadCounter.table","NW_015090842.1:9472627",3,7,4
"ZFPM1","s1639_F_VTA_03_ASEReadCounter.table","NW_015090842.1:9472668",3,3,0
"ZFPM1","s1639_F_VTA_03_ASEReadCounter.table","NW_015090842.1:9473655",4,9,5
"ZFPM1","s1639_F_VTA_03_ASEReadCounter.table","NW_015090842.1:9475827",5,10,5
"ZFPM1","s1639_F_VTA_03_ASEReadCounter.table","NW_015090842.1:9475842",5,10,5
"ZFPM1","s1639_F_VTA_03_ASEReadCounter.table","NW_015090842.1:9476119",5,7,2
"ZFPM1","s1639_F_VTA_03_ASEReadCounter.table","NW_015090842.1:9476161",5,7,2
"ZFPM1","s1639_F_VTA_03_ASEReadCounter.table","NW_015090842.1:9476219",2,6,4
"ZFPM1","s1639_F_VTA_03_ASEReadCounter.table","NW_015090842.1:9476233",3,7,4
"ZFPM1","s1639_F_VTA_03_ASEReadCounter.table","NW_015090842.1:9476305",4,6,2
"ZFPM1","s1639_F_VTA_03_ASEReadCounter.table","NW_015090842.1:9476395",6,9,3
"ZFPM1","s1639_F_VTA_03_ASEReadCounter.table","NW_015090842.1:9476421",8,13,5
"ZFPM1","s1639_F_VTA_03_ASEReadCounter.table","NW_015090842.1:9476539",2,5,3
"ZFPM1","s1639_F_VTA_03_ASEReadCounter.table","NW_015090842.1:9476576",3,5,2
"ZFPM1","s1639_F_VTA_03_ASEReadCounter.table","NW_015090842.1:9476599",6,6,0
"ZFPM1","s1639_F_VTA_03_ASEReadCounter.table","NW_015090842.1:9476792",14,24,10
"ZFPM1","s1639_F_VTA_03_ASEReadCounter.table","NW_015090842.1:9476803",12,21,9
"ZFPM1","s1639_F_VTA_03_ASEReadCounter.table","NW_015090842.1:9477115",8,16,8
"ZFPM1","s1639_F_VTA_03_ASEReadCounter.table","NW_015090842.1:9477299",5,14,9
"ZFPM1","s1639_F_VTA_03_ASEReadCounter.table","NW_015090842.1:9477398",14,14,0
"ZFPM1","s1639_F_VTA_03_ASEReadCounter.table","NW_015090842.1:9477422",3,12,9
"ZFPM1","s1639_F_VTA_03_ASEReadCounter.table","NW_015090842.1:9477554",10,19,9
"ZFPM1","s1639_F_VTA_03_ASEReadCounter.table","NW_015090842.1:9477575",22,22,0
"ZFPM1","s1639_F_VTA_03_ASEReadCounter.table","NW_015090842.1:9477595",15,28,13
"ZFPM1","s1639_F_VTA_03_ASEReadCounter.table","NW_015090842.1:9477611",13,27,14
"ZFPM1","s1639_F_VTA_03_ASEReadCounter.table","NW_015090842.1:9477659",10,25,15
"ZFPM1","s1639_F_VTA_03_ASEReadCounter.table","NW_015090842.1:9477737",7,25,18
"ZFPM1","s1639_F_VTA_03_ASEReadCounter.table","NW_015090842.1:9477791",8,21,13
"ZFPM1","s1639_F_VTA_03_ASEReadCounter.table","NW_015090842.1:9477844",13,29,16
"ZFPM1","s1639_F_VTA_03_ASEReadCounter.table","NW_015090842.1:9477917",18,40,22
"ZFPM1","s1639_F_VTA_03_ASEReadCounter.table","NW_015090842.1:9478295",19,43,24
"ZFPM1","s1639_F_VTA_03_ASEReadCounter.table","NW_015090842.1:9478349",23,53,30
"ZFPM1","s1639_F_VTA_03_ASEReadCounter.table","NW_015090842.1:9478524",11,35,24
"ZFPM1","s1639_F_VTA_03_ASEReadCounter.table","NW_015090842.1:9478546",16,42,26
"ZFPM1","s1639_F_VTA_03_ASEReadCounter.table","NW_015090842.1:9478573",18,45,27
"ZFPM1","s1639_F_VTA_03_ASEReadCounter.table","NW_015090842.1:9478582",15,33,18
"ZFPM1","s1639_F_VTA_03_ASEReadCounter.table","NW_015090842.1:9478684",5,13,8
"ZFPM1","s1639_F_VTA_03_ASEReadCounter.table","NW_015090842.1:9478711",7,15,8
"ZFPM1","s1639_F_VTA_03_ASEReadCounter.table","NW_015090842.1:9478761",7,19,12
"ZFPM1","s1639_F_VTA_03_ASEReadCounter.table","NW_015090842.1:9478829",15,15,0
"CIDEC","s1639_F_VTA_03_ASEReadCounter.table","NW_015090842.1:9481199",1,1,0
"CIDEC","s1639_F_VTA_03_ASEReadCounter.table","NW_015090842.1:9481604",0,1,1
"ZC3H18","s1639_F_VTA_03_ASEReadCounter.table","NW_015090842.1:9494271",5,11,6
"ZC3H18","s1639_F_VTA_03_ASEReadCounter.table","NW_015090842.1:9501427",14,27,13
"ZC3H18","s1639_F_VTA_03_ASEReadCounter.table","NW_015090842.1:9501442",14,27,13
"ZC3H18","s1639_F_VTA_03_ASEReadCounter.table","NW_015090842.1:9505538",11,28,17
"ZC3H18","s1639_F_VTA_03_ASEReadCounter.table","NW_015090842.1:9506778",13,39,26
"ZC3H18","s1639_F_VTA_03_ASEReadCounter.table","NW_015090842.1:9522538",17,39,22
"ZC3H18","s1639_F_VTA_03_ASEReadCounter.table","NW_015090842.1:9524350",11,29,18
"ZC3H18","s1639_F_VTA_03_ASEReadCounter.table","NW_015090842.1:9524366",12,31,19
"ZC3H18","s1639_F_VTA_03_ASEReadCounter.table","NW_015090842.1:9524424",13,30,17
"ZC3H18","s1639_F_VTA_03_ASEReadCounter.table","NW_015090842.1:9529649",13,43,30
"ZC3H18","s1639_F_VTA_03_ASEReadCounter.table","NW_015090842.1:9529688",18,53,35
"ZC3H18","s1639_F_VTA_03_ASEReadCounter.table","NW_015090842.1:9529691",17,53,36
"ZC3H18","s1639_F_VTA_03_ASEReadCounter.table","NW_015090842.1:9530977",29,79,50
"ZC3H18","s1639_F_VTA_03_ASEReadCounter.table","NW_015090842.1:9536699",0,44,44
"CYBA","s1639_F_VTA_03_ASEReadCounter.table","NW_015090842.1:9547281",24,32,8
"CYBA","s1639_F_VTA_03_ASEReadCounter.table","NW_015090842.1:9547402",54,75,21
"CYBA","s1639_F_VTA_03_ASEReadCounter.table","NW_015090842.1:9547553",31,52,21
"CYBA","s1639_F_VTA_03_ASEReadCounter.table","NW_015090842.1:9548052",39,48,9
"CYBA","s1639_F_VTA_03_ASEReadCounter.table","NW_015090842.1:9548436",47,68,21
"CYBA","s1639_F_VTA_03_ASEReadCounter.table","NW_015090842.1:9548442",49,73,24
"CYBA","s1639_F_VTA_03_ASEReadCounter.table","NW_015090842.1:9548478",53,74,21
"CYBA","s1639_F_VTA_03_ASEReadCounter.table","NW_015090842.1:9548487",48,67,19
"CYBA","s1639_F_VTA_03_ASEReadCounter.table","NW_015090842.1:9548490",50,69,19
"CYBA","s1639_F_VTA_03_ASEReadCounter.table","NW_015090842.1:9548717",48,64,16
"CYBA","s1639_F_VTA_03_ASEReadCounter.table","NW_015090842.1:9548750",29,47,18
"CYBA","s1639_F_VTA_03_ASEReadCounter.table","NW_015090842.1:9548766",22,36,14
"MVD","s1639_F_VTA_03_ASEReadCounter.table","NW_015090842.1:9550678",20,30,10
"MVD","s1639_F_VTA_03_ASEReadCounter.table","NW_015090842.1:9550690",20,33,13
"MVD","s1639_F_VTA_03_ASEReadCounter.table","NW_015090842.1:9550691",20,32,12
"MVD","s1639_F_VTA_03_ASEReadCounter.table","NW_015090842.1:9550699",22,34,12
"MVD","s1639_F_VTA_03_ASEReadCounter.table","NW_015090842.1:9550719",24,36,12
"MVD","s1639_F_VTA_03_ASEReadCounter.table","NW_015090842.1:9551596",48,95,47
"MVD","s1639_F_VTA_03_ASEReadCounter.table","NW_015090842.1:9551638",43,106,63
"MVD","s1639_F_VTA_03_ASEReadCounter.table","NW_015090842.1:9551899",0,7,7
"MVD","s1639_F_VTA_03_ASEReadCounter.table","NW_015090842.1:9552193",32,78,46
"MVD","s1639_F_VTA_03_ASEReadCounter.table","NW_015090842.1:9552202",31,74,43
"MVD","s1639_F_VTA_03_ASEReadCounter.table","NW_015090842.1:9552208",27,68,41
"MVD","s1639_F_VTA_03_ASEReadCounter.table","NW_015090842.1:9552625",23,50,27
"MVD","s1639_F_VTA_03_ASEReadCounter.table","NW_015090842.1:9552629",51,51,0
"MVD","s1639_F_VTA_03_ASEReadCounter.table","NW_015090842.1:9552644",18,48,30
"MVD","s1639_F_VTA_03_ASEReadCounter.table","NW_015090842.1:9553093",17,37,20
"MVD","s1639_F_VTA_03_ASEReadCounter.table","NW_015090842.1:9553114",15,33,18
"RNF166","s1639_F_VTA_03_ASEReadCounter.table","NW_015090842.1:9557900",12,26,14
"RNF166","s1639_F_VTA_03_ASEReadCounter.table","NW_015090842.1:9558048",16,30,14
"RNF166","s1639_F_VTA_03_ASEReadCounter.table","NW_015090842.1:9558116",15,24,9
"RNF166","s1639_F_VTA_03_ASEReadCounter.table","NW_015090842.1:9558308",19,36,17
"RNF166","s1639_F_VTA_03_ASEReadCounter.table","NW_015090842.1:9558405",20,39,19
"RNF166","s1639_F_VTA_03_ASEReadCounter.table","NW_015090842.1:9558549",20,43,23
"RNF166","s1639_F_VTA_03_ASEReadCounter.table","NW_015090842.1:9558556",19,40,21
"RNF166","s1639_F_VTA_03_ASEReadCounter.table","NW_015090842.1:9558579",20,38,18
"RNF166","s1639_F_VTA_03_ASEReadCounter.table","NW_015090842.1:9558599",17,35,18
"RNF166","s1639_F_VTA_03_ASEReadCounter.table","NW_015090842.1:9558688",12,27,15
"RNF166","s1639_F_VTA_03_ASEReadCounter.table","NW_015090842.1:9558711",13,31,18
"RNF166","s1639_F_VTA_03_ASEReadCounter.table","NW_015090842.1:9558733",13,32,19
"RNF166","s1639_F_VTA_03_ASEReadCounter.table","NW_015090842.1:9558847",11,25,14
"RNF166","s1639_F_VTA_03_ASEReadCounter.table","NW_015090842.1:9559798",9,28,19
"RNF166","s1639_F_VTA_03_ASEReadCounter.table","NW_015090842.1:9560575",13,31,18
"RNF166","s1639_F_VTA_03_ASEReadCounter.table","NW_015090842.1:9561055",9,19,10
"RNF166","s1639_F_VTA_03_ASEReadCounter.table","NW_015090842.1:9562458",11,23,12
"RNF166","s1639_F_VTA_03_ASEReadCounter.table","NW_015090842.1:9562497",10,18,8
"RNF166","s1639_F_VTA_03_ASEReadCounter.table","NW_015090842.1:9562539",3,10,7
"RNF166","s1639_F_VTA_03_ASEReadCounter.table","NW_015090842.1:9564056",9,11,2
"CTU2","s1639_F_VTA_03_ASEReadCounter.table","NW_015090842.1:9565149",11,17,6
"CTU2","s1639_F_VTA_03_ASEReadCounter.table","NW_015090842.1:9565193",13,24,11
"CTU2","s1639_F_VTA_03_ASEReadCounter.table","NW_015090842.1:9565300",10,23,13
"CTU2","s1639_F_VTA_03_ASEReadCounter.table","NW_015090842.1:9565321",12,25,13
"CTU2","s1639_F_VTA_03_ASEReadCounter.table","NW_015090842.1:9565721",11,21,10
"CTU2","s1639_F_VTA_03_ASEReadCounter.table","NW_015090842.1:9565739",13,21,8
"CTU2","s1639_F_VTA_03_ASEReadCounter.table","NW_015090842.1:9565905",14,25,11
"CTU2","s1639_F_VTA_03_ASEReadCounter.table","NW_015090842.1:9566013",30,30,0
"CTU2","s1639_F_VTA_03_ASEReadCounter.table","NW_015090842.1:9566055",18,33,15
"CTU2","s1639_F_VTA_03_ASEReadCounter.table","NW_015090842.1:9566056",18,32,14
"CTU2","s1639_F_VTA_03_ASEReadCounter.table","NW_015090842.1:9566151",15,30,15
"CTU2","s1639_F_VTA_03_ASEReadCounter.table","NW_015090842.1:9566300",24,41,17
"CTU2","s1639_F_VTA_03_ASEReadCounter.table","NW_015090842.1:9566342",26,45,19
"CTU2","s1639_F_VTA_03_ASEReadCounter.table","NW_015090842.1:9566548",23,35,12
"CTU2","s1639_F_VTA_03_ASEReadCounter.table","NW_015090842.1:9566625",20,41,21
"CTU2","s1639_F_VTA_03_ASEReadCounter.table","NW_015090842.1:9566633",18,36,18
"CTU2","s1639_F_VTA_03_ASEReadCounter.table","NW_015090842.1:9566807",17,33,16
"CTU2","s1639_F_VTA_03_ASEReadCounter.table","NW_015090842.1:9567139",31,54,23
"CTU2","s1639_F_VTA_03_ASEReadCounter.table","NW_015090842.1:9567156",27,50,23
"CTU2","s1639_F_VTA_03_ASEReadCounter.table","NW_015090842.1:9567614",24,58,34
"CTU2","s1639_F_VTA_03_ASEReadCounter.table","NW_015090842.1:9567677",33,74,41
"CTU2","s1639_F_VTA_03_ASEReadCounter.table","NW_015090842.1:9567747",26,61,35
"CTU2","s1639_F_VTA_03_ASEReadCounter.table","NW_015090842.1:9567828",21,49,28
"CTU2","s1639_F_VTA_03_ASEReadCounter.table","NW_015090842.1:9567829",21,48,27
"CTU2","s1639_F_VTA_03_ASEReadCounter.table","NW_015090842.1:9567885",16,35,19
"PIEZO1","s1639_F_VTA_03_ASEReadCounter.table","NW_015090842.1:9568093",29,102,73
"PIEZO1","s1639_F_VTA_03_ASEReadCounter.table","NW_015090842.1:9568672",38,90,52
"PIEZO1","s1639_F_VTA_03_ASEReadCounter.table","NW_015090842.1:9568948",39,103,64
"PIEZO1","s1639_F_VTA_03_ASEReadCounter.table","NW_015090842.1:9568987",75,75,0
"PIEZO1","s1639_F_VTA_03_ASEReadCounter.table","NW_015090842.1:9569040",26,68,42
"PIEZO1","s1639_F_VTA_03_ASEReadCounter.table","NW_015090842.1:9569180",25,68,43
"PIEZO1","s1639_F_VTA_03_ASEReadCounter.table","NW_015090842.1:9569192",22,69,47
"PIEZO1","s1639_F_VTA_03_ASEReadCounter.table","NW_015090842.1:9570088",26,69,43
"PIEZO1","s1639_F_VTA_03_ASEReadCounter.table","NW_015090842.1:9570480",17,39,22
"PIEZO1","s1639_F_VTA_03_ASEReadCounter.table","NW_015090842.1:9570639",9,36,27
"PIEZO1","s1639_F_VTA_03_ASEReadCounter.table","NW_015090842.1:9571847",24,58,34
"PIEZO1","s1639_F_VTA_03_ASEReadCounter.table","NW_015090842.1:9572371",13,31,18
"PIEZO1","s1639_F_VTA_03_ASEReadCounter.table","NW_015090842.1:9572638",8,19,11
"PIEZO1","s1639_F_VTA_03_ASEReadCounter.table","NW_015090842.1:9573156",18,50,32
"PIEZO1","s1639_F_VTA_03_ASEReadCounter.table","NW_015090842.1:9573280",19,46,27
"PIEZO1","s1639_F_VTA_03_ASEReadCounter.table","NW_015090842.1:9573566",7,37,30
"PIEZO1","s1639_F_VTA_03_ASEReadCounter.table","NW_015090842.1:9575341",10,23,13
"PIEZO1","s1639_F_VTA_03_ASEReadCounter.table","NW_015090842.1:9575367",6,21,15
"PIEZO1","s1639_F_VTA_03_ASEReadCounter.table","NW_015090842.1:9575645",7,22,15
"PIEZO1","s1639_F_VTA_03_ASEReadCounter.table","NW_015090842.1:9575696",9,19,10
"PIEZO1","s1639_F_VTA_03_ASEReadCounter.table","NW_015090842.1:9575897",9,20,11
"PIEZO1","s1639_F_VTA_03_ASEReadCounter.table","NW_015090842.1:9576060",3,13,10
"PIEZO1","s1639_F_VTA_03_ASEReadCounter.table","NW_015090842.1:9576087",1,14,13
"PIEZO1","s1639_F_VTA_03_ASEReadCounter.table","NW_015090842.1:9576093",3,18,15
"PIEZO1","s1639_F_VTA_03_ASEReadCounter.table","NW_015090842.1:9576120",5,18,13
"PIEZO1","s1639_F_VTA_03_ASEReadCounter.table","NW_015090842.1:9576687",4,13,9
"PIEZO1","s1639_F_VTA_03_ASEReadCounter.table","NW_015090842.1:9576710",12,12,0
"PIEZO1","s1639_F_VTA_03_ASEReadCounter.table","NW_015090842.1:9576723",6,17,11
"PIEZO1","s1639_F_VTA_03_ASEReadCounter.table","NW_015090842.1:9578268",11,18,7
"PIEZO1","s1639_F_VTA_03_ASEReadCounter.table","NW_015090842.1:9578770",5,15,10
"PIEZO1","s1639_F_VTA_03_ASEReadCounter.table","NW_015090842.1:9578806",5,16,11
"PIEZO1","s1639_F_VTA_03_ASEReadCounter.table","NW_015090842.1:9579064",7,16,9
"PIEZO1","s1639_F_VTA_03_ASEReadCounter.table","NW_015090842.1:9579065",6,15,9
"PIEZO1","s1639_F_VTA_03_ASEReadCounter.table","NW_015090842.1:9579347",6,12,6
"PIEZO1","s1639_F_VTA_03_ASEReadCounter.table","NW_015090842.1:9580765",6,8,2
"PIEZO1","s1639_F_VTA_03_ASEReadCounter.table","NW_015090842.1:9580996",4,16,12
"PIEZO1","s1639_F_VTA_03_ASEReadCounter.table","NW_015090842.1:9581101",3,12,9
"PIEZO1","s1639_F_VTA_03_ASEReadCounter.table","NW_015090842.1:9581299",3,8,5
"PIEZO1","s1639_F_VTA_03_ASEReadCounter.table","NW_015090842.1:9581875",4,13,9
"PIEZO1","s1639_F_VTA_03_ASEReadCounter.table","NW_015090842.1:9582046",4,11,7
"PIEZO1","s1639_F_VTA_03_ASEReadCounter.table","NW_015090842.1:9582961",5,13,8
"PIEZO1","s1639_F_VTA_03_ASEReadCounter.table","NW_015090842.1:9583298",5,8,3
"PIEZO1","s1639_F_VTA_03_ASEReadCounter.table","NW_015090842.1:9584337",2,9,7
"PIEZO1","s1639_F_VTA_03_ASEReadCounter.table","NW_015090842.1:9584425",5,14,9
"PIEZO1","s1639_F_VTA_03_ASEReadCounter.table","NW_015090842.1:9584435",5,13,8
"PIEZO1","s1639_F_VTA_03_ASEReadCounter.table","NW_015090842.1:9584438",5,12,7
"PIEZO1","s1639_F_VTA_03_ASEReadCounter.table","NW_015090842.1:9584441",5,11,6
"CDT1","s1639_F_VTA_03_ASEReadCounter.table","NW_015090842.1:9596596",1,1,0
"CDT1","s1639_F_VTA_03_ASEReadCounter.table","NW_015090842.1:9596766",1,2,1
"CDT1","s1639_F_VTA_03_ASEReadCounter.table","NW_015090842.1:9597054",6,10,4
"CDT1","s1639_F_VTA_03_ASEReadCounter.table","NW_015090842.1:9597074",8,10,2
"CDT1","s1639_F_VTA_03_ASEReadCounter.table","NW_015090842.1:9597137",11,12,1
"CDT1","s1639_F_VTA_03_ASEReadCounter.table","NW_015090842.1:9597756",7,11,4
"CDT1","s1639_F_VTA_03_ASEReadCounter.table","NW_015090842.1:9597766",8,12,4
"CDT1","s1639_F_VTA_03_ASEReadCounter.table","NW_015090842.1:9598496",5,9,4
"CDT1","s1639_F_VTA_03_ASEReadCounter.table","NW_015090842.1:9598498",5,9,4
"CDT1","s1639_F_VTA_03_ASEReadCounter.table","NW_015090842.1:9598816",1,9,8
"CDT1","s1639_F_VTA_03_ASEReadCounter.table","NW_015090842.1:9598879",5,12,7
"CDT1","s1639_F_VTA_03_ASEReadCounter.table","NW_015090842.1:9598912",5,11,6
"CDT1","s1639_F_VTA_03_ASEReadCounter.table","NW_015090842.1:9598959",3,7,4
"CDT1","s1639_F_VTA_03_ASEReadCounter.table","NW_015090842.1:9599807",7,11,4
"CDT1","s1639_F_VTA_03_ASEReadCounter.table","NW_015090842.1:9599819",5,9,4
"CDT1","s1639_F_VTA_03_ASEReadCounter.table","NW_015090842.1:9599845",7,13,6
"CDT1","s1639_F_VTA_03_ASEReadCounter.table","NW_015090842.1:9600148",10,19,9
"CDT1","s1639_F_VTA_03_ASEReadCounter.table","NW_015090842.1:9600151",10,19,9
"CDT1","s1639_F_VTA_03_ASEReadCounter.table","NW_015090842.1:9600217",10,20,10
"CDT1","s1639_F_VTA_03_ASEReadCounter.table","NW_015090842.1:9600226",9,20,11
"CDT1","s1639_F_VTA_03_ASEReadCounter.table","NW_015090842.1:9600260",13,23,10
"CDT1","s1639_F_VTA_03_ASEReadCounter.table","NW_015090842.1:9600268",13,23,10
"CDT1","s1639_F_VTA_03_ASEReadCounter.table","NW_015090842.1:9600305",15,22,7
"CDT1","s1639_F_VTA_03_ASEReadCounter.table","NW_015090842.1:9600397",12,18,6
"CDT1","s1639_F_VTA_03_ASEReadCounter.table","NW_015090842.1:9600447",9,13,4
"CDT1","s1639_F_VTA_03_ASEReadCounter.table","NW_015090842.1:9600450",9,12,3
"CDT1","s1639_F_VTA_03_ASEReadCounter.table","NW_015090842.1:9600485",12,15,3
"CDT1","s1639_F_VTA_03_ASEReadCounter.table","NW_015090842.1:9600579",6,11,5
"APRT","s1639_F_VTA_03_ASEReadCounter.table","NW_015090842.1:9602308",25,63,38
"APRT","s1639_F_VTA_03_ASEReadCounter.table","NW_015090842.1:9602440",52,117,65
"APRT","s1639_F_VTA_03_ASEReadCounter.table","NW_015090842.1:9602449",52,115,63
"APRT","s1639_F_VTA_03_ASEReadCounter.table","NW_015090842.1:9602451",52,120,68
"APRT","s1639_F_VTA_03_ASEReadCounter.table","NW_015090842.1:9602455",52,120,68
"APRT","s1639_F_VTA_03_ASEReadCounter.table","NW_015090842.1:9602462",50,114,64
"APRT","s1639_F_VTA_03_ASEReadCounter.table","NW_015090842.1:9602507",40,111,71
"APRT","s1639_F_VTA_03_ASEReadCounter.table","NW_015090842.1:9602514",41,105,64
"APRT","s1639_F_VTA_03_ASEReadCounter.table","NW_015090842.1:9602530",37,94,57
"APRT","s1639_F_VTA_03_ASEReadCounter.table","NW_015090842.1:9602582",27,79,52
"APRT","s1639_F_VTA_03_ASEReadCounter.table","NW_015090842.1:9602583",27,79,52
"APRT","s1639_F_VTA_03_ASEReadCounter.table","NW_015090842.1:9602650",39,98,59
"APRT","s1639_F_VTA_03_ASEReadCounter.table","NW_015090842.1:9602655",41,97,56
"APRT","s1639_F_VTA_03_ASEReadCounter.table","NW_015090842.1:9602712",31,97,66
"APRT","s1639_F_VTA_03_ASEReadCounter.table","NW_015090842.1:9602764",35,94,59
"APRT","s1639_F_VTA_03_ASEReadCounter.table","NW_015090842.1:9602821",34,85,51
"APRT","s1639_F_VTA_03_ASEReadCounter.table","NW_015090842.1:9602867",42,93,51
"APRT","s1639_F_VTA_03_ASEReadCounter.table","NW_015090842.1:9602883",45,97,52
"APRT","s1639_F_VTA_03_ASEReadCounter.table","NW_015090842.1:9602886",47,102,55
"APRT","s1639_F_VTA_03_ASEReadCounter.table","NW_015090842.1:9602948",48,101,53
"APRT","s1639_F_VTA_03_ASEReadCounter.table","NW_015090842.1:9602958",51,115,64
"APRT","s1639_F_VTA_03_ASEReadCounter.table","NW_015090842.1:9603020",66,133,67
"APRT","s1639_F_VTA_03_ASEReadCounter.table","NW_015090842.1:9603025",67,137,70
"APRT","s1639_F_VTA_03_ASEReadCounter.table","NW_015090842.1:9603154",46,111,65
"APRT","s1639_F_VTA_03_ASEReadCounter.table","NW_015090842.1:9603166",48,114,66
"APRT","s1639_F_VTA_03_ASEReadCounter.table","NW_015090842.1:9603326",50,102,52
"APRT","s1639_F_VTA_03_ASEReadCounter.table","NW_015090842.1:9603419",31,64,33
"APRT","s1639_F_VTA_03_ASEReadCounter.table","NW_015090842.1:9603420",29,62,33
"APRT","s1639_F_VTA_03_ASEReadCounter.table","NW_015090842.1:9603464",15,42,27
"APRT","s1639_F_VTA_03_ASEReadCounter.table","NW_015090842.1:9603528",20,51,31
"APRT","s1639_F_VTA_03_ASEReadCounter.table","NW_015090842.1:9603607",23,54,31
"APRT","s1639_F_VTA_03_ASEReadCounter.table","NW_015090842.1:9603622",18,48,30
"APRT","s1639_F_VTA_03_ASEReadCounter.table","NW_015090842.1:9604361",12,43,31
"APRT","s1639_F_VTA_03_ASEReadCounter.table","NW_015090842.1:9605317",13,33,20
"APRT","s1639_F_VTA_03_ASEReadCounter.table","NW_015090842.1:9605336",13,38,25
"GALNS","s1639_F_VTA_03_ASEReadCounter.table","NW_015090842.1:9612872",3,8,5
"GALNS","s1639_F_VTA_03_ASEReadCounter.table","NW_015090842.1:9612873",3,8,5
"GALNS","s1639_F_VTA_03_ASEReadCounter.table","NW_015090842.1:9612877",4,10,6
"GALNS","s1639_F_VTA_03_ASEReadCounter.table","NW_015090842.1:9612942",13,38,25
"GALNS","s1639_F_VTA_03_ASEReadCounter.table","NW_015090842.1:9612987",37,37,0
"GALNS","s1639_F_VTA_03_ASEReadCounter.table","NW_015090842.1:9613064",14,40,26
"GALNS","s1639_F_VTA_03_ASEReadCounter.table","NW_015090842.1:9613096",31,52,21
"GALNS","s1639_F_VTA_03_ASEReadCounter.table","NW_015090842.1:9613123",26,47,21
"GALNS","s1639_F_VTA_03_ASEReadCounter.table","NW_015090842.1:9613125",26,44,18
"GALNS","s1639_F_VTA_03_ASEReadCounter.table","NW_015090842.1:9613193",21,51,30
"GALNS","s1639_F_VTA_03_ASEReadCounter.table","NW_015090842.1:9613226",22,52,30
"GALNS","s1639_F_VTA_03_ASEReadCounter.table","NW_015090842.1:9613249",22,53,31
"GALNS","s1639_F_VTA_03_ASEReadCounter.table","NW_015090842.1:9613256",25,58,33
"GALNS","s1639_F_VTA_03_ASEReadCounter.table","NW_015090842.1:9613317",25,44,19
"GALNS","s1639_F_VTA_03_ASEReadCounter.table","NW_015090842.1:9613343",30,52,22
"GALNS","s1639_F_VTA_03_ASEReadCounter.table","NW_015090842.1:9613344",30,52,22
"GALNS","s1639_F_VTA_03_ASEReadCounter.table","NW_015090842.1:9613371",33,60,27
"GALNS","s1639_F_VTA_03_ASEReadCounter.table","NW_015090842.1:9613378",32,61,29
"GALNS","s1639_F_VTA_03_ASEReadCounter.table","NW_015090842.1:9613379",32,63,31
"GALNS","s1639_F_VTA_03_ASEReadCounter.table","NW_015090842.1:9613516",29,51,22
"GALNS","s1639_F_VTA_03_ASEReadCounter.table","NW_015090842.1:9613572",22,43,21
"GALNS","s1639_F_VTA_03_ASEReadCounter.table","NW_015090842.1:9613597",17,42,25
"GALNS","s1639_F_VTA_03_ASEReadCounter.table","NW_015090842.1:9613627",15,37,22
"GALNS","s1639_F_VTA_03_ASEReadCounter.table","NW_015090842.1:9613640",20,43,23
"GALNS","s1639_F_VTA_03_ASEReadCounter.table","NW_015090842.1:9614025",32,57,25
"GALNS","s1639_F_VTA_03_ASEReadCounter.table","NW_015090842.1:9614169",18,39,21
"GALNS","s1639_F_VTA_03_ASEReadCounter.table","NW_015090842.1:9614232",40,40,0
"GALNS","s1639_F_VTA_03_ASEReadCounter.table","NW_015090842.1:9614667",16,31,15
"GALNS","s1639_F_VTA_03_ASEReadCounter.table","NW_015090842.1:9614709",21,35,14
"GALNS","s1639_F_VTA_03_ASEReadCounter.table","NW_015090842.1:9614880",19,30,11
"GALNS","s1639_F_VTA_03_ASEReadCounter.table","NW_015090842.1:9614902",15,28,13
"GALNS","s1639_F_VTA_03_ASEReadCounter.table","NW_015090842.1:9614960",7,19,12
"GALNS","s1639_F_VTA_03_ASEReadCounter.table","NW_015090842.1:9615114",17,34,17
"GALNS","s1639_F_VTA_03_ASEReadCounter.table","NW_015090842.1:9615199",12,27,15
"GALNS","s1639_F_VTA_03_ASEReadCounter.table","NW_015090842.1:9615217",11,23,12
"GALNS","s1639_F_VTA_03_ASEReadCounter.table","NW_015090842.1:9615277",13,26,13
"GALNS","s1639_F_VTA_03_ASEReadCounter.table","NW_015090842.1:9615377",13,33,20
"GALNS","s1639_F_VTA_03_ASEReadCounter.table","NW_015090842.1:9647858",6,13,7
"GALNS","s1639_F_VTA_03_ASEReadCounter.table","NW_015090842.1:9649186",10,20,10
"GALNS","s1639_F_VTA_03_ASEReadCounter.table","NW_015090842.1:9649237",8,15,7
"GALNS","s1639_F_VTA_03_ASEReadCounter.table","NW_015090842.1:9661193",1,5,4
"TRAPPC2L","s1639_F_VTA_03_ASEReadCounter.table","NW_015090842.1:9662951",146,261,115
"TRAPPC2L","s1639_F_VTA_03_ASEReadCounter.table","NW_015090842.1:9663014",164,270,106
"TRAPPC2L","s1639_F_VTA_03_ASEReadCounter.table","NW_015090842.1:9664305",240,240,0
"TRAPPC2L","s1639_F_VTA_03_ASEReadCounter.table","NW_015090842.1:9665155",149,247,98
"TRAPPC2L","s1639_F_VTA_03_ASEReadCounter.table","NW_015090842.1:9665211",41,80,39
"CBFA2T3","s1639_F_VTA_03_ASEReadCounter.table","NW_015090842.1:9709469",1,26,25
"CBFA2T3","s1639_F_VTA_03_ASEReadCounter.table","NW_015090842.1:9709475",1,28,27
"CBFA2T3","s1639_F_VTA_03_ASEReadCounter.table","NW_015090842.1:9711845",0,10,10
"CBFA2T3","s1639_F_VTA_03_ASEReadCounter.table","NW_015090842.1:9712157",0,8,8
"CBFA2T3","s1639_F_VTA_03_ASEReadCounter.table","NW_015090842.1:9712160",0,8,8
"CBFA2T3","s1639_F_VTA_03_ASEReadCounter.table","NW_015090842.1:9712166",0,9,9
"CBFA2T3","s1639_F_VTA_03_ASEReadCounter.table","NW_015090842.1:9712536",3,7,4
"CBFA2T3","s1639_F_VTA_03_ASEReadCounter.table","NW_015090842.1:9712673",4,7,3
"CBFA2T3","s1639_F_VTA_03_ASEReadCounter.table","NW_015090842.1:9712787",6,11,5
"CBFA2T3","s1639_F_VTA_03_ASEReadCounter.table","NW_015090842.1:9712791",7,12,5
"CBFA2T3","s1639_F_VTA_03_ASEReadCounter.table","NW_015090842.1:9712805",8,13,5
"CBFA2T3","s1639_F_VTA_03_ASEReadCounter.table","NW_015090842.1:9712811",7,13,6
"CBFA2T3","s1639_F_VTA_03_ASEReadCounter.table","NW_015090842.1:9712848",10,16,6
"CBFA2T3","s1639_F_VTA_03_ASEReadCounter.table","NW_015090842.1:9713088",3,7,4
"CBFA2T3","s1639_F_VTA_03_ASEReadCounter.table","NW_015090842.1:9713121",6,10,4
"CBFA2T3","s1639_F_VTA_03_ASEReadCounter.table","NW_015090842.1:9717058",11,21,10
"CBFA2T3","s1639_F_VTA_03_ASEReadCounter.table","NW_015090842.1:9717093",11,22,11
"CBFA2T3","s1639_F_VTA_03_ASEReadCounter.table","NW_015090842.1:9717114",8,17,9
"CBFA2T3","s1639_F_VTA_03_ASEReadCounter.table","NW_015090842.1:9717139",6,13,7
"CBFA2T3","s1639_F_VTA_03_ASEReadCounter.table","NW_015090842.1:9719788",8,17,9
"CBFA2T3","s1639_F_VTA_03_ASEReadCounter.table","NW_015090842.1:9728475",1,3,2
"CBFA2T3","s1639_F_VTA_03_ASEReadCounter.table","NW_015090842.1:9728522",0,1,1
"CBFA2T3","s1639_F_VTA_03_ASEReadCounter.table","NW_015090842.1:9728525",0,1,1
"ACSF3","s1639_F_VTA_03_ASEReadCounter.table","NW_015090842.1:9773382",1,1,0
"ACSF3","s1639_F_VTA_03_ASEReadCounter.table","NW_015090842.1:9773384",1,1,0
"ACSF3","s1639_F_VTA_03_ASEReadCounter.table","NW_015090842.1:9773388",1,3,2
"ACSF3","s1639_F_VTA_03_ASEReadCounter.table","NW_015090842.1:9776753",7,12,5
"ACSF3","s1639_F_VTA_03_ASEReadCounter.table","NW_015090842.1:9776783",7,10,3
"ACSF3","s1639_F_VTA_03_ASEReadCounter.table","NW_015090842.1:9776879",9,12,3
"ACSF3","s1639_F_VTA_03_ASEReadCounter.table","NW_015090842.1:9776965",10,13,3
"ACSF3","s1639_F_VTA_03_ASEReadCounter.table","NW_015090842.1:9777091",14,20,6
"ACSF3","s1639_F_VTA_03_ASEReadCounter.table","NW_015090842.1:9777206",14,19,5
"ACSF3","s1639_F_VTA_03_ASEReadCounter.table","NW_015090842.1:9777283",15,24,9
"ACSF3","s1639_F_VTA_03_ASEReadCounter.table","NW_015090842.1:9778955",9,26,17
"ACSF3","s1639_F_VTA_03_ASEReadCounter.table","NW_015090842.1:9778997",17,34,17
"ACSF3","s1639_F_VTA_03_ASEReadCounter.table","NW_015090842.1:9789311",23,45,22
"ACSF3","s1639_F_VTA_03_ASEReadCounter.table","NW_015090842.1:9789906",2,27,25
"ACSF3","s1639_F_VTA_03_ASEReadCounter.table","NW_015090842.1:9834743",40,71,31
"ACSF3","s1639_F_VTA_03_ASEReadCounter.table","NW_015090842.1:9834852",37,67,30
"ACSF3","s1639_F_VTA_03_ASEReadCounter.table","NW_015090842.1:9834861",38,66,28
"ACSF3","s1639_F_VTA_03_ASEReadCounter.table","NW_015090842.1:9839359",29,54,25
"ACSF3","s1639_F_VTA_03_ASEReadCounter.table","NW_015090842.1:9839378",29,53,24
"ACSF3","s1639_F_VTA_03_ASEReadCounter.table","NW_015090842.1:9839455",30,58,28
"ACSF3","s1639_F_VTA_03_ASEReadCounter.table","NW_015090842.1:9839457",30,57,27
"ACSF3","s1639_F_VTA_03_ASEReadCounter.table","NW_015090842.1:9839489",23,45,22
"ACSF3","s1639_F_VTA_03_ASEReadCounter.table","NW_015090842.1:9839500",17,34,17
"ACSF3","s1639_F_VTA_03_ASEReadCounter.table","NW_015090842.1:9839501",17,35,18
"ACSF3","s1639_F_VTA_03_ASEReadCounter.table","NW_015090842.1:9839504",17,35,18
"ACSF3","s1639_F_VTA_03_ASEReadCounter.table","NW_015090842.1:9839512",17,32,15
"ACSF3","s1639_F_VTA_03_ASEReadCounter.table","NW_015090842.1:9839527",10,24,14
"ACSF3","s1639_F_VTA_03_ASEReadCounter.table","NW_015090842.1:9839533",5,17,12
"ACSF3","s1639_F_VTA_03_ASEReadCounter.table","NW_015090842.1:9839535",5,17,12
"ACSF3","s1639_F_VTA_03_ASEReadCounter.table","NW_015090842.1:9839545",2,12,10
"ACSF3","s1639_F_VTA_03_ASEReadCounter.table","NW_015090842.1:9839550",1,11,10
"ACSF3","s1639_F_VTA_03_ASEReadCounter.table","NW_015090842.1:9839551",1,11,10
"CDH15","s1639_F_VTA_03_ASEReadCounter.table","NW_015090842.1:9847163",2,2,0
"CDH15","s1639_F_VTA_03_ASEReadCounter.table","NW_015090842.1:9847174",2,2,0
"CDH15","s1639_F_VTA_03_ASEReadCounter.table","NW_015090842.1:9848307",1,1,0
"CDH15","s1639_F_VTA_03_ASEReadCounter.table","NW_015090842.1:9848310",1,1,0
"CDH15","s1639_F_VTA_03_ASEReadCounter.table","NW_015090842.1:9848313",1,1,0
"CDH15","s1639_F_VTA_03_ASEReadCounter.table","NW_015090842.1:9848531",1,1,0
"CDH15","s1639_F_VTA_03_ASEReadCounter.table","NW_015090842.1:9848552",1,1,0
"CDH15","s1639_F_VTA_03_ASEReadCounter.table","NW_015090842.1:9848888",1,1,0
"CDH15","s1639_F_VTA_03_ASEReadCounter.table","NW_015090842.1:9848936",1,1,0
"CDH15","s1639_F_VTA_03_ASEReadCounter.table","NW_015090842.1:9850386",0,3,3
"CDH15","s1639_F_VTA_03_ASEReadCounter.table","NW_015090842.1:9850432",0,2,2
"CDH15","s1639_F_VTA_03_ASEReadCounter.table","NW_015090842.1:9850609",0,3,3
"SLC22A31","s1639_F_VTA_03_ASEReadCounter.table","NW_015090842.1:9851117",2,6,4
"SLC22A31","s1639_F_VTA_03_ASEReadCounter.table","NW_015090842.1:9851130",2,6,4
"SLC22A31","s1639_F_VTA_03_ASEReadCounter.table","NW_015090842.1:9851139",1,5,4
"SLC22A31","s1639_F_VTA_03_ASEReadCounter.table","NW_015090842.1:9851265",5,13,8
"SLC22A31","s1639_F_VTA_03_ASEReadCounter.table","NW_015090842.1:9851302",3,12,9
"SLC22A31","s1639_F_VTA_03_ASEReadCounter.table","NW_015090842.1:9851303",3,12,9
"SLC22A31","s1639_F_VTA_03_ASEReadCounter.table","NW_015090842.1:9851305",3,12,9
"SLC22A31","s1639_F_VTA_03_ASEReadCounter.table","NW_015090842.1:9851343",4,12,8
"SLC22A31","s1639_F_VTA_03_ASEReadCounter.table","NW_015090842.1:9851344",4,11,7
"SLC22A31","s1639_F_VTA_03_ASEReadCounter.table","NW_015090842.1:9851361",13,13,0
"SLC22A31","s1639_F_VTA_03_ASEReadCounter.table","NW_015090842.1:9851381",8,15,7
"SLC22A31","s1639_F_VTA_03_ASEReadCounter.table","NW_015090842.1:9851421",10,19,9
"SLC22A31","s1639_F_VTA_03_ASEReadCounter.table","NW_015090842.1:9851501",3,8,5
"SLC22A31","s1639_F_VTA_03_ASEReadCounter.table","NW_015090842.1:9851526",5,8,3
"SLC22A31","s1639_F_VTA_03_ASEReadCounter.table","NW_015090842.1:9851589",5,11,6
"SLC22A31","s1639_F_VTA_03_ASEReadCounter.table","NW_015090842.1:9851712",6,14,8
"SLC22A31","s1639_F_VTA_03_ASEReadCounter.table","NW_015090842.1:9851899",4,7,3
"SLC22A31","s1639_F_VTA_03_ASEReadCounter.table","NW_015090842.1:9852139",4,9,5
"SLC22A31","s1639_F_VTA_03_ASEReadCounter.table","NW_015090842.1:9852380",10,12,2
"SLC22A31","s1639_F_VTA_03_ASEReadCounter.table","NW_015090842.1:9852431",4,9,5
"SLC22A31","s1639_F_VTA_03_ASEReadCounter.table","NW_015090842.1:9852630",1,7,6
"SLC22A31","s1639_F_VTA_03_ASEReadCounter.table","NW_015090842.1:9852711",3,10,7
"SLC22A31","s1639_F_VTA_03_ASEReadCounter.table","NW_015090842.1:9853099",2,4,2
"SLC22A31","s1639_F_VTA_03_ASEReadCounter.table","NW_015090842.1:9853102",2,4,2
"SLC22A31","s1639_F_VTA_03_ASEReadCounter.table","NW_015090842.1:9853421",1,1,0
"SLC22A31","s1639_F_VTA_03_ASEReadCounter.table","NW_015090842.1:9853457",1,1,0
"SLC22A31","s1639_F_VTA_03_ASEReadCounter.table","NW_015090842.1:9853502",1,1,0
"ANKRD11","s1639_F_VTA_03_ASEReadCounter.table","NW_015090842.1:9858863",3,8,5
"ANKRD11","s1639_F_VTA_03_ASEReadCounter.table","NW_015090842.1:9859101",104,242,138
"ANKRD11","s1639_F_VTA_03_ASEReadCounter.table","NW_015090842.1:9859352",134,326,192
"ANKRD11","s1639_F_VTA_03_ASEReadCounter.table","NW_015090842.1:9859381",68,206,138
"ANKRD11","s1639_F_VTA_03_ASEReadCounter.table","NW_015090842.1:9859679",103,237,134
"ANKRD11","s1639_F_VTA_03_ASEReadCounter.table","NW_015090842.1:9861097",104,209,105
"ANKRD11","s1639_F_VTA_03_ASEReadCounter.table","NW_015090842.1:9862571",51,107,56
"ANKRD11","s1639_F_VTA_03_ASEReadCounter.table","NW_015090842.1:9862652",35,60,25
"ANKRD11","s1639_F_VTA_03_ASEReadCounter.table","NW_015090842.1:9866071",0,48,48
"ANKRD11","s1639_F_VTA_03_ASEReadCounter.table","NW_015090842.1:9866200",0,60,60
"ANKRD11","s1639_F_VTA_03_ASEReadCounter.table","NW_015090842.1:9867391",20,41,21
"ANKRD11","s1639_F_VTA_03_ASEReadCounter.table","NW_015090842.1:9867472",29,62,33
"ANKRD11","s1639_F_VTA_03_ASEReadCounter.table","NW_015090842.1:9867559",35,65,30
"ANKRD11","s1639_F_VTA_03_ASEReadCounter.table","NW_015090842.1:9867667",28,52,24
"ANKRD11","s1639_F_VTA_03_ASEReadCounter.table","NW_015090842.1:9867934",36,68,32
"ANKRD11","s1639_F_VTA_03_ASEReadCounter.table","NW_015090842.1:9868064",39,65,26
"ANKRD11","s1639_F_VTA_03_ASEReadCounter.table","NW_015090842.1:9868093",36,59,23
"ANKRD11","s1639_F_VTA_03_ASEReadCounter.table","NW_015090842.1:9868222",37,78,41
"ANKRD11","s1639_F_VTA_03_ASEReadCounter.table","NW_015090842.1:9868327",44,91,47
"ANKRD11","s1639_F_VTA_03_ASEReadCounter.table","NW_015090842.1:9868414",51,111,60
"ANKRD11","s1639_F_VTA_03_ASEReadCounter.table","NW_015090842.1:9868441",51,103,52
"ANKRD11","s1639_F_VTA_03_ASEReadCounter.table","NW_015090842.1:9868444",51,106,55
"ANKRD11","s1639_F_VTA_03_ASEReadCounter.table","NW_015090842.1:9868519",64,133,69
"ANKRD11","s1639_F_VTA_03_ASEReadCounter.table","NW_015090842.1:9868609",81,155,74
"ANKRD11","s1639_F_VTA_03_ASEReadCounter.table","NW_015090842.1:9868666",100,184,84
"ANKRD11","s1639_F_VTA_03_ASEReadCounter.table","NW_015090842.1:9868738",205,205,0
"ANKRD11","s1639_F_VTA_03_ASEReadCounter.table","NW_015090842.1:9869431",106,239,133
"ANKRD11","s1639_F_VTA_03_ASEReadCounter.table","NW_015090842.1:9869578",193,387,194
"ANKRD11","s1639_F_VTA_03_ASEReadCounter.table","NW_015090842.1:9869734",195,411,216
"ANKRD11","s1639_F_VTA_03_ASEReadCounter.table","NW_015090842.1:9870070",145,344,199
"ANKRD11","s1639_F_VTA_03_ASEReadCounter.table","NW_015090842.1:9870349",222,448,226
"ANKRD11","s1639_F_VTA_03_ASEReadCounter.table","NW_015090842.1:9870604",200,407,207
"ANKRD11","s1639_F_VTA_03_ASEReadCounter.table","NW_015090842.1:9870613",225,448,223
"ANKRD11","s1639_F_VTA_03_ASEReadCounter.table","NW_015090842.1:9870685",239,543,304
"ANKRD11","s1639_F_VTA_03_ASEReadCounter.table","NW_015090842.1:9870760",219,523,304
"ANKRD11","s1639_F_VTA_03_ASEReadCounter.table","NW_015090842.1:9870847",207,457,250
"ANKRD11","s1639_F_VTA_03_ASEReadCounter.table","NW_015090842.1:9871103",167,356,189
"ANKRD11","s1639_F_VTA_03_ASEReadCounter.table","NW_015090842.1:9871165",172,382,210
"ANKRD11","s1639_F_VTA_03_ASEReadCounter.table","NW_015090842.1:9871508",243,243,0
"ANKRD11","s1639_F_VTA_03_ASEReadCounter.table","NW_015090842.1:9871820",42,105,63
"ANKRD11","s1639_F_VTA_03_ASEReadCounter.table","NW_015090842.1:9872118",49,108,59
"ANKRD11","s1639_F_VTA_03_ASEReadCounter.table","NW_015090842.1:9877406",20,52,32
"SPG7","s1639_F_VTA_03_ASEReadCounter.table","NW_015090842.1:10051190",47,104,57
"SPG7","s1639_F_VTA_03_ASEReadCounter.table","NW_015090842.1:10051218",52,116,64
"SPG7","s1639_F_VTA_03_ASEReadCounter.table","NW_015090842.1:10052348",85,162,77
"SPG7","s1639_F_VTA_03_ASEReadCounter.table","NW_015090842.1:10052366",88,168,80
"SPG7","s1639_F_VTA_03_ASEReadCounter.table","NW_015090842.1:10065173",108,204,96
"SPG7","s1639_F_VTA_03_ASEReadCounter.table","NW_015090842.1:10065215",96,178,82
"SPG7","s1639_F_VTA_03_ASEReadCounter.table","NW_015090842.1:10066365",78,171,93
"SPG7","s1639_F_VTA_03_ASEReadCounter.table","NW_015090842.1:10069752",111,222,111
"SPG7","s1639_F_VTA_03_ASEReadCounter.table","NW_015090842.1:10069800",119,234,115
"SPG7","s1639_F_VTA_03_ASEReadCounter.table","NW_015090842.1:10071192",144,263,119
"SPG7","s1639_F_VTA_03_ASEReadCounter.table","NW_015090842.1:10071219",126,237,111
"SPG7","s1639_F_VTA_03_ASEReadCounter.table","NW_015090842.1:10071967",130,261,131
"SPG7","s1639_F_VTA_03_ASEReadCounter.table","NW_015090842.1:10075109",225,401,176
"SPG7","s1639_F_VTA_03_ASEReadCounter.table","NW_015090842.1:10075114",227,408,181
"SPG7","s1639_F_VTA_03_ASEReadCounter.table","NW_015090842.1:10075198",185,348,163
"SPG7","s1639_F_VTA_03_ASEReadCounter.table","NW_015090842.1:10075487",133,292,159
"SPG7","s1639_F_VTA_03_ASEReadCounter.table","NW_015090842.1:10075488",134,289,155
"SPG7","s1639_F_VTA_03_ASEReadCounter.table","NW_015090842.1:10075548",110,222,112
"RPL13","s1639_F_VTA_03_ASEReadCounter.table","NW_015090842.1:10077387",470,979,509
"RPL13","s1639_F_VTA_03_ASEReadCounter.table","NW_015090842.1:10077978",723,1501,778
"RPL13","s1639_F_VTA_03_ASEReadCounter.table","NW_015090842.1:10077992",709,1422,713
"CPNE7","s1639_F_VTA_03_ASEReadCounter.table","NW_015090842.1:10084001",1,1,0
"CPNE7","s1639_F_VTA_03_ASEReadCounter.table","NW_015090842.1:10084856",1,1,0
"CPNE7","s1639_F_VTA_03_ASEReadCounter.table","NW_015090842.1:10084872",1,2,1
"CPNE7","s1639_F_VTA_03_ASEReadCounter.table","NW_015090842.1:10084892",1,2,1
"CPNE7","s1639_F_VTA_03_ASEReadCounter.table","NW_015090842.1:10084921",3,4,1
"CPNE7","s1639_F_VTA_03_ASEReadCounter.table","NW_015090842.1:10084935",3,4,1
"CPNE7","s1639_F_VTA_03_ASEReadCounter.table","NW_015090842.1:10085000",4,5,1
"CPNE7","s1639_F_VTA_03_ASEReadCounter.table","NW_015090842.1:10085089",4,4,0
"CPNE7","s1639_F_VTA_03_ASEReadCounter.table","NW_015090842.1:10085096",4,4,0
"CPNE7","s1639_F_VTA_03_ASEReadCounter.table","NW_015090842.1:10085126",4,4,0
"CPNE7","s1639_F_VTA_03_ASEReadCounter.table","NW_015090842.1:10085167",5,5,0
"CPNE7","s1639_F_VTA_03_ASEReadCounter.table","NW_015090842.1:10085180",5,5,0
"CPNE7","s1639_F_VTA_03_ASEReadCounter.table","NW_015090842.1:10085201",5,5,0
"CPNE7","s1639_F_VTA_03_ASEReadCounter.table","NW_015090842.1:10088134",5,10,5
"CPNE7","s1639_F_VTA_03_ASEReadCounter.table","NW_015090842.1:10088146",5,10,5
"CPNE7","s1639_F_VTA_03_ASEReadCounter.table","NW_015090842.1:10088806",7,12,5
"CPNE7","s1639_F_VTA_03_ASEReadCounter.table","NW_015090842.1:10088940",5,13,8
"CPNE7","s1639_F_VTA_03_ASEReadCounter.table","NW_015090842.1:10088965",6,13,7
"CPNE7","s1639_F_VTA_03_ASEReadCounter.table","NW_015090842.1:10088967",7,13,6
"CPNE7","s1639_F_VTA_03_ASEReadCounter.table","NW_015090842.1:10088973",7,14,7
"CPNE7","s1639_F_VTA_03_ASEReadCounter.table","NW_015090842.1:10090924",19,25,6
"CPNE7","s1639_F_VTA_03_ASEReadCounter.table","NW_015090842.1:10090930",19,25,6
"CPNE7","s1639_F_VTA_03_ASEReadCounter.table","NW_015090842.1:10091075",21,30,9
"CPNE7","s1639_F_VTA_03_ASEReadCounter.table","NW_015090842.1:10091389",28,42,14
"CPNE7","s1639_F_VTA_03_ASEReadCounter.table","NW_015090842.1:10091407",28,40,12
"CPNE7","s1639_F_VTA_03_ASEReadCounter.table","NW_015090842.1:10091488",23,23,0
"CPNE7","s1639_F_VTA_03_ASEReadCounter.table","NW_015090842.1:10091491",24,24,0
"CPNE7","s1639_F_VTA_03_ASEReadCounter.table","NW_015090842.1:10091530",19,24,5
"CPNE7","s1639_F_VTA_03_ASEReadCounter.table","NW_015090842.1:10091875",19,25,6
"CPNE7","s1639_F_VTA_03_ASEReadCounter.table","NW_015090842.1:10091983",15,26,11
"CPNE7","s1639_F_VTA_03_ASEReadCounter.table","NW_015090842.1:10091997",19,31,12
"CPNE7","s1639_F_VTA_03_ASEReadCounter.table","NW_015090842.1:10092038",6,17,11
"CPNE7","s1639_F_VTA_03_ASEReadCounter.table","NW_015090842.1:10092140",9,15,6
"CPNE7","s1639_F_VTA_03_ASEReadCounter.table","NW_015090842.1:10092183",5,7,2
"CPNE7","s1639_F_VTA_03_ASEReadCounter.table","NW_015090842.1:10092201",4,7,3
"CPNE7","s1639_F_VTA_03_ASEReadCounter.table","NW_015090842.1:10092230",3,6,3
"CPNE7","s1639_F_VTA_03_ASEReadCounter.table","NW_015090842.1:10092246",3,4,1
"LOC106888185","s1639_F_VTA_03_ASEReadCounter.table","NW_015090842.1:10094965",0,3,3
"LOC106888185","s1639_F_VTA_03_ASEReadCounter.table","NW_015090842.1:10094966",0,2,2
"LOC106888185","s1639_F_VTA_03_ASEReadCounter.table","NW_015090842.1:10094985",0,3,3
"LOC106888185","s1639_F_VTA_03_ASEReadCounter.table","NW_015090842.1:10095055",0,3,3
"LOC106888185","s1639_F_VTA_03_ASEReadCounter.table","NW_015090842.1:10095062",0,3,3
"LOC106888185","s1639_F_VTA_03_ASEReadCounter.table","NW_015090842.1:10095130",0,3,3
"LOC106888185","s1639_F_VTA_03_ASEReadCounter.table","NW_015090842.1:10095265",7,23,16
"LOC106888185","s1639_F_VTA_03_ASEReadCounter.table","NW_015090842.1:10095586",11,23,12
"LOC106888185","s1639_F_VTA_03_ASEReadCounter.table","NW_015090842.1:10095593",12,23,11
"LOC106888185","s1639_F_VTA_03_ASEReadCounter.table","NW_015090842.1:10095616",7,18,11
"LOC106888185","s1639_F_VTA_03_ASEReadCounter.table","NW_015090842.1:10095662",6,16,10
"LOC106888185","s1639_F_VTA_03_ASEReadCounter.table","NW_015090842.1:10095674",6,17,11
"LOC106888185","s1639_F_VTA_03_ASEReadCounter.table","NW_015090842.1:10095786",9,16,7
"LOC106888185","s1639_F_VTA_03_ASEReadCounter.table","NW_015090842.1:10095831",9,15,6
"LOC106888185","s1639_F_VTA_03_ASEReadCounter.table","NW_015090842.1:10096230",8,16,8
"LOC106888185","s1639_F_VTA_03_ASEReadCounter.table","NW_015090842.1:10096249",8,16,8
"LOC106888185","s1639_F_VTA_03_ASEReadCounter.table","NW_015090842.1:10096272",8,13,5
"LOC106888185","s1639_F_VTA_03_ASEReadCounter.table","NW_015090842.1:10096288",11,17,6
"LOC106888185","s1639_F_VTA_03_ASEReadCounter.table","NW_015090842.1:10097248",2,8,6
"LOC106888185","s1639_F_VTA_03_ASEReadCounter.table","NW_015090842.1:10097265",3,8,5
"LOC106888185","s1639_F_VTA_03_ASEReadCounter.table","NW_015090842.1:10097446",2,6,4
"DPEP1","s1639_F_VTA_03_ASEReadCounter.table","NW_015090842.1:10098017",0,1,1
"DPEP1","s1639_F_VTA_03_ASEReadCounter.table","NW_015090842.1:10098518",0,1,1
"DPEP1","s1639_F_VTA_03_ASEReadCounter.table","NW_015090842.1:10098659",0,1,1
"DPEP1","s1639_F_VTA_03_ASEReadCounter.table","NW_015090842.1:10099765",0,1,1
"DPEP1","s1639_F_VTA_03_ASEReadCounter.table","NW_015090842.1:10099985",0,2,2
"DPEP1","s1639_F_VTA_03_ASEReadCounter.table","NW_015090842.1:10099986",0,2,2
"DPEP1","s1639_F_VTA_03_ASEReadCounter.table","NW_015090842.1:10099991",0,2,2
"DPEP1","s1639_F_VTA_03_ASEReadCounter.table","NW_015090842.1:10100044",0,1,1
"DPEP1","s1639_F_VTA_03_ASEReadCounter.table","NW_015090842.1:10100045",0,1,1
"DPEP1","s1639_F_VTA_03_ASEReadCounter.table","NW_015090842.1:10100084",0,2,2
"DPEP1","s1639_F_VTA_03_ASEReadCounter.table","NW_015090842.1:10100529",0,1,1
"DPEP1","s1639_F_VTA_03_ASEReadCounter.table","NW_015090842.1:10100893",0,1,1
"DPEP1","s1639_F_VTA_03_ASEReadCounter.table","NW_015090842.1:10100902",0,1,1
"DPEP1","s1639_F_VTA_03_ASEReadCounter.table","NW_015090842.1:10101072",0,1,1
"DPEP1","s1639_F_VTA_03_ASEReadCounter.table","NW_015090842.1:10101199",0,2,2
"DPEP1","s1639_F_VTA_03_ASEReadCounter.table","NW_015090842.1:10101483",0,1,1
"DPEP1","s1639_F_VTA_03_ASEReadCounter.table","NW_015090842.1:10101497",0,3,3
"DPEP1","s1639_F_VTA_03_ASEReadCounter.table","NW_015090842.1:10101525",0,2,2
"DPEP1","s1639_F_VTA_03_ASEReadCounter.table","NW_015090842.1:10101913",0,1,1
"DPEP1","s1639_F_VTA_03_ASEReadCounter.table","NW_015090842.1:10101996",0,1,1
"CHMP1A","s1639_F_VTA_03_ASEReadCounter.table","NW_015090842.1:10102901",71,167,96
"CHMP1A","s1639_F_VTA_03_ASEReadCounter.table","NW_015090842.1:10102961",55,150,95
"CHMP1A","s1639_F_VTA_03_ASEReadCounter.table","NW_015090842.1:10102996",53,146,93
"CHMP1A","s1639_F_VTA_03_ASEReadCounter.table","NW_015090842.1:10103004",58,145,87
"CHMP1A","s1639_F_VTA_03_ASEReadCounter.table","NW_015090842.1:10103006",58,151,93
"CHMP1A","s1639_F_VTA_03_ASEReadCounter.table","NW_015090842.1:10103052",95,209,114
"CHMP1A","s1639_F_VTA_03_ASEReadCounter.table","NW_015090842.1:10103095",83,197,114
"CHMP1A","s1639_F_VTA_03_ASEReadCounter.table","NW_015090842.1:10103096",83,197,114
"CHMP1A","s1639_F_VTA_03_ASEReadCounter.table","NW_015090842.1:10103152",69,140,71
"CHMP1A","s1639_F_VTA_03_ASEReadCounter.table","NW_015090842.1:10103173",70,146,76
"CHMP1A","s1639_F_VTA_03_ASEReadCounter.table","NW_015090842.1:10103334",31,106,75
"CHMP1A","s1639_F_VTA_03_ASEReadCounter.table","NW_015090842.1:10103373",25,104,79
"CHMP1A","s1639_F_VTA_03_ASEReadCounter.table","NW_015090842.1:10103408",42,119,77
"CHMP1A","s1639_F_VTA_03_ASEReadCounter.table","NW_015090842.1:10103412",52,127,75
"CHMP1A","s1639_F_VTA_03_ASEReadCounter.table","NW_015090842.1:10103512",63,140,77
"CHMP1A","s1639_F_VTA_03_ASEReadCounter.table","NW_015090842.1:10103513",63,140,77
"CHMP1A","s1639_F_VTA_03_ASEReadCounter.table","NW_015090842.1:10103583",41,89,48
"CHMP1A","s1639_F_VTA_03_ASEReadCounter.table","NW_015090842.1:10103614",38,99,61
"CHMP1A","s1639_F_VTA_03_ASEReadCounter.table","NW_015090842.1:10103657",41,116,75
"CHMP1A","s1639_F_VTA_03_ASEReadCounter.table","NW_015090842.1:10103669",36,112,76
"CHMP1A","s1639_F_VTA_03_ASEReadCounter.table","NW_015090842.1:10103674",34,106,72
"CHMP1A","s1639_F_VTA_03_ASEReadCounter.table","NW_015090842.1:10103677",31,102,71
"CHMP1A","s1639_F_VTA_03_ASEReadCounter.table","NW_015090842.1:10103729",44,98,54
"CHMP1A","s1639_F_VTA_03_ASEReadCounter.table","NW_015090842.1:10103758",46,90,44
"CHMP1A","s1639_F_VTA_03_ASEReadCounter.table","NW_015090842.1:10103761",46,91,45
"CHMP1A","s1639_F_VTA_03_ASEReadCounter.table","NW_015090842.1:10103788",44,108,64
"CHMP1A","s1639_F_VTA_03_ASEReadCounter.table","NW_015090842.1:10103789",46,110,64
"CHMP1A","s1639_F_VTA_03_ASEReadCounter.table","NW_015090842.1:10103790",44,107,63
"CHMP1A","s1639_F_VTA_03_ASEReadCounter.table","NW_015090842.1:10103950",67,112,45
"CHMP1A","s1639_F_VTA_03_ASEReadCounter.table","NW_015090842.1:10104335",33,83,50
"CHMP1A","s1639_F_VTA_03_ASEReadCounter.table","NW_015090842.1:10104429",44,105,61
"CHMP1A","s1639_F_VTA_03_ASEReadCounter.table","NW_015090842.1:10104532",40,87,47
"CHMP1A","s1639_F_VTA_03_ASEReadCounter.table","NW_015090842.1:10104633",39,85,46
"CHMP1A","s1639_F_VTA_03_ASEReadCounter.table","NW_015090842.1:10104759",37,84,47
"CHMP1A","s1639_F_VTA_03_ASEReadCounter.table","NW_015090842.1:10104794",43,103,60
"CHMP1A","s1639_F_VTA_03_ASEReadCounter.table","NW_015090842.1:10104841",76,76,0
"CHMP1A","s1639_F_VTA_03_ASEReadCounter.table","NW_015090842.1:10104844",27,79,52
"CHMP1A","s1639_F_VTA_03_ASEReadCounter.table","NW_015090842.1:10106242",46,87,41
"CHMP1A","s1639_F_VTA_03_ASEReadCounter.table","NW_015090842.1:10106290",34,75,41
"CHMP1A","s1639_F_VTA_03_ASEReadCounter.table","NW_015090842.1:10106335",41,83,42
"CHMP1A","s1639_F_VTA_03_ASEReadCounter.table","NW_015090842.1:10106383",50,107,57
"CHMP1A","s1639_F_VTA_03_ASEReadCounter.table","NW_015090842.1:10106747",47,99,52
"CHMP1A","s1639_F_VTA_03_ASEReadCounter.table","NW_015090842.1:10107404",35,83,48
"CHMP1A","s1639_F_VTA_03_ASEReadCounter.table","NW_015090842.1:10107876",37,73,36
"CDK10","s1639_F_VTA_03_ASEReadCounter.table","NW_015090842.1:10109030",4,7,3
"CDK10","s1639_F_VTA_03_ASEReadCounter.table","NW_015090842.1:10109963",18,69,51
"CDK10","s1639_F_VTA_03_ASEReadCounter.table","NW_015090842.1:10110887",28,77,49
"CDK10","s1639_F_VTA_03_ASEReadCounter.table","NW_015090842.1:10111254",15,66,51
"CDK10","s1639_F_VTA_03_ASEReadCounter.table","NW_015090842.1:10111380",19,79,60
"CDK10","s1639_F_VTA_03_ASEReadCounter.table","NW_015090842.1:10111395",20,73,53
"CDK10","s1639_F_VTA_03_ASEReadCounter.table","NW_015090842.1:10111437",18,72,54
"CDK10","s1639_F_VTA_03_ASEReadCounter.table","NW_015090842.1:10111798",32,102,70
"CDK10","s1639_F_VTA_03_ASEReadCounter.table","NW_015090842.1:10111840",35,96,61
"CDK10","s1639_F_VTA_03_ASEReadCounter.table","NW_015090842.1:10112031",22,111,89
"CDK10","s1639_F_VTA_03_ASEReadCounter.table","NW_015090842.1:10112285",30,114,84
"CDK10","s1639_F_VTA_03_ASEReadCounter.table","NW_015090842.1:10112398",39,135,96
"CDK10","s1639_F_VTA_03_ASEReadCounter.table","NW_015090842.1:10112455",35,125,90
"CDK10","s1639_F_VTA_03_ASEReadCounter.table","NW_015090842.1:10112461",33,117,84
"CDK10","s1639_F_VTA_03_ASEReadCounter.table","NW_015090842.1:10112497",29,100,71
"CDK10","s1639_F_VTA_03_ASEReadCounter.table","NW_015090842.1:10112508",26,106,80
"CDK10","s1639_F_VTA_03_ASEReadCounter.table","NW_015090842.1:10112518",19,95,76
"CDK10","s1639_F_VTA_03_ASEReadCounter.table","NW_015090842.1:10112540",5,78,73
"CDK10","s1639_F_VTA_03_ASEReadCounter.table","NW_015090842.1:10112556",30,103,73
"CDK10","s1639_F_VTA_03_ASEReadCounter.table","NW_015090842.1:10112561",30,114,84
"CDK10","s1639_F_VTA_03_ASEReadCounter.table","NW_015090842.1:10112596",31,108,77
"CDK10","s1639_F_VTA_03_ASEReadCounter.table","NW_015090842.1:10112630",21,87,66
"CDK10","s1639_F_VTA_03_ASEReadCounter.table","NW_015090842.1:10112656",23,88,65
"CDK10","s1639_F_VTA_03_ASEReadCounter.table","NW_015090842.1:10112665",23,73,50
"CDK10","s1639_F_VTA_03_ASEReadCounter.table","NW_015090842.1:10112668",24,74,50
"CDK10","s1639_F_VTA_03_ASEReadCounter.table","NW_015090842.1:10112781",17,37,20
"CDK10","s1639_F_VTA_03_ASEReadCounter.table","NW_015090842.1:10112782",17,38,21
"CDK10","s1639_F_VTA_03_ASEReadCounter.table","NW_015090842.1:10112795",15,35,20
"CDK10","s1639_F_VTA_03_ASEReadCounter.table","NW_015090842.1:10112841",4,13,9
"CDK10","s1639_F_VTA_03_ASEReadCounter.table","NW_015090842.1:10112861",1,7,6
"SPATA2L","s1639_F_VTA_03_ASEReadCounter.table","NW_015090842.1:10113212",21,46,25
"SPATA2L","s1639_F_VTA_03_ASEReadCounter.table","NW_015090842.1:10113280",22,75,53
"SPATA2L","s1639_F_VTA_03_ASEReadCounter.table","NW_015090842.1:10113296",21,81,60
"SPATA2L","s1639_F_VTA_03_ASEReadCounter.table","NW_015090842.1:10113321",27,94,67
"SPATA2L","s1639_F_VTA_03_ASEReadCounter.table","NW_015090842.1:10113332",31,105,74
"SPATA2L","s1639_F_VTA_03_ASEReadCounter.table","NW_015090842.1:10113380",32,109,77
"SPATA2L","s1639_F_VTA_03_ASEReadCounter.table","NW_015090842.1:10113381",32,111,79
"SPATA2L","s1639_F_VTA_03_ASEReadCounter.table","NW_015090842.1:10113412",39,126,87
"SPATA2L","s1639_F_VTA_03_ASEReadCounter.table","NW_015090842.1:10113421",34,118,84
"SPATA2L","s1639_F_VTA_03_ASEReadCounter.table","NW_015090842.1:10113465",36,116,80
"SPATA2L","s1639_F_VTA_03_ASEReadCounter.table","NW_015090842.1:10113535",54,121,67
"SPATA2L","s1639_F_VTA_03_ASEReadCounter.table","NW_015090842.1:10113645",46,120,74
"SPATA2L","s1639_F_VTA_03_ASEReadCounter.table","NW_015090842.1:10113682",58,151,93
"SPATA2L","s1639_F_VTA_03_ASEReadCounter.table","NW_015090842.1:10113696",49,130,81
"SPATA2L","s1639_F_VTA_03_ASEReadCounter.table","NW_015090842.1:10113727",49,136,87
"SPATA2L","s1639_F_VTA_03_ASEReadCounter.table","NW_015090842.1:10113799",49,129,80
"SPATA2L","s1639_F_VTA_03_ASEReadCounter.table","NW_015090842.1:10113809",57,146,89
"SPATA2L","s1639_F_VTA_03_ASEReadCounter.table","NW_015090842.1:10113827",58,145,87
"SPATA2L","s1639_F_VTA_03_ASEReadCounter.table","NW_015090842.1:10113831",59,146,87
"SPATA2L","s1639_F_VTA_03_ASEReadCounter.table","NW_015090842.1:10113894",52,133,81
"SPATA2L","s1639_F_VTA_03_ASEReadCounter.table","NW_015090842.1:10113905",44,123,79
"SPATA2L","s1639_F_VTA_03_ASEReadCounter.table","NW_015090842.1:10113914",48,113,65
"SPATA2L","s1639_F_VTA_03_ASEReadCounter.table","NW_015090842.1:10113920",53,122,69
"SPATA2L","s1639_F_VTA_03_ASEReadCounter.table","NW_015090842.1:10113937",62,134,72
"SPATA2L","s1639_F_VTA_03_ASEReadCounter.table","NW_015090842.1:10113971",50,122,72
"SPATA2L","s1639_F_VTA_03_ASEReadCounter.table","NW_015090842.1:10113976",40,123,83
"SPATA2L","s1639_F_VTA_03_ASEReadCounter.table","NW_015090842.1:10113985",44,113,69
"SPATA2L","s1639_F_VTA_03_ASEReadCounter.table","NW_015090842.1:10113994",47,122,75
"SPATA2L","s1639_F_VTA_03_ASEReadCounter.table","NW_015090842.1:10114063",43,106,63
"SPATA2L","s1639_F_VTA_03_ASEReadCounter.table","NW_015090842.1:10114066",42,104,62
"SPATA2L","s1639_F_VTA_03_ASEReadCounter.table","NW_015090842.1:10114069",44,104,60
"SPATA2L","s1639_F_VTA_03_ASEReadCounter.table","NW_015090842.1:10114121",20,56,36
"SPATA2L","s1639_F_VTA_03_ASEReadCounter.table","NW_015090842.1:10114159",21,74,53
"SPATA2L","s1639_F_VTA_03_ASEReadCounter.table","NW_015090842.1:10114282",90,90,0
"SPATA2L","s1639_F_VTA_03_ASEReadCounter.table","NW_015090842.1:10114470",25,61,36
"SPATA2L","s1639_F_VTA_03_ASEReadCounter.table","NW_015090842.1:10114524",17,48,31
"VPS9D1","s1639_F_VTA_03_ASEReadCounter.table","NW_015090842.1:10116377",30,66,36
"VPS9D1","s1639_F_VTA_03_ASEReadCounter.table","NW_015090842.1:10116415",33,69,36
"VPS9D1","s1639_F_VTA_03_ASEReadCounter.table","NW_015090842.1:10116607",34,59,25
"VPS9D1","s1639_F_VTA_03_ASEReadCounter.table","NW_015090842.1:10116816",58,58,0
"VPS9D1","s1639_F_VTA_03_ASEReadCounter.table","NW_015090842.1:10116821",19,57,38
"VPS9D1","s1639_F_VTA_03_ASEReadCounter.table","NW_015090842.1:10116825",20,56,36
"VPS9D1","s1639_F_VTA_03_ASEReadCounter.table","NW_015090842.1:10116882",19,45,26
"VPS9D1","s1639_F_VTA_03_ASEReadCounter.table","NW_015090842.1:10116885",16,39,23
"VPS9D1","s1639_F_VTA_03_ASEReadCounter.table","NW_015090842.1:10116933",20,43,23
"VPS9D1","s1639_F_VTA_03_ASEReadCounter.table","NW_015090842.1:10116942",16,40,24
"VPS9D1","s1639_F_VTA_03_ASEReadCounter.table","NW_015090842.1:10117152",14,43,29
"VPS9D1","s1639_F_VTA_03_ASEReadCounter.table","NW_015090842.1:10117396",29,29,0
"VPS9D1","s1639_F_VTA_03_ASEReadCounter.table","NW_015090842.1:10117405",16,16,0
"VPS9D1","s1639_F_VTA_03_ASEReadCounter.table","NW_015090842.1:10117480",9,28,19
"VPS9D1","s1639_F_VTA_03_ASEReadCounter.table","NW_015090842.1:10117497",9,28,19
"VPS9D1","s1639_F_VTA_03_ASEReadCounter.table","NW_015090842.1:10117499",9,27,18
"VPS9D1","s1639_F_VTA_03_ASEReadCounter.table","NW_015090842.1:10117516",8,28,20
"VPS9D1","s1639_F_VTA_03_ASEReadCounter.table","NW_015090842.1:10117525",7,29,22
"VPS9D1","s1639_F_VTA_03_ASEReadCounter.table","NW_015090842.1:10117579",13,41,28
"VPS9D1","s1639_F_VTA_03_ASEReadCounter.table","NW_015090842.1:10117627",17,41,24
"VPS9D1","s1639_F_VTA_03_ASEReadCounter.table","NW_015090842.1:10117678",8,36,28
"VPS9D1","s1639_F_VTA_03_ASEReadCounter.table","NW_015090842.1:10117773",19,53,34
"VPS9D1","s1639_F_VTA_03_ASEReadCounter.table","NW_015090842.1:10117937",20,66,46
"VPS9D1","s1639_F_VTA_03_ASEReadCounter.table","NW_015090842.1:10117961",19,64,45
"VPS9D1","s1639_F_VTA_03_ASEReadCounter.table","NW_015090842.1:10118236",25,70,45
"VPS9D1","s1639_F_VTA_03_ASEReadCounter.table","NW_015090842.1:10118414",14,52,38
"VPS9D1","s1639_F_VTA_03_ASEReadCounter.table","NW_015090842.1:10118973",15,50,35
"VPS9D1","s1639_F_VTA_03_ASEReadCounter.table","NW_015090842.1:10119500",22,37,15
"ZNF276","s1639_F_VTA_03_ASEReadCounter.table","NW_015090842.1:10121760",5,10,5
"ZNF276","s1639_F_VTA_03_ASEReadCounter.table","NW_015090842.1:10121769",4,10,6
"ZNF276","s1639_F_VTA_03_ASEReadCounter.table","NW_015090842.1:10121802",3,9,6
"ZNF276","s1639_F_VTA_03_ASEReadCounter.table","NW_015090842.1:10121971",6,15,9
"ZNF276","s1639_F_VTA_03_ASEReadCounter.table","NW_015090842.1:10122883",10,17,7
"ZNF276","s1639_F_VTA_03_ASEReadCounter.table","NW_015090842.1:10123069",11,24,13
"ZNF276","s1639_F_VTA_03_ASEReadCounter.table","NW_015090842.1:10123207",21,41,20
"ZNF276","s1639_F_VTA_03_ASEReadCounter.table","NW_015090842.1:10125787",29,57,28
"ZNF276","s1639_F_VTA_03_ASEReadCounter.table","NW_015090842.1:10126309",33,58,25
"ZNF276","s1639_F_VTA_03_ASEReadCounter.table","NW_015090842.1:10126348",39,64,25
"ZNF276","s1639_F_VTA_03_ASEReadCounter.table","NW_015090842.1:10126978",33,66,33
"ZNF276","s1639_F_VTA_03_ASEReadCounter.table","NW_015090842.1:10126991",32,65,33
"ZNF276","s1639_F_VTA_03_ASEReadCounter.table","NW_015090842.1:10127023",37,72,35
"ZNF276","s1639_F_VTA_03_ASEReadCounter.table","NW_015090842.1:10127063",30,62,32
"ZNF276","s1639_F_VTA_03_ASEReadCounter.table","NW_015090842.1:10127373",26,55,29
"ZNF276","s1639_F_VTA_03_ASEReadCounter.table","NW_015090842.1:10127931",31,61,30
"ZNF276","s1639_F_VTA_03_ASEReadCounter.table","NW_015090842.1:10128070",40,73,33
"ZNF276","s1639_F_VTA_03_ASEReadCounter.table","NW_015090842.1:10128102",38,68,30
"ZNF276","s1639_F_VTA_03_ASEReadCounter.table","NW_015090842.1:10128356",22,55,33
"ZNF276","s1639_F_VTA_03_ASEReadCounter.table","NW_015090842.1:10128497",20,38,18
"FANCA","s1639_F_VTA_03_ASEReadCounter.table","NW_015090842.1:10128743",3,4,1
"FANCA","s1639_F_VTA_03_ASEReadCounter.table","NW_015090842.1:10128822",5,6,1
"FANCA","s1639_F_VTA_03_ASEReadCounter.table","NW_015090842.1:10129383",4,5,1
"FANCA","s1639_F_VTA_03_ASEReadCounter.table","NW_015090842.1:10129390",3,4,1
"FANCA","s1639_F_VTA_03_ASEReadCounter.table","NW_015090842.1:10129422",3,4,1
"FANCA","s1639_F_VTA_03_ASEReadCounter.table","NW_015090842.1:10129969",1,3,2
"FANCA","s1639_F_VTA_03_ASEReadCounter.table","NW_015090842.1:10130399",2,3,1
"FANCA","s1639_F_VTA_03_ASEReadCounter.table","NW_015090842.1:10130857",1,2,1
"FANCA","s1639_F_VTA_03_ASEReadCounter.table","NW_015090842.1:10130878",0,1,1
"FANCA","s1639_F_VTA_03_ASEReadCounter.table","NW_015090842.1:10133530",1,3,2
"FANCA","s1639_F_VTA_03_ASEReadCounter.table","NW_015090842.1:10133533",1,3,2
"FANCA","s1639_F_VTA_03_ASEReadCounter.table","NW_015090842.1:10133536",1,3,2
"FANCA","s1639_F_VTA_03_ASEReadCounter.table","NW_015090842.1:10133601",1,4,3
"FANCA","s1639_F_VTA_03_ASEReadCounter.table","NW_015090842.1:10134492",0,2,2
"FANCA","s1639_F_VTA_03_ASEReadCounter.table","NW_015090842.1:10134531",0,3,3
"FANCA","s1639_F_VTA_03_ASEReadCounter.table","NW_015090842.1:10136957",0,1,1
"FANCA","s1639_F_VTA_03_ASEReadCounter.table","NW_015090842.1:10137019",2,2,0
"FANCA","s1639_F_VTA_03_ASEReadCounter.table","NW_015090842.1:10137673",3,4,1
"FANCA","s1639_F_VTA_03_ASEReadCounter.table","NW_015090842.1:10138618",0,1,1
"FANCA","s1639_F_VTA_03_ASEReadCounter.table","NW_015090842.1:10139140",0,1,1
"FANCA","s1639_F_VTA_03_ASEReadCounter.table","NW_015090842.1:10140699",0,2,2
"FANCA","s1639_F_VTA_03_ASEReadCounter.table","NW_015090842.1:10141234",0,1,1
"FANCA","s1639_F_VTA_03_ASEReadCounter.table","NW_015090842.1:10145030",1,2,1
"FANCA","s1639_F_VTA_03_ASEReadCounter.table","NW_015090842.1:10152863",1,1,0
"FANCA","s1639_F_VTA_03_ASEReadCounter.table","NW_015090842.1:10154490",0,2,2
"SPIRE2","s1639_F_VTA_03_ASEReadCounter.table","NW_015090842.1:10172284",12,24,12
"SPIRE2","s1639_F_VTA_03_ASEReadCounter.table","NW_015090842.1:10175262",16,35,19
"SPIRE2","s1639_F_VTA_03_ASEReadCounter.table","NW_015090842.1:10175352",5,11,6
"SPIRE2","s1639_F_VTA_03_ASEReadCounter.table","NW_015090842.1:10175400",20,49,29
"SPIRE2","s1639_F_VTA_03_ASEReadCounter.table","NW_015090842.1:10175418",21,53,32
"SPIRE2","s1639_F_VTA_03_ASEReadCounter.table","NW_015090842.1:10175704",29,71,42
"SPIRE2","s1639_F_VTA_03_ASEReadCounter.table","NW_015090842.1:10176115",54,109,55
"SPIRE2","s1639_F_VTA_03_ASEReadCounter.table","NW_015090842.1:10176561",67,139,72
"SPIRE2","s1639_F_VTA_03_ASEReadCounter.table","NW_015090842.1:10176817",59,124,65
"SPIRE2","s1639_F_VTA_03_ASEReadCounter.table","NW_015090842.1:10177084",40,98,58
"SPIRE2","s1639_F_VTA_03_ASEReadCounter.table","NW_015090842.1:10177110",42,94,52
"SPIRE2","s1639_F_VTA_03_ASEReadCounter.table","NW_015090842.1:10177838",79,151,72
"SPIRE2","s1639_F_VTA_03_ASEReadCounter.table","NW_015090842.1:10178000",77,177,100
"SPIRE2","s1639_F_VTA_03_ASEReadCounter.table","NW_015090842.1:10178164",107,210,103
"SPIRE2","s1639_F_VTA_03_ASEReadCounter.table","NW_015090842.1:10178216",124,246,122
"SPIRE2","s1639_F_VTA_03_ASEReadCounter.table","NW_015090842.1:10178403",91,189,98
"SPIRE2","s1639_F_VTA_03_ASEReadCounter.table","NW_015090842.1:10178409",88,183,95
"SPIRE2","s1639_F_VTA_03_ASEReadCounter.table","NW_015090842.1:10178524",83,206,123
"SPIRE2","s1639_F_VTA_03_ASEReadCounter.table","NW_015090842.1:10178526",84,210,126
"SPIRE2","s1639_F_VTA_03_ASEReadCounter.table","NW_015090842.1:10178531",86,210,124
"SPIRE2","s1639_F_VTA_03_ASEReadCounter.table","NW_015090842.1:10178565",72,186,114
"SPIRE2","s1639_F_VTA_03_ASEReadCounter.table","NW_015090842.1:10178587",64,149,85
"SPIRE2","s1639_F_VTA_03_ASEReadCounter.table","NW_015090842.1:10178640",60,139,79
"SPIRE2","s1639_F_VTA_03_ASEReadCounter.table","NW_015090842.1:10178651",64,150,86
"SPIRE2","s1639_F_VTA_03_ASEReadCounter.table","NW_015090842.1:10178682",56,131,75
"TCF25","s1639_F_VTA_03_ASEReadCounter.table","NW_015090842.1:10180912",32,63,31
"TCF25","s1639_F_VTA_03_ASEReadCounter.table","NW_015090842.1:10180924",35,64,29
"TCF25","s1639_F_VTA_03_ASEReadCounter.table","NW_015090842.1:10180931",34,65,31
"TCF25","s1639_F_VTA_03_ASEReadCounter.table","NW_015090842.1:10185332",104,194,90
"TCF25","s1639_F_VTA_03_ASEReadCounter.table","NW_015090842.1:10188816",66,115,49
"DBNDD1","s1639_F_VTA_03_ASEReadCounter.table","NW_015090842.1:10223105",95,209,114
"GAS8","s1639_F_VTA_03_ASEReadCounter.table","NW_015090842.1:10228982",12,32,20
"GAS8","s1639_F_VTA_03_ASEReadCounter.table","NW_015090842.1:10229832",9,18,9
"GAS8","s1639_F_VTA_03_ASEReadCounter.table","NW_015090842.1:10232375",27,48,21
"GAS8","s1639_F_VTA_03_ASEReadCounter.table","NW_015090842.1:10232901",43,83,40
"GAS8","s1639_F_VTA_03_ASEReadCounter.table","NW_015090842.1:10232928",46,83,37
"GAS8","s1639_F_VTA_03_ASEReadCounter.table","NW_015090842.1:10232967",44,81,37
"GAS8","s1639_F_VTA_03_ASEReadCounter.table","NW_015090842.1:10233032",27,56,29
"GAS8","s1639_F_VTA_03_ASEReadCounter.table","NW_015090842.1:10233057",20,46,26
"GAS8","s1639_F_VTA_03_ASEReadCounter.table","NW_015090842.1:10233058",20,46,26
"GAS8","s1639_F_VTA_03_ASEReadCounter.table","NW_015090842.1:10233176",21,40,19
"GAS8","s1639_F_VTA_03_ASEReadCounter.table","NW_015090842.1:10233196",22,41,19
"GAS8","s1639_F_VTA_03_ASEReadCounter.table","NW_015090842.1:10233252",14,27,13
"GAS8","s1639_F_VTA_03_ASEReadCounter.table","NW_015090842.1:10233303",5,14,9
"LOC106888094","s1639_F_VTA_03_ASEReadCounter.table","NW_015090842.1:10233334",3,11,8
"LOC106888094","s1639_F_VTA_03_ASEReadCounter.table","NW_015090842.1:10233362",6,21,15
"LOC106888094","s1639_F_VTA_03_ASEReadCounter.table","NW_015090842.1:10233373",7,24,17
"LOC106888094","s1639_F_VTA_03_ASEReadCounter.table","NW_015090842.1:10233388",9,33,24
"LOC106888094","s1639_F_VTA_03_ASEReadCounter.table","NW_015090842.1:10233402",10,33,23
"LOC106888094","s1639_F_VTA_03_ASEReadCounter.table","NW_015090842.1:10233465",16,52,36
"LOC106888094","s1639_F_VTA_03_ASEReadCounter.table","NW_015090842.1:10233803",16,46,30
"LOC106888094","s1639_F_VTA_03_ASEReadCounter.table","NW_015090842.1:10233815",14,40,26
"LOC106888094","s1639_F_VTA_03_ASEReadCounter.table","NW_015090842.1:10235484",5,11,6
"LOC106888094","s1639_F_VTA_03_ASEReadCounter.table","NW_015090842.1:10235611",5,10,5
"LOC106888094","s1639_F_VTA_03_ASEReadCounter.table","NW_015090842.1:10236098",7,12,5
"LOC106888094","s1639_F_VTA_03_ASEReadCounter.table","NW_015090842.1:10236161",3,11,8
"LOC106888094","s1639_F_VTA_03_ASEReadCounter.table","NW_015090842.1:10236380",1,3,2
"LOC106888094","s1639_F_VTA_03_ASEReadCounter.table","NW_015090842.1:10236388",1,3,2
"LOC106888094","s1639_F_VTA_03_ASEReadCounter.table","NW_015090842.1:10236425",1,3,2
"LOC106888094","s1639_F_VTA_03_ASEReadCounter.table","NW_015090842.1:10236426",1,3,2
"LOC106888173","s1639_F_VTA_03_ASEReadCounter.table","NW_015090842.1:10239596",1,20,19
"LOC106888173","s1639_F_VTA_03_ASEReadCounter.table","NW_015090842.1:10240036",7,61,54
"LOC106888173","s1639_F_VTA_03_ASEReadCounter.table","NW_015090842.1:10240095",12,68,56
"LOC106888173","s1639_F_VTA_03_ASEReadCounter.table","NW_015090842.1:10240280",8,68,60
"LOC106888173","s1639_F_VTA_03_ASEReadCounter.table","NW_015090842.1:10240557",13,98,85
"LOC106888173","s1639_F_VTA_03_ASEReadCounter.table","NW_015090842.1:10240603",14,98,84
"LOC106888173","s1639_F_VTA_03_ASEReadCounter.table","NW_015090842.1:10240609",14,102,88
"LOC106888173","s1639_F_VTA_03_ASEReadCounter.table","NW_015090842.1:10240690",14,98,84
"LOC106888173","s1639_F_VTA_03_ASEReadCounter.table","NW_015090842.1:10240924",12,77,65
"LOC106888173","s1639_F_VTA_03_ASEReadCounter.table","NW_015090842.1:10241037",7,77,70
"LOC106888173","s1639_F_VTA_03_ASEReadCounter.table","NW_015090842.1:10241046",8,75,67
"LOC106888173","s1639_F_VTA_03_ASEReadCounter.table","NW_015090842.1:10241058",8,75,67
"LOC106888173","s1639_F_VTA_03_ASEReadCounter.table","NW_015090842.1:10241064",9,78,69
"LOC106888173","s1639_F_VTA_03_ASEReadCounter.table","NW_015090842.1:10241103",96,96,0
"LOC106888173","s1639_F_VTA_03_ASEReadCounter.table","NW_015090842.1:10241163",11,89,78
"LOC106888173","s1639_F_VTA_03_ASEReadCounter.table","NW_015090842.1:10241803",10,99,89
"LOC106888173","s1639_F_VTA_03_ASEReadCounter.table","NW_015090842.1:10241827",12,105,93
"LOC106888173","s1639_F_VTA_03_ASEReadCounter.table","NW_015090842.1:10241869",14,117,103
"LOC106888173","s1639_F_VTA_03_ASEReadCounter.table","NW_015090842.1:10242079",20,108,88
"LOC106888173","s1639_F_VTA_03_ASEReadCounter.table","NW_015090842.1:10242103",19,103,84
"LOC106888173","s1639_F_VTA_03_ASEReadCounter.table","NW_015090842.1:10242157",20,108,88
"LOC106888173","s1639_F_VTA_03_ASEReadCounter.table","NW_015090842.1:10242455",24,107,83
"LOC106888173","s1639_F_VTA_03_ASEReadCounter.table","NW_015090842.1:10242481",25,115,90
"LOC106888173","s1639_F_VTA_03_ASEReadCounter.table","NW_015090842.1:10242590",27,137,110
"LOC106888173","s1639_F_VTA_03_ASEReadCounter.table","NW_015090842.1:10242794",18,110,92
"LOC106888173","s1639_F_VTA_03_ASEReadCounter.table","NW_015090842.1:10242909",22,102,80
"LOC106888173","s1639_F_VTA_03_ASEReadCounter.table","NW_015090842.1:10243094",30,130,100
"LOC106888173","s1639_F_VTA_03_ASEReadCounter.table","NW_015090842.1:10243133",21,124,103
"LOC106888173","s1639_F_VTA_03_ASEReadCounter.table","NW_015090842.1:10243273",32,169,137
"LOC106888173","s1639_F_VTA_03_ASEReadCounter.table","NW_015090842.1:10243278",34,171,137
"LOC106888173","s1639_F_VTA_03_ASEReadCounter.table","NW_015090842.1:10243281",32,170,138
"LOC106888173","s1639_F_VTA_03_ASEReadCounter.table","NW_015090842.1:10243347",74,74,0
"LOC106888173","s1639_F_VTA_03_ASEReadCounter.table","NW_015090842.1:10243353",20,71,51
"LOC106888173","s1639_F_VTA_03_ASEReadCounter.table","NW_015090842.1:10243363",21,50,29
"LOC106888173","s1639_F_VTA_03_ASEReadCounter.table","NW_015090842.1:10243365",19,51,32
"LOC106888173","s1639_F_VTA_03_ASEReadCounter.table","NW_015090842.1:10243566",39,197,158
"LOC106888173","s1639_F_VTA_03_ASEReadCounter.table","NW_015090842.1:10243605",37,183,146
"LOC106888173","s1639_F_VTA_03_ASEReadCounter.table","NW_015090842.1:10243614",32,167,135
"LOC106888173","s1639_F_VTA_03_ASEReadCounter.table","NW_015090842.1:10243615",32,176,144
"LOC106888173","s1639_F_VTA_03_ASEReadCounter.table","NW_015090842.1:10243640",24,152,128
"LOC106888173","s1639_F_VTA_03_ASEReadCounter.table","NW_015090842.1:10243680",19,117,98
"LOC106888173","s1639_F_VTA_03_ASEReadCounter.table","NW_015090842.1:10243742",30,155,125
"LOC106888173","s1639_F_VTA_03_ASEReadCounter.table","NW_015090842.1:10243804",22,117,95
"LOC106888173","s1639_F_VTA_03_ASEReadCounter.table","NW_015090842.1:10243913",9,57,48
"LOC106888173","s1639_F_VTA_03_ASEReadCounter.table","NW_015090842.1:10243921",9,59,50
"LOC106888384","s1639_F_VTA_03_ASEReadCounter.table","NW_015090842.1:10251339",1,1,0
"LOC106888384","s1639_F_VTA_03_ASEReadCounter.table","NW_015090842.1:10251343",1,1,0
"LOC106888384","s1639_F_VTA_03_ASEReadCounter.table","NW_015090842.1:10251344",1,1,0
"LOC106888384","s1639_F_VTA_03_ASEReadCounter.table","NW_015090842.1:10251349",1,1,0
"LOC106888384","s1639_F_VTA_03_ASEReadCounter.table","NW_015090842.1:10251354",1,5,4
"LOC106888384","s1639_F_VTA_03_ASEReadCounter.table","NW_015090842.1:10251358",1,5,4
"LOC106888384","s1639_F_VTA_03_ASEReadCounter.table","NW_015090842.1:10251369",1,5,4
"LOC106888384","s1639_F_VTA_03_ASEReadCounter.table","NW_015090842.1:10251370",1,5,4
"LOC106888384","s1639_F_VTA_03_ASEReadCounter.table","NW_015090842.1:10251375",1,5,4
"LOC106888384","s1639_F_VTA_03_ASEReadCounter.table","NW_015090842.1:10251388",0,3,3
"LOC106888384","s1639_F_VTA_03_ASEReadCounter.table","NW_015090842.1:10251390",0,3,3
"LOC106888384","s1639_F_VTA_03_ASEReadCounter.table","NW_015090842.1:10251393",0,2,2
"LOC106888384","s1639_F_VTA_03_ASEReadCounter.table","NW_015090842.1:10251399",0,2,2
"LOC106888384","s1639_F_VTA_03_ASEReadCounter.table","NW_015090842.1:10253165",3,4,1
"LOC106888384","s1639_F_VTA_03_ASEReadCounter.table","NW_015090842.1:10253284",3,3,0
"LOC106888384","s1639_F_VTA_03_ASEReadCounter.table","NW_015090842.1:10254028",4,4,0
"LOC106888384","s1639_F_VTA_03_ASEReadCounter.table","NW_015090842.1:10254227",1,1,0
"LOC106888384","s1639_F_VTA_03_ASEReadCounter.table","NW_015090842.1:10254263",2,2,0
"LOC106888384","s1639_F_VTA_03_ASEReadCounter.table","NW_015090842.1:10254293",4,4,0
"LOC106888384","s1639_F_VTA_03_ASEReadCounter.table","NW_015090842.1:10254570",3,3,0
"LOC106888384","s1639_F_VTA_03_ASEReadCounter.table","NW_015090842.1:10254605",2,2,0
"LOC106888384","s1639_F_VTA_03_ASEReadCounter.table","NW_015090842.1:10254608",3,4,1
"LOC106888384","s1639_F_VTA_03_ASEReadCounter.table","NW_015090842.1:10254618",2,3,1
"LOC106888384","s1639_F_VTA_03_ASEReadCounter.table","NW_015090842.1:10254620",2,4,2
"LOC106888384","s1639_F_VTA_03_ASEReadCounter.table","NW_015090842.1:10254623",1,3,2
"LOC106888384","s1639_F_VTA_03_ASEReadCounter.table","NW_015090842.1:10254624",1,3,2
"LOC106888384","s1639_F_VTA_03_ASEReadCounter.table","NW_015090842.1:10254627",2,4,2
"LOC106888384","s1639_F_VTA_03_ASEReadCounter.table","NW_015090842.1:10254629",2,3,1
"LOC106888384","s1639_F_VTA_03_ASEReadCounter.table","NW_015090842.1:10254647",4,4,0
"LOC106888384","s1639_F_VTA_03_ASEReadCounter.table","NW_015090842.1:10254663",2,2,0
"LOC106888384","s1639_F_VTA_03_ASEReadCounter.table","NW_015090842.1:10254840",0,1,1
"LOC106888384","s1639_F_VTA_03_ASEReadCounter.table","NW_015090842.1:10254891",0,1,1
"LOC106888384","s1639_F_VTA_03_ASEReadCounter.table","NW_015090842.1:10254900",1,1,0
"LOC106888384","s1639_F_VTA_03_ASEReadCounter.table","NW_015090842.1:10254915",1,1,0
"LOC106888384","s1639_F_VTA_03_ASEReadCounter.table","NW_015090842.1:10254965",1,1,0
"LOC106888384","s1639_F_VTA_03_ASEReadCounter.table","NW_015090842.1:10254975",0,1,1
"LOC106888384","s1639_F_VTA_03_ASEReadCounter.table","NW_015090842.1:10255077",2,2,0
"LOC106888384","s1639_F_VTA_03_ASEReadCounter.table","NW_015090842.1:10255117",2,2,0
"LOC106888384","s1639_F_VTA_03_ASEReadCounter.table","NW_015090842.1:10255138",2,2,0
"LOC106888384","s1639_F_VTA_03_ASEReadCounter.table","NW_015090842.1:10255139",2,2,0
"LOC106888384","s1639_F_VTA_03_ASEReadCounter.table","NW_015090842.1:10255209",3,3,0
"LOC106888384","s1639_F_VTA_03_ASEReadCounter.table","NW_015090842.1:10255211",3,3,0
"LOC106888384","s1639_F_VTA_03_ASEReadCounter.table","NW_015090842.1:10255236",3,3,0
"LOC106888384","s1639_F_VTA_03_ASEReadCounter.table","NW_015090842.1:10255262",2,2,0
"LOC106888384","s1639_F_VTA_03_ASEReadCounter.table","NW_015090842.1:10255264",2,2,0
"LOC106888384","s1639_F_VTA_03_ASEReadCounter.table","NW_015090842.1:10255306",4,5,1
"LOC106888384","s1639_F_VTA_03_ASEReadCounter.table","NW_015090842.1:10255340",7,8,1
"LOC106888384","s1639_F_VTA_03_ASEReadCounter.table","NW_015090842.1:10255410",4,5,1
"LOC106888384","s1639_F_VTA_03_ASEReadCounter.table","NW_015090842.1:10255449",1,3,2
"LOC106888384","s1639_F_VTA_03_ASEReadCounter.table","NW_015090842.1:10255496",3,4,1
"LOC106888384","s1639_F_VTA_03_ASEReadCounter.table","NW_015090842.1:10255505",2,3,1
"LOC106888384","s1639_F_VTA_03_ASEReadCounter.table","NW_015090842.1:10255531",3,3,0
"LOC106888384","s1639_F_VTA_03_ASEReadCounter.table","NW_015090842.1:10255608",5,6,1
"LOC106888384","s1639_F_VTA_03_ASEReadCounter.table","NW_015090842.1:10255704",6,6,0
"LOC106888384","s1639_F_VTA_03_ASEReadCounter.table","NW_015090842.1:10255731",6,7,1
"LOC106888384","s1639_F_VTA_03_ASEReadCounter.table","NW_015090842.1:10255771",4,5,1
"TANGO6","s1639_F_VTA_03_ASEReadCounter.table","NW_015090842.1:10257782",9,15,6
"TANGO6","s1639_F_VTA_03_ASEReadCounter.table","NW_015090842.1:10258162",8,24,16
"TANGO6","s1639_F_VTA_03_ASEReadCounter.table","NW_015090842.1:10258185",9,23,14
"TANGO6","s1639_F_VTA_03_ASEReadCounter.table","NW_015090842.1:10259267",9,21,12
"TANGO6","s1639_F_VTA_03_ASEReadCounter.table","NW_015090842.1:10260250",19,37,18
"TANGO6","s1639_F_VTA_03_ASEReadCounter.table","NW_015090842.1:10260289",20,35,15
"TANGO6","s1639_F_VTA_03_ASEReadCounter.table","NW_015090842.1:10260309",16,30,14
"TANGO6","s1639_F_VTA_03_ASEReadCounter.table","NW_015090842.1:10260979",14,30,16
"TANGO6","s1639_F_VTA_03_ASEReadCounter.table","NW_015090842.1:10261599",11,27,16
"TANGO6","s1639_F_VTA_03_ASEReadCounter.table","NW_015090842.1:10268425",30,49,19
"TANGO6","s1639_F_VTA_03_ASEReadCounter.table","NW_015090842.1:10269831",23,45,22
"TANGO6","s1639_F_VTA_03_ASEReadCounter.table","NW_015090842.1:10270813",17,45,28
"TANGO6","s1639_F_VTA_03_ASEReadCounter.table","NW_015090842.1:10274018",21,43,22
"TANGO6","s1639_F_VTA_03_ASEReadCounter.table","NW_015090842.1:10275974",20,38,18
"TANGO6","s1639_F_VTA_03_ASEReadCounter.table","NW_015090842.1:10275976",19,35,16
"TANGO6","s1639_F_VTA_03_ASEReadCounter.table","NW_015090842.1:10276123",33,52,19
"TANGO6","s1639_F_VTA_03_ASEReadCounter.table","NW_015090842.1:10276271",37,66,29
"TANGO6","s1639_F_VTA_03_ASEReadCounter.table","NW_015090842.1:10276272",37,68,31
"TANGO6","s1639_F_VTA_03_ASEReadCounter.table","NW_015090842.1:10276275",39,71,32
"TANGO6","s1639_F_VTA_03_ASEReadCounter.table","NW_015090842.1:10276278",39,72,33
"TANGO6","s1639_F_VTA_03_ASEReadCounter.table","NW_015090842.1:10276368",26,49,23
"TANGO6","s1639_F_VTA_03_ASEReadCounter.table","NW_015090842.1:10276373",26,51,25
"TANGO6","s1639_F_VTA_03_ASEReadCounter.table","NW_015090842.1:10276630",37,64,27
"TANGO6","s1639_F_VTA_03_ASEReadCounter.table","NW_015090842.1:10281498",30,63,33
"TANGO6","s1639_F_VTA_03_ASEReadCounter.table","NW_015090842.1:10281516",30,62,32
"TANGO6","s1639_F_VTA_03_ASEReadCounter.table","NW_015090842.1:10282842",41,70,29
"TANGO6","s1639_F_VTA_03_ASEReadCounter.table","NW_015090842.1:10282863",37,62,25
"TANGO6","s1639_F_VTA_03_ASEReadCounter.table","NW_015090842.1:10282869",36,60,24
"TANGO6","s1639_F_VTA_03_ASEReadCounter.table","NW_015090842.1:10282903",44,80,36
"TANGO6","s1639_F_VTA_03_ASEReadCounter.table","NW_015090842.1:10283757",55,99,44
"TANGO6","s1639_F_VTA_03_ASEReadCounter.table","NW_015090842.1:10283785",54,92,38
"HAS3","s1639_F_VTA_03_ASEReadCounter.table","NW_015090842.1:10288364",1,1,0
"HAS3","s1639_F_VTA_03_ASEReadCounter.table","NW_015090842.1:10289269",1,2,1
"HAS3","s1639_F_VTA_03_ASEReadCounter.table","NW_015090842.1:10289272",1,2,1
"HAS3","s1639_F_VTA_03_ASEReadCounter.table","NW_015090842.1:10289469",1,1,0
"HAS3","s1639_F_VTA_03_ASEReadCounter.table","NW_015090842.1:10290375",0,1,1
"HAS3","s1639_F_VTA_03_ASEReadCounter.table","NW_015090842.1:10290395",0,1,1
"HAS3","s1639_F_VTA_03_ASEReadCounter.table","NW_015090842.1:10290561",1,2,1
"HAS3","s1639_F_VTA_03_ASEReadCounter.table","NW_015090842.1:10290609",1,2,1
"HAS3","s1639_F_VTA_03_ASEReadCounter.table","NW_015090842.1:10290666",3,4,1
"HAS3","s1639_F_VTA_03_ASEReadCounter.table","NW_015090842.1:10290723",2,4,2
"HAS3","s1639_F_VTA_03_ASEReadCounter.table","NW_015090842.1:10290927",1,2,1
"HAS3","s1639_F_VTA_03_ASEReadCounter.table","NW_015090842.1:10291004",2,4,2
"CHTF8","s1639_F_VTA_03_ASEReadCounter.table","NW_015090842.1:10291319",4,8,4
"CHTF8","s1639_F_VTA_03_ASEReadCounter.table","NW_015090842.1:10291491",8,12,4
"CHTF8","s1639_F_VTA_03_ASEReadCounter.table","NW_015090842.1:10291520",6,12,6
"CHTF8","s1639_F_VTA_03_ASEReadCounter.table","NW_015090842.1:10291593",7,14,7
"CHTF8","s1639_F_VTA_03_ASEReadCounter.table","NW_015090842.1:10291600",7,14,7
"CHTF8","s1639_F_VTA_03_ASEReadCounter.table","NW_015090842.1:10291609",7,13,6
"CHTF8","s1639_F_VTA_03_ASEReadCounter.table","NW_015090842.1:10291639",7,12,5
"CHTF8","s1639_F_VTA_03_ASEReadCounter.table","NW_015090842.1:10291641",7,11,4
"CHTF8","s1639_F_VTA_03_ASEReadCounter.table","NW_015090842.1:10291648",6,12,6
"CHTF8","s1639_F_VTA_03_ASEReadCounter.table","NW_015090842.1:10291656",5,11,6
"CHTF8","s1639_F_VTA_03_ASEReadCounter.table","NW_015090842.1:10291675",5,10,5
"CHTF8","s1639_F_VTA_03_ASEReadCounter.table","NW_015090842.1:10291696",6,10,4
"CHTF8","s1639_F_VTA_03_ASEReadCounter.table","NW_015090842.1:10291714",6,10,4
"CHTF8","s1639_F_VTA_03_ASEReadCounter.table","NW_015090842.1:10291732",8,13,5
"CHTF8","s1639_F_VTA_03_ASEReadCounter.table","NW_015090842.1:10291755",8,13,5
"CHTF8","s1639_F_VTA_03_ASEReadCounter.table","NW_015090842.1:10291756",8,13,5
"CHTF8","s1639_F_VTA_03_ASEReadCounter.table","NW_015090842.1:10291758",8,13,5
"CHTF8","s1639_F_VTA_03_ASEReadCounter.table","NW_015090842.1:10291792",11,17,6
"CHTF8","s1639_F_VTA_03_ASEReadCounter.table","NW_015090842.1:10291895",8,13,5
"CHTF8","s1639_F_VTA_03_ASEReadCounter.table","NW_015090842.1:10292132",7,11,4
"CHTF8","s1639_F_VTA_03_ASEReadCounter.table","NW_015090842.1:10292314",5,9,4
"CHTF8","s1639_F_VTA_03_ASEReadCounter.table","NW_015090842.1:10292317",5,9,4
"CHTF8","s1639_F_VTA_03_ASEReadCounter.table","NW_015090842.1:10292928",1,1,0
"UTP4","s1639_F_VTA_03_ASEReadCounter.table","NW_015090842.1:10293146",9,14,5
"UTP4","s1639_F_VTA_03_ASEReadCounter.table","NW_015090842.1:10293151",8,13,5
"UTP4","s1639_F_VTA_03_ASEReadCounter.table","NW_015090842.1:10293191",5,7,2
"UTP4","s1639_F_VTA_03_ASEReadCounter.table","NW_015090842.1:10293362",10,17,7
"UTP4","s1639_F_VTA_03_ASEReadCounter.table","NW_015090842.1:10293430",8,14,6
"UTP4","s1639_F_VTA_03_ASEReadCounter.table","NW_015090842.1:10293625",7,12,5
"UTP4","s1639_F_VTA_03_ASEReadCounter.table","NW_015090842.1:10293684",10,16,6
"UTP4","s1639_F_VTA_03_ASEReadCounter.table","NW_015090842.1:10294093",8,14,6
"UTP4","s1639_F_VTA_03_ASEReadCounter.table","NW_015090842.1:10294622",9,14,5
"UTP4","s1639_F_VTA_03_ASEReadCounter.table","NW_015090842.1:10294632",10,15,5
"UTP4","s1639_F_VTA_03_ASEReadCounter.table","NW_015090842.1:10295238",8,17,9
"UTP4","s1639_F_VTA_03_ASEReadCounter.table","NW_015090842.1:10295880",10,20,10
"UTP4","s1639_F_VTA_03_ASEReadCounter.table","NW_015090842.1:10295884",7,19,12
"UTP4","s1639_F_VTA_03_ASEReadCounter.table","NW_015090842.1:10295903",6,17,11
"UTP4","s1639_F_VTA_03_ASEReadCounter.table","NW_015090842.1:10295906",6,17,11
"UTP4","s1639_F_VTA_03_ASEReadCounter.table","NW_015090842.1:10295915",7,18,11
"UTP4","s1639_F_VTA_03_ASEReadCounter.table","NW_015090842.1:10295938",8,18,10
"UTP4","s1639_F_VTA_03_ASEReadCounter.table","NW_015090842.1:10296175",11,27,16
"UTP4","s1639_F_VTA_03_ASEReadCounter.table","NW_015090842.1:10296660",11,31,20
"UTP4","s1639_F_VTA_03_ASEReadCounter.table","NW_015090842.1:10296679",11,33,22
"UTP4","s1639_F_VTA_03_ASEReadCounter.table","NW_015090842.1:10297193",21,51,30
"UTP4","s1639_F_VTA_03_ASEReadCounter.table","NW_015090842.1:10297220",25,54,29
"UTP4","s1639_F_VTA_03_ASEReadCounter.table","NW_015090842.1:10297307",19,47,28
"UTP4","s1639_F_VTA_03_ASEReadCounter.table","NW_015090842.1:10297558",27,54,27
"UTP4","s1639_F_VTA_03_ASEReadCounter.table","NW_015090842.1:10297943",15,41,26
"UTP4","s1639_F_VTA_03_ASEReadCounter.table","NW_015090842.1:10297979",19,42,23
"UTP4","s1639_F_VTA_03_ASEReadCounter.table","NW_015090842.1:10298022",11,28,17
"UTP4","s1639_F_VTA_03_ASEReadCounter.table","NW_015090842.1:10298079",1,7,6
"UTP4","s1639_F_VTA_03_ASEReadCounter.table","NW_015090842.1:10298081",1,7,6
"UTP4","s1639_F_VTA_03_ASEReadCounter.table","NW_015090842.1:10298082",0,7,7
"SNTB2","s1639_F_VTA_03_ASEReadCounter.table","NW_015090842.1:10298905",0,1,1
"SNTB2","s1639_F_VTA_03_ASEReadCounter.table","NW_015090842.1:10298928",0,1,1
"SNTB2","s1639_F_VTA_03_ASEReadCounter.table","NW_015090842.1:10303506",2,4,2
"SNTB2","s1639_F_VTA_03_ASEReadCounter.table","NW_015090842.1:10303524",2,4,2
"SNTB2","s1639_F_VTA_03_ASEReadCounter.table","NW_015090842.1:10304059",3,5,2
"SNTB2","s1639_F_VTA_03_ASEReadCounter.table","NW_015090842.1:10304089",3,4,1
"SNTB2","s1639_F_VTA_03_ASEReadCounter.table","NW_015090842.1:10304167",2,3,1
"SNTB2","s1639_F_VTA_03_ASEReadCounter.table","NW_015090842.1:10304176",1,2,1
"SNTB2","s1639_F_VTA_03_ASEReadCounter.table","NW_015090842.1:10305069",2,2,0
"SNTB2","s1639_F_VTA_03_ASEReadCounter.table","NW_015090842.1:10305099",1,2,1
"SNTB2","s1639_F_VTA_03_ASEReadCounter.table","NW_015090842.1:10305171",3,3,0
"SNTB2","s1639_F_VTA_03_ASEReadCounter.table","NW_015090842.1:10305177",2,2,0
"SNTB2","s1639_F_VTA_03_ASEReadCounter.table","NW_015090842.1:10305451",3,3,0
"SNTB2","s1639_F_VTA_03_ASEReadCounter.table","NW_015090842.1:10305547",1,2,1
"SNTB2","s1639_F_VTA_03_ASEReadCounter.table","NW_015090842.1:10305847",3,4,1
"SNTB2","s1639_F_VTA_03_ASEReadCounter.table","NW_015090842.1:10306173",3,4,1
"SNTB2","s1639_F_VTA_03_ASEReadCounter.table","NW_015090842.1:10306275",4,6,2
"SNTB2","s1639_F_VTA_03_ASEReadCounter.table","NW_015090842.1:10306457",1,3,2
"SNTB2","s1639_F_VTA_03_ASEReadCounter.table","NW_015090842.1:10306496",1,3,2
"SNTB2","s1639_F_VTA_03_ASEReadCounter.table","NW_015090842.1:10306499",1,3,2
"VPS4A","s1639_F_VTA_03_ASEReadCounter.table","NW_015090842.1:10308566",58,121,63
"VPS4A","s1639_F_VTA_03_ASEReadCounter.table","NW_015090842.1:10308573",58,118,60
"VPS4A","s1639_F_VTA_03_ASEReadCounter.table","NW_015090842.1:10308856",69,160,91
"VPS4A","s1639_F_VTA_03_ASEReadCounter.table","NW_015090842.1:10309056",130,270,140
"VPS4A","s1639_F_VTA_03_ASEReadCounter.table","NW_015090842.1:10309089",148,274,126
"VPS4A","s1639_F_VTA_03_ASEReadCounter.table","NW_015090842.1:10309392",123,245,122
"VPS4A","s1639_F_VTA_03_ASEReadCounter.table","NW_015090842.1:10309413",139,257,118
"VPS4A","s1639_F_VTA_03_ASEReadCounter.table","NW_015090842.1:10309467",144,297,153
"VPS4A","s1639_F_VTA_03_ASEReadCounter.table","NW_015090842.1:10310230",121,297,176
"VPS4A","s1639_F_VTA_03_ASEReadCounter.table","NW_015090842.1:10310425",125,287,162
"VPS4A","s1639_F_VTA_03_ASEReadCounter.table","NW_015090842.1:10310639",138,287,149
"VPS4A","s1639_F_VTA_03_ASEReadCounter.table","NW_015090842.1:10310734",147,290,143
"VPS4A","s1639_F_VTA_03_ASEReadCounter.table","NW_015090842.1:10310737",154,301,147
"VPS4A","s1639_F_VTA_03_ASEReadCounter.table","NW_015090842.1:10310746",158,309,151
"VPS4A","s1639_F_VTA_03_ASEReadCounter.table","NW_015090842.1:10310767",157,318,161
"VPS4A","s1639_F_VTA_03_ASEReadCounter.table","NW_015090842.1:10310995",175,344,169
"VPS4A","s1639_F_VTA_03_ASEReadCounter.table","NW_015090842.1:10311004",174,343,169
"VPS4A","s1639_F_VTA_03_ASEReadCounter.table","NW_015090842.1:10311007",176,344,168
"VPS4A","s1639_F_VTA_03_ASEReadCounter.table","NW_015090842.1:10311013",184,344,160
"VPS4A","s1639_F_VTA_03_ASEReadCounter.table","NW_015090842.1:10311022",174,341,167
"VPS4A","s1639_F_VTA_03_ASEReadCounter.table","NW_015090842.1:10311023",171,335,164
"VPS4A","s1639_F_VTA_03_ASEReadCounter.table","NW_015090842.1:10311426",190,389,199
"VPS4A","s1639_F_VTA_03_ASEReadCounter.table","NW_015090842.1:10311489",1,11,10
"VPS4A","s1639_F_VTA_03_ASEReadCounter.table","NW_015090842.1:10311490",2,11,9
"VPS4A","s1639_F_VTA_03_ASEReadCounter.table","NW_015090842.1:10311525",12,19,7
"VPS4A","s1639_F_VTA_03_ASEReadCounter.table","NW_015090842.1:10311529",13,26,13
"VPS4A","s1639_F_VTA_03_ASEReadCounter.table","NW_015090842.1:10311530",13,28,15
"VPS4A","s1639_F_VTA_03_ASEReadCounter.table","NW_015090842.1:10311552",47,69,22
"VPS4A","s1639_F_VTA_03_ASEReadCounter.table","NW_015090842.1:10311689",38,86,48
"VPS4A","s1639_F_VTA_03_ASEReadCounter.table","NW_015090842.1:10311700",48,93,45
"VPS4A","s1639_F_VTA_03_ASEReadCounter.table","NW_015090842.1:10311701",48,96,48
"VPS4A","s1639_F_VTA_03_ASEReadCounter.table","NW_015090842.1:10311703",48,98,50
"COG8","s1639_F_VTA_03_ASEReadCounter.table","NW_015090842.1:10313487",22,49,27
"COG8","s1639_F_VTA_03_ASEReadCounter.table","NW_015090842.1:10313559",28,62,34
"COG8","s1639_F_VTA_03_ASEReadCounter.table","NW_015090842.1:10313579",32,58,26
"COG8","s1639_F_VTA_03_ASEReadCounter.table","NW_015090842.1:10313665",37,59,22
"COG8","s1639_F_VTA_03_ASEReadCounter.table","NW_015090842.1:10313681",32,59,27
"COG8","s1639_F_VTA_03_ASEReadCounter.table","NW_015090842.1:10313768",44,75,31
"COG8","s1639_F_VTA_03_ASEReadCounter.table","NW_015090842.1:10313775",44,72,28
"COG8","s1639_F_VTA_03_ASEReadCounter.table","NW_015090842.1:10313811",28,51,23
"COG8","s1639_F_VTA_03_ASEReadCounter.table","NW_015090842.1:10313858",18,43,25
"COG8","s1639_F_VTA_03_ASEReadCounter.table","NW_015090842.1:10314100",27,55,28
"COG8","s1639_F_VTA_03_ASEReadCounter.table","NW_015090842.1:10314213",29,51,22
"COG8","s1639_F_VTA_03_ASEReadCounter.table","NW_015090842.1:10315093",22,40,18
"COG8","s1639_F_VTA_03_ASEReadCounter.table","NW_015090842.1:10315162",11,25,14
"COG8","s1639_F_VTA_03_ASEReadCounter.table","NW_015090842.1:10315285",22,43,21
"COG8","s1639_F_VTA_03_ASEReadCounter.table","NW_015090842.1:10315360",12,25,13
"COG8","s1639_F_VTA_03_ASEReadCounter.table","NW_015090842.1:10315369",14,25,11
"COG8","s1639_F_VTA_03_ASEReadCounter.table","NW_015090842.1:10315504",6,17,11
"COG8","s1639_F_VTA_03_ASEReadCounter.table","NW_015090842.1:10315508",6,17,11
"COG8","s1639_F_VTA_03_ASEReadCounter.table","NW_015090842.1:10315624",13,30,17
"COG8","s1639_F_VTA_03_ASEReadCounter.table","NW_015090842.1:10315693",12,22,10
"COG8","s1639_F_VTA_03_ASEReadCounter.table","NW_015090842.1:10315698",11,24,13
"COG8","s1639_F_VTA_03_ASEReadCounter.table","NW_015090842.1:10315768",9,22,13
"COG8","s1639_F_VTA_03_ASEReadCounter.table","NW_015090842.1:10315769",9,20,11
"COG8","s1639_F_VTA_03_ASEReadCounter.table","NW_015090842.1:10315784",9,22,13
"COG8","s1639_F_VTA_03_ASEReadCounter.table","NW_015090842.1:10316093",10,22,12
"COG8","s1639_F_VTA_03_ASEReadCounter.table","NW_015090842.1:10316133",7,14,7
"NIP7","s1639_F_VTA_03_ASEReadCounter.table","NW_015090842.1:10316759",2,19,17
"NIP7","s1639_F_VTA_03_ASEReadCounter.table","NW_015090842.1:10316967",62,145,83
"NIP7","s1639_F_VTA_03_ASEReadCounter.table","NW_015090842.1:10316995",79,174,95
"NIP7","s1639_F_VTA_03_ASEReadCounter.table","NW_015090842.1:10317240",152,289,137
"NIP7","s1639_F_VTA_03_ASEReadCounter.table","NW_015090842.1:10317247",149,285,136
"NIP7","s1639_F_VTA_03_ASEReadCounter.table","NW_015090842.1:10317264",138,262,124
"NIP7","s1639_F_VTA_03_ASEReadCounter.table","NW_015090842.1:10317433",158,333,175
"NIP7","s1639_F_VTA_03_ASEReadCounter.table","NW_015090842.1:10317738",137,293,156
"NIP7","s1639_F_VTA_03_ASEReadCounter.table","NW_015090842.1:10317769",146,297,151
"NIP7","s1639_F_VTA_03_ASEReadCounter.table","NW_015090842.1:10317808",88,188,100
"NIP7","s1639_F_VTA_03_ASEReadCounter.table","NW_015090842.1:10317870",60,143,83
"NIP7","s1639_F_VTA_03_ASEReadCounter.table","NW_015090842.1:10317871",60,136,76
"NIP7","s1639_F_VTA_03_ASEReadCounter.table","NW_015090842.1:10317898",44,98,54
"NIP7","s1639_F_VTA_03_ASEReadCounter.table","NW_015090842.1:10317911",39,85,46
"TERF2","s1639_F_VTA_03_ASEReadCounter.table","NW_015090842.1:10321665",9,9,0
"TERF2","s1639_F_VTA_03_ASEReadCounter.table","NW_015090842.1:10321768",23,53,30
"TERF2","s1639_F_VTA_03_ASEReadCounter.table","NW_015090842.1:10321777",25,56,31
"TERF2","s1639_F_VTA_03_ASEReadCounter.table","NW_015090842.1:10321805",23,56,33
"TERF2","s1639_F_VTA_03_ASEReadCounter.table","NW_015090842.1:10321878",30,79,49
"TERF2","s1639_F_VTA_03_ASEReadCounter.table","NW_015090842.1:10321893",4,81,77
"TERF2","s1639_F_VTA_03_ASEReadCounter.table","NW_015090842.1:10321897",25,70,45
"TERF2","s1639_F_VTA_03_ASEReadCounter.table","NW_015090842.1:10321908",27,71,44
"TERF2","s1639_F_VTA_03_ASEReadCounter.table","NW_015090842.1:10322001",54,112,58
"TERF2","s1639_F_VTA_03_ASEReadCounter.table","NW_015090842.1:10322035",44,96,52
"TERF2","s1639_F_VTA_03_ASEReadCounter.table","NW_015090842.1:10322051",42,103,61
"TERF2","s1639_F_VTA_03_ASEReadCounter.table","NW_015090842.1:10322137",36,80,44
"TERF2","s1639_F_VTA_03_ASEReadCounter.table","NW_015090842.1:10322144",30,73,43
"TERF2","s1639_F_VTA_03_ASEReadCounter.table","NW_015090842.1:10322388",18,79,61
"TERF2","s1639_F_VTA_03_ASEReadCounter.table","NW_015090842.1:10322396",21,78,57
"TERF2","s1639_F_VTA_03_ASEReadCounter.table","NW_015090842.1:10322502",24,76,52
"TERF2","s1639_F_VTA_03_ASEReadCounter.table","NW_015090842.1:10322504",25,76,51
"TERF2","s1639_F_VTA_03_ASEReadCounter.table","NW_015090842.1:10322510",26,84,58
"TERF2","s1639_F_VTA_03_ASEReadCounter.table","NW_015090842.1:10323580",36,71,35
"TERF2","s1639_F_VTA_03_ASEReadCounter.table","NW_015090842.1:10324314",28,67,39
"TERF2","s1639_F_VTA_03_ASEReadCounter.table","NW_015090842.1:10326832",24,58,34
"TERF2","s1639_F_VTA_03_ASEReadCounter.table","NW_015090842.1:10327787",14,38,24
"TERF2","s1639_F_VTA_03_ASEReadCounter.table","NW_015090842.1:10328588",23,47,24
"TERF2","s1639_F_VTA_03_ASEReadCounter.table","NW_015090842.1:10328644",15,36,21
"TERF2","s1639_F_VTA_03_ASEReadCounter.table","NW_015090842.1:10329813",11,20,9
"TERF2","s1639_F_VTA_03_ASEReadCounter.table","NW_015090842.1:10330749",16,25,9
"TERF2","s1639_F_VTA_03_ASEReadCounter.table","NW_015090842.1:10330789",12,22,10
"CYB5B","s1639_F_VTA_03_ASEReadCounter.table","NW_015090842.1:10336595",3,4,1
"CYB5B","s1639_F_VTA_03_ASEReadCounter.table","NW_015090842.1:10336667",26,65,39
"CYB5B","s1639_F_VTA_03_ASEReadCounter.table","NW_015090842.1:10336689",44,100,56
"CYB5B","s1639_F_VTA_03_ASEReadCounter.table","NW_015090842.1:10336728",77,151,74
"CYB5B","s1639_F_VTA_03_ASEReadCounter.table","NW_015090842.1:10345068",71,140,69
"CYB5B","s1639_F_VTA_03_ASEReadCounter.table","NW_015090842.1:10348800",115,212,97
"CYB5B","s1639_F_VTA_03_ASEReadCounter.table","NW_015090842.1:10348888",110,203,93
"CYB5B","s1639_F_VTA_03_ASEReadCounter.table","NW_015090842.1:10349046",114,184,70
"CYB5B","s1639_F_VTA_03_ASEReadCounter.table","NW_015090842.1:10349119",67,160,93
"CYB5B","s1639_F_VTA_03_ASEReadCounter.table","NW_015090842.1:10349146",46,144,98
"CYB5B","s1639_F_VTA_03_ASEReadCounter.table","NW_015090842.1:10349157",71,172,101
