"gene","id","snp","ref_count","total_count","alt_count"
"CENPN","s1650_F_GON_01_ASEReadCounter.table","NW_015090842.1:5801612",29,505,476
"CENPN","s1650_F_GON_01_ASEReadCounter.table","NW_015090842.1:5801618",40,524,484
"CENPN","s1650_F_GON_01_ASEReadCounter.table","NW_015090842.1:5801623",59,543,484
"CENPN","s1650_F_GON_01_ASEReadCounter.table","NW_015090842.1:5801631",83,576,493
"CENPN","s1650_F_GON_01_ASEReadCounter.table","NW_015090842.1:5801632",83,575,492
"CENPN","s1650_F_GON_01_ASEReadCounter.table","NW_015090842.1:5801655",116,505,389
"CENPN","s1650_F_GON_01_ASEReadCounter.table","NW_015090842.1:5801662",133,569,436
"CENPN","s1650_F_GON_01_ASEReadCounter.table","NW_015090842.1:5801670",143,592,449
"CENPN","s1650_F_GON_01_ASEReadCounter.table","NW_015090842.1:5801674",142,606,464
"CENPN","s1650_F_GON_01_ASEReadCounter.table","NW_015090842.1:5801692",165,664,499
"CENPN","s1650_F_GON_01_ASEReadCounter.table","NW_015090842.1:5801697",168,670,502
"CENPN","s1650_F_GON_01_ASEReadCounter.table","NW_015090842.1:5802008",215,1046,831
"CENPN","s1650_F_GON_01_ASEReadCounter.table","NW_015090842.1:5802012",216,1057,841
"CENPN","s1650_F_GON_01_ASEReadCounter.table","NW_015090842.1:5802087",284,1370,1086
"CENPN","s1650_F_GON_01_ASEReadCounter.table","NW_015090842.1:5810113",24,34,10
"CENPN","s1650_F_GON_01_ASEReadCounter.table","NW_015090842.1:5810147",39,48,9
"CENPN","s1650_F_GON_01_ASEReadCounter.table","NW_015090842.1:5810148",39,48,9
"ATMIN","s1650_F_GON_01_ASEReadCounter.table","NW_015090842.1:5818789",31,38,7
"ATMIN","s1650_F_GON_01_ASEReadCounter.table","NW_015090842.1:5819958",35,46,11
"ATMIN","s1650_F_GON_01_ASEReadCounter.table","NW_015090842.1:5820004",39,51,12
"ATMIN","s1650_F_GON_01_ASEReadCounter.table","NW_015090842.1:5820217",22,30,8
"ATMIN","s1650_F_GON_01_ASEReadCounter.table","NW_015090842.1:5820250",33,42,9
"ATMIN","s1650_F_GON_01_ASEReadCounter.table","NW_015090842.1:5820298",31,39,8
"ATMIN","s1650_F_GON_01_ASEReadCounter.table","NW_015090842.1:5820417",9,17,8
"ATMIN","s1650_F_GON_01_ASEReadCounter.table","NW_015090842.1:5820421",9,16,7
"ATMIN","s1650_F_GON_01_ASEReadCounter.table","NW_015090842.1:5820448",8,14,6
"ATMIN","s1650_F_GON_01_ASEReadCounter.table","NW_015090842.1:5820457",6,11,5
"ATMIN","s1650_F_GON_01_ASEReadCounter.table","NW_015090842.1:5820510",5,13,8
"ATMIN","s1650_F_GON_01_ASEReadCounter.table","NW_015090842.1:5820673",5,12,7
"ATMIN","s1650_F_GON_01_ASEReadCounter.table","NW_015090842.1:5820754",6,11,5
"ATMIN","s1650_F_GON_01_ASEReadCounter.table","NW_015090842.1:5820820",8,14,6
"ATMIN","s1650_F_GON_01_ASEReadCounter.table","NW_015090842.1:5820865",7,11,4
"ATMIN","s1650_F_GON_01_ASEReadCounter.table","NW_015090842.1:5820889",9,14,5
"ATMIN","s1650_F_GON_01_ASEReadCounter.table","NW_015090842.1:5820891",9,15,6
"ATMIN","s1650_F_GON_01_ASEReadCounter.table","NW_015090842.1:5820997",13,17,4
"ATMIN","s1650_F_GON_01_ASEReadCounter.table","NW_015090842.1:5821063",9,18,9
"ATMIN","s1650_F_GON_01_ASEReadCounter.table","NW_015090842.1:5821132",11,17,6
"ATMIN","s1650_F_GON_01_ASEReadCounter.table","NW_015090842.1:5821645",11,18,7
"ATMIN","s1650_F_GON_01_ASEReadCounter.table","NW_015090842.1:5825066",14,23,9
"ATMIN","s1650_F_GON_01_ASEReadCounter.table","NW_015090842.1:5825106",13,17,4
"ATMIN","s1650_F_GON_01_ASEReadCounter.table","NW_015090842.1:5825122",12,16,4
"ATMIN","s1650_F_GON_01_ASEReadCounter.table","NW_015090842.1:5825178",14,25,11
"ATMIN","s1650_F_GON_01_ASEReadCounter.table","NW_015090842.1:5825194",15,25,10
"ATMIN","s1650_F_GON_01_ASEReadCounter.table","NW_015090842.1:5825195",15,25,10
"ATMIN","s1650_F_GON_01_ASEReadCounter.table","NW_015090842.1:5825220",17,27,10
"ATMIN","s1650_F_GON_01_ASEReadCounter.table","NW_015090842.1:5825240",20,30,10
"ATMIN","s1650_F_GON_01_ASEReadCounter.table","NW_015090842.1:5825303",23,42,19
"ATMIN","s1650_F_GON_01_ASEReadCounter.table","NW_015090842.1:5825304",24,42,18
"ATMIN","s1650_F_GON_01_ASEReadCounter.table","NW_015090842.1:5825310",22,40,18
"ATMIN","s1650_F_GON_01_ASEReadCounter.table","NW_015090842.1:5825406",25,49,24
"ATMIN","s1650_F_GON_01_ASEReadCounter.table","NW_015090842.1:5825415",24,48,24
"ATMIN","s1650_F_GON_01_ASEReadCounter.table","NW_015090842.1:5825438",23,44,21
"ATMIN","s1650_F_GON_01_ASEReadCounter.table","NW_015090842.1:5825485",30,52,22
"ATMIN","s1650_F_GON_01_ASEReadCounter.table","NW_015090842.1:5825524",30,53,23
"ATMIN","s1650_F_GON_01_ASEReadCounter.table","NW_015090842.1:5825557",27,49,22
"ATMIN","s1650_F_GON_01_ASEReadCounter.table","NW_015090842.1:5825571",29,50,21
"ATMIN","s1650_F_GON_01_ASEReadCounter.table","NW_015090842.1:5825579",27,49,22
"ATMIN","s1650_F_GON_01_ASEReadCounter.table","NW_015090842.1:5825590",19,37,18
"ATMIN","s1650_F_GON_01_ASEReadCounter.table","NW_015090842.1:5825689",32,58,26
"ATMIN","s1650_F_GON_01_ASEReadCounter.table","NW_015090842.1:5825703",36,63,27
"ATMIN","s1650_F_GON_01_ASEReadCounter.table","NW_015090842.1:5825787",28,52,24
"ATMIN","s1650_F_GON_01_ASEReadCounter.table","NW_015090842.1:5825833",33,60,27
"ATMIN","s1650_F_GON_01_ASEReadCounter.table","NW_015090842.1:5825841",24,50,26
"ATMIN","s1650_F_GON_01_ASEReadCounter.table","NW_015090842.1:5825895",32,61,29
"ATMIN","s1650_F_GON_01_ASEReadCounter.table","NW_015090842.1:5825984",29,51,22
"ATMIN","s1650_F_GON_01_ASEReadCounter.table","NW_015090842.1:5826162",45,67,22
"ATMIN","s1650_F_GON_01_ASEReadCounter.table","NW_015090842.1:5826194",51,74,23
"ATMIN","s1650_F_GON_01_ASEReadCounter.table","NW_015090842.1:5826235",50,74,24
"ATMIN","s1650_F_GON_01_ASEReadCounter.table","NW_015090842.1:5826245",50,75,25
"ATMIN","s1650_F_GON_01_ASEReadCounter.table","NW_015090842.1:5826335",20,35,15
"ATMIN","s1650_F_GON_01_ASEReadCounter.table","NW_015090842.1:5826417",23,42,19
"ATMIN","s1650_F_GON_01_ASEReadCounter.table","NW_015090842.1:5826431",22,45,23
"ATMIN","s1650_F_GON_01_ASEReadCounter.table","NW_015090842.1:5826438",25,43,18
"ATMIN","s1650_F_GON_01_ASEReadCounter.table","NW_015090842.1:5826463",29,58,29
"ATMIN","s1650_F_GON_01_ASEReadCounter.table","NW_015090842.1:5826502",36,74,38
"ATMIN","s1650_F_GON_01_ASEReadCounter.table","NW_015090842.1:5826511",34,73,39
"ATMIN","s1650_F_GON_01_ASEReadCounter.table","NW_015090842.1:5826659",39,70,31
"ATMIN","s1650_F_GON_01_ASEReadCounter.table","NW_015090842.1:5826701",35,71,36
"ATMIN","s1650_F_GON_01_ASEReadCounter.table","NW_015090842.1:5826702",38,74,36
"ATMIN","s1650_F_GON_01_ASEReadCounter.table","NW_015090842.1:5826732",39,76,37
"ATMIN","s1650_F_GON_01_ASEReadCounter.table","NW_015090842.1:5826745",46,81,35
"ATMIN","s1650_F_GON_01_ASEReadCounter.table","NW_015090842.1:5826835",56,90,34
"ATMIN","s1650_F_GON_01_ASEReadCounter.table","NW_015090842.1:5826942",30,73,43
"ATMIN","s1650_F_GON_01_ASEReadCounter.table","NW_015090842.1:5827193",50,106,56
"ATMIN","s1650_F_GON_01_ASEReadCounter.table","NW_015090842.1:5827196",49,105,56
"ATMIN","s1650_F_GON_01_ASEReadCounter.table","NW_015090842.1:5827269",65,123,58
"ATMIN","s1650_F_GON_01_ASEReadCounter.table","NW_015090842.1:5827315",49,85,36
"ATMIN","s1650_F_GON_01_ASEReadCounter.table","NW_015090842.1:5827316",49,90,41
"ATMIN","s1650_F_GON_01_ASEReadCounter.table","NW_015090842.1:5827333",49,86,37
"PPP1R3E","s1650_F_GON_01_ASEReadCounter.table","NW_015090842.1:5837733",11,25,14
"PPP1R3E","s1650_F_GON_01_ASEReadCounter.table","NW_015090842.1:5837947",2,10,8
"PKD1L2","s1650_F_GON_01_ASEReadCounter.table","NW_015090842.1:5867509",17,36,19
"PKD1L2","s1650_F_GON_01_ASEReadCounter.table","NW_015090842.1:5867597",30,57,27
"PKD1L2","s1650_F_GON_01_ASEReadCounter.table","NW_015090842.1:5867600",29,61,32
"PKD1L2","s1650_F_GON_01_ASEReadCounter.table","NW_015090842.1:5867660",32,71,39
"PKD1L2","s1650_F_GON_01_ASEReadCounter.table","NW_015090842.1:5867675",32,78,46
"PKD1L2","s1650_F_GON_01_ASEReadCounter.table","NW_015090842.1:5867788",29,68,39
"PKD1L2","s1650_F_GON_01_ASEReadCounter.table","NW_015090842.1:5867843",37,91,54
"PKD1L2","s1650_F_GON_01_ASEReadCounter.table","NW_015090842.1:5871422",1,7,6
"PKD1L2","s1650_F_GON_01_ASEReadCounter.table","NW_015090842.1:5872825",2,2,0
"PKD1L2","s1650_F_GON_01_ASEReadCounter.table","NW_015090842.1:5872876",2,5,3
"PKD1L2","s1650_F_GON_01_ASEReadCounter.table","NW_015090842.1:5872924",3,6,3
"PKD1L2","s1650_F_GON_01_ASEReadCounter.table","NW_015090842.1:5872948",2,4,2
"BCO1","s1650_F_GON_01_ASEReadCounter.table","NW_015090842.1:5915610",36,70,34
"BCO1","s1650_F_GON_01_ASEReadCounter.table","NW_015090842.1:5915646",25,58,33
"BCO1","s1650_F_GON_01_ASEReadCounter.table","NW_015090842.1:5917836",36,69,33
"BCO1","s1650_F_GON_01_ASEReadCounter.table","NW_015090842.1:5917912",32,60,28
"BCO1","s1650_F_GON_01_ASEReadCounter.table","NW_015090842.1:5917941",26,55,29
"BCO1","s1650_F_GON_01_ASEReadCounter.table","NW_015090842.1:5917971",34,75,41
"BCO1","s1650_F_GON_01_ASEReadCounter.table","NW_015090842.1:5921679",40,86,46
"BCO1","s1650_F_GON_01_ASEReadCounter.table","NW_015090842.1:5921726",38,84,46
"BCO1","s1650_F_GON_01_ASEReadCounter.table","NW_015090842.1:5925669",27,57,30
"BCO1","s1650_F_GON_01_ASEReadCounter.table","NW_015090842.1:5926937",22,51,29
"BCO1","s1650_F_GON_01_ASEReadCounter.table","NW_015090842.1:5927921",34,62,28
"BCO1","s1650_F_GON_01_ASEReadCounter.table","NW_015090842.1:5927948",31,63,32
"BCO1","s1650_F_GON_01_ASEReadCounter.table","NW_015090842.1:5927968",34,66,32
"BCO1","s1650_F_GON_01_ASEReadCounter.table","NW_015090842.1:5928052",31,63,32
"BCO1","s1650_F_GON_01_ASEReadCounter.table","NW_015090842.1:5932726",38,88,50
"BCO1","s1650_F_GON_01_ASEReadCounter.table","NW_015090842.1:5932801",48,95,47
"BCO1","s1650_F_GON_01_ASEReadCounter.table","NW_015090842.1:5934558",47,77,30
"BCO1","s1650_F_GON_01_ASEReadCounter.table","NW_015090842.1:5934575",50,83,33
"BCO1","s1650_F_GON_01_ASEReadCounter.table","NW_015090842.1:5934608",56,92,36
"BCO1","s1650_F_GON_01_ASEReadCounter.table","NW_015090842.1:5934647",55,92,37
"BCO1","s1650_F_GON_01_ASEReadCounter.table","NW_015090842.1:5934725",57,94,37
"BCO1","s1650_F_GON_01_ASEReadCounter.table","NW_015090842.1:5934726",58,92,34
"BCO1","s1650_F_GON_01_ASEReadCounter.table","NW_015090842.1:5934733",59,88,29
"BCO1","s1650_F_GON_01_ASEReadCounter.table","NW_015090842.1:5934821",45,71,26
"BCO1","s1650_F_GON_01_ASEReadCounter.table","NW_015090842.1:5934826",40,67,27
"BCO1","s1650_F_GON_01_ASEReadCounter.table","NW_015090842.1:5934844",23,45,22
"BCO1","s1650_F_GON_01_ASEReadCounter.table","NW_015090842.1:5934958",54,79,25
"BCO1","s1650_F_GON_01_ASEReadCounter.table","NW_015090842.1:5934976",53,79,26
"GAN","s1650_F_GON_01_ASEReadCounter.table","NW_015090842.1:5939249",1,3,2
"GAN","s1650_F_GON_01_ASEReadCounter.table","NW_015090842.1:5953759",12,36,24
"GAN","s1650_F_GON_01_ASEReadCounter.table","NW_015090842.1:5957502",19,53,34
"GAN","s1650_F_GON_01_ASEReadCounter.table","NW_015090842.1:5957578",17,48,31
"GAN","s1650_F_GON_01_ASEReadCounter.table","NW_015090842.1:5966047",26,49,23
"GAN","s1650_F_GON_01_ASEReadCounter.table","NW_015090842.1:5966126",11,40,29
"GAN","s1650_F_GON_01_ASEReadCounter.table","NW_015090842.1:5966127",10,39,29
"GAN","s1650_F_GON_01_ASEReadCounter.table","NW_015090842.1:5966162",22,60,38
"GAN","s1650_F_GON_01_ASEReadCounter.table","NW_015090842.1:5966483",13,28,15
"CMIP","s1650_F_GON_01_ASEReadCounter.table","NW_015090842.1:6109159",22,31,9
"CMIP","s1650_F_GON_01_ASEReadCounter.table","NW_015090842.1:6109166",20,27,7
"CMIP","s1650_F_GON_01_ASEReadCounter.table","NW_015090842.1:6114641",15,36,21
"CMIP","s1650_F_GON_01_ASEReadCounter.table","NW_015090842.1:6114751",15,27,12
"CMIP","s1650_F_GON_01_ASEReadCounter.table","NW_015090842.1:6114824",16,25,9
"CMIP","s1650_F_GON_01_ASEReadCounter.table","NW_015090842.1:6126295",41,41,0
"CMIP","s1650_F_GON_01_ASEReadCounter.table","NW_015090842.1:6128998",12,32,20
"CMIP","s1650_F_GON_01_ASEReadCounter.table","NW_015090842.1:6130562",26,61,35
"CMIP","s1650_F_GON_01_ASEReadCounter.table","NW_015090842.1:6132522",22,47,25
"CMIP","s1650_F_GON_01_ASEReadCounter.table","NW_015090842.1:6138265",30,63,33
"CMIP","s1650_F_GON_01_ASEReadCounter.table","NW_015090842.1:6138300",25,66,41
"CMIP","s1650_F_GON_01_ASEReadCounter.table","NW_015090842.1:6138342",26,56,30
"CMIP","s1650_F_GON_01_ASEReadCounter.table","NW_015090842.1:6138343",27,57,30
"CMIP","s1650_F_GON_01_ASEReadCounter.table","NW_015090842.1:6138345",27,58,31
"CMIP","s1650_F_GON_01_ASEReadCounter.table","NW_015090842.1:6138647",13,43,30
"CMIP","s1650_F_GON_01_ASEReadCounter.table","NW_015090842.1:6138745",20,47,27
"CMIP","s1650_F_GON_01_ASEReadCounter.table","NW_015090842.1:6138832",3,15,12
"CMIP","s1650_F_GON_01_ASEReadCounter.table","NW_015090842.1:6138967",16,38,22
"CMIP","s1650_F_GON_01_ASEReadCounter.table","NW_015090842.1:6139131",11,24,13
"CMIP","s1650_F_GON_01_ASEReadCounter.table","NW_015090842.1:6139163",1,12,11
"CMIP","s1650_F_GON_01_ASEReadCounter.table","NW_015090842.1:6139212",35,37,2
"CMIP","s1650_F_GON_01_ASEReadCounter.table","NW_015090842.1:6139360",8,15,7
"CMIP","s1650_F_GON_01_ASEReadCounter.table","NW_015090842.1:6139572",9,14,5
"PLCG2","s1650_F_GON_01_ASEReadCounter.table","NW_015090842.1:6179613",8,8,0
"PLCG2","s1650_F_GON_01_ASEReadCounter.table","NW_015090842.1:6179658",11,11,0
"PLCG2","s1650_F_GON_01_ASEReadCounter.table","NW_015090842.1:6203766",10,10,0
"PLCG2","s1650_F_GON_01_ASEReadCounter.table","NW_015090842.1:6203775",10,10,0
"PLCG2","s1650_F_GON_01_ASEReadCounter.table","NW_015090842.1:6203787",6,6,0
"PLCG2","s1650_F_GON_01_ASEReadCounter.table","NW_015090842.1:6209741",10,10,0
"PLCG2","s1650_F_GON_01_ASEReadCounter.table","NW_015090842.1:6209798",12,12,0
"PLCG2","s1650_F_GON_01_ASEReadCounter.table","NW_015090842.1:6209816",10,10,0
"PLCG2","s1650_F_GON_01_ASEReadCounter.table","NW_015090842.1:6217547",15,19,4
"PLCG2","s1650_F_GON_01_ASEReadCounter.table","NW_015090842.1:6218641",13,27,14
"PLCG2","s1650_F_GON_01_ASEReadCounter.table","NW_015090842.1:6220552",10,16,6
"PLCG2","s1650_F_GON_01_ASEReadCounter.table","NW_015090842.1:6221969",15,19,4
"PLCG2","s1650_F_GON_01_ASEReadCounter.table","NW_015090842.1:6228672",15,20,5
"PLCG2","s1650_F_GON_01_ASEReadCounter.table","NW_015090842.1:6228694",15,19,4
"PLCG2","s1650_F_GON_01_ASEReadCounter.table","NW_015090842.1:6228722",16,21,5
"PLCG2","s1650_F_GON_01_ASEReadCounter.table","NW_015090842.1:6228747",12,17,5
"PLCG2","s1650_F_GON_01_ASEReadCounter.table","NW_015090842.1:6228835",12,15,3
"PLCG2","s1650_F_GON_01_ASEReadCounter.table","NW_015090842.1:6228841",11,15,4
"PLCG2","s1650_F_GON_01_ASEReadCounter.table","NW_015090842.1:6228865",15,20,5
"PLCG2","s1650_F_GON_01_ASEReadCounter.table","NW_015090842.1:6228917",19,23,4
"PLCG2","s1650_F_GON_01_ASEReadCounter.table","NW_015090842.1:6228926",19,23,4
"PLCG2","s1650_F_GON_01_ASEReadCounter.table","NW_015090842.1:6228954",18,21,3
"PLCG2","s1650_F_GON_01_ASEReadCounter.table","NW_015090842.1:6229002",20,23,3
"PLCG2","s1650_F_GON_01_ASEReadCounter.table","NW_015090842.1:6229006",19,23,4
"PLCG2","s1650_F_GON_01_ASEReadCounter.table","NW_015090842.1:6229081",10,12,2
"PLCG2","s1650_F_GON_01_ASEReadCounter.table","NW_015090842.1:6229097",5,7,2
"PLCG2","s1650_F_GON_01_ASEReadCounter.table","NW_015090842.1:6229160",9,10,1
"PLCG2","s1650_F_GON_01_ASEReadCounter.table","NW_015090842.1:6229213",11,12,1
"PLCG2","s1650_F_GON_01_ASEReadCounter.table","NW_015090842.1:6229231",11,14,3
"PLCG2","s1650_F_GON_01_ASEReadCounter.table","NW_015090842.1:6229663",19,22,3
"PLCG2","s1650_F_GON_01_ASEReadCounter.table","NW_015090842.1:6229748",20,24,4
"PLCG2","s1650_F_GON_01_ASEReadCounter.table","NW_015090842.1:6229892",24,26,2
"PLCG2","s1650_F_GON_01_ASEReadCounter.table","NW_015090842.1:6230248",20,21,1
"PLCG2","s1650_F_GON_01_ASEReadCounter.table","NW_015090842.1:6230255",19,21,2
"PLCG2","s1650_F_GON_01_ASEReadCounter.table","NW_015090842.1:6230276",20,22,2
"PLCG2","s1650_F_GON_01_ASEReadCounter.table","NW_015090842.1:6230296",14,16,2
"PLCG2","s1650_F_GON_01_ASEReadCounter.table","NW_015090842.1:6230349",16,20,4
"PLCG2","s1650_F_GON_01_ASEReadCounter.table","NW_015090842.1:6230408",21,24,3
"PLCG2","s1650_F_GON_01_ASEReadCounter.table","NW_015090842.1:6230439",17,18,1
"PLCG2","s1650_F_GON_01_ASEReadCounter.table","NW_015090842.1:6230757",5,6,1
"PLCG2","s1650_F_GON_01_ASEReadCounter.table","NW_015090842.1:6230758",5,6,1
"PLCG2","s1650_F_GON_01_ASEReadCounter.table","NW_015090842.1:6230898",22,25,3
"PLCG2","s1650_F_GON_01_ASEReadCounter.table","NW_015090842.1:6230976",19,22,3
"PLCG2","s1650_F_GON_01_ASEReadCounter.table","NW_015090842.1:6231078",18,20,2
"PLCG2","s1650_F_GON_01_ASEReadCounter.table","NW_015090842.1:6231138",32,34,2
"PLCG2","s1650_F_GON_01_ASEReadCounter.table","NW_015090842.1:6231177",40,41,1
"PLCG2","s1650_F_GON_01_ASEReadCounter.table","NW_015090842.1:6231263",32,33,1
"SDR42E1","s1650_F_GON_01_ASEReadCounter.table","NW_015090842.1:6235292",11,31,20
"SDR42E1","s1650_F_GON_01_ASEReadCounter.table","NW_015090842.1:6235315",19,72,53
"SDR42E1","s1650_F_GON_01_ASEReadCounter.table","NW_015090842.1:6235348",34,102,68
"SDR42E1","s1650_F_GON_01_ASEReadCounter.table","NW_015090842.1:6235355",38,107,69
"SDR42E1","s1650_F_GON_01_ASEReadCounter.table","NW_015090842.1:6235417",45,116,71
"SDR42E1","s1650_F_GON_01_ASEReadCounter.table","NW_015090842.1:6235558",56,147,91
"SDR42E1","s1650_F_GON_01_ASEReadCounter.table","NW_015090842.1:6235741",100,206,106
"SDR42E1","s1650_F_GON_01_ASEReadCounter.table","NW_015090842.1:6235777",97,204,107
"SDR42E1","s1650_F_GON_01_ASEReadCounter.table","NW_015090842.1:6235806",108,234,126
"SDR42E1","s1650_F_GON_01_ASEReadCounter.table","NW_015090842.1:6235809",101,227,126
"SDR42E1","s1650_F_GON_01_ASEReadCounter.table","NW_015090842.1:6235816",104,232,128
"SDR42E1","s1650_F_GON_01_ASEReadCounter.table","NW_015090842.1:6235914",69,144,75
"SDR42E1","s1650_F_GON_01_ASEReadCounter.table","NW_015090842.1:6235935",67,147,80
"SDR42E1","s1650_F_GON_01_ASEReadCounter.table","NW_015090842.1:6235957",73,156,83
"SDR42E1","s1650_F_GON_01_ASEReadCounter.table","NW_015090842.1:6236040",47,117,70
"SDR42E1","s1650_F_GON_01_ASEReadCounter.table","NW_015090842.1:6236260",65,130,65
"SDR42E1","s1650_F_GON_01_ASEReadCounter.table","NW_015090842.1:6236281",76,149,73
"SDR42E1","s1650_F_GON_01_ASEReadCounter.table","NW_015090842.1:6236305",69,149,80
"SDR42E1","s1650_F_GON_01_ASEReadCounter.table","NW_015090842.1:6236458",70,135,65
"SDR42E1","s1650_F_GON_01_ASEReadCounter.table","NW_015090842.1:6236476",72,144,72
"SDR42E1","s1650_F_GON_01_ASEReadCounter.table","NW_015090842.1:6236608",82,154,72
"SDR42E1","s1650_F_GON_01_ASEReadCounter.table","NW_015090842.1:6238244",54,109,55
"SDR42E1","s1650_F_GON_01_ASEReadCounter.table","NW_015090842.1:6238829",25,56,31
"HSD17B2","s1650_F_GON_01_ASEReadCounter.table","NW_015090842.1:6257758",0,1,1
"HSD17B2","s1650_F_GON_01_ASEReadCounter.table","NW_015090842.1:6257767",0,1,1
"HSD17B2","s1650_F_GON_01_ASEReadCounter.table","NW_015090842.1:6257829",0,1,1
"HSD17B2","s1650_F_GON_01_ASEReadCounter.table","NW_015090842.1:6257851",0,1,1
"HSD17B2","s1650_F_GON_01_ASEReadCounter.table","NW_015090842.1:6257889",0,1,1
"HSD17B2","s1650_F_GON_01_ASEReadCounter.table","NW_015090842.1:6262974",0,1,1
"HSD17B2","s1650_F_GON_01_ASEReadCounter.table","NW_015090842.1:6266125",0,2,2
"HSD17B2","s1650_F_GON_01_ASEReadCounter.table","NW_015090842.1:6266135",0,2,2
"HSD17B2","s1650_F_GON_01_ASEReadCounter.table","NW_015090842.1:6266795",1,1,0
"HSD17B2","s1650_F_GON_01_ASEReadCounter.table","NW_015090842.1:6267053",0,1,1
"HSD17B2","s1650_F_GON_01_ASEReadCounter.table","NW_015090842.1:6267273",2,4,2
"HSD17B2","s1650_F_GON_01_ASEReadCounter.table","NW_015090842.1:6267674",2,4,2
"HSD17B2","s1650_F_GON_01_ASEReadCounter.table","NW_015090842.1:6267913",0,2,2
"HSD17B2","s1650_F_GON_01_ASEReadCounter.table","NW_015090842.1:6268098",1,4,3
"HSD17B2","s1650_F_GON_01_ASEReadCounter.table","NW_015090842.1:6268203",2,4,2
"ARY2","s1650_F_GON_01_ASEReadCounter.table","NW_015090842.1:6303922",61,61,0
"ARY2","s1650_F_GON_01_ASEReadCounter.table","NW_015090842.1:6303954",66,66,0
"ARY2","s1650_F_GON_01_ASEReadCounter.table","NW_015090842.1:6303979",78,79,1
"ARY2","s1650_F_GON_01_ASEReadCounter.table","NW_015090842.1:6305848",79,79,0
"ARY2","s1650_F_GON_01_ASEReadCounter.table","NW_015090842.1:6305856",81,81,0
"ARY2","s1650_F_GON_01_ASEReadCounter.table","NW_015090842.1:6305857",78,78,0
"ARY2","s1650_F_GON_01_ASEReadCounter.table","NW_015090842.1:6306017",79,82,3
"ARY2","s1650_F_GON_01_ASEReadCounter.table","NW_015090842.1:6306052",70,75,5
"ARY2","s1650_F_GON_01_ASEReadCounter.table","NW_015090842.1:6306094",88,90,2
"ARY2","s1650_F_GON_01_ASEReadCounter.table","NW_015090842.1:6306100",94,96,2
"ARY2","s1650_F_GON_01_ASEReadCounter.table","NW_015090842.1:6306146",90,92,2
"ARY2","s1650_F_GON_01_ASEReadCounter.table","NW_015090842.1:6306147",91,93,2
"ARY2","s1650_F_GON_01_ASEReadCounter.table","NW_015090842.1:6306390",62,62,0
"ARY2","s1650_F_GON_01_ASEReadCounter.table","NW_015090842.1:6306567",42,46,4
"ARY2","s1650_F_GON_01_ASEReadCounter.table","NW_015090842.1:6306773",1,2,1
"ARY2","s1650_F_GON_01_ASEReadCounter.table","NW_015090842.1:6307039",1,3,2
"ARY2","s1650_F_GON_01_ASEReadCounter.table","NW_015090842.1:6307043",1,3,2
"ARY2","s1650_F_GON_01_ASEReadCounter.table","NW_015090842.1:6307093",1,2,1
"ARY2","s1650_F_GON_01_ASEReadCounter.table","NW_015090842.1:6307138",1,1,0
"ARY2","s1650_F_GON_01_ASEReadCounter.table","NW_015090842.1:6307157",1,1,0
"ARY2","s1650_F_GON_01_ASEReadCounter.table","NW_015090842.1:6307187",1,1,0
"ARY2","s1650_F_GON_01_ASEReadCounter.table","NW_015090842.1:6307204",1,1,0
"ARY2","s1650_F_GON_01_ASEReadCounter.table","NW_015090842.1:6307278",1,4,3
"ARY2","s1650_F_GON_01_ASEReadCounter.table","NW_015090842.1:6307305",2,5,3
"ARY2","s1650_F_GON_01_ASEReadCounter.table","NW_015090842.1:6307318",3,5,2
"ARY2","s1650_F_GON_01_ASEReadCounter.table","NW_015090842.1:6307429",3,6,3
"ARY2","s1650_F_GON_01_ASEReadCounter.table","NW_015090842.1:6307487",1,1,0
"ARYL","s1650_F_GON_01_ASEReadCounter.table","NW_015090842.1:6313360",4,6,2
"ARYL","s1650_F_GON_01_ASEReadCounter.table","NW_015090842.1:6313377",5,7,2
"ARYL","s1650_F_GON_01_ASEReadCounter.table","NW_015090842.1:6313767",4,9,5
"ARY1","s1650_F_GON_01_ASEReadCounter.table","NW_015090842.1:6314296",0,5,5
"ARY1","s1650_F_GON_01_ASEReadCounter.table","NW_015090842.1:6314541",2,5,3
"ARY1","s1650_F_GON_01_ASEReadCounter.table","NW_015090842.1:6314597",2,5,3
"ARY1","s1650_F_GON_01_ASEReadCounter.table","NW_015090842.1:6314750",1,5,4
"ARY1","s1650_F_GON_01_ASEReadCounter.table","NW_015090842.1:6314794",2,6,4
"ARY1","s1650_F_GON_01_ASEReadCounter.table","NW_015090842.1:6314827",3,4,1
"ARY1","s1650_F_GON_01_ASEReadCounter.table","NW_015090842.1:6314859",6,11,5
"ARY1","s1650_F_GON_01_ASEReadCounter.table","NW_015090842.1:6314886",6,13,7
"ARY1","s1650_F_GON_01_ASEReadCounter.table","NW_015090842.1:6315022",5,11,6
"ARY1","s1650_F_GON_01_ASEReadCounter.table","NW_015090842.1:6315026",5,10,5
"ARY1","s1650_F_GON_01_ASEReadCounter.table","NW_015090842.1:6315043",5,10,5
"ARY1","s1650_F_GON_01_ASEReadCounter.table","NW_015090842.1:6315065",5,10,5
"ARY1","s1650_F_GON_01_ASEReadCounter.table","NW_015090842.1:6315409",3,6,3
"ARY1","s1650_F_GON_01_ASEReadCounter.table","NW_015090842.1:6315479",2,6,4
"ARY1","s1650_F_GON_01_ASEReadCounter.table","NW_015090842.1:6318342",6,8,2
"ARY1","s1650_F_GON_01_ASEReadCounter.table","NW_015090842.1:6318427",2,6,4
"ARY1","s1650_F_GON_01_ASEReadCounter.table","NW_015090842.1:6318603",6,8,2
"ARY1","s1650_F_GON_01_ASEReadCounter.table","NW_015090842.1:6318708",4,6,2
"ARY1","s1650_F_GON_01_ASEReadCounter.table","NW_015090842.1:6318858",5,7,2
"ARY1","s1650_F_GON_01_ASEReadCounter.table","NW_015090842.1:6318952",9,13,4
"MPHOSPH6","s1650_F_GON_01_ASEReadCounter.table","NW_015090842.1:6324063",26,62,36
"MPHOSPH6","s1650_F_GON_01_ASEReadCounter.table","NW_015090842.1:6324174",46,110,64
"MPHOSPH6","s1650_F_GON_01_ASEReadCounter.table","NW_015090842.1:6324270",74,149,75
"MPHOSPH6","s1650_F_GON_01_ASEReadCounter.table","NW_015090842.1:6324762",91,172,81
"MPHOSPH6","s1650_F_GON_01_ASEReadCounter.table","NW_015090842.1:6324780",85,162,77
"MPHOSPH6","s1650_F_GON_01_ASEReadCounter.table","NW_015090842.1:6324902",92,192,100
"MPHOSPH6","s1650_F_GON_01_ASEReadCounter.table","NW_015090842.1:6325066",77,176,99
"MPHOSPH6","s1650_F_GON_01_ASEReadCounter.table","NW_015090842.1:6325089",98,202,104
"MPHOSPH6","s1650_F_GON_01_ASEReadCounter.table","NW_015090842.1:6325877",125,273,148
"MPHOSPH6","s1650_F_GON_01_ASEReadCounter.table","NW_015090842.1:6326976",86,209,123
"CDH13","s1650_F_GON_01_ASEReadCounter.table","NW_015090842.1:6662283",10,13,3
"CDH13","s1650_F_GON_01_ASEReadCounter.table","NW_015090842.1:6693665",5,11,6
"CDH13","s1650_F_GON_01_ASEReadCounter.table","NW_015090842.1:6693697",4,11,7
"CDH13","s1650_F_GON_01_ASEReadCounter.table","NW_015090842.1:6693712",6,13,7
"CDH13","s1650_F_GON_01_ASEReadCounter.table","NW_015090842.1:6693723",5,11,6
"CDH13","s1650_F_GON_01_ASEReadCounter.table","NW_015090842.1:6693738",6,13,7
"CDH13","s1650_F_GON_01_ASEReadCounter.table","NW_015090842.1:6823730",9,18,9
"CDH13","s1650_F_GON_01_ASEReadCounter.table","NW_015090842.1:6889713",12,23,11
"CDH13","s1650_F_GON_01_ASEReadCounter.table","NW_015090842.1:6955167",9,15,6
"MLYCD","s1650_F_GON_01_ASEReadCounter.table","NW_015090842.1:7150054",26,59,33
"MLYCD","s1650_F_GON_01_ASEReadCounter.table","NW_015090842.1:7150131",40,98,58
"MLYCD","s1650_F_GON_01_ASEReadCounter.table","NW_015090842.1:7150585",23,62,39
"MLYCD","s1650_F_GON_01_ASEReadCounter.table","NW_015090842.1:7150686",15,50,35
"MLYCD","s1650_F_GON_01_ASEReadCounter.table","NW_015090842.1:7150696",18,57,39
"MLYCD","s1650_F_GON_01_ASEReadCounter.table","NW_015090842.1:7150869",14,55,41
"MLYCD","s1650_F_GON_01_ASEReadCounter.table","NW_015090842.1:7151100",36,76,40
"MLYCD","s1650_F_GON_01_ASEReadCounter.table","NW_015090842.1:7151127",41,84,43
"MLYCD","s1650_F_GON_01_ASEReadCounter.table","NW_015090842.1:7157538",32,87,55
"MLYCD","s1650_F_GON_01_ASEReadCounter.table","NW_015090842.1:7167662",14,32,18
"MLYCD","s1650_F_GON_01_ASEReadCounter.table","NW_015090842.1:7167675",11,28,17
"MLYCD","s1650_F_GON_01_ASEReadCounter.table","NW_015090842.1:7167710",13,32,19
"MLYCD","s1650_F_GON_01_ASEReadCounter.table","NW_015090842.1:7167781",12,27,15
"MLYCD","s1650_F_GON_01_ASEReadCounter.table","NW_015090842.1:7167803",11,23,12
"MLYCD","s1650_F_GON_01_ASEReadCounter.table","NW_015090842.1:7167812",11,22,11
"MLYCD","s1650_F_GON_01_ASEReadCounter.table","NW_015090842.1:7167845",14,27,13
"MLYCD","s1650_F_GON_01_ASEReadCounter.table","NW_015090842.1:7167862",13,28,15
"MLYCD","s1650_F_GON_01_ASEReadCounter.table","NW_015090842.1:7167929",8,24,16
"MLYCD","s1650_F_GON_01_ASEReadCounter.table","NW_015090842.1:7167995",9,21,12
"MLYCD","s1650_F_GON_01_ASEReadCounter.table","NW_015090842.1:7168005",9,19,10
"MLYCD","s1650_F_GON_01_ASEReadCounter.table","NW_015090842.1:7168037",8,18,10
"HSBP1","s1650_F_GON_01_ASEReadCounter.table","NW_015090842.1:7245192",145,258,113
"HSBP1","s1650_F_GON_01_ASEReadCounter.table","NW_015090842.1:7245226",147,295,148
"HSBP1","s1650_F_GON_01_ASEReadCounter.table","NW_015090842.1:7245257",115,244,129
"HSBP1","s1650_F_GON_01_ASEReadCounter.table","NW_015090842.1:7245296",109,252,143
"HSBP1","s1650_F_GON_01_ASEReadCounter.table","NW_015090842.1:7245389",167,317,150
"HSBP1","s1650_F_GON_01_ASEReadCounter.table","NW_015090842.1:7245400",166,295,129
"HSBP1","s1650_F_GON_01_ASEReadCounter.table","NW_015090842.1:7245445",153,285,132
"HSBP1","s1650_F_GON_01_ASEReadCounter.table","NW_015090842.1:7245495",137,270,133
"HSBP1","s1650_F_GON_01_ASEReadCounter.table","NW_015090842.1:7245733",96,194,98
"HSBP1","s1650_F_GON_01_ASEReadCounter.table","NW_015090842.1:7245771",113,191,78
"HSBP1","s1650_F_GON_01_ASEReadCounter.table","NW_015090842.1:7245813",112,179,67
"HSBP1","s1650_F_GON_01_ASEReadCounter.table","NW_015090842.1:7245926",137,229,92
"HSBP1","s1650_F_GON_01_ASEReadCounter.table","NW_015090842.1:7245927",139,230,91
"HSBP1","s1650_F_GON_01_ASEReadCounter.table","NW_015090842.1:7245933",140,230,90
"HSBP1","s1650_F_GON_01_ASEReadCounter.table","NW_015090842.1:7246002",109,193,84
"HSBP1","s1650_F_GON_01_ASEReadCounter.table","NW_015090842.1:7246094",115,209,94
"HSBP1","s1650_F_GON_01_ASEReadCounter.table","NW_015090842.1:7246167",126,233,107
"HSBP1","s1650_F_GON_01_ASEReadCounter.table","NW_015090842.1:7246183",126,238,112
"HSBP1","s1650_F_GON_01_ASEReadCounter.table","NW_015090842.1:7247285",57,97,40
"HSBP1","s1650_F_GON_01_ASEReadCounter.table","NW_015090842.1:7247651",491,1096,605
"HSBP1","s1650_F_GON_01_ASEReadCounter.table","NW_015090842.1:7247657",491,1106,615
"HSBP1","s1650_F_GON_01_ASEReadCounter.table","NW_015090842.1:7248520",413,816,403
"HSBP1","s1650_F_GON_01_ASEReadCounter.table","NW_015090842.1:7248535",351,690,339
"KCNG4","s1650_F_GON_01_ASEReadCounter.table","NW_015090842.1:7282481",4,30,26
"KCNG4","s1650_F_GON_01_ASEReadCounter.table","NW_015090842.1:7282500",5,28,23
"KCNG4","s1650_F_GON_01_ASEReadCounter.table","NW_015090842.1:7282542",8,34,26
"KCNG4","s1650_F_GON_01_ASEReadCounter.table","NW_015090842.1:7282579",9,30,21
"KCNG4","s1650_F_GON_01_ASEReadCounter.table","NW_015090842.1:7282630",9,32,23
"KCNG4","s1650_F_GON_01_ASEReadCounter.table","NW_015090842.1:7283056",4,19,15
"KCNG4","s1650_F_GON_01_ASEReadCounter.table","NW_015090842.1:7283245",9,27,18
"KCNG4","s1650_F_GON_01_ASEReadCounter.table","NW_015090842.1:7301195",7,18,11
"KCNG4","s1650_F_GON_01_ASEReadCounter.table","NW_015090842.1:7301227",6,18,12
"KCNG4","s1650_F_GON_01_ASEReadCounter.table","NW_015090842.1:7301240",6,19,13
"KCNG4","s1650_F_GON_01_ASEReadCounter.table","NW_015090842.1:7301413",5,16,11
"WFDC1","s1650_F_GON_01_ASEReadCounter.table","NW_015090842.1:7366517",2,5,3
"WFDC1","s1650_F_GON_01_ASEReadCounter.table","NW_015090842.1:7373367",4,5,1
"WFDC1","s1650_F_GON_01_ASEReadCounter.table","NW_015090842.1:7375828",3,5,2
"WFDC1","s1650_F_GON_01_ASEReadCounter.table","NW_015090842.1:7378036",4,10,6
"WFDC1","s1650_F_GON_01_ASEReadCounter.table","NW_015090842.1:7379125",5,10,5
"WFDC1","s1650_F_GON_01_ASEReadCounter.table","NW_015090842.1:7379451",5,10,5
"WFDC1","s1650_F_GON_01_ASEReadCounter.table","NW_015090842.1:7379471",6,11,5
"WFDC1","s1650_F_GON_01_ASEReadCounter.table","NW_015090842.1:7379576",3,8,5
"WFDC1","s1650_F_GON_01_ASEReadCounter.table","NW_015090842.1:7379596",3,8,5
"WFDC1","s1650_F_GON_01_ASEReadCounter.table","NW_015090842.1:7379605",3,8,5
"WFDC1","s1650_F_GON_01_ASEReadCounter.table","NW_015090842.1:7379626",0,6,6
"WFDC1","s1650_F_GON_01_ASEReadCounter.table","NW_015090842.1:7379631",0,7,7
"WFDC1","s1650_F_GON_01_ASEReadCounter.table","NW_015090842.1:7379632",0,6,6
"WFDC1","s1650_F_GON_01_ASEReadCounter.table","NW_015090842.1:7379652",1,6,5
"WFDC1","s1650_F_GON_01_ASEReadCounter.table","NW_015090842.1:7379669",1,6,5
"WFDC1","s1650_F_GON_01_ASEReadCounter.table","NW_015090842.1:7379674",1,5,4
"WFDC1","s1650_F_GON_01_ASEReadCounter.table","NW_015090842.1:7379719",1,6,5
"WFDC1","s1650_F_GON_01_ASEReadCounter.table","NW_015090842.1:7379735",0,4,4
"WFDC1","s1650_F_GON_01_ASEReadCounter.table","NW_015090842.1:7379739",0,4,4
"WFDC1","s1650_F_GON_01_ASEReadCounter.table","NW_015090842.1:7379821",3,9,6
"WFDC1","s1650_F_GON_01_ASEReadCounter.table","NW_015090842.1:7379840",3,8,5
"WFDC1","s1650_F_GON_01_ASEReadCounter.table","NW_015090842.1:7379933",1,10,9
"WFDC1","s1650_F_GON_01_ASEReadCounter.table","NW_015090842.1:7379935",1,10,9
"WFDC1","s1650_F_GON_01_ASEReadCounter.table","NW_015090842.1:7379983",2,9,7
"WFDC1","s1650_F_GON_01_ASEReadCounter.table","NW_015090842.1:7380060",2,9,7
"WFDC1","s1650_F_GON_01_ASEReadCounter.table","NW_015090842.1:7380136",2,4,2
"WFDC1","s1650_F_GON_01_ASEReadCounter.table","NW_015090842.1:7380150",2,4,2
"WFDC1","s1650_F_GON_01_ASEReadCounter.table","NW_015090842.1:7380164",3,5,2
"WFDC1","s1650_F_GON_01_ASEReadCounter.table","NW_015090842.1:7380237",7,13,6
"WFDC1","s1650_F_GON_01_ASEReadCounter.table","NW_015090842.1:7380261",6,14,8
"WFDC1","s1650_F_GON_01_ASEReadCounter.table","NW_015090842.1:7380322",2,12,10
"WFDC1","s1650_F_GON_01_ASEReadCounter.table","NW_015090842.1:7380491",3,8,5
"WFDC1","s1650_F_GON_01_ASEReadCounter.table","NW_015090842.1:7380567",4,7,3
"WFDC1","s1650_F_GON_01_ASEReadCounter.table","NW_015090842.1:7380672",4,12,8
"WFDC1","s1650_F_GON_01_ASEReadCounter.table","NW_015090842.1:7380721",8,16,8
"WFDC1","s1650_F_GON_01_ASEReadCounter.table","NW_015090842.1:7380743",8,17,9
"WFDC1","s1650_F_GON_01_ASEReadCounter.table","NW_015090842.1:7380852",4,11,7
"WFDC1","s1650_F_GON_01_ASEReadCounter.table","NW_015090842.1:7380878",5,12,7
"WFDC1","s1650_F_GON_01_ASEReadCounter.table","NW_015090842.1:7381081",6,16,10
"WFDC1","s1650_F_GON_01_ASEReadCounter.table","NW_015090842.1:7381127",5,15,10
"WFDC1","s1650_F_GON_01_ASEReadCounter.table","NW_015090842.1:7381195",5,14,9
"WFDC1","s1650_F_GON_01_ASEReadCounter.table","NW_015090842.1:7381253",5,14,9
"WFDC1","s1650_F_GON_01_ASEReadCounter.table","NW_015090842.1:7381378",2,13,11
"WFDC1","s1650_F_GON_01_ASEReadCounter.table","NW_015090842.1:7381433",5,13,8
"WFDC1","s1650_F_GON_01_ASEReadCounter.table","NW_015090842.1:7381434",5,13,8
"WFDC1","s1650_F_GON_01_ASEReadCounter.table","NW_015090842.1:7381442",5,13,8
"WFDC1","s1650_F_GON_01_ASEReadCounter.table","NW_015090842.1:7381517",3,7,4
"WFDC1","s1650_F_GON_01_ASEReadCounter.table","NW_015090842.1:7381520",3,8,5
"WFDC1","s1650_F_GON_01_ASEReadCounter.table","NW_015090842.1:7381677",2,6,4
"WFDC1","s1650_F_GON_01_ASEReadCounter.table","NW_015090842.1:7381709",1,5,4
"ATP2C2","s1650_F_GON_01_ASEReadCounter.table","NW_015090842.1:7395230",0,1,1
"ATP2C2","s1650_F_GON_01_ASEReadCounter.table","NW_015090842.1:7395366",0,6,6
"ATP2C2","s1650_F_GON_01_ASEReadCounter.table","NW_015090842.1:7396756",0,2,2
"ATP2C2","s1650_F_GON_01_ASEReadCounter.table","NW_015090842.1:7397049",0,10,10
"ATP2C2","s1650_F_GON_01_ASEReadCounter.table","NW_015090842.1:7398395",0,7,7
"ATP2C2","s1650_F_GON_01_ASEReadCounter.table","NW_015090842.1:7399774",0,4,4
"ATP2C2","s1650_F_GON_01_ASEReadCounter.table","NW_015090842.1:7402554",1,12,11
"ATP2C2","s1650_F_GON_01_ASEReadCounter.table","NW_015090842.1:7402578",1,9,8
"ATP2C2","s1650_F_GON_01_ASEReadCounter.table","NW_015090842.1:7405621",0,6,6
"ATP2C2","s1650_F_GON_01_ASEReadCounter.table","NW_015090842.1:7413855",0,1,1
"ATP2C2","s1650_F_GON_01_ASEReadCounter.table","NW_015090842.1:7413869",0,1,1
"ATP2C2","s1650_F_GON_01_ASEReadCounter.table","NW_015090842.1:7413875",0,1,1
"TLDC1","s1650_F_GON_01_ASEReadCounter.table","NW_015090842.1:7421137",29,58,29
"TLDC1","s1650_F_GON_01_ASEReadCounter.table","NW_015090842.1:7421155",25,60,35
"TLDC1","s1650_F_GON_01_ASEReadCounter.table","NW_015090842.1:7421218",38,67,29
"TLDC1","s1650_F_GON_01_ASEReadCounter.table","NW_015090842.1:7421399",34,52,18
"TLDC1","s1650_F_GON_01_ASEReadCounter.table","NW_015090842.1:7421402",34,51,17
"TLDC1","s1650_F_GON_01_ASEReadCounter.table","NW_015090842.1:7421528",41,63,22
"TLDC1","s1650_F_GON_01_ASEReadCounter.table","NW_015090842.1:7421532",40,63,23
"TLDC1","s1650_F_GON_01_ASEReadCounter.table","NW_015090842.1:7421621",40,59,19
"TLDC1","s1650_F_GON_01_ASEReadCounter.table","NW_015090842.1:7421647",34,48,14
"TLDC1","s1650_F_GON_01_ASEReadCounter.table","NW_015090842.1:7421657",32,48,16
"TLDC1","s1650_F_GON_01_ASEReadCounter.table","NW_015090842.1:7421693",33,57,24
"TLDC1","s1650_F_GON_01_ASEReadCounter.table","NW_015090842.1:7421796",25,46,21
"TLDC1","s1650_F_GON_01_ASEReadCounter.table","NW_015090842.1:7421810",26,52,26
"TLDC1","s1650_F_GON_01_ASEReadCounter.table","NW_015090842.1:7421833",21,49,28
"TLDC1","s1650_F_GON_01_ASEReadCounter.table","NW_015090842.1:7421879",36,66,30
"TLDC1","s1650_F_GON_01_ASEReadCounter.table","NW_015090842.1:7421914",35,60,25
"TLDC1","s1650_F_GON_01_ASEReadCounter.table","NW_015090842.1:7421969",25,38,13
"TLDC1","s1650_F_GON_01_ASEReadCounter.table","NW_015090842.1:7422015",26,39,13
"TLDC1","s1650_F_GON_01_ASEReadCounter.table","NW_015090842.1:7422042",35,56,21
"TLDC1","s1650_F_GON_01_ASEReadCounter.table","NW_015090842.1:7422230",39,75,36
"TLDC1","s1650_F_GON_01_ASEReadCounter.table","NW_015090842.1:7423349",37,56,19
"TLDC1","s1650_F_GON_01_ASEReadCounter.table","NW_015090842.1:7423362",31,46,15
"TLDC1","s1650_F_GON_01_ASEReadCounter.table","NW_015090842.1:7426091",38,56,18
"TLDC1","s1650_F_GON_01_ASEReadCounter.table","NW_015090842.1:7426485",31,56,25
"TLDC1","s1650_F_GON_01_ASEReadCounter.table","NW_015090842.1:7427211",39,59,20
"TLDC1","s1650_F_GON_01_ASEReadCounter.table","NW_015090842.1:7428179",25,41,16
"COTL1","s1650_F_GON_01_ASEReadCounter.table","NW_015090842.1:7490744",4,15,11
"COTL1","s1650_F_GON_01_ASEReadCounter.table","NW_015090842.1:7491051",11,24,13
"COTL1","s1650_F_GON_01_ASEReadCounter.table","NW_015090842.1:7491124",9,18,9
"COTL1","s1650_F_GON_01_ASEReadCounter.table","NW_015090842.1:7491418",10,24,14
"COTL1","s1650_F_GON_01_ASEReadCounter.table","NW_015090842.1:7491539",8,13,5
"COTL1","s1650_F_GON_01_ASEReadCounter.table","NW_015090842.1:7491585",7,17,10
"COTL1","s1650_F_GON_01_ASEReadCounter.table","NW_015090842.1:7491586",7,18,11
"COTL1","s1650_F_GON_01_ASEReadCounter.table","NW_015090842.1:7491646",12,24,12
"COTL1","s1650_F_GON_01_ASEReadCounter.table","NW_015090842.1:7491747",13,20,7
"COTL1","s1650_F_GON_01_ASEReadCounter.table","NW_015090842.1:7491803",15,23,8
"COTL1","s1650_F_GON_01_ASEReadCounter.table","NW_015090842.1:7506078",0,3,3
"COTL1","s1650_F_GON_01_ASEReadCounter.table","NW_015090842.1:7507551",2,2,0
"COTL1","s1650_F_GON_01_ASEReadCounter.table","NW_015090842.1:7507563",1,1,0
"COTL1","s1650_F_GON_01_ASEReadCounter.table","NW_015090842.1:7510900",1,2,1
"COTL1","s1650_F_GON_01_ASEReadCounter.table","NW_015090842.1:7513196",7,12,5
"COTL1","s1650_F_GON_01_ASEReadCounter.table","NW_015090842.1:7513223",9,14,5
"COTL1","s1650_F_GON_01_ASEReadCounter.table","NW_015090842.1:7513239",7,12,5
"KLHL36","s1650_F_GON_01_ASEReadCounter.table","NW_015090842.1:7514700",4,11,7
"KLHL36","s1650_F_GON_01_ASEReadCounter.table","NW_015090842.1:7519691",0,2,2
"KLHL36","s1650_F_GON_01_ASEReadCounter.table","NW_015090842.1:7519696",0,2,2
"KLHL36","s1650_F_GON_01_ASEReadCounter.table","NW_015090842.1:7526160",6,7,1
"KLHL36","s1650_F_GON_01_ASEReadCounter.table","NW_015090842.1:7526469",0,3,3
"KLHL36","s1650_F_GON_01_ASEReadCounter.table","NW_015090842.1:7526587",6,9,3
"KLHL36","s1650_F_GON_01_ASEReadCounter.table","NW_015090842.1:7526997",3,5,2
"KLHL36","s1650_F_GON_01_ASEReadCounter.table","NW_015090842.1:7527142",3,5,2
"KLHL36","s1650_F_GON_01_ASEReadCounter.table","NW_015090842.1:7535174",1,7,6
"KLHL36","s1650_F_GON_01_ASEReadCounter.table","NW_015090842.1:7535384",4,8,4
"KLHL36","s1650_F_GON_01_ASEReadCounter.table","NW_015090842.1:7535420",5,13,8
"KLHL36","s1650_F_GON_01_ASEReadCounter.table","NW_015090842.1:7535545",5,8,3
"KLHL36","s1650_F_GON_01_ASEReadCounter.table","NW_015090842.1:7535829",4,7,3
"KLHL36","s1650_F_GON_01_ASEReadCounter.table","NW_015090842.1:7535977",7,15,8
"KLHL36","s1650_F_GON_01_ASEReadCounter.table","NW_015090842.1:7536010",7,14,7
"KLHL36","s1650_F_GON_01_ASEReadCounter.table","NW_015090842.1:7536051",5,15,10
"KLHL36","s1650_F_GON_01_ASEReadCounter.table","NW_015090842.1:7536096",7,17,10
"KLHL36","s1650_F_GON_01_ASEReadCounter.table","NW_015090842.1:7536135",6,14,8
"KLHL36","s1650_F_GON_01_ASEReadCounter.table","NW_015090842.1:7536136",6,14,8
"KLHL36","s1650_F_GON_01_ASEReadCounter.table","NW_015090842.1:7536160",5,12,7
"KLHL36","s1650_F_GON_01_ASEReadCounter.table","NW_015090842.1:7536336",5,9,4
"KLHL36","s1650_F_GON_01_ASEReadCounter.table","NW_015090842.1:7536352",4,8,4
"KLHL36","s1650_F_GON_01_ASEReadCounter.table","NW_015090842.1:7536412",3,7,4
"KLHL36","s1650_F_GON_01_ASEReadCounter.table","NW_015090842.1:7536418",3,6,3
"KLHL36","s1650_F_GON_01_ASEReadCounter.table","NW_015090842.1:7536465",7,9,2
"KLHL36","s1650_F_GON_01_ASEReadCounter.table","NW_015090842.1:7536466",7,9,2
"KLHL36","s1650_F_GON_01_ASEReadCounter.table","NW_015090842.1:7536553",10,20,10
"KLHL36","s1650_F_GON_01_ASEReadCounter.table","NW_015090842.1:7536698",6,17,11
"KLHL36","s1650_F_GON_01_ASEReadCounter.table","NW_015090842.1:7536713",3,16,13
"KLHL36","s1650_F_GON_01_ASEReadCounter.table","NW_015090842.1:7536720",8,13,5
"KLHL36","s1650_F_GON_01_ASEReadCounter.table","NW_015090842.1:7536791",7,12,5
"KLHL36","s1650_F_GON_01_ASEReadCounter.table","NW_015090842.1:7536849",10,18,8
"KLHL36","s1650_F_GON_01_ASEReadCounter.table","NW_015090842.1:7536872",10,20,10
"KLHL36","s1650_F_GON_01_ASEReadCounter.table","NW_015090842.1:7536878",10,20,10
"KLHL36","s1650_F_GON_01_ASEReadCounter.table","NW_015090842.1:7536916",5,15,10
"KLHL36","s1650_F_GON_01_ASEReadCounter.table","NW_015090842.1:7536927",6,21,15
"KLHL36","s1650_F_GON_01_ASEReadCounter.table","NW_015090842.1:7537315",9,16,7
"KLHL36","s1650_F_GON_01_ASEReadCounter.table","NW_015090842.1:7537352",7,13,6
"KLHL36","s1650_F_GON_01_ASEReadCounter.table","NW_015090842.1:7537631",8,16,8
"KLHL36","s1650_F_GON_01_ASEReadCounter.table","NW_015090842.1:7537830",9,23,14
"KLHL36","s1650_F_GON_01_ASEReadCounter.table","NW_015090842.1:7537838",6,20,14
"KLHL36","s1650_F_GON_01_ASEReadCounter.table","NW_015090842.1:7538153",4,19,15
"KLHL36","s1650_F_GON_01_ASEReadCounter.table","NW_015090842.1:7538256",5,20,15
"KLHL36","s1650_F_GON_01_ASEReadCounter.table","NW_015090842.1:7538265",5,20,15
"KLHL36","s1650_F_GON_01_ASEReadCounter.table","NW_015090842.1:7538300",5,23,18
"USP10","s1650_F_GON_01_ASEReadCounter.table","NW_015090842.1:7563972",4,9,5
"USP10","s1650_F_GON_01_ASEReadCounter.table","NW_015090842.1:7571816",13,29,16
"USP10","s1650_F_GON_01_ASEReadCounter.table","NW_015090842.1:7571993",17,27,10
"USP10","s1650_F_GON_01_ASEReadCounter.table","NW_015090842.1:7572580",24,42,18
"USP10","s1650_F_GON_01_ASEReadCounter.table","NW_015090842.1:7587372",21,63,42
"CRISPLD2","s1650_F_GON_01_ASEReadCounter.table","NW_015090842.1:7604605",2,2,0
"CRISPLD2","s1650_F_GON_01_ASEReadCounter.table","NW_015090842.1:7609844",2,2,0
"CRISPLD2","s1650_F_GON_01_ASEReadCounter.table","NW_015090842.1:7609845",2,2,0
"CRISPLD2","s1650_F_GON_01_ASEReadCounter.table","NW_015090842.1:7609883",4,5,1
"CRISPLD2","s1650_F_GON_01_ASEReadCounter.table","NW_015090842.1:7610084",7,7,0
"CRISPLD2","s1650_F_GON_01_ASEReadCounter.table","NW_015090842.1:7617757",5,5,0
"CRISPLD2","s1650_F_GON_01_ASEReadCounter.table","NW_015090842.1:7617781",5,5,0
"CRISPLD2","s1650_F_GON_01_ASEReadCounter.table","NW_015090842.1:7617790",4,4,0
"CRISPLD2","s1650_F_GON_01_ASEReadCounter.table","NW_015090842.1:7621452",3,4,1
"CRISPLD2","s1650_F_GON_01_ASEReadCounter.table","NW_015090842.1:7625451",6,7,1
"CRISPLD2","s1650_F_GON_01_ASEReadCounter.table","NW_015090842.1:7626214",7,9,2
"CRISPLD2","s1650_F_GON_01_ASEReadCounter.table","NW_015090842.1:7630784",7,8,1
"CRISPLD2","s1650_F_GON_01_ASEReadCounter.table","NW_015090842.1:7630823",4,4,0
"CRISPLD2","s1650_F_GON_01_ASEReadCounter.table","NW_015090842.1:7633172",4,6,2
"CRISPLD2","s1650_F_GON_01_ASEReadCounter.table","NW_015090842.1:7633326",3,5,2
"CRISPLD2","s1650_F_GON_01_ASEReadCounter.table","NW_015090842.1:7633336",5,7,2
"CRISPLD2","s1650_F_GON_01_ASEReadCounter.table","NW_015090842.1:7633381",3,5,2
"CRISPLD2","s1650_F_GON_01_ASEReadCounter.table","NW_015090842.1:7633388",4,6,2
"CRISPLD2","s1650_F_GON_01_ASEReadCounter.table","NW_015090842.1:7633400",5,6,1
"CRISPLD2","s1650_F_GON_01_ASEReadCounter.table","NW_015090842.1:7633486",5,6,1
"CRISPLD2","s1650_F_GON_01_ASEReadCounter.table","NW_015090842.1:7633503",4,5,1
"CRISPLD2","s1650_F_GON_01_ASEReadCounter.table","NW_015090842.1:7633504",4,5,1
"CRISPLD2","s1650_F_GON_01_ASEReadCounter.table","NW_015090842.1:7633557",7,8,1
"CRISPLD2","s1650_F_GON_01_ASEReadCounter.table","NW_015090842.1:7633571",7,8,1
"CRISPLD2","s1650_F_GON_01_ASEReadCounter.table","NW_015090842.1:7633588",6,6,0
"CRISPLD2","s1650_F_GON_01_ASEReadCounter.table","NW_015090842.1:7633617",8,8,0
"CRISPLD2","s1650_F_GON_01_ASEReadCounter.table","NW_015090842.1:7633695",7,7,0
"CRISPLD2","s1650_F_GON_01_ASEReadCounter.table","NW_015090842.1:7633721",5,6,1
"CRISPLD2","s1650_F_GON_01_ASEReadCounter.table","NW_015090842.1:7633888",6,6,0
"CRISPLD2","s1650_F_GON_01_ASEReadCounter.table","NW_015090842.1:7633910",5,5,0
"CRISPLD2","s1650_F_GON_01_ASEReadCounter.table","NW_015090842.1:7634142",6,7,1
"CRISPLD2","s1650_F_GON_01_ASEReadCounter.table","NW_015090842.1:7634417",8,9,1
"CRISPLD2","s1650_F_GON_01_ASEReadCounter.table","NW_015090842.1:7634825",3,4,1
"CRISPLD2","s1650_F_GON_01_ASEReadCounter.table","NW_015090842.1:7634852",6,7,1
"CRISPLD2","s1650_F_GON_01_ASEReadCounter.table","NW_015090842.1:7635009",8,10,2
"CRISPLD2","s1650_F_GON_01_ASEReadCounter.table","NW_015090842.1:7635208",13,13,0
"CRISPLD2","s1650_F_GON_01_ASEReadCounter.table","NW_015090842.1:7635373",5,6,1
"CRISPLD2","s1650_F_GON_01_ASEReadCounter.table","NW_015090842.1:7635525",7,7,0
"CRISPLD2","s1650_F_GON_01_ASEReadCounter.table","NW_015090842.1:7635583",5,6,1
"CRISPLD2","s1650_F_GON_01_ASEReadCounter.table","NW_015090842.1:7635924",5,7,2
"LOC106888312","s1650_F_GON_01_ASEReadCounter.table","NW_015090842.1:7713031",1,3,2
"LOC106888312","s1650_F_GON_01_ASEReadCounter.table","NW_015090842.1:7727001",8,15,7
"LOC106888312","s1650_F_GON_01_ASEReadCounter.table","NW_015090842.1:7727036",5,10,5
"LOC106888312","s1650_F_GON_01_ASEReadCounter.table","NW_015090842.1:7727072",4,11,7
"LOC106888312","s1650_F_GON_01_ASEReadCounter.table","NW_015090842.1:7727961",1,6,5
"LOC106888312","s1650_F_GON_01_ASEReadCounter.table","NW_015090842.1:7731961",1,7,6
"LOC106888312","s1650_F_GON_01_ASEReadCounter.table","NW_015090842.1:7732244",8,17,9
"LOC106888312","s1650_F_GON_01_ASEReadCounter.table","NW_015090842.1:7732443",4,5,1
"LOC106888312","s1650_F_GON_01_ASEReadCounter.table","NW_015090842.1:7732444",4,5,1
"LOC106888312","s1650_F_GON_01_ASEReadCounter.table","NW_015090842.1:7732538",2,3,1
"LOC106888312","s1650_F_GON_01_ASEReadCounter.table","NW_015090842.1:7732548",2,4,2
"LOC106888312","s1650_F_GON_01_ASEReadCounter.table","NW_015090842.1:7732576",2,6,4
"LOC106888312","s1650_F_GON_01_ASEReadCounter.table","NW_015090842.1:7732580",2,6,4
"LOC106888312","s1650_F_GON_01_ASEReadCounter.table","NW_015090842.1:7732629",1,5,4
"LOC106888312","s1650_F_GON_01_ASEReadCounter.table","NW_015090842.1:7732630",1,5,4
"LOC106888312","s1650_F_GON_01_ASEReadCounter.table","NW_015090842.1:7732637",1,5,4
"LOC106888312","s1650_F_GON_01_ASEReadCounter.table","NW_015090842.1:7732682",1,2,1
"LOC106888312","s1650_F_GON_01_ASEReadCounter.table","NW_015090842.1:7732696",1,2,1
"LOC106888312","s1650_F_GON_01_ASEReadCounter.table","NW_015090842.1:7732709",1,3,2
"LOC106888312","s1650_F_GON_01_ASEReadCounter.table","NW_015090842.1:7732718",1,3,2
"LOC106888312","s1650_F_GON_01_ASEReadCounter.table","NW_015090842.1:7732739",1,3,2
"LOC106888312","s1650_F_GON_01_ASEReadCounter.table","NW_015090842.1:7732743",0,2,2
"LOC106888312","s1650_F_GON_01_ASEReadCounter.table","NW_015090842.1:7732744",0,2,2
"LOC106888312","s1650_F_GON_01_ASEReadCounter.table","NW_015090842.1:7732756",0,2,2
"LOC106888312","s1650_F_GON_01_ASEReadCounter.table","NW_015090842.1:7732757",0,2,2
"LOC106888312","s1650_F_GON_01_ASEReadCounter.table","NW_015090842.1:7732782",0,2,2
"LOC106888312","s1650_F_GON_01_ASEReadCounter.table","NW_015090842.1:7732796",0,2,2
"LOC106888312","s1650_F_GON_01_ASEReadCounter.table","NW_015090842.1:7732860",0,1,1
"LOC106888312","s1650_F_GON_01_ASEReadCounter.table","NW_015090842.1:7732861",0,1,1
"LOC106888312","s1650_F_GON_01_ASEReadCounter.table","NW_015090842.1:7732918",0,1,1
"LOC106888312","s1650_F_GON_01_ASEReadCounter.table","NW_015090842.1:7732997",0,2,2
"LOC106888312","s1650_F_GON_01_ASEReadCounter.table","NW_015090842.1:7733011",0,2,2
"LOC106888312","s1650_F_GON_01_ASEReadCounter.table","NW_015090842.1:7733046",0,1,1
"LOC106888312","s1650_F_GON_01_ASEReadCounter.table","NW_015090842.1:7733068",0,1,1
"LOC106888312","s1650_F_GON_01_ASEReadCounter.table","NW_015090842.1:7733077",0,2,2
"LOC106888312","s1650_F_GON_01_ASEReadCounter.table","NW_015090842.1:7733096",0,3,3
"LOC106888312","s1650_F_GON_01_ASEReadCounter.table","NW_015090842.1:7733142",0,5,5
"LOC106888312","s1650_F_GON_01_ASEReadCounter.table","NW_015090842.1:7733196",0,5,5
"LOC106888312","s1650_F_GON_01_ASEReadCounter.table","NW_015090842.1:7733299",0,3,3
"LOC106888312","s1650_F_GON_01_ASEReadCounter.table","NW_015090842.1:7733470",1,2,1
"LOC106888312","s1650_F_GON_01_ASEReadCounter.table","NW_015090842.1:7733471",1,2,1
"LOC106888312","s1650_F_GON_01_ASEReadCounter.table","NW_015090842.1:7733472",1,2,1
"LOC106888312","s1650_F_GON_01_ASEReadCounter.table","NW_015090842.1:7733507",1,3,2
"LOC106888312","s1650_F_GON_01_ASEReadCounter.table","NW_015090842.1:7733508",1,3,2
"LOC106888312","s1650_F_GON_01_ASEReadCounter.table","NW_015090842.1:7733518",1,3,2
"LOC106888312","s1650_F_GON_01_ASEReadCounter.table","NW_015090842.1:7733609",1,2,1
"LOC106888312","s1650_F_GON_01_ASEReadCounter.table","NW_015090842.1:7733631",1,2,1
"LOC106888312","s1650_F_GON_01_ASEReadCounter.table","NW_015090842.1:7733674",1,3,2
"ZDHHC7","s1650_F_GON_01_ASEReadCounter.table","NW_015090842.1:7737199",10,25,15
"ZDHHC7","s1650_F_GON_01_ASEReadCounter.table","NW_015090842.1:7737332",3,14,11
"ZDHHC7","s1650_F_GON_01_ASEReadCounter.table","NW_015090842.1:7737553",21,30,9
"ZDHHC7","s1650_F_GON_01_ASEReadCounter.table","NW_015090842.1:7737920",10,23,13
"ZDHHC7","s1650_F_GON_01_ASEReadCounter.table","NW_015090842.1:7737953",7,21,14
"ZDHHC7","s1650_F_GON_01_ASEReadCounter.table","NW_015090842.1:7737987",9,21,12
"ZDHHC7","s1650_F_GON_01_ASEReadCounter.table","NW_015090842.1:7738068",11,18,7
"ZDHHC7","s1650_F_GON_01_ASEReadCounter.table","NW_015090842.1:7738204",13,22,9
"LOC106888097","s1650_F_GON_01_ASEReadCounter.table","NW_015090842.1:7767178",6,14,8
"LOC106888097","s1650_F_GON_01_ASEReadCounter.table","NW_015090842.1:7767187",6,14,8
"LOC106888097","s1650_F_GON_01_ASEReadCounter.table","NW_015090842.1:7768144",8,16,8
"LOC106888097","s1650_F_GON_01_ASEReadCounter.table","NW_015090842.1:7768196",15,26,11
"LOC106888097","s1650_F_GON_01_ASEReadCounter.table","NW_015090842.1:7769884",17,25,8
"LOC106888097","s1650_F_GON_01_ASEReadCounter.table","NW_015090842.1:7769893",15,22,7
"LOC106888097","s1650_F_GON_01_ASEReadCounter.table","NW_015090842.1:7770245",13,27,14
"LOC106888097","s1650_F_GON_01_ASEReadCounter.table","NW_015090842.1:7772402",19,39,20
"LOC106888097","s1650_F_GON_01_ASEReadCounter.table","NW_015090842.1:7772483",22,36,14
"LOC106888097","s1650_F_GON_01_ASEReadCounter.table","NW_015090842.1:7772490",24,41,17
"LOC106888097","s1650_F_GON_01_ASEReadCounter.table","NW_015090842.1:7774281",22,35,13
"LOC106888097","s1650_F_GON_01_ASEReadCounter.table","NW_015090842.1:7774552",20,57,37
"LOC106888097","s1650_F_GON_01_ASEReadCounter.table","NW_015090842.1:7774564",20,54,34
"LOC106888097","s1650_F_GON_01_ASEReadCounter.table","NW_015090842.1:7774611",13,41,28
"LOC106888097","s1650_F_GON_01_ASEReadCounter.table","NW_015090842.1:7774681",18,37,19
"LOC106888097","s1650_F_GON_01_ASEReadCounter.table","NW_015090842.1:7774698",14,33,19
"LOC106888097","s1650_F_GON_01_ASEReadCounter.table","NW_015090842.1:7774730",6,17,11
"LOC106888097","s1650_F_GON_01_ASEReadCounter.table","NW_015090842.1:7774778",4,4,0
"LOC106888097","s1650_F_GON_01_ASEReadCounter.table","NW_015090842.1:7774793",4,4,0
"FOXC2","s1650_F_GON_01_ASEReadCounter.table","NW_015090842.1:8129599",0,2,2
"FOXC2","s1650_F_GON_01_ASEReadCounter.table","NW_015090842.1:8129616",0,2,2
"FOXC2","s1650_F_GON_01_ASEReadCounter.table","NW_015090842.1:8129715",0,2,2
"FOXC2","s1650_F_GON_01_ASEReadCounter.table","NW_015090842.1:8129719",0,2,2
"FOXC2","s1650_F_GON_01_ASEReadCounter.table","NW_015090842.1:8130244",0,1,1
"FOXC2","s1650_F_GON_01_ASEReadCounter.table","NW_015090842.1:8130472",0,1,1
"FOXC2","s1650_F_GON_01_ASEReadCounter.table","NW_015090842.1:8130490",0,1,1
"MTHFSD","s1650_F_GON_01_ASEReadCounter.table","NW_015090842.1:8140051",88,195,107
"MTHFSD","s1650_F_GON_01_ASEReadCounter.table","NW_015090842.1:8142923",160,311,151
"MTHFSD","s1650_F_GON_01_ASEReadCounter.table","NW_015090842.1:8143029",144,321,177
"MTHFSD","s1650_F_GON_01_ASEReadCounter.table","NW_015090842.1:8152035",91,204,113
"MTHFSD","s1650_F_GON_01_ASEReadCounter.table","NW_015090842.1:8152315",57,139,82
"MTHFSD","s1650_F_GON_01_ASEReadCounter.table","NW_015090842.1:8152511",61,143,82
"MTHFSD","s1650_F_GON_01_ASEReadCounter.table","NW_015090842.1:8152518",61,141,80
"MTHFSD","s1650_F_GON_01_ASEReadCounter.table","NW_015090842.1:8152553",41,113,72
"MTHFSD","s1650_F_GON_01_ASEReadCounter.table","NW_015090842.1:8152773",90,171,81
"MTHFSD","s1650_F_GON_01_ASEReadCounter.table","NW_015090842.1:8152805",78,155,77
"FOXF1","s1650_F_GON_01_ASEReadCounter.table","NW_015090842.1:8164789",0,1,1
"IRF8","s1650_F_GON_01_ASEReadCounter.table","NW_015090842.1:8406652",4,7,3
"IRF8","s1650_F_GON_01_ASEReadCounter.table","NW_015090842.1:8406703",5,10,5
"IRF8","s1650_F_GON_01_ASEReadCounter.table","NW_015090842.1:8406704",5,10,5
"IRF8","s1650_F_GON_01_ASEReadCounter.table","NW_015090842.1:8406757",6,8,2
"IRF8","s1650_F_GON_01_ASEReadCounter.table","NW_015090842.1:8406778",6,8,2
"IRF8","s1650_F_GON_01_ASEReadCounter.table","NW_015090842.1:8406819",4,6,2
"IRF8","s1650_F_GON_01_ASEReadCounter.table","NW_015090842.1:8406941",4,7,3
"IRF8","s1650_F_GON_01_ASEReadCounter.table","NW_015090842.1:8407008",4,5,1
"IRF8","s1650_F_GON_01_ASEReadCounter.table","NW_015090842.1:8407057",2,4,2
"IRF8","s1650_F_GON_01_ASEReadCounter.table","NW_015090842.1:8407064",2,4,2
"IRF8","s1650_F_GON_01_ASEReadCounter.table","NW_015090842.1:8407069",1,3,2
"IRF8","s1650_F_GON_01_ASEReadCounter.table","NW_015090842.1:8407120",0,3,3
"IRF8","s1650_F_GON_01_ASEReadCounter.table","NW_015090842.1:8407157",2,3,1
"IRF8","s1650_F_GON_01_ASEReadCounter.table","NW_015090842.1:8407203",2,4,2
"IRF8","s1650_F_GON_01_ASEReadCounter.table","NW_015090842.1:8407272",3,4,1
"IRF8","s1650_F_GON_01_ASEReadCounter.table","NW_015090842.1:8407276",3,5,2
"IRF8","s1650_F_GON_01_ASEReadCounter.table","NW_015090842.1:8407303",4,8,4
"IRF8","s1650_F_GON_01_ASEReadCounter.table","NW_015090842.1:8407451",2,4,2
"IRF8","s1650_F_GON_01_ASEReadCounter.table","NW_015090842.1:8407456",2,4,2
"IRF8","s1650_F_GON_01_ASEReadCounter.table","NW_015090842.1:8408564",2,4,2
"IRF8","s1650_F_GON_01_ASEReadCounter.table","NW_015090842.1:8408585",7,7,0
"IRF8","s1650_F_GON_01_ASEReadCounter.table","NW_015090842.1:8408973",3,5,2
"IRF8","s1650_F_GON_01_ASEReadCounter.table","NW_015090842.1:8409060",1,2,1
"IRF8","s1650_F_GON_01_ASEReadCounter.table","NW_015090842.1:8409065",1,2,1
"IRF8","s1650_F_GON_01_ASEReadCounter.table","NW_015090842.1:8409254",0,1,1
"IRF8","s1650_F_GON_01_ASEReadCounter.table","NW_015090842.1:8409255",0,1,1
"IRF8","s1650_F_GON_01_ASEReadCounter.table","NW_015090842.1:8409312",4,9,5
"IRF8","s1650_F_GON_01_ASEReadCounter.table","NW_015090842.1:8410216",3,6,3
"IRF8","s1650_F_GON_01_ASEReadCounter.table","NW_015090842.1:8410237",4,7,3
"IRF8","s1650_F_GON_01_ASEReadCounter.table","NW_015090842.1:8410276",6,6,0
"IRF8","s1650_F_GON_01_ASEReadCounter.table","NW_015090842.1:8410813",3,3,0
"IRF8","s1650_F_GON_01_ASEReadCounter.table","NW_015090842.1:8410861",3,6,3
"IRF8","s1650_F_GON_01_ASEReadCounter.table","NW_015090842.1:8411940",1,4,3
"IRF8","s1650_F_GON_01_ASEReadCounter.table","NW_015090842.1:8412006",0,2,2
"DUSP15","s1650_F_GON_01_ASEReadCounter.table","NW_015090842.1:8422787",0,1,1
"DUSP15","s1650_F_GON_01_ASEReadCounter.table","NW_015090842.1:8422832",0,1,1
"DUSP15","s1650_F_GON_01_ASEReadCounter.table","NW_015090842.1:8422898",0,1,1
"DUSP15","s1650_F_GON_01_ASEReadCounter.table","NW_015090842.1:8422909",0,1,1
"COX4I1","s1650_F_GON_01_ASEReadCounter.table","NW_015090842.1:8442258",1594,3026,1432
"COX4I1","s1650_F_GON_01_ASEReadCounter.table","NW_015090842.1:8442333",1517,2772,1255
"EMC8","s1650_F_GON_01_ASEReadCounter.table","NW_015090842.1:8444046",240,508,268
"EMC8","s1650_F_GON_01_ASEReadCounter.table","NW_015090842.1:8444064",183,393,210
"EMC8","s1650_F_GON_01_ASEReadCounter.table","NW_015090842.1:8452029",21,85,64
"EMC8","s1650_F_GON_01_ASEReadCounter.table","NW_015090842.1:8452116",32,101,69
"EMC8","s1650_F_GON_01_ASEReadCounter.table","NW_015090842.1:8452121",34,106,72
"EMC8","s1650_F_GON_01_ASEReadCounter.table","NW_015090842.1:8452222",41,110,69
"EMC8","s1650_F_GON_01_ASEReadCounter.table","NW_015090842.1:8452244",39,110,71
"EMC8","s1650_F_GON_01_ASEReadCounter.table","NW_015090842.1:8452477",12,30,18
"EMC8","s1650_F_GON_01_ASEReadCounter.table","NW_015090842.1:8452498",8,23,15
"EMC8","s1650_F_GON_01_ASEReadCounter.table","NW_015090842.1:8452535",5,16,11
"EMC8","s1650_F_GON_01_ASEReadCounter.table","NW_015090842.1:8452575",4,15,11
"EMC8","s1650_F_GON_01_ASEReadCounter.table","NW_015090842.1:8452600",3,17,14
"EMC8","s1650_F_GON_01_ASEReadCounter.table","NW_015090842.1:8452616",4,16,12
"EMC8","s1650_F_GON_01_ASEReadCounter.table","NW_015090842.1:8452630",4,14,10
"EMC8","s1650_F_GON_01_ASEReadCounter.table","NW_015090842.1:8452650",4,14,10
"EMC8","s1650_F_GON_01_ASEReadCounter.table","NW_015090842.1:8452678",9,22,13
"EMC8","s1650_F_GON_01_ASEReadCounter.table","NW_015090842.1:8452724",8,19,11
"EMC8","s1650_F_GON_01_ASEReadCounter.table","NW_015090842.1:8452731",8,19,11
"EMC8","s1650_F_GON_01_ASEReadCounter.table","NW_015090842.1:8452743",6,20,14
"EMC8","s1650_F_GON_01_ASEReadCounter.table","NW_015090842.1:8452750",6,21,15
"EMC8","s1650_F_GON_01_ASEReadCounter.table","NW_015090842.1:8452778",5,22,17
"EMC8","s1650_F_GON_01_ASEReadCounter.table","NW_015090842.1:8452783",5,24,19
"EMC8","s1650_F_GON_01_ASEReadCounter.table","NW_015090842.1:8452800",11,30,19
"EMC8","s1650_F_GON_01_ASEReadCounter.table","NW_015090842.1:8452804",10,29,19
"EMC8","s1650_F_GON_01_ASEReadCounter.table","NW_015090842.1:8452812",9,27,18
"EMC8","s1650_F_GON_01_ASEReadCounter.table","NW_015090842.1:8452858",19,32,13
"EMC8","s1650_F_GON_01_ASEReadCounter.table","NW_015090842.1:8452906",24,48,24
"EMC8","s1650_F_GON_01_ASEReadCounter.table","NW_015090842.1:8452913",25,49,24
"EMC8","s1650_F_GON_01_ASEReadCounter.table","NW_015090842.1:8453000",18,42,24
"EMC8","s1650_F_GON_01_ASEReadCounter.table","NW_015090842.1:8453007",20,46,26
"EMC8","s1650_F_GON_01_ASEReadCounter.table","NW_015090842.1:8453058",19,42,23
"EMC8","s1650_F_GON_01_ASEReadCounter.table","NW_015090842.1:8453106",18,40,22
"GINS2","s1650_F_GON_01_ASEReadCounter.table","NW_015090842.1:8466420",146,184,38
"GINS2","s1650_F_GON_01_ASEReadCounter.table","NW_015090842.1:8466424",157,201,44
"GINS2","s1650_F_GON_01_ASEReadCounter.table","NW_015090842.1:8466518",167,232,65
"GINS2","s1650_F_GON_01_ASEReadCounter.table","NW_015090842.1:8468482",368,479,111
"GINS2","s1650_F_GON_01_ASEReadCounter.table","NW_015090842.1:8470290",371,481,110
"GINS2","s1650_F_GON_01_ASEReadCounter.table","NW_015090842.1:8470305",338,421,83
"GINS2","s1650_F_GON_01_ASEReadCounter.table","NW_015090842.1:8470381",337,425,88
"GINS2","s1650_F_GON_01_ASEReadCounter.table","NW_015090842.1:8470418",323,422,99
"GINS2","s1650_F_GON_01_ASEReadCounter.table","NW_015090842.1:8470421",296,391,95
"GINS2","s1650_F_GON_01_ASEReadCounter.table","NW_015090842.1:8470430",254,348,94
"GINS2","s1650_F_GON_01_ASEReadCounter.table","NW_015090842.1:8470433",247,345,98
"GINS2","s1650_F_GON_01_ASEReadCounter.table","NW_015090842.1:8470457",164,243,79
"GINS2","s1650_F_GON_01_ASEReadCounter.table","NW_015090842.1:8470491",157,238,81
"GINS2","s1650_F_GON_01_ASEReadCounter.table","NW_015090842.1:8470548",215,295,80
"GINS2","s1650_F_GON_01_ASEReadCounter.table","NW_015090842.1:8470649",169,249,80
"GSE1","s1650_F_GON_01_ASEReadCounter.table","NW_015090842.1:8475362",1,2,1
"GSE1","s1650_F_GON_01_ASEReadCounter.table","NW_015090842.1:8475961",2,2,0
"GSE1","s1650_F_GON_01_ASEReadCounter.table","NW_015090842.1:8476027",1,1,0
"GSE1","s1650_F_GON_01_ASEReadCounter.table","NW_015090842.1:8477442",0,1,1
"GSE1","s1650_F_GON_01_ASEReadCounter.table","NW_015090842.1:8477448",0,1,1
"GSE1","s1650_F_GON_01_ASEReadCounter.table","NW_015090842.1:8477662",0,1,1
"GSE1","s1650_F_GON_01_ASEReadCounter.table","NW_015090842.1:8477933",0,1,1
"GSE1","s1650_F_GON_01_ASEReadCounter.table","NW_015090842.1:8477945",0,1,1
"GSE1","s1650_F_GON_01_ASEReadCounter.table","NW_015090842.1:8483272",1,5,4
"GSE1","s1650_F_GON_01_ASEReadCounter.table","NW_015090842.1:8486867",4,5,1
"GSE1","s1650_F_GON_01_ASEReadCounter.table","NW_015090842.1:8486939",3,4,1
"GSE1","s1650_F_GON_01_ASEReadCounter.table","NW_015090842.1:8486945",3,5,2
"GSE1","s1650_F_GON_01_ASEReadCounter.table","NW_015090842.1:8486993",2,5,3
"GSE1","s1650_F_GON_01_ASEReadCounter.table","NW_015090842.1:8487062",2,4,2
"GSE1","s1650_F_GON_01_ASEReadCounter.table","NW_015090842.1:8488065",1,1,0
"GSE1","s1650_F_GON_01_ASEReadCounter.table","NW_015090842.1:8488457",0,1,1
"GSE1","s1650_F_GON_01_ASEReadCounter.table","NW_015090842.1:8488463",0,1,1
"GSE1","s1650_F_GON_01_ASEReadCounter.table","NW_015090842.1:8488490",2,2,0
"GSE1","s1650_F_GON_01_ASEReadCounter.table","NW_015090842.1:8488505",2,3,1
"GSE1","s1650_F_GON_01_ASEReadCounter.table","NW_015090842.1:8490180",0,3,3
"KIAA0513","s1650_F_GON_01_ASEReadCounter.table","NW_015090842.1:8668363",19,49,30
"KIAA0513","s1650_F_GON_01_ASEReadCounter.table","NW_015090842.1:8668387",18,45,27
"KIAA0513","s1650_F_GON_01_ASEReadCounter.table","NW_015090842.1:8668390",18,46,28
"KIAA0513","s1650_F_GON_01_ASEReadCounter.table","NW_015090842.1:8673107",21,48,27
"KIAA0513","s1650_F_GON_01_ASEReadCounter.table","NW_015090842.1:8673147",24,48,24
"KIAA0513","s1650_F_GON_01_ASEReadCounter.table","NW_015090842.1:8674661",23,43,20
"KIAA0513","s1650_F_GON_01_ASEReadCounter.table","NW_015090842.1:8674685",23,42,19
"KIAA0513","s1650_F_GON_01_ASEReadCounter.table","NW_015090842.1:8674730",21,45,24
"KIAA0513","s1650_F_GON_01_ASEReadCounter.table","NW_015090842.1:8675525",11,32,21
"KIAA0513","s1650_F_GON_01_ASEReadCounter.table","NW_015090842.1:8675561",13,34,21
"KIAA0513","s1650_F_GON_01_ASEReadCounter.table","NW_015090842.1:8678608",1,5,4
"KIAA0513","s1650_F_GON_01_ASEReadCounter.table","NW_015090842.1:8686455",0,4,4
"KIAA0513","s1650_F_GON_01_ASEReadCounter.table","NW_015090842.1:8686508",0,2,2
"KIAA0513","s1650_F_GON_01_ASEReadCounter.table","NW_015090842.1:8686521",0,2,2
"KIAA0513","s1650_F_GON_01_ASEReadCounter.table","NW_015090842.1:8693642",4,8,4
"KIAA0513","s1650_F_GON_01_ASEReadCounter.table","NW_015090842.1:8693712",8,15,7
"KIAA0513","s1650_F_GON_01_ASEReadCounter.table","NW_015090842.1:8695794",0,1,1
"FBXO31","s1650_F_GON_01_ASEReadCounter.table","NW_015090842.1:8710240",318,778,460
"FBXO31","s1650_F_GON_01_ASEReadCounter.table","NW_015090842.1:8710372",281,681,400
"FBXO31","s1650_F_GON_01_ASEReadCounter.table","NW_015090842.1:8711239",315,691,376
"FBXO31","s1650_F_GON_01_ASEReadCounter.table","NW_015090842.1:8714565",370,873,503
"FBXO31","s1650_F_GON_01_ASEReadCounter.table","NW_015090842.1:8716001",215,525,310
"FBXO31","s1650_F_GON_01_ASEReadCounter.table","NW_015090842.1:8725050",4,6,2
"FBXO31","s1650_F_GON_01_ASEReadCounter.table","NW_015090842.1:8725057",4,6,2
"FBXO31","s1650_F_GON_01_ASEReadCounter.table","NW_015090842.1:8725162",8,15,7
"FBXO31","s1650_F_GON_01_ASEReadCounter.table","NW_015090842.1:8725163",8,15,7
"FBXO31","s1650_F_GON_01_ASEReadCounter.table","NW_015090842.1:8725170",9,16,7
"FBXO31","s1650_F_GON_01_ASEReadCounter.table","NW_015090842.1:8725187",9,15,6
"FBXO31","s1650_F_GON_01_ASEReadCounter.table","NW_015090842.1:8725188",9,15,6
"FBXO31","s1650_F_GON_01_ASEReadCounter.table","NW_015090842.1:8725190",8,15,7
"FBXO31","s1650_F_GON_01_ASEReadCounter.table","NW_015090842.1:8725370",6,8,2
"ZCCHC14","s1650_F_GON_01_ASEReadCounter.table","NW_015090842.1:8750174",43,63,20
"ZCCHC14","s1650_F_GON_01_ASEReadCounter.table","NW_015090842.1:8750189",59,73,14
"ZCCHC14","s1650_F_GON_01_ASEReadCounter.table","NW_015090842.1:8750365",28,56,28
"ZCCHC14","s1650_F_GON_01_ASEReadCounter.table","NW_015090842.1:8750433",15,35,20
"ZCCHC14","s1650_F_GON_01_ASEReadCounter.table","NW_015090842.1:8750449",17,45,28
"ZCCHC14","s1650_F_GON_01_ASEReadCounter.table","NW_015090842.1:8750456",19,46,27
"ZCCHC14","s1650_F_GON_01_ASEReadCounter.table","NW_015090842.1:8750497",30,57,27
"ZCCHC14","s1650_F_GON_01_ASEReadCounter.table","NW_015090842.1:8750547",41,71,30
"ZCCHC14","s1650_F_GON_01_ASEReadCounter.table","NW_015090842.1:8751100",5,14,9
"ZCCHC14","s1650_F_GON_01_ASEReadCounter.table","NW_015090842.1:8751374",14,34,20
"ZCCHC14","s1650_F_GON_01_ASEReadCounter.table","NW_015090842.1:8751403",15,39,24
"ZCCHC14","s1650_F_GON_01_ASEReadCounter.table","NW_015090842.1:8751517",13,24,11
"ZCCHC14","s1650_F_GON_01_ASEReadCounter.table","NW_015090842.1:8752060",15,25,10
"ZCCHC14","s1650_F_GON_01_ASEReadCounter.table","NW_015090842.1:8752172",19,32,13
"ZCCHC14","s1650_F_GON_01_ASEReadCounter.table","NW_015090842.1:8752183",17,28,11
"ZCCHC14","s1650_F_GON_01_ASEReadCounter.table","NW_015090842.1:8752198",15,25,10
"ZCCHC14","s1650_F_GON_01_ASEReadCounter.table","NW_015090842.1:8752248",16,29,13
"ZCCHC14","s1650_F_GON_01_ASEReadCounter.table","NW_015090842.1:8752326",12,32,20
"ZCCHC14","s1650_F_GON_01_ASEReadCounter.table","NW_015090842.1:8752393",10,29,19
"ZCCHC14","s1650_F_GON_01_ASEReadCounter.table","NW_015090842.1:8752914",13,27,14
"ZCCHC14","s1650_F_GON_01_ASEReadCounter.table","NW_015090842.1:8753528",16,26,10
"ZCCHC14","s1650_F_GON_01_ASEReadCounter.table","NW_015090842.1:8753892",13,24,11
"ZCCHC14","s1650_F_GON_01_ASEReadCounter.table","NW_015090842.1:8753910",15,28,13
"ZCCHC14","s1650_F_GON_01_ASEReadCounter.table","NW_015090842.1:8755096",5,11,6
"ZCCHC14","s1650_F_GON_01_ASEReadCounter.table","NW_015090842.1:8755327",4,9,5
"ZCCHC14","s1650_F_GON_01_ASEReadCounter.table","NW_015090842.1:8755723",4,10,6
"ZCCHC14","s1650_F_GON_01_ASEReadCounter.table","NW_015090842.1:8755739",4,9,5
"ZCCHC14","s1650_F_GON_01_ASEReadCounter.table","NW_015090842.1:8756149",6,9,3
"ZCCHC14","s1650_F_GON_01_ASEReadCounter.table","NW_015090842.1:8756347",8,12,4
"ZCCHC14","s1650_F_GON_01_ASEReadCounter.table","NW_015090842.1:8756361",9,13,4
"ZCCHC14","s1650_F_GON_01_ASEReadCounter.table","NW_015090842.1:8756388",7,11,4
"ZCCHC14","s1650_F_GON_01_ASEReadCounter.table","NW_015090842.1:8756389",6,10,4
"ZCCHC14","s1650_F_GON_01_ASEReadCounter.table","NW_015090842.1:8757160",6,11,5
"ZCCHC14","s1650_F_GON_01_ASEReadCounter.table","NW_015090842.1:8804511",9,14,5
"ZCCHC14","s1650_F_GON_01_ASEReadCounter.table","NW_015090842.1:8804979",3,4,1
"JPH3","s1650_F_GON_01_ASEReadCounter.table","NW_015090842.1:8845375",0,1,1
"JPH3","s1650_F_GON_01_ASEReadCounter.table","NW_015090842.1:8872283",0,1,1
"JPH3","s1650_F_GON_01_ASEReadCounter.table","NW_015090842.1:8872294",0,1,1
"JPH3","s1650_F_GON_01_ASEReadCounter.table","NW_015090842.1:8885260",0,1,1
"JPH3","s1650_F_GON_01_ASEReadCounter.table","NW_015090842.1:8885438",2,5,3
"JPH3","s1650_F_GON_01_ASEReadCounter.table","NW_015090842.1:8885525",1,2,1
"KLHDC4","s1650_F_GON_01_ASEReadCounter.table","NW_015090842.1:8890729",104,145,41
"KLHDC4","s1650_F_GON_01_ASEReadCounter.table","NW_015090842.1:8890749",112,156,44
"KLHDC4","s1650_F_GON_01_ASEReadCounter.table","NW_015090842.1:8890761",126,176,50
"KLHDC4","s1650_F_GON_01_ASEReadCounter.table","NW_015090842.1:8891123",166,237,71
"KLHDC4","s1650_F_GON_01_ASEReadCounter.table","NW_015090842.1:8893124",128,174,46
"KLHDC4","s1650_F_GON_01_ASEReadCounter.table","NW_015090842.1:8894542",108,150,42
"KLHDC4","s1650_F_GON_01_ASEReadCounter.table","NW_015090842.1:8896726",80,108,28
"KLHDC4","s1650_F_GON_01_ASEReadCounter.table","NW_015090842.1:8896767",82,112,30
"KLHDC4","s1650_F_GON_01_ASEReadCounter.table","NW_015090842.1:8904174",53,79,26
"KLHDC4","s1650_F_GON_01_ASEReadCounter.table","NW_015090842.1:8904231",59,85,26
"KLHDC4","s1650_F_GON_01_ASEReadCounter.table","NW_015090842.1:8905251",63,86,23
"KLHDC4","s1650_F_GON_01_ASEReadCounter.table","NW_015090842.1:8905263",64,90,26
"KLHDC4","s1650_F_GON_01_ASEReadCounter.table","NW_015090842.1:8919626",16,22,6
"SLC7A5","s1650_F_GON_01_ASEReadCounter.table","NW_015090842.1:8938782",99,186,87
"SLC7A5","s1650_F_GON_01_ASEReadCounter.table","NW_015090842.1:8938943",64,102,38
"SLC7A5","s1650_F_GON_01_ASEReadCounter.table","NW_015090842.1:8939611",24,38,14
"SLC7A5","s1650_F_GON_01_ASEReadCounter.table","NW_015090842.1:8939738",36,56,20
"SLC7A5","s1650_F_GON_01_ASEReadCounter.table","NW_015090842.1:8939739",35,53,18
"SLC7A5","s1650_F_GON_01_ASEReadCounter.table","NW_015090842.1:8939740",35,54,19
"SLC7A5","s1650_F_GON_01_ASEReadCounter.table","NW_015090842.1:8939795",32,57,25
"SLC7A5","s1650_F_GON_01_ASEReadCounter.table","NW_015090842.1:8939815",30,58,28
"SLC7A5","s1650_F_GON_01_ASEReadCounter.table","NW_015090842.1:8939816",29,57,28
"SLC7A5","s1650_F_GON_01_ASEReadCounter.table","NW_015090842.1:8939817",30,58,28
"SLC7A5","s1650_F_GON_01_ASEReadCounter.table","NW_015090842.1:8939845",32,63,31
"SLC7A5","s1650_F_GON_01_ASEReadCounter.table","NW_015090842.1:8939894",27,50,23
"SLC7A5","s1650_F_GON_01_ASEReadCounter.table","NW_015090842.1:8939895",27,50,23
"SLC7A5","s1650_F_GON_01_ASEReadCounter.table","NW_015090842.1:8939997",86,86,0
"SLC7A5","s1650_F_GON_01_ASEReadCounter.table","NW_015090842.1:8940172",33,58,25
"SLC7A5","s1650_F_GON_01_ASEReadCounter.table","NW_015090842.1:8940331",28,43,15
"SLC7A5","s1650_F_GON_01_ASEReadCounter.table","NW_015090842.1:8940696",19,31,12
"SLC7A5","s1650_F_GON_01_ASEReadCounter.table","NW_015090842.1:8940719",12,33,21
"SLC7A5","s1650_F_GON_01_ASEReadCounter.table","NW_015090842.1:8940737",15,38,23
"SLC7A5","s1650_F_GON_01_ASEReadCounter.table","NW_015090842.1:8940743",14,37,23
"SLC7A5","s1650_F_GON_01_ASEReadCounter.table","NW_015090842.1:8940766",15,37,22
"SLC7A5","s1650_F_GON_01_ASEReadCounter.table","NW_015090842.1:8940769",16,38,22
"SLC7A5","s1650_F_GON_01_ASEReadCounter.table","NW_015090842.1:8940861",22,39,17
"SLC7A5","s1650_F_GON_01_ASEReadCounter.table","NW_015090842.1:8941068",26,46,20
"SLC7A5","s1650_F_GON_01_ASEReadCounter.table","NW_015090842.1:8941467",24,41,17
"SLC7A5","s1650_F_GON_01_ASEReadCounter.table","NW_015090842.1:8941531",25,49,24
"SLC7A5","s1650_F_GON_01_ASEReadCounter.table","NW_015090842.1:8941588",29,53,24
"SLC7A5","s1650_F_GON_01_ASEReadCounter.table","NW_015090842.1:8941698",22,35,13
"SLC7A5","s1650_F_GON_01_ASEReadCounter.table","NW_015090842.1:8941717",21,32,11
"SLC7A5","s1650_F_GON_01_ASEReadCounter.table","NW_015090842.1:8941745",23,37,14
"SLC7A5","s1650_F_GON_01_ASEReadCounter.table","NW_015090842.1:8941781",24,41,17
"SLC7A5","s1650_F_GON_01_ASEReadCounter.table","NW_015090842.1:8941887",15,28,13
"SLC7A5","s1650_F_GON_01_ASEReadCounter.table","NW_015090842.1:8941968",8,25,17
"SLC7A5","s1650_F_GON_01_ASEReadCounter.table","NW_015090842.1:8942025",18,39,21
"SLC7A5","s1650_F_GON_01_ASEReadCounter.table","NW_015090842.1:8942069",22,36,14
"SLC7A5","s1650_F_GON_01_ASEReadCounter.table","NW_015090842.1:8942170",28,40,12
"SLC7A5","s1650_F_GON_01_ASEReadCounter.table","NW_015090842.1:8942241",31,43,12
"SLC7A5","s1650_F_GON_01_ASEReadCounter.table","NW_015090842.1:8942283",28,46,18
"SLC7A5","s1650_F_GON_01_ASEReadCounter.table","NW_015090842.1:8942717",26,41,15
"SLC7A5","s1650_F_GON_01_ASEReadCounter.table","NW_015090842.1:8942756",41,60,19
"SLC7A5","s1650_F_GON_01_ASEReadCounter.table","NW_015090842.1:8942766",39,58,19
"SLC7A5","s1650_F_GON_01_ASEReadCounter.table","NW_015090842.1:8943271",23,41,18
"SLC7A5","s1650_F_GON_01_ASEReadCounter.table","NW_015090842.1:8943524",21,34,13
"SLC7A5","s1650_F_GON_01_ASEReadCounter.table","NW_015090842.1:8943530",23,37,14
"SLC7A5","s1650_F_GON_01_ASEReadCounter.table","NW_015090842.1:8943602",22,34,12
"SLC7A5","s1650_F_GON_01_ASEReadCounter.table","NW_015090842.1:8943622",18,33,15
"SLC7A5","s1650_F_GON_01_ASEReadCounter.table","NW_015090842.1:8943661",17,36,19
"SLC7A5","s1650_F_GON_01_ASEReadCounter.table","NW_015090842.1:8943686",13,36,23
"SLC7A5","s1650_F_GON_01_ASEReadCounter.table","NW_015090842.1:8943788",14,34,20
"SLC7A5","s1650_F_GON_01_ASEReadCounter.table","NW_015090842.1:8943814",14,33,19
"SLC7A5","s1650_F_GON_01_ASEReadCounter.table","NW_015090842.1:8943876",13,35,22
"SLC7A5","s1650_F_GON_01_ASEReadCounter.table","NW_015090842.1:8943892",13,32,19
"SLC7A5","s1650_F_GON_01_ASEReadCounter.table","NW_015090842.1:8944097",20,35,15
"SLC7A5","s1650_F_GON_01_ASEReadCounter.table","NW_015090842.1:8944104",19,31,12
"SLC7A5","s1650_F_GON_01_ASEReadCounter.table","NW_015090842.1:8944293",12,21,9
"SLC7A5","s1650_F_GON_01_ASEReadCounter.table","NW_015090842.1:8944297",12,20,8
"SLC7A5","s1650_F_GON_01_ASEReadCounter.table","NW_015090842.1:8944397",16,24,8
"SLC7A5","s1650_F_GON_01_ASEReadCounter.table","NW_015090842.1:8944552",25,39,14
"SLC7A5","s1650_F_GON_01_ASEReadCounter.table","NW_015090842.1:8944629",24,41,17
"CA5A","s1650_F_GON_01_ASEReadCounter.table","NW_015090842.1:8989479",21,63,42
"CA5A","s1650_F_GON_01_ASEReadCounter.table","NW_015090842.1:8989562",24,59,35
"CA5A","s1650_F_GON_01_ASEReadCounter.table","NW_015090842.1:8989609",25,68,43
"CA5A","s1650_F_GON_01_ASEReadCounter.table","NW_015090842.1:8989693",28,83,55
"CA5A","s1650_F_GON_01_ASEReadCounter.table","NW_015090842.1:8989702",31,83,52
"CA5A","s1650_F_GON_01_ASEReadCounter.table","NW_015090842.1:8989746",31,86,55
"CA5A","s1650_F_GON_01_ASEReadCounter.table","NW_015090842.1:8989880",27,73,46
"CA5A","s1650_F_GON_01_ASEReadCounter.table","NW_015090842.1:8989885",30,77,47
"CA5A","s1650_F_GON_01_ASEReadCounter.table","NW_015090842.1:8989929",33,83,50
"CA5A","s1650_F_GON_01_ASEReadCounter.table","NW_015090842.1:8990002",26,67,41
"CA5A","s1650_F_GON_01_ASEReadCounter.table","NW_015090842.1:8990004",26,71,45
"CA5A","s1650_F_GON_01_ASEReadCounter.table","NW_015090842.1:8990005",26,72,46
"CA5A","s1650_F_GON_01_ASEReadCounter.table","NW_015090842.1:8990017",26,68,42
"CA5A","s1650_F_GON_01_ASEReadCounter.table","NW_015090842.1:8990043",13,52,39
"CA5A","s1650_F_GON_01_ASEReadCounter.table","NW_015090842.1:8990060",53,53,0
"CA5A","s1650_F_GON_01_ASEReadCounter.table","NW_015090842.1:8990080",10,52,42
"CA5A","s1650_F_GON_01_ASEReadCounter.table","NW_015090842.1:8990084",11,54,43
"CA5A","s1650_F_GON_01_ASEReadCounter.table","NW_015090842.1:8990090",12,56,44
"CA5A","s1650_F_GON_01_ASEReadCounter.table","NW_015090842.1:8990095",16,58,42
"CA5A","s1650_F_GON_01_ASEReadCounter.table","NW_015090842.1:8990111",11,53,42
"CA5A","s1650_F_GON_01_ASEReadCounter.table","NW_015090842.1:8990112",11,51,40
"CA5A","s1650_F_GON_01_ASEReadCounter.table","NW_015090842.1:8990115",14,54,40
"CA5A","s1650_F_GON_01_ASEReadCounter.table","NW_015090842.1:8990166",10,37,27
"CA5A","s1650_F_GON_01_ASEReadCounter.table","NW_015090842.1:8990169",11,37,26
"CA5A","s1650_F_GON_01_ASEReadCounter.table","NW_015090842.1:8990193",37,37,0
"CA5A","s1650_F_GON_01_ASEReadCounter.table","NW_015090842.1:8990222",13,35,22
"CA5A","s1650_F_GON_01_ASEReadCounter.table","NW_015090842.1:8990289",15,43,28
"CA5A","s1650_F_GON_01_ASEReadCounter.table","NW_015090842.1:8990314",16,45,29
"CA5A","s1650_F_GON_01_ASEReadCounter.table","NW_015090842.1:8990361",17,44,27
"CA5A","s1650_F_GON_01_ASEReadCounter.table","NW_015090842.1:8990368",17,43,26
"CA5A","s1650_F_GON_01_ASEReadCounter.table","NW_015090842.1:8990429",16,46,30
"CA5A","s1650_F_GON_01_ASEReadCounter.table","NW_015090842.1:8990466",14,42,28
"CA5A","s1650_F_GON_01_ASEReadCounter.table","NW_015090842.1:8990663",17,45,28
"CA5A","s1650_F_GON_01_ASEReadCounter.table","NW_015090842.1:8990797",13,37,24
"CA5A","s1650_F_GON_01_ASEReadCounter.table","NW_015090842.1:8990836",14,37,23
"CA5A","s1650_F_GON_01_ASEReadCounter.table","NW_015090842.1:8990842",15,39,24
"CA5A","s1650_F_GON_01_ASEReadCounter.table","NW_015090842.1:8990851",15,35,20
"CA5A","s1650_F_GON_01_ASEReadCounter.table","NW_015090842.1:8990918",21,43,22
"CA5A","s1650_F_GON_01_ASEReadCounter.table","NW_015090842.1:8990921",21,44,23
"CA5A","s1650_F_GON_01_ASEReadCounter.table","NW_015090842.1:8990942",22,46,24
"CA5A","s1650_F_GON_01_ASEReadCounter.table","NW_015090842.1:8991001",14,49,35
"CA5A","s1650_F_GON_01_ASEReadCounter.table","NW_015090842.1:8991038",12,43,31
"CA5A","s1650_F_GON_01_ASEReadCounter.table","NW_015090842.1:8991149",14,49,35
"CA5A","s1650_F_GON_01_ASEReadCounter.table","NW_015090842.1:8991176",10,47,37
"CA5A","s1650_F_GON_01_ASEReadCounter.table","NW_015090842.1:8991241",12,42,30
"CA5A","s1650_F_GON_01_ASEReadCounter.table","NW_015090842.1:8991262",17,44,27
"CA5A","s1650_F_GON_01_ASEReadCounter.table","NW_015090842.1:8991316",14,17,3
"CA5A","s1650_F_GON_01_ASEReadCounter.table","NW_015090842.1:8991319",14,18,4
"CA5A","s1650_F_GON_01_ASEReadCounter.table","NW_015090842.1:8991330",14,17,3
"CA5A","s1650_F_GON_01_ASEReadCounter.table","NW_015090842.1:8991334",13,16,3
"CA5A","s1650_F_GON_01_ASEReadCounter.table","NW_015090842.1:8991362",9,38,29
"CA5A","s1650_F_GON_01_ASEReadCounter.table","NW_015090842.1:8991368",8,37,29
"CA5A","s1650_F_GON_01_ASEReadCounter.table","NW_015090842.1:8991390",11,43,32
"CA5A","s1650_F_GON_01_ASEReadCounter.table","NW_015090842.1:8991395",11,44,33
"CA5A","s1650_F_GON_01_ASEReadCounter.table","NW_015090842.1:8991422",11,47,36
"CA5A","s1650_F_GON_01_ASEReadCounter.table","NW_015090842.1:8991467",19,40,21
"CA5A","s1650_F_GON_01_ASEReadCounter.table","NW_015090842.1:8991576",10,26,16
"CA5A","s1650_F_GON_01_ASEReadCounter.table","NW_015090842.1:8991587",10,28,18
"CA5A","s1650_F_GON_01_ASEReadCounter.table","NW_015090842.1:8991655",12,34,22
"CA5A","s1650_F_GON_01_ASEReadCounter.table","NW_015090842.1:8991717",16,34,18
"CA5A","s1650_F_GON_01_ASEReadCounter.table","NW_015090842.1:8991726",18,37,19
"CA5A","s1650_F_GON_01_ASEReadCounter.table","NW_015090842.1:8991799",12,36,24
"CA5A","s1650_F_GON_01_ASEReadCounter.table","NW_015090842.1:8991809",10,32,22
"CA5A","s1650_F_GON_01_ASEReadCounter.table","NW_015090842.1:8991848",7,27,20
"CA5A","s1650_F_GON_01_ASEReadCounter.table","NW_015090842.1:8991849",7,28,21
"CA5A","s1650_F_GON_01_ASEReadCounter.table","NW_015090842.1:8991927",13,36,23
"CA5A","s1650_F_GON_01_ASEReadCounter.table","NW_015090842.1:8991941",13,38,25
"CA5A","s1650_F_GON_01_ASEReadCounter.table","NW_015090842.1:8992121",15,42,27
"CA5A","s1650_F_GON_01_ASEReadCounter.table","NW_015090842.1:8992224",23,46,23
"CA5A","s1650_F_GON_01_ASEReadCounter.table","NW_015090842.1:9002570",21,49,28
"CA5A","s1650_F_GON_01_ASEReadCounter.table","NW_015090842.1:9002600",22,46,24
"CA5A","s1650_F_GON_01_ASEReadCounter.table","NW_015090842.1:9004312",18,44,26
"CA5A","s1650_F_GON_01_ASEReadCounter.table","NW_015090842.1:9004506",13,25,12
"CA5A","s1650_F_GON_01_ASEReadCounter.table","NW_015090842.1:9004523",19,31,12
"CA5A","s1650_F_GON_01_ASEReadCounter.table","NW_015090842.1:9004530",20,33,13
"CA5A","s1650_F_GON_01_ASEReadCounter.table","NW_015090842.1:9004556",31,46,15
"CA5A","s1650_F_GON_01_ASEReadCounter.table","NW_015090842.1:9005116",70,108,38
"CA5A","s1650_F_GON_01_ASEReadCounter.table","NW_015090842.1:9005120",72,112,40
"CA5A","s1650_F_GON_01_ASEReadCounter.table","NW_015090842.1:9005140",75,114,39
"CA5A","s1650_F_GON_01_ASEReadCounter.table","NW_015090842.1:9005152",80,120,40
"CA5A","s1650_F_GON_01_ASEReadCounter.table","NW_015090842.1:9011011",2,3,1
"CA5A","s1650_F_GON_01_ASEReadCounter.table","NW_015090842.1:9011189",4,6,2
"CA5A","s1650_F_GON_01_ASEReadCounter.table","NW_015090842.1:9011194",4,6,2
"BANP","s1650_F_GON_01_ASEReadCounter.table","NW_015090842.1:9033407",13,19,6
"BANP","s1650_F_GON_01_ASEReadCounter.table","NW_015090842.1:9033409",13,17,4
"BANP","s1650_F_GON_01_ASEReadCounter.table","NW_015090842.1:9033420",10,16,6
"BANP","s1650_F_GON_01_ASEReadCounter.table","NW_015090842.1:9067974",0,16,16
"BANP","s1650_F_GON_01_ASEReadCounter.table","NW_015090842.1:9102510",17,32,15
"BANP","s1650_F_GON_01_ASEReadCounter.table","NW_015090842.1:9168534",27,54,27
"BANP","s1650_F_GON_01_ASEReadCounter.table","NW_015090842.1:9168818",14,27,13
"ZNF469","s1650_F_GON_01_ASEReadCounter.table","NW_015090842.1:9424333",1,1,0
"ZNF469","s1650_F_GON_01_ASEReadCounter.table","NW_015090842.1:9425182",0,1,1
"ZNF469","s1650_F_GON_01_ASEReadCounter.table","NW_015090842.1:9426585",0,1,1
"ZNF469","s1650_F_GON_01_ASEReadCounter.table","NW_015090842.1:9428122",0,2,2
"ZNF469","s1650_F_GON_01_ASEReadCounter.table","NW_015090842.1:9428178",0,1,1
"ZNF469","s1650_F_GON_01_ASEReadCounter.table","NW_015090842.1:9429633",2,3,1
"ZNF469","s1650_F_GON_01_ASEReadCounter.table","NW_015090842.1:9430560",0,2,2
"ZNF469","s1650_F_GON_01_ASEReadCounter.table","NW_015090842.1:9431031",0,1,1
"ZNF469","s1650_F_GON_01_ASEReadCounter.table","NW_015090842.1:9431073",0,1,1
"ZNF469","s1650_F_GON_01_ASEReadCounter.table","NW_015090842.1:9431091",0,1,1
"ZNF469","s1650_F_GON_01_ASEReadCounter.table","NW_015090842.1:9431150",0,1,1
"ZNF469","s1650_F_GON_01_ASEReadCounter.table","NW_015090842.1:9431162",0,1,1
"ZNF469","s1650_F_GON_01_ASEReadCounter.table","NW_015090842.1:9431700",1,1,0
"ZNF469","s1650_F_GON_01_ASEReadCounter.table","NW_015090842.1:9431901",1,2,1
"ZNF469","s1650_F_GON_01_ASEReadCounter.table","NW_015090842.1:9432110",1,5,4
"ZNF469","s1650_F_GON_01_ASEReadCounter.table","NW_015090842.1:9432302",0,3,3
"ZNF469","s1650_F_GON_01_ASEReadCounter.table","NW_015090842.1:9432361",0,3,3
"ZNF469","s1650_F_GON_01_ASEReadCounter.table","NW_015090842.1:9432374",0,2,2
"ZNF469","s1650_F_GON_01_ASEReadCounter.table","NW_015090842.1:9432382",0,2,2
"ZNF469","s1650_F_GON_01_ASEReadCounter.table","NW_015090842.1:9433268",1,1,0
"ZNF469","s1650_F_GON_01_ASEReadCounter.table","NW_015090842.1:9433678",0,3,3
"ZNF469","s1650_F_GON_01_ASEReadCounter.table","NW_015090842.1:9433902",1,4,3
"ZNF469","s1650_F_GON_01_ASEReadCounter.table","NW_015090842.1:9433980",0,1,1
"ZNF469","s1650_F_GON_01_ASEReadCounter.table","NW_015090842.1:9434259",1,2,1
"ZNF469","s1650_F_GON_01_ASEReadCounter.table","NW_015090842.1:9435221",1,5,4
"ZFPM1","s1650_F_GON_01_ASEReadCounter.table","NW_015090842.1:9458862",12,36,24
"ZFPM1","s1650_F_GON_01_ASEReadCounter.table","NW_015090842.1:9458888",9,38,29
"ZFPM1","s1650_F_GON_01_ASEReadCounter.table","NW_015090842.1:9458904",13,44,31
"ZFPM1","s1650_F_GON_01_ASEReadCounter.table","NW_015090842.1:9458916",13,43,30
"ZFPM1","s1650_F_GON_01_ASEReadCounter.table","NW_015090842.1:9468568",15,40,25
"ZFPM1","s1650_F_GON_01_ASEReadCounter.table","NW_015090842.1:9468593",17,49,32
"ZFPM1","s1650_F_GON_01_ASEReadCounter.table","NW_015090842.1:9471561",10,32,22
"ZFPM1","s1650_F_GON_01_ASEReadCounter.table","NW_015090842.1:9472557",12,34,22
"ZFPM1","s1650_F_GON_01_ASEReadCounter.table","NW_015090842.1:9472565",13,33,20
"ZFPM1","s1650_F_GON_01_ASEReadCounter.table","NW_015090842.1:9472608",15,42,27
"ZFPM1","s1650_F_GON_01_ASEReadCounter.table","NW_015090842.1:9472627",15,38,23
"ZFPM1","s1650_F_GON_01_ASEReadCounter.table","NW_015090842.1:9472668",13,41,28
"ZFPM1","s1650_F_GON_01_ASEReadCounter.table","NW_015090842.1:9473655",11,29,18
"ZFPM1","s1650_F_GON_01_ASEReadCounter.table","NW_015090842.1:9475827",18,42,24
"ZFPM1","s1650_F_GON_01_ASEReadCounter.table","NW_015090842.1:9475842",24,45,21
"ZFPM1","s1650_F_GON_01_ASEReadCounter.table","NW_015090842.1:9476119",15,33,18
"ZFPM1","s1650_F_GON_01_ASEReadCounter.table","NW_015090842.1:9476161",11,28,17
"ZFPM1","s1650_F_GON_01_ASEReadCounter.table","NW_015090842.1:9476219",7,28,21
"ZFPM1","s1650_F_GON_01_ASEReadCounter.table","NW_015090842.1:9476233",8,27,19
"ZFPM1","s1650_F_GON_01_ASEReadCounter.table","NW_015090842.1:9476305",17,38,21
"ZFPM1","s1650_F_GON_01_ASEReadCounter.table","NW_015090842.1:9476395",12,32,20
"ZFPM1","s1650_F_GON_01_ASEReadCounter.table","NW_015090842.1:9476421",18,46,28
"ZFPM1","s1650_F_GON_01_ASEReadCounter.table","NW_015090842.1:9476539",13,34,21
"ZFPM1","s1650_F_GON_01_ASEReadCounter.table","NW_015090842.1:9476576",10,33,23
"ZFPM1","s1650_F_GON_01_ASEReadCounter.table","NW_015090842.1:9476599",39,39,0
"ZFPM1","s1650_F_GON_01_ASEReadCounter.table","NW_015090842.1:9476792",21,47,26
"ZFPM1","s1650_F_GON_01_ASEReadCounter.table","NW_015090842.1:9476803",21,46,25
"ZFPM1","s1650_F_GON_01_ASEReadCounter.table","NW_015090842.1:9477115",9,29,20
"ZFPM1","s1650_F_GON_01_ASEReadCounter.table","NW_015090842.1:9477299",4,18,14
"ZFPM1","s1650_F_GON_01_ASEReadCounter.table","NW_015090842.1:9477398",30,30,0
"ZFPM1","s1650_F_GON_01_ASEReadCounter.table","NW_015090842.1:9477422",3,16,13
"ZFPM1","s1650_F_GON_01_ASEReadCounter.table","NW_015090842.1:9477554",17,38,21
"ZFPM1","s1650_F_GON_01_ASEReadCounter.table","NW_015090842.1:9477575",38,38,0
"ZFPM1","s1650_F_GON_01_ASEReadCounter.table","NW_015090842.1:9477595",20,41,21
"ZFPM1","s1650_F_GON_01_ASEReadCounter.table","NW_015090842.1:9477611",17,37,20
"ZFPM1","s1650_F_GON_01_ASEReadCounter.table","NW_015090842.1:9477659",18,43,25
"ZFPM1","s1650_F_GON_01_ASEReadCounter.table","NW_015090842.1:9477737",13,38,25
"ZFPM1","s1650_F_GON_01_ASEReadCounter.table","NW_015090842.1:9477791",12,32,20
"ZFPM1","s1650_F_GON_01_ASEReadCounter.table","NW_015090842.1:9477844",18,38,20
"ZFPM1","s1650_F_GON_01_ASEReadCounter.table","NW_015090842.1:9477917",13,27,14
"ZFPM1","s1650_F_GON_01_ASEReadCounter.table","NW_015090842.1:9478295",13,35,22
"ZFPM1","s1650_F_GON_01_ASEReadCounter.table","NW_015090842.1:9478349",19,43,24
"ZFPM1","s1650_F_GON_01_ASEReadCounter.table","NW_015090842.1:9478524",17,37,20
"ZFPM1","s1650_F_GON_01_ASEReadCounter.table","NW_015090842.1:9478546",20,42,22
"ZFPM1","s1650_F_GON_01_ASEReadCounter.table","NW_015090842.1:9478573",21,41,20
"ZFPM1","s1650_F_GON_01_ASEReadCounter.table","NW_015090842.1:9478582",19,37,18
"ZFPM1","s1650_F_GON_01_ASEReadCounter.table","NW_015090842.1:9478684",5,16,11
"ZFPM1","s1650_F_GON_01_ASEReadCounter.table","NW_015090842.1:9478711",4,13,9
"ZFPM1","s1650_F_GON_01_ASEReadCounter.table","NW_015090842.1:9478761",7,20,13
"ZFPM1","s1650_F_GON_01_ASEReadCounter.table","NW_015090842.1:9478829",9,9,0
"CIDEC","s1650_F_GON_01_ASEReadCounter.table","NW_015090842.1:9480170",5,7,2
"CIDEC","s1650_F_GON_01_ASEReadCounter.table","NW_015090842.1:9480171",5,7,2
"CIDEC","s1650_F_GON_01_ASEReadCounter.table","NW_015090842.1:9480212",6,9,3
"CIDEC","s1650_F_GON_01_ASEReadCounter.table","NW_015090842.1:9480252",5,9,4
"CIDEC","s1650_F_GON_01_ASEReadCounter.table","NW_015090842.1:9480391",6,13,7
"CIDEC","s1650_F_GON_01_ASEReadCounter.table","NW_015090842.1:9480394",7,14,7
"CIDEC","s1650_F_GON_01_ASEReadCounter.table","NW_015090842.1:9480630",6,14,8
"CIDEC","s1650_F_GON_01_ASEReadCounter.table","NW_015090842.1:9480675",5,11,6
"CIDEC","s1650_F_GON_01_ASEReadCounter.table","NW_015090842.1:9480686",4,8,4
"CIDEC","s1650_F_GON_01_ASEReadCounter.table","NW_015090842.1:9480693",6,10,4
"CIDEC","s1650_F_GON_01_ASEReadCounter.table","NW_015090842.1:9480756",6,14,8
"CIDEC","s1650_F_GON_01_ASEReadCounter.table","NW_015090842.1:9481199",5,5,0
"CIDEC","s1650_F_GON_01_ASEReadCounter.table","NW_015090842.1:9481604",1,2,1
"ZC3H18","s1650_F_GON_01_ASEReadCounter.table","NW_015090842.1:9494271",8,27,19
"ZC3H18","s1650_F_GON_01_ASEReadCounter.table","NW_015090842.1:9501427",29,88,59
"ZC3H18","s1650_F_GON_01_ASEReadCounter.table","NW_015090842.1:9501442",26,89,63
"ZC3H18","s1650_F_GON_01_ASEReadCounter.table","NW_015090842.1:9505538",23,80,57
"ZC3H18","s1650_F_GON_01_ASEReadCounter.table","NW_015090842.1:9506778",23,99,76
"ZC3H18","s1650_F_GON_01_ASEReadCounter.table","NW_015090842.1:9522538",28,54,26
"ZC3H18","s1650_F_GON_01_ASEReadCounter.table","NW_015090842.1:9524350",31,62,31
"ZC3H18","s1650_F_GON_01_ASEReadCounter.table","NW_015090842.1:9524366",35,65,30
"ZC3H18","s1650_F_GON_01_ASEReadCounter.table","NW_015090842.1:9524424",35,63,28
"ZC3H18","s1650_F_GON_01_ASEReadCounter.table","NW_015090842.1:9529649",24,87,63
"ZC3H18","s1650_F_GON_01_ASEReadCounter.table","NW_015090842.1:9529688",29,80,51
"ZC3H18","s1650_F_GON_01_ASEReadCounter.table","NW_015090842.1:9529691",27,79,52
"ZC3H18","s1650_F_GON_01_ASEReadCounter.table","NW_015090842.1:9530977",40,87,47
"ZC3H18","s1650_F_GON_01_ASEReadCounter.table","NW_015090842.1:9536699",0,36,36
"CYBA","s1650_F_GON_01_ASEReadCounter.table","NW_015090842.1:9547281",48,65,17
"CYBA","s1650_F_GON_01_ASEReadCounter.table","NW_015090842.1:9547402",130,182,52
"CYBA","s1650_F_GON_01_ASEReadCounter.table","NW_015090842.1:9547553",79,145,66
"CYBA","s1650_F_GON_01_ASEReadCounter.table","NW_015090842.1:9548052",105,137,32
"CYBA","s1650_F_GON_01_ASEReadCounter.table","NW_015090842.1:9548436",158,222,64
"CYBA","s1650_F_GON_01_ASEReadCounter.table","NW_015090842.1:9548442",160,227,67
"CYBA","s1650_F_GON_01_ASEReadCounter.table","NW_015090842.1:9548478",200,267,67
"CYBA","s1650_F_GON_01_ASEReadCounter.table","NW_015090842.1:9548487",190,251,61
"CYBA","s1650_F_GON_01_ASEReadCounter.table","NW_015090842.1:9548490",188,247,59
"CYBA","s1650_F_GON_01_ASEReadCounter.table","NW_015090842.1:9548717",175,230,55
"CYBA","s1650_F_GON_01_ASEReadCounter.table","NW_015090842.1:9548750",120,164,44
"CYBA","s1650_F_GON_01_ASEReadCounter.table","NW_015090842.1:9548766",91,122,31
"MVD","s1650_F_GON_01_ASEReadCounter.table","NW_015090842.1:9550678",23,37,14
"MVD","s1650_F_GON_01_ASEReadCounter.table","NW_015090842.1:9550690",23,44,21
"MVD","s1650_F_GON_01_ASEReadCounter.table","NW_015090842.1:9550691",24,45,21
"MVD","s1650_F_GON_01_ASEReadCounter.table","NW_015090842.1:9550699",30,59,29
"MVD","s1650_F_GON_01_ASEReadCounter.table","NW_015090842.1:9550719",32,58,26
"MVD","s1650_F_GON_01_ASEReadCounter.table","NW_015090842.1:9551596",45,99,54
"MVD","s1650_F_GON_01_ASEReadCounter.table","NW_015090842.1:9551638",56,111,55
"MVD","s1650_F_GON_01_ASEReadCounter.table","NW_015090842.1:9551899",0,4,4
"MVD","s1650_F_GON_01_ASEReadCounter.table","NW_015090842.1:9552193",48,89,41
"MVD","s1650_F_GON_01_ASEReadCounter.table","NW_015090842.1:9552202",46,86,40
"MVD","s1650_F_GON_01_ASEReadCounter.table","NW_015090842.1:9552208",45,82,37
"MVD","s1650_F_GON_01_ASEReadCounter.table","NW_015090842.1:9552625",24,49,25
"MVD","s1650_F_GON_01_ASEReadCounter.table","NW_015090842.1:9552629",51,51,0
"MVD","s1650_F_GON_01_ASEReadCounter.table","NW_015090842.1:9552644",28,55,27
"MVD","s1650_F_GON_01_ASEReadCounter.table","NW_015090842.1:9553093",25,59,34
"MVD","s1650_F_GON_01_ASEReadCounter.table","NW_015090842.1:9553114",32,64,32
"RNF166","s1650_F_GON_01_ASEReadCounter.table","NW_015090842.1:9557900",25,47,22
"RNF166","s1650_F_GON_01_ASEReadCounter.table","NW_015090842.1:9558048",23,43,20
"RNF166","s1650_F_GON_01_ASEReadCounter.table","NW_015090842.1:9558116",28,46,18
"RNF166","s1650_F_GON_01_ASEReadCounter.table","NW_015090842.1:9558308",23,48,25
"RNF166","s1650_F_GON_01_ASEReadCounter.table","NW_015090842.1:9558405",26,48,22
"RNF166","s1650_F_GON_01_ASEReadCounter.table","NW_015090842.1:9558549",57,92,35
"RNF166","s1650_F_GON_01_ASEReadCounter.table","NW_015090842.1:9558556",45,83,38
"RNF166","s1650_F_GON_01_ASEReadCounter.table","NW_015090842.1:9558579",47,99,52
"RNF166","s1650_F_GON_01_ASEReadCounter.table","NW_015090842.1:9558599",38,92,54
"RNF166","s1650_F_GON_01_ASEReadCounter.table","NW_015090842.1:9558688",37,72,35
"RNF166","s1650_F_GON_01_ASEReadCounter.table","NW_015090842.1:9558711",40,80,40
"RNF166","s1650_F_GON_01_ASEReadCounter.table","NW_015090842.1:9558733",45,87,42
"RNF166","s1650_F_GON_01_ASEReadCounter.table","NW_015090842.1:9558847",47,91,44
"RNF166","s1650_F_GON_01_ASEReadCounter.table","NW_015090842.1:9559798",39,89,50
"RNF166","s1650_F_GON_01_ASEReadCounter.table","NW_015090842.1:9560575",66,117,51
"RNF166","s1650_F_GON_01_ASEReadCounter.table","NW_015090842.1:9561055",56,106,50
"RNF166","s1650_F_GON_01_ASEReadCounter.table","NW_015090842.1:9562458",53,86,33
"RNF166","s1650_F_GON_01_ASEReadCounter.table","NW_015090842.1:9562497",46,74,28
"RNF166","s1650_F_GON_01_ASEReadCounter.table","NW_015090842.1:9562539",41,74,33
"RNF166","s1650_F_GON_01_ASEReadCounter.table","NW_015090842.1:9564056",29,54,25
"CTU2","s1650_F_GON_01_ASEReadCounter.table","NW_015090842.1:9565149",17,36,19
"CTU2","s1650_F_GON_01_ASEReadCounter.table","NW_015090842.1:9565193",14,31,17
"CTU2","s1650_F_GON_01_ASEReadCounter.table","NW_015090842.1:9565300",15,33,18
"CTU2","s1650_F_GON_01_ASEReadCounter.table","NW_015090842.1:9565321",12,31,19
"CTU2","s1650_F_GON_01_ASEReadCounter.table","NW_015090842.1:9565721",18,41,23
"CTU2","s1650_F_GON_01_ASEReadCounter.table","NW_015090842.1:9565739",17,39,22
"CTU2","s1650_F_GON_01_ASEReadCounter.table","NW_015090842.1:9565905",15,26,11
"CTU2","s1650_F_GON_01_ASEReadCounter.table","NW_015090842.1:9566013",31,31,0
"CTU2","s1650_F_GON_01_ASEReadCounter.table","NW_015090842.1:9566055",22,41,19
"CTU2","s1650_F_GON_01_ASEReadCounter.table","NW_015090842.1:9566056",21,40,19
"CTU2","s1650_F_GON_01_ASEReadCounter.table","NW_015090842.1:9566151",12,27,15
"CTU2","s1650_F_GON_01_ASEReadCounter.table","NW_015090842.1:9566300",16,39,23
"CTU2","s1650_F_GON_01_ASEReadCounter.table","NW_015090842.1:9566342",16,38,22
"CTU2","s1650_F_GON_01_ASEReadCounter.table","NW_015090842.1:9566548",16,43,27
"CTU2","s1650_F_GON_01_ASEReadCounter.table","NW_015090842.1:9566625",19,42,23
"CTU2","s1650_F_GON_01_ASEReadCounter.table","NW_015090842.1:9566633",18,43,25
"CTU2","s1650_F_GON_01_ASEReadCounter.table","NW_015090842.1:9566807",21,54,33
"CTU2","s1650_F_GON_01_ASEReadCounter.table","NW_015090842.1:9567139",22,62,40
"CTU2","s1650_F_GON_01_ASEReadCounter.table","NW_015090842.1:9567156",25,62,37
"CTU2","s1650_F_GON_01_ASEReadCounter.table","NW_015090842.1:9567614",20,45,25
"CTU2","s1650_F_GON_01_ASEReadCounter.table","NW_015090842.1:9567677",20,46,26
"CTU2","s1650_F_GON_01_ASEReadCounter.table","NW_015090842.1:9567747",24,46,22
"CTU2","s1650_F_GON_01_ASEReadCounter.table","NW_015090842.1:9567828",11,26,15
"CTU2","s1650_F_GON_01_ASEReadCounter.table","NW_015090842.1:9567829",11,26,15
"CTU2","s1650_F_GON_01_ASEReadCounter.table","NW_015090842.1:9567885",8,23,15
"PIEZO1","s1650_F_GON_01_ASEReadCounter.table","NW_015090842.1:9568093",40,77,37
"PIEZO1","s1650_F_GON_01_ASEReadCounter.table","NW_015090842.1:9568672",33,52,19
"PIEZO1","s1650_F_GON_01_ASEReadCounter.table","NW_015090842.1:9568948",30,51,21
"PIEZO1","s1650_F_GON_01_ASEReadCounter.table","NW_015090842.1:9568987",30,30,0
"PIEZO1","s1650_F_GON_01_ASEReadCounter.table","NW_015090842.1:9569040",10,22,12
"PIEZO1","s1650_F_GON_01_ASEReadCounter.table","NW_015090842.1:9569180",14,27,13
"PIEZO1","s1650_F_GON_01_ASEReadCounter.table","NW_015090842.1:9569192",15,26,11
"PIEZO1","s1650_F_GON_01_ASEReadCounter.table","NW_015090842.1:9570088",11,19,8
"PIEZO1","s1650_F_GON_01_ASEReadCounter.table","NW_015090842.1:9570480",11,23,12
"PIEZO1","s1650_F_GON_01_ASEReadCounter.table","NW_015090842.1:9570639",8,15,7
"PIEZO1","s1650_F_GON_01_ASEReadCounter.table","NW_015090842.1:9571847",8,10,2
"PIEZO1","s1650_F_GON_01_ASEReadCounter.table","NW_015090842.1:9572371",6,11,5
"PIEZO1","s1650_F_GON_01_ASEReadCounter.table","NW_015090842.1:9572638",8,9,1
"PIEZO1","s1650_F_GON_01_ASEReadCounter.table","NW_015090842.1:9573156",10,21,11
"PIEZO1","s1650_F_GON_01_ASEReadCounter.table","NW_015090842.1:9573280",10,17,7
"PIEZO1","s1650_F_GON_01_ASEReadCounter.table","NW_015090842.1:9573566",5,6,1
"PIEZO1","s1650_F_GON_01_ASEReadCounter.table","NW_015090842.1:9575341",4,7,3
"PIEZO1","s1650_F_GON_01_ASEReadCounter.table","NW_015090842.1:9575367",4,8,4
"PIEZO1","s1650_F_GON_01_ASEReadCounter.table","NW_015090842.1:9575645",7,11,4
"PIEZO1","s1650_F_GON_01_ASEReadCounter.table","NW_015090842.1:9575696",4,6,2
"PIEZO1","s1650_F_GON_01_ASEReadCounter.table","NW_015090842.1:9575897",4,9,5
"PIEZO1","s1650_F_GON_01_ASEReadCounter.table","NW_015090842.1:9576060",3,5,2
"PIEZO1","s1650_F_GON_01_ASEReadCounter.table","NW_015090842.1:9576087",4,6,2
"PIEZO1","s1650_F_GON_01_ASEReadCounter.table","NW_015090842.1:9576093",4,6,2
"PIEZO1","s1650_F_GON_01_ASEReadCounter.table","NW_015090842.1:9576120",4,6,2
"PIEZO1","s1650_F_GON_01_ASEReadCounter.table","NW_015090842.1:9576687",4,6,2
"PIEZO1","s1650_F_GON_01_ASEReadCounter.table","NW_015090842.1:9576710",5,7,2
"PIEZO1","s1650_F_GON_01_ASEReadCounter.table","NW_015090842.1:9576723",4,7,3
"PIEZO1","s1650_F_GON_01_ASEReadCounter.table","NW_015090842.1:9578268",6,6,0
"PIEZO1","s1650_F_GON_01_ASEReadCounter.table","NW_015090842.1:9578770",2,4,2
"PIEZO1","s1650_F_GON_01_ASEReadCounter.table","NW_015090842.1:9578806",1,2,1
"PIEZO1","s1650_F_GON_01_ASEReadCounter.table","NW_015090842.1:9579064",4,5,1
"PIEZO1","s1650_F_GON_01_ASEReadCounter.table","NW_015090842.1:9579065",3,4,1
"PIEZO1","s1650_F_GON_01_ASEReadCounter.table","NW_015090842.1:9579347",2,2,0
"PIEZO1","s1650_F_GON_01_ASEReadCounter.table","NW_015090842.1:9580765",2,5,3
"PIEZO1","s1650_F_GON_01_ASEReadCounter.table","NW_015090842.1:9580996",0,4,4
"PIEZO1","s1650_F_GON_01_ASEReadCounter.table","NW_015090842.1:9581101",3,7,4
"PIEZO1","s1650_F_GON_01_ASEReadCounter.table","NW_015090842.1:9581299",1,3,2
"PIEZO1","s1650_F_GON_01_ASEReadCounter.table","NW_015090842.1:9581875",6,8,2
"PIEZO1","s1650_F_GON_01_ASEReadCounter.table","NW_015090842.1:9582046",2,2,0
"PIEZO1","s1650_F_GON_01_ASEReadCounter.table","NW_015090842.1:9582961",4,5,1
"PIEZO1","s1650_F_GON_01_ASEReadCounter.table","NW_015090842.1:9583298",1,2,1
"PIEZO1","s1650_F_GON_01_ASEReadCounter.table","NW_015090842.1:9584337",1,4,3
"PIEZO1","s1650_F_GON_01_ASEReadCounter.table","NW_015090842.1:9584425",0,2,2
"PIEZO1","s1650_F_GON_01_ASEReadCounter.table","NW_015090842.1:9584435",0,3,3
"PIEZO1","s1650_F_GON_01_ASEReadCounter.table","NW_015090842.1:9584438",0,3,3
"PIEZO1","s1650_F_GON_01_ASEReadCounter.table","NW_015090842.1:9584441",0,3,3
"CDT1","s1650_F_GON_01_ASEReadCounter.table","NW_015090842.1:9596596",6,15,9
"CDT1","s1650_F_GON_01_ASEReadCounter.table","NW_015090842.1:9596766",7,13,6
"CDT1","s1650_F_GON_01_ASEReadCounter.table","NW_015090842.1:9597054",19,40,21
"CDT1","s1650_F_GON_01_ASEReadCounter.table","NW_015090842.1:9597074",19,36,17
"CDT1","s1650_F_GON_01_ASEReadCounter.table","NW_015090842.1:9597137",23,45,22
"CDT1","s1650_F_GON_01_ASEReadCounter.table","NW_015090842.1:9597756",26,50,24
"CDT1","s1650_F_GON_01_ASEReadCounter.table","NW_015090842.1:9597766",30,58,28
"CDT1","s1650_F_GON_01_ASEReadCounter.table","NW_015090842.1:9598496",42,66,24
"CDT1","s1650_F_GON_01_ASEReadCounter.table","NW_015090842.1:9598498",42,64,22
"CDT1","s1650_F_GON_01_ASEReadCounter.table","NW_015090842.1:9598816",30,58,28
"CDT1","s1650_F_GON_01_ASEReadCounter.table","NW_015090842.1:9598879",35,64,29
"CDT1","s1650_F_GON_01_ASEReadCounter.table","NW_015090842.1:9598912",36,71,35
"CDT1","s1650_F_GON_01_ASEReadCounter.table","NW_015090842.1:9598959",39,80,41
"CDT1","s1650_F_GON_01_ASEReadCounter.table","NW_015090842.1:9599807",37,63,26
"CDT1","s1650_F_GON_01_ASEReadCounter.table","NW_015090842.1:9599819",34,65,31
"CDT1","s1650_F_GON_01_ASEReadCounter.table","NW_015090842.1:9599845",41,75,34
"CDT1","s1650_F_GON_01_ASEReadCounter.table","NW_015090842.1:9600148",65,129,64
"CDT1","s1650_F_GON_01_ASEReadCounter.table","NW_015090842.1:9600151",65,128,63
"CDT1","s1650_F_GON_01_ASEReadCounter.table","NW_015090842.1:9600217",64,128,64
"CDT1","s1650_F_GON_01_ASEReadCounter.table","NW_015090842.1:9600226",58,119,61
"CDT1","s1650_F_GON_01_ASEReadCounter.table","NW_015090842.1:9600260",53,107,54
"CDT1","s1650_F_GON_01_ASEReadCounter.table","NW_015090842.1:9600268",54,104,50
"CDT1","s1650_F_GON_01_ASEReadCounter.table","NW_015090842.1:9600305",46,102,56
"CDT1","s1650_F_GON_01_ASEReadCounter.table","NW_015090842.1:9600397",57,97,40
"CDT1","s1650_F_GON_01_ASEReadCounter.table","NW_015090842.1:9600447",30,54,24
"CDT1","s1650_F_GON_01_ASEReadCounter.table","NW_015090842.1:9600450",27,51,24
"CDT1","s1650_F_GON_01_ASEReadCounter.table","NW_015090842.1:9600485",40,70,30
"CDT1","s1650_F_GON_01_ASEReadCounter.table","NW_015090842.1:9600579",37,77,40
"APRT","s1650_F_GON_01_ASEReadCounter.table","NW_015090842.1:9602308",28,44,16
"APRT","s1650_F_GON_01_ASEReadCounter.table","NW_015090842.1:9602440",48,86,38
"APRT","s1650_F_GON_01_ASEReadCounter.table","NW_015090842.1:9602449",46,84,38
"APRT","s1650_F_GON_01_ASEReadCounter.table","NW_015090842.1:9602451",46,86,40
"APRT","s1650_F_GON_01_ASEReadCounter.table","NW_015090842.1:9602455",40,83,43
"APRT","s1650_F_GON_01_ASEReadCounter.table","NW_015090842.1:9602462",41,83,42
"APRT","s1650_F_GON_01_ASEReadCounter.table","NW_015090842.1:9602507",41,82,41
"APRT","s1650_F_GON_01_ASEReadCounter.table","NW_015090842.1:9602514",43,87,44
"APRT","s1650_F_GON_01_ASEReadCounter.table","NW_015090842.1:9602530",40,81,41
"APRT","s1650_F_GON_01_ASEReadCounter.table","NW_015090842.1:9602582",40,74,34
"APRT","s1650_F_GON_01_ASEReadCounter.table","NW_015090842.1:9602583",40,75,35
"APRT","s1650_F_GON_01_ASEReadCounter.table","NW_015090842.1:9602650",48,85,37
"APRT","s1650_F_GON_01_ASEReadCounter.table","NW_015090842.1:9602655",46,86,40
"APRT","s1650_F_GON_01_ASEReadCounter.table","NW_015090842.1:9602712",42,86,44
"APRT","s1650_F_GON_01_ASEReadCounter.table","NW_015090842.1:9602764",42,83,41
"APRT","s1650_F_GON_01_ASEReadCounter.table","NW_015090842.1:9602821",45,88,43
"APRT","s1650_F_GON_01_ASEReadCounter.table","NW_015090842.1:9602867",51,95,44
"APRT","s1650_F_GON_01_ASEReadCounter.table","NW_015090842.1:9602883",49,89,40
"APRT","s1650_F_GON_01_ASEReadCounter.table","NW_015090842.1:9602886",50,91,41
"APRT","s1650_F_GON_01_ASEReadCounter.table","NW_015090842.1:9602948",44,72,28
"APRT","s1650_F_GON_01_ASEReadCounter.table","NW_015090842.1:9602958",49,78,29
"APRT","s1650_F_GON_01_ASEReadCounter.table","NW_015090842.1:9603020",71,112,41
"APRT","s1650_F_GON_01_ASEReadCounter.table","NW_015090842.1:9603025",70,109,39
"APRT","s1650_F_GON_01_ASEReadCounter.table","NW_015090842.1:9603154",41,74,33
"APRT","s1650_F_GON_01_ASEReadCounter.table","NW_015090842.1:9603166",55,101,46
"APRT","s1650_F_GON_01_ASEReadCounter.table","NW_015090842.1:9603326",53,92,39
"APRT","s1650_F_GON_01_ASEReadCounter.table","NW_015090842.1:9603419",50,86,36
"APRT","s1650_F_GON_01_ASEReadCounter.table","NW_015090842.1:9603420",50,83,33
"APRT","s1650_F_GON_01_ASEReadCounter.table","NW_015090842.1:9603464",48,110,62
"APRT","s1650_F_GON_01_ASEReadCounter.table","NW_015090842.1:9603528",76,190,114
"APRT","s1650_F_GON_01_ASEReadCounter.table","NW_015090842.1:9603607",105,261,156
"APRT","s1650_F_GON_01_ASEReadCounter.table","NW_015090842.1:9603622",98,254,156
"APRT","s1650_F_GON_01_ASEReadCounter.table","NW_015090842.1:9604361",101,273,172
"APRT","s1650_F_GON_01_ASEReadCounter.table","NW_015090842.1:9605317",98,258,160
"APRT","s1650_F_GON_01_ASEReadCounter.table","NW_015090842.1:9605336",97,272,175
"GALNS","s1650_F_GON_01_ASEReadCounter.table","NW_015090842.1:9612872",24,36,12
"GALNS","s1650_F_GON_01_ASEReadCounter.table","NW_015090842.1:9612873",19,32,13
"GALNS","s1650_F_GON_01_ASEReadCounter.table","NW_015090842.1:9612877",20,32,12
"GALNS","s1650_F_GON_01_ASEReadCounter.table","NW_015090842.1:9612942",82,146,64
"GALNS","s1650_F_GON_01_ASEReadCounter.table","NW_015090842.1:9612987",144,144,0
"GALNS","s1650_F_GON_01_ASEReadCounter.table","NW_015090842.1:9613064",120,219,99
"GALNS","s1650_F_GON_01_ASEReadCounter.table","NW_015090842.1:9613096",155,263,108
"GALNS","s1650_F_GON_01_ASEReadCounter.table","NW_015090842.1:9613123",121,215,94
"GALNS","s1650_F_GON_01_ASEReadCounter.table","NW_015090842.1:9613125",123,210,87
"GALNS","s1650_F_GON_01_ASEReadCounter.table","NW_015090842.1:9613193",146,252,106
"GALNS","s1650_F_GON_01_ASEReadCounter.table","NW_015090842.1:9613226",148,253,105
"GALNS","s1650_F_GON_01_ASEReadCounter.table","NW_015090842.1:9613249",153,273,120
"GALNS","s1650_F_GON_01_ASEReadCounter.table","NW_015090842.1:9613256",170,294,124
"GALNS","s1650_F_GON_01_ASEReadCounter.table","NW_015090842.1:9613317",152,275,123
"GALNS","s1650_F_GON_01_ASEReadCounter.table","NW_015090842.1:9613343",156,273,117
"GALNS","s1650_F_GON_01_ASEReadCounter.table","NW_015090842.1:9613344",154,271,117
"GALNS","s1650_F_GON_01_ASEReadCounter.table","NW_015090842.1:9613371",153,284,131
"GALNS","s1650_F_GON_01_ASEReadCounter.table","NW_015090842.1:9613378",148,283,135
"GALNS","s1650_F_GON_01_ASEReadCounter.table","NW_015090842.1:9613379",151,285,134
"GALNS","s1650_F_GON_01_ASEReadCounter.table","NW_015090842.1:9613516",189,324,135
"GALNS","s1650_F_GON_01_ASEReadCounter.table","NW_015090842.1:9613572",175,321,146
"GALNS","s1650_F_GON_01_ASEReadCounter.table","NW_015090842.1:9613597",163,326,163
"GALNS","s1650_F_GON_01_ASEReadCounter.table","NW_015090842.1:9613627",118,243,125
"GALNS","s1650_F_GON_01_ASEReadCounter.table","NW_015090842.1:9613640",125,263,138
"GALNS","s1650_F_GON_01_ASEReadCounter.table","NW_015090842.1:9614025",149,249,100
"GALNS","s1650_F_GON_01_ASEReadCounter.table","NW_015090842.1:9614169",138,223,85
"GALNS","s1650_F_GON_01_ASEReadCounter.table","NW_015090842.1:9614232",254,254,0
"GALNS","s1650_F_GON_01_ASEReadCounter.table","NW_015090842.1:9614667",143,245,102
"GALNS","s1650_F_GON_01_ASEReadCounter.table","NW_015090842.1:9614709",123,230,107
"GALNS","s1650_F_GON_01_ASEReadCounter.table","NW_015090842.1:9614880",194,295,101
"GALNS","s1650_F_GON_01_ASEReadCounter.table","NW_015090842.1:9614902",181,287,106
"GALNS","s1650_F_GON_01_ASEReadCounter.table","NW_015090842.1:9614960",161,277,116
"GALNS","s1650_F_GON_01_ASEReadCounter.table","NW_015090842.1:9615114",219,378,159
"GALNS","s1650_F_GON_01_ASEReadCounter.table","NW_015090842.1:9615199",202,385,183
"GALNS","s1650_F_GON_01_ASEReadCounter.table","NW_015090842.1:9615217",193,373,180
"GALNS","s1650_F_GON_01_ASEReadCounter.table","NW_015090842.1:9615277",161,407,246
"GALNS","s1650_F_GON_01_ASEReadCounter.table","NW_015090842.1:9615377",251,663,412
"GALNS","s1650_F_GON_01_ASEReadCounter.table","NW_015090842.1:9647858",202,708,506
"GALNS","s1650_F_GON_01_ASEReadCounter.table","NW_015090842.1:9649186",186,708,522
"GALNS","s1650_F_GON_01_ASEReadCounter.table","NW_015090842.1:9649237",190,659,469
"GALNS","s1650_F_GON_01_ASEReadCounter.table","NW_015090842.1:9661193",108,347,239
"TRAPPC2L","s1650_F_GON_01_ASEReadCounter.table","NW_015090842.1:9662951",625,1042,417
"TRAPPC2L","s1650_F_GON_01_ASEReadCounter.table","NW_015090842.1:9663014",677,1129,452
"TRAPPC2L","s1650_F_GON_01_ASEReadCounter.table","NW_015090842.1:9664305",890,892,2
"TRAPPC2L","s1650_F_GON_01_ASEReadCounter.table","NW_015090842.1:9665155",486,799,313
"TRAPPC2L","s1650_F_GON_01_ASEReadCounter.table","NW_015090842.1:9665211",146,274,128
"PABPN1L","s1650_F_GON_01_ASEReadCounter.table","NW_015090842.1:9669959",6,14,8
"CBFA2T3","s1650_F_GON_01_ASEReadCounter.table","NW_015090842.1:9717058",0,1,1
"CBFA2T3","s1650_F_GON_01_ASEReadCounter.table","NW_015090842.1:9717093",1,2,1
"CBFA2T3","s1650_F_GON_01_ASEReadCounter.table","NW_015090842.1:9717114",1,1,0
"CBFA2T3","s1650_F_GON_01_ASEReadCounter.table","NW_015090842.1:9717139",1,1,0
"ACSF3","s1650_F_GON_01_ASEReadCounter.table","NW_015090842.1:9773379",7,25,18
"ACSF3","s1650_F_GON_01_ASEReadCounter.table","NW_015090842.1:9773382",7,25,18
"ACSF3","s1650_F_GON_01_ASEReadCounter.table","NW_015090842.1:9773384",8,24,16
"ACSF3","s1650_F_GON_01_ASEReadCounter.table","NW_015090842.1:9773388",7,28,21
"ACSF3","s1650_F_GON_01_ASEReadCounter.table","NW_015090842.1:9776753",31,68,37
"ACSF3","s1650_F_GON_01_ASEReadCounter.table","NW_015090842.1:9776783",29,64,35
"ACSF3","s1650_F_GON_01_ASEReadCounter.table","NW_015090842.1:9776879",28,68,40
"ACSF3","s1650_F_GON_01_ASEReadCounter.table","NW_015090842.1:9776965",36,79,43
"ACSF3","s1650_F_GON_01_ASEReadCounter.table","NW_015090842.1:9777091",43,103,60
"ACSF3","s1650_F_GON_01_ASEReadCounter.table","NW_015090842.1:9777206",39,92,53
"ACSF3","s1650_F_GON_01_ASEReadCounter.table","NW_015090842.1:9777283",41,115,74
"ACSF3","s1650_F_GON_01_ASEReadCounter.table","NW_015090842.1:9778955",36,114,78
"ACSF3","s1650_F_GON_01_ASEReadCounter.table","NW_015090842.1:9778997",62,151,89
"ACSF3","s1650_F_GON_01_ASEReadCounter.table","NW_015090842.1:9789311",14,31,17
"ACSF3","s1650_F_GON_01_ASEReadCounter.table","NW_015090842.1:9789906",0,24,24
"ACSF3","s1650_F_GON_01_ASEReadCounter.table","NW_015090842.1:9834743",28,62,34
"ACSF3","s1650_F_GON_01_ASEReadCounter.table","NW_015090842.1:9834852",47,76,29
"ACSF3","s1650_F_GON_01_ASEReadCounter.table","NW_015090842.1:9834861",45,71,26
"ACSF3","s1650_F_GON_01_ASEReadCounter.table","NW_015090842.1:9839359",33,58,25
"ACSF3","s1650_F_GON_01_ASEReadCounter.table","NW_015090842.1:9839378",31,54,23
"ACSF3","s1650_F_GON_01_ASEReadCounter.table","NW_015090842.1:9839455",17,40,23
"ACSF3","s1650_F_GON_01_ASEReadCounter.table","NW_015090842.1:9839457",17,39,22
"ACSF3","s1650_F_GON_01_ASEReadCounter.table","NW_015090842.1:9839489",16,36,20
"ACSF3","s1650_F_GON_01_ASEReadCounter.table","NW_015090842.1:9839500",15,31,16
"ACSF3","s1650_F_GON_01_ASEReadCounter.table","NW_015090842.1:9839501",15,30,15
"ACSF3","s1650_F_GON_01_ASEReadCounter.table","NW_015090842.1:9839504",17,32,15
"ACSF3","s1650_F_GON_01_ASEReadCounter.table","NW_015090842.1:9839512",13,25,12
"ACSF3","s1650_F_GON_01_ASEReadCounter.table","NW_015090842.1:9839527",11,23,12
"ACSF3","s1650_F_GON_01_ASEReadCounter.table","NW_015090842.1:9839533",8,19,11
"ACSF3","s1650_F_GON_01_ASEReadCounter.table","NW_015090842.1:9839535",7,18,11
"ACSF3","s1650_F_GON_01_ASEReadCounter.table","NW_015090842.1:9839545",4,13,9
"ACSF3","s1650_F_GON_01_ASEReadCounter.table","NW_015090842.1:9839550",3,13,10
"ACSF3","s1650_F_GON_01_ASEReadCounter.table","NW_015090842.1:9839551",3,12,9
"CDH15","s1650_F_GON_01_ASEReadCounter.table","NW_015090842.1:9847174",0,1,1
"CDH15","s1650_F_GON_01_ASEReadCounter.table","NW_015090842.1:9848004",0,1,1
"CDH15","s1650_F_GON_01_ASEReadCounter.table","NW_015090842.1:9848531",0,1,1
"CDH15","s1650_F_GON_01_ASEReadCounter.table","NW_015090842.1:9848552",0,1,1
"CDH15","s1650_F_GON_01_ASEReadCounter.table","NW_015090842.1:9848888",0,1,1
"CDH15","s1650_F_GON_01_ASEReadCounter.table","NW_015090842.1:9848936",0,1,1
"CDH15","s1650_F_GON_01_ASEReadCounter.table","NW_015090842.1:9849086",1,2,1
"CDH15","s1650_F_GON_01_ASEReadCounter.table","NW_015090842.1:9849140",0,1,1
"CDH15","s1650_F_GON_01_ASEReadCounter.table","NW_015090842.1:9849473",2,2,0
"CDH15","s1650_F_GON_01_ASEReadCounter.table","NW_015090842.1:9850141",1,1,0
"CDH15","s1650_F_GON_01_ASEReadCounter.table","NW_015090842.1:9850386",1,1,0
"CDH15","s1650_F_GON_01_ASEReadCounter.table","NW_015090842.1:9850432",1,1,0
"CDH15","s1650_F_GON_01_ASEReadCounter.table","NW_015090842.1:9850609",1,1,0
"SLC22A31","s1650_F_GON_01_ASEReadCounter.table","NW_015090842.1:9850797",2,2,0
"SLC22A31","s1650_F_GON_01_ASEReadCounter.table","NW_015090842.1:9850818",2,2,0
"SLC22A31","s1650_F_GON_01_ASEReadCounter.table","NW_015090842.1:9850929",0,1,1
"SLC22A31","s1650_F_GON_01_ASEReadCounter.table","NW_015090842.1:9850936",1,2,1
"SLC22A31","s1650_F_GON_01_ASEReadCounter.table","NW_015090842.1:9850940",1,2,1
"SLC22A31","s1650_F_GON_01_ASEReadCounter.table","NW_015090842.1:9850948",1,2,1
"SLC22A31","s1650_F_GON_01_ASEReadCounter.table","NW_015090842.1:9850961",1,2,1
"SLC22A31","s1650_F_GON_01_ASEReadCounter.table","NW_015090842.1:9850970",1,2,1
"SLC22A31","s1650_F_GON_01_ASEReadCounter.table","NW_015090842.1:9850978",1,2,1
"SLC22A31","s1650_F_GON_01_ASEReadCounter.table","NW_015090842.1:9850981",1,2,1
"SLC22A31","s1650_F_GON_01_ASEReadCounter.table","NW_015090842.1:9851117",24,34,10
"SLC22A31","s1650_F_GON_01_ASEReadCounter.table","NW_015090842.1:9851130",29,38,9
"SLC22A31","s1650_F_GON_01_ASEReadCounter.table","NW_015090842.1:9851139",30,43,13
"SLC22A31","s1650_F_GON_01_ASEReadCounter.table","NW_015090842.1:9851265",50,82,32
"SLC22A31","s1650_F_GON_01_ASEReadCounter.table","NW_015090842.1:9851302",50,81,31
"SLC22A31","s1650_F_GON_01_ASEReadCounter.table","NW_015090842.1:9851303",52,81,29
"SLC22A31","s1650_F_GON_01_ASEReadCounter.table","NW_015090842.1:9851305",51,82,31
"SLC22A31","s1650_F_GON_01_ASEReadCounter.table","NW_015090842.1:9851343",50,70,20
"SLC22A31","s1650_F_GON_01_ASEReadCounter.table","NW_015090842.1:9851344",60,76,16
"SLC22A31","s1650_F_GON_01_ASEReadCounter.table","NW_015090842.1:9851361",79,80,1
"SLC22A31","s1650_F_GON_01_ASEReadCounter.table","NW_015090842.1:9851381",71,101,30
"SLC22A31","s1650_F_GON_01_ASEReadCounter.table","NW_015090842.1:9851421",94,138,44
"SLC22A31","s1650_F_GON_01_ASEReadCounter.table","NW_015090842.1:9851501",77,109,32
"SLC22A31","s1650_F_GON_01_ASEReadCounter.table","NW_015090842.1:9851526",86,136,50
"SLC22A31","s1650_F_GON_01_ASEReadCounter.table","NW_015090842.1:9851589",103,148,45
"SLC22A31","s1650_F_GON_01_ASEReadCounter.table","NW_015090842.1:9851712",113,162,49
"SLC22A31","s1650_F_GON_01_ASEReadCounter.table","NW_015090842.1:9851899",115,171,56
"SLC22A31","s1650_F_GON_01_ASEReadCounter.table","NW_015090842.1:9852139",123,169,46
"SLC22A31","s1650_F_GON_01_ASEReadCounter.table","NW_015090842.1:9852380",140,194,54
"SLC22A31","s1650_F_GON_01_ASEReadCounter.table","NW_015090842.1:9852431",90,132,42
"SLC22A31","s1650_F_GON_01_ASEReadCounter.table","NW_015090842.1:9852630",98,126,28
"SLC22A31","s1650_F_GON_01_ASEReadCounter.table","NW_015090842.1:9852711",76,110,34
"SLC22A31","s1650_F_GON_01_ASEReadCounter.table","NW_015090842.1:9853099",83,109,26
"SLC22A31","s1650_F_GON_01_ASEReadCounter.table","NW_015090842.1:9853102",87,112,25
"SLC22A31","s1650_F_GON_01_ASEReadCounter.table","NW_015090842.1:9853421",84,84,0
"SLC22A31","s1650_F_GON_01_ASEReadCounter.table","NW_015090842.1:9853457",88,88,0
"SLC22A31","s1650_F_GON_01_ASEReadCounter.table","NW_015090842.1:9853502",71,71,0
"ANKRD11","s1650_F_GON_01_ASEReadCounter.table","NW_015090842.1:9858863",0,1,1
"ANKRD11","s1650_F_GON_01_ASEReadCounter.table","NW_015090842.1:9859101",24,39,15
"ANKRD11","s1650_F_GON_01_ASEReadCounter.table","NW_015090842.1:9859352",19,43,24
"ANKRD11","s1650_F_GON_01_ASEReadCounter.table","NW_015090842.1:9859381",3,25,22
"ANKRD11","s1650_F_GON_01_ASEReadCounter.table","NW_015090842.1:9859679",20,38,18
"ANKRD11","s1650_F_GON_01_ASEReadCounter.table","NW_015090842.1:9861097",14,36,22
"ANKRD11","s1650_F_GON_01_ASEReadCounter.table","NW_015090842.1:9862571",5,13,8
"ANKRD11","s1650_F_GON_01_ASEReadCounter.table","NW_015090842.1:9862652",6,8,2
"ANKRD11","s1650_F_GON_01_ASEReadCounter.table","NW_015090842.1:9866071",0,8,8
"ANKRD11","s1650_F_GON_01_ASEReadCounter.table","NW_015090842.1:9866200",0,13,13
"ANKRD11","s1650_F_GON_01_ASEReadCounter.table","NW_015090842.1:9867391",4,8,4
"ANKRD11","s1650_F_GON_01_ASEReadCounter.table","NW_015090842.1:9867472",2,10,8
"ANKRD11","s1650_F_GON_01_ASEReadCounter.table","NW_015090842.1:9867559",6,14,8
"ANKRD11","s1650_F_GON_01_ASEReadCounter.table","NW_015090842.1:9867667",3,13,10
"ANKRD11","s1650_F_GON_01_ASEReadCounter.table","NW_015090842.1:9867934",8,16,8
"ANKRD11","s1650_F_GON_01_ASEReadCounter.table","NW_015090842.1:9868064",8,16,8
"ANKRD11","s1650_F_GON_01_ASEReadCounter.table","NW_015090842.1:9868093",6,16,10
"ANKRD11","s1650_F_GON_01_ASEReadCounter.table","NW_015090842.1:9868222",10,19,9
"ANKRD11","s1650_F_GON_01_ASEReadCounter.table","NW_015090842.1:9868327",12,16,4
"ANKRD11","s1650_F_GON_01_ASEReadCounter.table","NW_015090842.1:9868414",5,12,7
"ANKRD11","s1650_F_GON_01_ASEReadCounter.table","NW_015090842.1:9868441",4,8,4
"ANKRD11","s1650_F_GON_01_ASEReadCounter.table","NW_015090842.1:9868444",6,11,5
"ANKRD11","s1650_F_GON_01_ASEReadCounter.table","NW_015090842.1:9868519",11,18,7
"ANKRD11","s1650_F_GON_01_ASEReadCounter.table","NW_015090842.1:9868609",9,15,6
"ANKRD11","s1650_F_GON_01_ASEReadCounter.table","NW_015090842.1:9868666",14,24,10
"ANKRD11","s1650_F_GON_01_ASEReadCounter.table","NW_015090842.1:9868738",25,25,0
"ANKRD11","s1650_F_GON_01_ASEReadCounter.table","NW_015090842.1:9869431",6,12,6
"ANKRD11","s1650_F_GON_01_ASEReadCounter.table","NW_015090842.1:9869578",18,33,15
"ANKRD11","s1650_F_GON_01_ASEReadCounter.table","NW_015090842.1:9869734",16,32,16
"ANKRD11","s1650_F_GON_01_ASEReadCounter.table","NW_015090842.1:9870070",13,24,11
"ANKRD11","s1650_F_GON_01_ASEReadCounter.table","NW_015090842.1:9870349",13,23,10
"ANKRD11","s1650_F_GON_01_ASEReadCounter.table","NW_015090842.1:9870604",14,24,10
"ANKRD11","s1650_F_GON_01_ASEReadCounter.table","NW_015090842.1:9870613",13,23,10
"ANKRD11","s1650_F_GON_01_ASEReadCounter.table","NW_015090842.1:9870685",19,33,14
"ANKRD11","s1650_F_GON_01_ASEReadCounter.table","NW_015090842.1:9870760",8,22,14
"ANKRD11","s1650_F_GON_01_ASEReadCounter.table","NW_015090842.1:9870847",8,16,8
"ANKRD11","s1650_F_GON_01_ASEReadCounter.table","NW_015090842.1:9871103",9,12,3
"ANKRD11","s1650_F_GON_01_ASEReadCounter.table","NW_015090842.1:9871165",11,18,7
"ANKRD11","s1650_F_GON_01_ASEReadCounter.table","NW_015090842.1:9871508",15,15,0
"ANKRD11","s1650_F_GON_01_ASEReadCounter.table","NW_015090842.1:9871820",2,4,2
"ANKRD11","s1650_F_GON_01_ASEReadCounter.table","NW_015090842.1:9872118",5,12,7
"ANKRD11","s1650_F_GON_01_ASEReadCounter.table","NW_015090842.1:9877406",1,5,4
"SPG7","s1650_F_GON_01_ASEReadCounter.table","NW_015090842.1:10051190",146,334,188
"SPG7","s1650_F_GON_01_ASEReadCounter.table","NW_015090842.1:10051218",172,411,239
"SPG7","s1650_F_GON_01_ASEReadCounter.table","NW_015090842.1:10052348",205,451,246
"SPG7","s1650_F_GON_01_ASEReadCounter.table","NW_015090842.1:10052366",197,454,257
"SPG7","s1650_F_GON_01_ASEReadCounter.table","NW_015090842.1:10065173",186,416,230
"SPG7","s1650_F_GON_01_ASEReadCounter.table","NW_015090842.1:10065215",175,382,207
"SPG7","s1650_F_GON_01_ASEReadCounter.table","NW_015090842.1:10066365",161,360,199
"SPG7","s1650_F_GON_01_ASEReadCounter.table","NW_015090842.1:10069752",170,399,229
"SPG7","s1650_F_GON_01_ASEReadCounter.table","NW_015090842.1:10069800",190,489,299
"SPG7","s1650_F_GON_01_ASEReadCounter.table","NW_015090842.1:10071192",219,532,313
"SPG7","s1650_F_GON_01_ASEReadCounter.table","NW_015090842.1:10071219",189,473,284
"SPG7","s1650_F_GON_01_ASEReadCounter.table","NW_015090842.1:10071967",160,438,278
"SPG7","s1650_F_GON_01_ASEReadCounter.table","NW_015090842.1:10075109",224,544,320
"SPG7","s1650_F_GON_01_ASEReadCounter.table","NW_015090842.1:10075114",240,549,309
"SPG7","s1650_F_GON_01_ASEReadCounter.table","NW_015090842.1:10075198",198,435,237
"SPG7","s1650_F_GON_01_ASEReadCounter.table","NW_015090842.1:10075487",143,369,226
"SPG7","s1650_F_GON_01_ASEReadCounter.table","NW_015090842.1:10075488",144,370,226
"SPG7","s1650_F_GON_01_ASEReadCounter.table","NW_015090842.1:10075548",104,252,148
"RPL13","s1650_F_GON_01_ASEReadCounter.table","NW_015090842.1:10077387",815,1658,843
"RPL13","s1650_F_GON_01_ASEReadCounter.table","NW_015090842.1:10077978",1231,2412,1181
"RPL13","s1650_F_GON_01_ASEReadCounter.table","NW_015090842.1:10077992",1222,2344,1122
"CPNE7","s1650_F_GON_01_ASEReadCounter.table","NW_015090842.1:10084001",2,5,3
"CPNE7","s1650_F_GON_01_ASEReadCounter.table","NW_015090842.1:10084856",2,3,1
"CPNE7","s1650_F_GON_01_ASEReadCounter.table","NW_015090842.1:10084872",1,2,1
"CPNE7","s1650_F_GON_01_ASEReadCounter.table","NW_015090842.1:10084892",1,1,0
"CPNE7","s1650_F_GON_01_ASEReadCounter.table","NW_015090842.1:10084921",3,4,1
"CPNE7","s1650_F_GON_01_ASEReadCounter.table","NW_015090842.1:10084935",3,5,2
"CPNE7","s1650_F_GON_01_ASEReadCounter.table","NW_015090842.1:10085000",6,8,2
"CPNE7","s1650_F_GON_01_ASEReadCounter.table","NW_015090842.1:10085089",1,3,2
"CPNE7","s1650_F_GON_01_ASEReadCounter.table","NW_015090842.1:10085096",1,3,2
"CPNE7","s1650_F_GON_01_ASEReadCounter.table","NW_015090842.1:10085126",1,3,2
"CPNE7","s1650_F_GON_01_ASEReadCounter.table","NW_015090842.1:10085167",1,1,0
"CPNE7","s1650_F_GON_01_ASEReadCounter.table","NW_015090842.1:10085180",0,2,2
"CPNE7","s1650_F_GON_01_ASEReadCounter.table","NW_015090842.1:10085201",0,2,2
"CPNE7","s1650_F_GON_01_ASEReadCounter.table","NW_015090842.1:10088134",1,2,1
"CPNE7","s1650_F_GON_01_ASEReadCounter.table","NW_015090842.1:10088146",1,2,1
"CPNE7","s1650_F_GON_01_ASEReadCounter.table","NW_015090842.1:10088806",3,8,5
"CPNE7","s1650_F_GON_01_ASEReadCounter.table","NW_015090842.1:10088940",3,8,5
"CPNE7","s1650_F_GON_01_ASEReadCounter.table","NW_015090842.1:10088965",4,8,4
"CPNE7","s1650_F_GON_01_ASEReadCounter.table","NW_015090842.1:10088967",4,8,4
"CPNE7","s1650_F_GON_01_ASEReadCounter.table","NW_015090842.1:10088973",4,7,3
"CPNE7","s1650_F_GON_01_ASEReadCounter.table","NW_015090842.1:10090924",4,10,6
"CPNE7","s1650_F_GON_01_ASEReadCounter.table","NW_015090842.1:10090930",2,8,6
"CPNE7","s1650_F_GON_01_ASEReadCounter.table","NW_015090842.1:10091075",2,8,6
"CPNE7","s1650_F_GON_01_ASEReadCounter.table","NW_015090842.1:10091389",6,8,2
"CPNE7","s1650_F_GON_01_ASEReadCounter.table","NW_015090842.1:10091407",6,7,1
"CPNE7","s1650_F_GON_01_ASEReadCounter.table","NW_015090842.1:10091488",7,7,0
"CPNE7","s1650_F_GON_01_ASEReadCounter.table","NW_015090842.1:10091491",7,7,0
"CPNE7","s1650_F_GON_01_ASEReadCounter.table","NW_015090842.1:10091530",6,8,2
"CPNE7","s1650_F_GON_01_ASEReadCounter.table","NW_015090842.1:10091875",7,9,2
"CPNE7","s1650_F_GON_01_ASEReadCounter.table","NW_015090842.1:10091983",2,6,4
"CPNE7","s1650_F_GON_01_ASEReadCounter.table","NW_015090842.1:10091997",3,7,4
"CPNE7","s1650_F_GON_01_ASEReadCounter.table","NW_015090842.1:10092038",1,3,2
"CPNE7","s1650_F_GON_01_ASEReadCounter.table","NW_015090842.1:10092140",2,3,1
"CPNE7","s1650_F_GON_01_ASEReadCounter.table","NW_015090842.1:10092183",2,3,1
"CPNE7","s1650_F_GON_01_ASEReadCounter.table","NW_015090842.1:10092201",1,2,1
"CPNE7","s1650_F_GON_01_ASEReadCounter.table","NW_015090842.1:10092230",1,2,1
"CPNE7","s1650_F_GON_01_ASEReadCounter.table","NW_015090842.1:10092246",1,4,3
"LOC106888185","s1650_F_GON_01_ASEReadCounter.table","NW_015090842.1:10094965",0,12,12
"LOC106888185","s1650_F_GON_01_ASEReadCounter.table","NW_015090842.1:10094966",1,12,11
"LOC106888185","s1650_F_GON_01_ASEReadCounter.table","NW_015090842.1:10094985",1,13,12
"LOC106888185","s1650_F_GON_01_ASEReadCounter.table","NW_015090842.1:10095055",0,9,9
"LOC106888185","s1650_F_GON_01_ASEReadCounter.table","NW_015090842.1:10095062",0,7,7
"LOC106888185","s1650_F_GON_01_ASEReadCounter.table","NW_015090842.1:10095130",0,20,20
"LOC106888185","s1650_F_GON_01_ASEReadCounter.table","NW_015090842.1:10095265",28,65,37
"LOC106888185","s1650_F_GON_01_ASEReadCounter.table","NW_015090842.1:10095586",31,94,63
"LOC106888185","s1650_F_GON_01_ASEReadCounter.table","NW_015090842.1:10095593",35,96,61
"LOC106888185","s1650_F_GON_01_ASEReadCounter.table","NW_015090842.1:10095616",32,93,61
"LOC106888185","s1650_F_GON_01_ASEReadCounter.table","NW_015090842.1:10095662",23,70,47
"LOC106888185","s1650_F_GON_01_ASEReadCounter.table","NW_015090842.1:10095674",21,64,43
"LOC106888185","s1650_F_GON_01_ASEReadCounter.table","NW_015090842.1:10095786",31,73,42
"LOC106888185","s1650_F_GON_01_ASEReadCounter.table","NW_015090842.1:10095831",34,71,37
"LOC106888185","s1650_F_GON_01_ASEReadCounter.table","NW_015090842.1:10096230",28,77,49
"LOC106888185","s1650_F_GON_01_ASEReadCounter.table","NW_015090842.1:10096249",31,78,47
"LOC106888185","s1650_F_GON_01_ASEReadCounter.table","NW_015090842.1:10096272",31,79,48
"LOC106888185","s1650_F_GON_01_ASEReadCounter.table","NW_015090842.1:10096288",34,83,49
"LOC106888185","s1650_F_GON_01_ASEReadCounter.table","NW_015090842.1:10097248",35,92,57
"LOC106888185","s1650_F_GON_01_ASEReadCounter.table","NW_015090842.1:10097265",44,114,70
"LOC106888185","s1650_F_GON_01_ASEReadCounter.table","NW_015090842.1:10097446",6,13,7
"DPEP1","s1650_F_GON_01_ASEReadCounter.table","NW_015090842.1:10098017",2,11,9
"DPEP1","s1650_F_GON_01_ASEReadCounter.table","NW_015090842.1:10098518",0,11,11
"DPEP1","s1650_F_GON_01_ASEReadCounter.table","NW_015090842.1:10098595",4,19,15
"DPEP1","s1650_F_GON_01_ASEReadCounter.table","NW_015090842.1:10098597",4,16,12
"DPEP1","s1650_F_GON_01_ASEReadCounter.table","NW_015090842.1:10098601",4,17,13
"DPEP1","s1650_F_GON_01_ASEReadCounter.table","NW_015090842.1:10098608",4,17,13
"DPEP1","s1650_F_GON_01_ASEReadCounter.table","NW_015090842.1:10098630",4,21,17
"DPEP1","s1650_F_GON_01_ASEReadCounter.table","NW_015090842.1:10098659",4,24,20
"DPEP1","s1650_F_GON_01_ASEReadCounter.table","NW_015090842.1:10099765",9,28,19
"DPEP1","s1650_F_GON_01_ASEReadCounter.table","NW_015090842.1:10099985",9,26,17
"DPEP1","s1650_F_GON_01_ASEReadCounter.table","NW_015090842.1:10099986",8,24,16
"DPEP1","s1650_F_GON_01_ASEReadCounter.table","NW_015090842.1:10099991",9,29,20
"DPEP1","s1650_F_GON_01_ASEReadCounter.table","NW_015090842.1:10100044",7,30,23
"DPEP1","s1650_F_GON_01_ASEReadCounter.table","NW_015090842.1:10100045",7,29,22
"DPEP1","s1650_F_GON_01_ASEReadCounter.table","NW_015090842.1:10100084",9,34,25
"DPEP1","s1650_F_GON_01_ASEReadCounter.table","NW_015090842.1:10100295",3,18,15
"DPEP1","s1650_F_GON_01_ASEReadCounter.table","NW_015090842.1:10100529",7,26,19
"DPEP1","s1650_F_GON_01_ASEReadCounter.table","NW_015090842.1:10100893",9,31,22
"DPEP1","s1650_F_GON_01_ASEReadCounter.table","NW_015090842.1:10100902",8,29,21
"DPEP1","s1650_F_GON_01_ASEReadCounter.table","NW_015090842.1:10101072",6,26,20
"DPEP1","s1650_F_GON_01_ASEReadCounter.table","NW_015090842.1:10101199",5,27,22
"DPEP1","s1650_F_GON_01_ASEReadCounter.table","NW_015090842.1:10101483",5,31,26
"DPEP1","s1650_F_GON_01_ASEReadCounter.table","NW_015090842.1:10101497",7,30,23
"DPEP1","s1650_F_GON_01_ASEReadCounter.table","NW_015090842.1:10101525",10,35,25
"DPEP1","s1650_F_GON_01_ASEReadCounter.table","NW_015090842.1:10101875",6,32,26
"DPEP1","s1650_F_GON_01_ASEReadCounter.table","NW_015090842.1:10101913",4,27,23
"DPEP1","s1650_F_GON_01_ASEReadCounter.table","NW_015090842.1:10101996",4,23,19
"DPEP1","s1650_F_GON_01_ASEReadCounter.table","NW_015090842.1:10102014",4,16,12
"DPEP1","s1650_F_GON_01_ASEReadCounter.table","NW_015090842.1:10102035",3,9,6
"CHMP1A","s1650_F_GON_01_ASEReadCounter.table","NW_015090842.1:10102901",83,208,125
"CHMP1A","s1650_F_GON_01_ASEReadCounter.table","NW_015090842.1:10102961",74,227,153
"CHMP1A","s1650_F_GON_01_ASEReadCounter.table","NW_015090842.1:10102996",72,224,152
"CHMP1A","s1650_F_GON_01_ASEReadCounter.table","NW_015090842.1:10103004",81,231,150
"CHMP1A","s1650_F_GON_01_ASEReadCounter.table","NW_015090842.1:10103006",81,233,152
"CHMP1A","s1650_F_GON_01_ASEReadCounter.table","NW_015090842.1:10103052",142,316,174
"CHMP1A","s1650_F_GON_01_ASEReadCounter.table","NW_015090842.1:10103095",136,330,194
"CHMP1A","s1650_F_GON_01_ASEReadCounter.table","NW_015090842.1:10103096",135,330,195
"CHMP1A","s1650_F_GON_01_ASEReadCounter.table","NW_015090842.1:10103152",121,252,131
"CHMP1A","s1650_F_GON_01_ASEReadCounter.table","NW_015090842.1:10103173",107,232,125
"CHMP1A","s1650_F_GON_01_ASEReadCounter.table","NW_015090842.1:10103334",80,181,101
"CHMP1A","s1650_F_GON_01_ASEReadCounter.table","NW_015090842.1:10103373",52,168,116
"CHMP1A","s1650_F_GON_01_ASEReadCounter.table","NW_015090842.1:10103408",88,230,142
"CHMP1A","s1650_F_GON_01_ASEReadCounter.table","NW_015090842.1:10103412",100,239,139
"CHMP1A","s1650_F_GON_01_ASEReadCounter.table","NW_015090842.1:10103512",146,291,145
"CHMP1A","s1650_F_GON_01_ASEReadCounter.table","NW_015090842.1:10103513",148,293,145
"CHMP1A","s1650_F_GON_01_ASEReadCounter.table","NW_015090842.1:10103583",95,200,105
"CHMP1A","s1650_F_GON_01_ASEReadCounter.table","NW_015090842.1:10103614",88,195,107
"CHMP1A","s1650_F_GON_01_ASEReadCounter.table","NW_015090842.1:10103657",91,202,111
"CHMP1A","s1650_F_GON_01_ASEReadCounter.table","NW_015090842.1:10103669",81,187,106
"CHMP1A","s1650_F_GON_01_ASEReadCounter.table","NW_015090842.1:10103674",82,180,98
"CHMP1A","s1650_F_GON_01_ASEReadCounter.table","NW_015090842.1:10103677",79,176,97
"CHMP1A","s1650_F_GON_01_ASEReadCounter.table","NW_015090842.1:10103729",116,211,95
"CHMP1A","s1650_F_GON_01_ASEReadCounter.table","NW_015090842.1:10103758",118,208,90
"CHMP1A","s1650_F_GON_01_ASEReadCounter.table","NW_015090842.1:10103761",119,212,93
"CHMP1A","s1650_F_GON_01_ASEReadCounter.table","NW_015090842.1:10103788",127,255,128
"CHMP1A","s1650_F_GON_01_ASEReadCounter.table","NW_015090842.1:10103789",128,255,127
"CHMP1A","s1650_F_GON_01_ASEReadCounter.table","NW_015090842.1:10103790",127,254,127
"CHMP1A","s1650_F_GON_01_ASEReadCounter.table","NW_015090842.1:10103950",138,252,114
"CHMP1A","s1650_F_GON_01_ASEReadCounter.table","NW_015090842.1:10104335",105,211,106
"CHMP1A","s1650_F_GON_01_ASEReadCounter.table","NW_015090842.1:10104429",139,287,148
"CHMP1A","s1650_F_GON_01_ASEReadCounter.table","NW_015090842.1:10104532",167,343,176
"CHMP1A","s1650_F_GON_01_ASEReadCounter.table","NW_015090842.1:10104633",119,245,126
"CHMP1A","s1650_F_GON_01_ASEReadCounter.table","NW_015090842.1:10104759",115,245,130
"CHMP1A","s1650_F_GON_01_ASEReadCounter.table","NW_015090842.1:10104794",138,268,130
"CHMP1A","s1650_F_GON_01_ASEReadCounter.table","NW_015090842.1:10104841",197,197,0
"CHMP1A","s1650_F_GON_01_ASEReadCounter.table","NW_015090842.1:10104844",89,201,112
"CHMP1A","s1650_F_GON_01_ASEReadCounter.table","NW_015090842.1:10106242",105,230,125
"CHMP1A","s1650_F_GON_01_ASEReadCounter.table","NW_015090842.1:10106290",100,226,126
"CHMP1A","s1650_F_GON_01_ASEReadCounter.table","NW_015090842.1:10106335",118,252,134
"CHMP1A","s1650_F_GON_01_ASEReadCounter.table","NW_015090842.1:10106383",150,305,155
"CHMP1A","s1650_F_GON_01_ASEReadCounter.table","NW_015090842.1:10106747",142,293,151
"CHMP1A","s1650_F_GON_01_ASEReadCounter.table","NW_015090842.1:10107404",146,296,150
"CHMP1A","s1650_F_GON_01_ASEReadCounter.table","NW_015090842.1:10107876",136,283,147
"CDK10","s1650_F_GON_01_ASEReadCounter.table","NW_015090842.1:10109030",30,32,2
"CDK10","s1650_F_GON_01_ASEReadCounter.table","NW_015090842.1:10109963",122,272,150
"CDK10","s1650_F_GON_01_ASEReadCounter.table","NW_015090842.1:10110887",112,238,126
"CDK10","s1650_F_GON_01_ASEReadCounter.table","NW_015090842.1:10111254",92,191,99
"CDK10","s1650_F_GON_01_ASEReadCounter.table","NW_015090842.1:10111380",84,202,118
"CDK10","s1650_F_GON_01_ASEReadCounter.table","NW_015090842.1:10111395",89,196,107
"CDK10","s1650_F_GON_01_ASEReadCounter.table","NW_015090842.1:10111437",53,169,116
"CDK10","s1650_F_GON_01_ASEReadCounter.table","NW_015090842.1:10111798",96,229,133
"CDK10","s1650_F_GON_01_ASEReadCounter.table","NW_015090842.1:10111840",99,213,114
"CDK10","s1650_F_GON_01_ASEReadCounter.table","NW_015090842.1:10112031",98,241,143
"CDK10","s1650_F_GON_01_ASEReadCounter.table","NW_015090842.1:10112285",97,234,137
"CDK10","s1650_F_GON_01_ASEReadCounter.table","NW_015090842.1:10112398",114,249,135
"CDK10","s1650_F_GON_01_ASEReadCounter.table","NW_015090842.1:10112455",108,229,121
"CDK10","s1650_F_GON_01_ASEReadCounter.table","NW_015090842.1:10112461",100,218,118
"CDK10","s1650_F_GON_01_ASEReadCounter.table","NW_015090842.1:10112497",87,205,118
"CDK10","s1650_F_GON_01_ASEReadCounter.table","NW_015090842.1:10112508",72,200,128
"CDK10","s1650_F_GON_01_ASEReadCounter.table","NW_015090842.1:10112518",53,166,113
"CDK10","s1650_F_GON_01_ASEReadCounter.table","NW_015090842.1:10112540",27,149,122
"CDK10","s1650_F_GON_01_ASEReadCounter.table","NW_015090842.1:10112556",63,185,122
"CDK10","s1650_F_GON_01_ASEReadCounter.table","NW_015090842.1:10112561",69,211,142
"CDK10","s1650_F_GON_01_ASEReadCounter.table","NW_015090842.1:10112596",79,213,134
"CDK10","s1650_F_GON_01_ASEReadCounter.table","NW_015090842.1:10112630",65,169,104
"CDK10","s1650_F_GON_01_ASEReadCounter.table","NW_015090842.1:10112656",68,158,90
"CDK10","s1650_F_GON_01_ASEReadCounter.table","NW_015090842.1:10112665",56,109,53
"CDK10","s1650_F_GON_01_ASEReadCounter.table","NW_015090842.1:10112668",54,108,54
"CDK10","s1650_F_GON_01_ASEReadCounter.table","NW_015090842.1:10112781",33,63,30
"CDK10","s1650_F_GON_01_ASEReadCounter.table","NW_015090842.1:10112782",33,65,32
"CDK10","s1650_F_GON_01_ASEReadCounter.table","NW_015090842.1:10112795",29,59,30
"CDK10","s1650_F_GON_01_ASEReadCounter.table","NW_015090842.1:10112841",13,27,14
"CDK10","s1650_F_GON_01_ASEReadCounter.table","NW_015090842.1:10112861",10,19,9
"SPATA2L","s1650_F_GON_01_ASEReadCounter.table","NW_015090842.1:10113212",6,14,8
"SPATA2L","s1650_F_GON_01_ASEReadCounter.table","NW_015090842.1:10113280",8,27,19
"SPATA2L","s1650_F_GON_01_ASEReadCounter.table","NW_015090842.1:10113296",9,30,21
"SPATA2L","s1650_F_GON_01_ASEReadCounter.table","NW_015090842.1:10113321",12,35,23
"SPATA2L","s1650_F_GON_01_ASEReadCounter.table","NW_015090842.1:10113332",12,36,24
"SPATA2L","s1650_F_GON_01_ASEReadCounter.table","NW_015090842.1:10113380",15,38,23
"SPATA2L","s1650_F_GON_01_ASEReadCounter.table","NW_015090842.1:10113381",15,37,22
"SPATA2L","s1650_F_GON_01_ASEReadCounter.table","NW_015090842.1:10113412",16,40,24
"SPATA2L","s1650_F_GON_01_ASEReadCounter.table","NW_015090842.1:10113421",17,41,24
"SPATA2L","s1650_F_GON_01_ASEReadCounter.table","NW_015090842.1:10113465",14,37,23
"SPATA2L","s1650_F_GON_01_ASEReadCounter.table","NW_015090842.1:10113535",20,50,30
"SPATA2L","s1650_F_GON_01_ASEReadCounter.table","NW_015090842.1:10113645",15,50,35
"SPATA2L","s1650_F_GON_01_ASEReadCounter.table","NW_015090842.1:10113682",20,50,30
"SPATA2L","s1650_F_GON_01_ASEReadCounter.table","NW_015090842.1:10113696",17,44,27
"SPATA2L","s1650_F_GON_01_ASEReadCounter.table","NW_015090842.1:10113727",19,52,33
"SPATA2L","s1650_F_GON_01_ASEReadCounter.table","NW_015090842.1:10113799",27,59,32
"SPATA2L","s1650_F_GON_01_ASEReadCounter.table","NW_015090842.1:10113809",30,63,33
"SPATA2L","s1650_F_GON_01_ASEReadCounter.table","NW_015090842.1:10113827",34,64,30
"SPATA2L","s1650_F_GON_01_ASEReadCounter.table","NW_015090842.1:10113831",34,64,30
"SPATA2L","s1650_F_GON_01_ASEReadCounter.table","NW_015090842.1:10113894",24,53,29
"SPATA2L","s1650_F_GON_01_ASEReadCounter.table","NW_015090842.1:10113905",15,39,24
"SPATA2L","s1650_F_GON_01_ASEReadCounter.table","NW_015090842.1:10113914",17,39,22
"SPATA2L","s1650_F_GON_01_ASEReadCounter.table","NW_015090842.1:10113920",18,38,20
"SPATA2L","s1650_F_GON_01_ASEReadCounter.table","NW_015090842.1:10113937",21,43,22
"SPATA2L","s1650_F_GON_01_ASEReadCounter.table","NW_015090842.1:10113971",12,32,20
"SPATA2L","s1650_F_GON_01_ASEReadCounter.table","NW_015090842.1:10113976",15,41,26
"SPATA2L","s1650_F_GON_01_ASEReadCounter.table","NW_015090842.1:10113985",14,33,19
"SPATA2L","s1650_F_GON_01_ASEReadCounter.table","NW_015090842.1:10113994",16,40,24
"SPATA2L","s1650_F_GON_01_ASEReadCounter.table","NW_015090842.1:10114063",19,43,24
"SPATA2L","s1650_F_GON_01_ASEReadCounter.table","NW_015090842.1:10114066",19,43,24
"SPATA2L","s1650_F_GON_01_ASEReadCounter.table","NW_015090842.1:10114069",18,42,24
"SPATA2L","s1650_F_GON_01_ASEReadCounter.table","NW_015090842.1:10114121",13,33,20
"SPATA2L","s1650_F_GON_01_ASEReadCounter.table","NW_015090842.1:10114159",9,31,22
"SPATA2L","s1650_F_GON_01_ASEReadCounter.table","NW_015090842.1:10114282",14,42,28
"SPATA2L","s1650_F_GON_01_ASEReadCounter.table","NW_015090842.1:10114470",11,32,21
"SPATA2L","s1650_F_GON_01_ASEReadCounter.table","NW_015090842.1:10114524",12,27,15
"VPS9D1","s1650_F_GON_01_ASEReadCounter.table","NW_015090842.1:10116377",16,27,11
"VPS9D1","s1650_F_GON_01_ASEReadCounter.table","NW_015090842.1:10116415",10,22,12
"VPS9D1","s1650_F_GON_01_ASEReadCounter.table","NW_015090842.1:10116607",12,28,16
"VPS9D1","s1650_F_GON_01_ASEReadCounter.table","NW_015090842.1:10116816",13,13,0
"VPS9D1","s1650_F_GON_01_ASEReadCounter.table","NW_015090842.1:10116821",6,13,7
"VPS9D1","s1650_F_GON_01_ASEReadCounter.table","NW_015090842.1:10116825",7,12,5
"VPS9D1","s1650_F_GON_01_ASEReadCounter.table","NW_015090842.1:10116882",6,15,9
"VPS9D1","s1650_F_GON_01_ASEReadCounter.table","NW_015090842.1:10116885",6,15,9
"VPS9D1","s1650_F_GON_01_ASEReadCounter.table","NW_015090842.1:10116933",7,14,7
"VPS9D1","s1650_F_GON_01_ASEReadCounter.table","NW_015090842.1:10116942",9,16,7
"VPS9D1","s1650_F_GON_01_ASEReadCounter.table","NW_015090842.1:10117152",9,20,11
"VPS9D1","s1650_F_GON_01_ASEReadCounter.table","NW_015090842.1:10117396",20,20,0
"VPS9D1","s1650_F_GON_01_ASEReadCounter.table","NW_015090842.1:10117405",13,13,0
"VPS9D1","s1650_F_GON_01_ASEReadCounter.table","NW_015090842.1:10117480",9,13,4
"VPS9D1","s1650_F_GON_01_ASEReadCounter.table","NW_015090842.1:10117497",8,13,5
"VPS9D1","s1650_F_GON_01_ASEReadCounter.table","NW_015090842.1:10117499",7,12,5
"VPS9D1","s1650_F_GON_01_ASEReadCounter.table","NW_015090842.1:10117516",13,18,5
"VPS9D1","s1650_F_GON_01_ASEReadCounter.table","NW_015090842.1:10117525",14,18,4
"VPS9D1","s1650_F_GON_01_ASEReadCounter.table","NW_015090842.1:10117579",9,12,3
"VPS9D1","s1650_F_GON_01_ASEReadCounter.table","NW_015090842.1:10117627",4,5,1
"VPS9D1","s1650_F_GON_01_ASEReadCounter.table","NW_015090842.1:10117678",4,11,7
"VPS9D1","s1650_F_GON_01_ASEReadCounter.table","NW_015090842.1:10117773",8,16,8
"VPS9D1","s1650_F_GON_01_ASEReadCounter.table","NW_015090842.1:10117937",7,15,8
"VPS9D1","s1650_F_GON_01_ASEReadCounter.table","NW_015090842.1:10117961",5,12,7
"VPS9D1","s1650_F_GON_01_ASEReadCounter.table","NW_015090842.1:10118236",5,13,8
"VPS9D1","s1650_F_GON_01_ASEReadCounter.table","NW_015090842.1:10118414",10,20,10
"VPS9D1","s1650_F_GON_01_ASEReadCounter.table","NW_015090842.1:10118973",14,25,11
"VPS9D1","s1650_F_GON_01_ASEReadCounter.table","NW_015090842.1:10119500",10,16,6
"ZNF276","s1650_F_GON_01_ASEReadCounter.table","NW_015090842.1:10121760",3,4,1
"ZNF276","s1650_F_GON_01_ASEReadCounter.table","NW_015090842.1:10121769",3,5,2
"ZNF276","s1650_F_GON_01_ASEReadCounter.table","NW_015090842.1:10121802",5,9,4
"ZNF276","s1650_F_GON_01_ASEReadCounter.table","NW_015090842.1:10121971",10,25,15
"ZNF276","s1650_F_GON_01_ASEReadCounter.table","NW_015090842.1:10122883",6,13,7
"ZNF276","s1650_F_GON_01_ASEReadCounter.table","NW_015090842.1:10123069",8,18,10
"ZNF276","s1650_F_GON_01_ASEReadCounter.table","NW_015090842.1:10123207",9,24,15
"ZNF276","s1650_F_GON_01_ASEReadCounter.table","NW_015090842.1:10125787",16,40,24
"ZNF276","s1650_F_GON_01_ASEReadCounter.table","NW_015090842.1:10126309",18,41,23
"ZNF276","s1650_F_GON_01_ASEReadCounter.table","NW_015090842.1:10126348",16,37,21
"ZNF276","s1650_F_GON_01_ASEReadCounter.table","NW_015090842.1:10126978",18,39,21
"ZNF276","s1650_F_GON_01_ASEReadCounter.table","NW_015090842.1:10126991",17,38,21
"ZNF276","s1650_F_GON_01_ASEReadCounter.table","NW_015090842.1:10127023",17,41,24
"ZNF276","s1650_F_GON_01_ASEReadCounter.table","NW_015090842.1:10127063",9,31,22
"ZNF276","s1650_F_GON_01_ASEReadCounter.table","NW_015090842.1:10127373",9,34,25
"ZNF276","s1650_F_GON_01_ASEReadCounter.table","NW_015090842.1:10127931",20,47,27
"ZNF276","s1650_F_GON_01_ASEReadCounter.table","NW_015090842.1:10128070",23,51,28
"ZNF276","s1650_F_GON_01_ASEReadCounter.table","NW_015090842.1:10128102",26,53,27
"ZNF276","s1650_F_GON_01_ASEReadCounter.table","NW_015090842.1:10128356",21,38,17
"ZNF276","s1650_F_GON_01_ASEReadCounter.table","NW_015090842.1:10128497",9,21,12
"FANCA","s1650_F_GON_01_ASEReadCounter.table","NW_015090842.1:10128743",19,39,20
"FANCA","s1650_F_GON_01_ASEReadCounter.table","NW_015090842.1:10128822",27,50,23
"FANCA","s1650_F_GON_01_ASEReadCounter.table","NW_015090842.1:10129383",38,66,28
"FANCA","s1650_F_GON_01_ASEReadCounter.table","NW_015090842.1:10129390",39,69,30
"FANCA","s1650_F_GON_01_ASEReadCounter.table","NW_015090842.1:10129422",36,68,32
"FANCA","s1650_F_GON_01_ASEReadCounter.table","NW_015090842.1:10129969",36,59,23
"FANCA","s1650_F_GON_01_ASEReadCounter.table","NW_015090842.1:10130399",37,64,27
"FANCA","s1650_F_GON_01_ASEReadCounter.table","NW_015090842.1:10130857",31,59,28
"FANCA","s1650_F_GON_01_ASEReadCounter.table","NW_015090842.1:10130878",31,56,25
"FANCA","s1650_F_GON_01_ASEReadCounter.table","NW_015090842.1:10133530",20,40,20
"FANCA","s1650_F_GON_01_ASEReadCounter.table","NW_015090842.1:10133533",20,41,21
"FANCA","s1650_F_GON_01_ASEReadCounter.table","NW_015090842.1:10133536",19,42,23
"FANCA","s1650_F_GON_01_ASEReadCounter.table","NW_015090842.1:10133601",17,40,23
"FANCA","s1650_F_GON_01_ASEReadCounter.table","NW_015090842.1:10134492",13,32,19
"FANCA","s1650_F_GON_01_ASEReadCounter.table","NW_015090842.1:10134531",17,39,22
"FANCA","s1650_F_GON_01_ASEReadCounter.table","NW_015090842.1:10136957",16,37,21
"FANCA","s1650_F_GON_01_ASEReadCounter.table","NW_015090842.1:10136982",13,35,22
"FANCA","s1650_F_GON_01_ASEReadCounter.table","NW_015090842.1:10136999",10,25,15
"FANCA","s1650_F_GON_01_ASEReadCounter.table","NW_015090842.1:10137019",19,39,20
"FANCA","s1650_F_GON_01_ASEReadCounter.table","NW_015090842.1:10137673",23,42,19
"FANCA","s1650_F_GON_01_ASEReadCounter.table","NW_015090842.1:10138618",19,31,12
"FANCA","s1650_F_GON_01_ASEReadCounter.table","NW_015090842.1:10139140",12,23,11
"FANCA","s1650_F_GON_01_ASEReadCounter.table","NW_015090842.1:10140699",8,21,13
"FANCA","s1650_F_GON_01_ASEReadCounter.table","NW_015090842.1:10141234",10,15,5
"FANCA","s1650_F_GON_01_ASEReadCounter.table","NW_015090842.1:10145030",11,20,9
"FANCA","s1650_F_GON_01_ASEReadCounter.table","NW_015090842.1:10150518",11,21,10
"FANCA","s1650_F_GON_01_ASEReadCounter.table","NW_015090842.1:10152863",7,14,7
"FANCA","s1650_F_GON_01_ASEReadCounter.table","NW_015090842.1:10154490",9,13,4
"FANCA","s1650_F_GON_01_ASEReadCounter.table","NW_015090842.1:10158162",6,13,7
"FANCA","s1650_F_GON_01_ASEReadCounter.table","NW_015090842.1:10158957",8,16,8
"FANCA","s1650_F_GON_01_ASEReadCounter.table","NW_015090842.1:10160177",11,16,5
"FANCA","s1650_F_GON_01_ASEReadCounter.table","NW_015090842.1:10162980",6,13,7
"FANCA","s1650_F_GON_01_ASEReadCounter.table","NW_015090842.1:10163667",3,6,3
"FANCA","s1650_F_GON_01_ASEReadCounter.table","NW_015090842.1:10164257",10,15,5
"FANCA","s1650_F_GON_01_ASEReadCounter.table","NW_015090842.1:10165331",8,11,3
"SPIRE2","s1650_F_GON_01_ASEReadCounter.table","NW_015090842.1:10172284",4,4,0
"SPIRE2","s1650_F_GON_01_ASEReadCounter.table","NW_015090842.1:10175262",3,3,0
"SPIRE2","s1650_F_GON_01_ASEReadCounter.table","NW_015090842.1:10175352",4,5,1
"SPIRE2","s1650_F_GON_01_ASEReadCounter.table","NW_015090842.1:10175400",18,19,1
"SPIRE2","s1650_F_GON_01_ASEReadCounter.table","NW_015090842.1:10175418",19,20,1
"SPIRE2","s1650_F_GON_01_ASEReadCounter.table","NW_015090842.1:10175704",20,20,0
"SPIRE2","s1650_F_GON_01_ASEReadCounter.table","NW_015090842.1:10176115",13,15,2
"SPIRE2","s1650_F_GON_01_ASEReadCounter.table","NW_015090842.1:10176561",16,19,3
"SPIRE2","s1650_F_GON_01_ASEReadCounter.table","NW_015090842.1:10176817",13,15,2
"SPIRE2","s1650_F_GON_01_ASEReadCounter.table","NW_015090842.1:10177084",4,4,0
"SPIRE2","s1650_F_GON_01_ASEReadCounter.table","NW_015090842.1:10177110",4,4,0
"SPIRE2","s1650_F_GON_01_ASEReadCounter.table","NW_015090842.1:10177838",9,9,0
"SPIRE2","s1650_F_GON_01_ASEReadCounter.table","NW_015090842.1:10178000",11,12,1
"SPIRE2","s1650_F_GON_01_ASEReadCounter.table","NW_015090842.1:10178164",13,13,0
"SPIRE2","s1650_F_GON_01_ASEReadCounter.table","NW_015090842.1:10178216",16,17,1
"SPIRE2","s1650_F_GON_01_ASEReadCounter.table","NW_015090842.1:10178403",7,7,0
"SPIRE2","s1650_F_GON_01_ASEReadCounter.table","NW_015090842.1:10178409",5,5,0
"SPIRE2","s1650_F_GON_01_ASEReadCounter.table","NW_015090842.1:10178524",7,8,1
"SPIRE2","s1650_F_GON_01_ASEReadCounter.table","NW_015090842.1:10178526",6,7,1
"SPIRE2","s1650_F_GON_01_ASEReadCounter.table","NW_015090842.1:10178531",7,8,1
"SPIRE2","s1650_F_GON_01_ASEReadCounter.table","NW_015090842.1:10178565",6,7,1
"SPIRE2","s1650_F_GON_01_ASEReadCounter.table","NW_015090842.1:10178587",3,4,1
"SPIRE2","s1650_F_GON_01_ASEReadCounter.table","NW_015090842.1:10178640",4,5,1
"SPIRE2","s1650_F_GON_01_ASEReadCounter.table","NW_015090842.1:10178651",3,4,1
"SPIRE2","s1650_F_GON_01_ASEReadCounter.table","NW_015090842.1:10178682",2,2,0
"TCF25","s1650_F_GON_01_ASEReadCounter.table","NW_015090842.1:10180912",57,118,61
"TCF25","s1650_F_GON_01_ASEReadCounter.table","NW_015090842.1:10180924",58,119,61
"TCF25","s1650_F_GON_01_ASEReadCounter.table","NW_015090842.1:10180931",62,124,62
"TCF25","s1650_F_GON_01_ASEReadCounter.table","NW_015090842.1:10185332",169,368,199
"TCF25","s1650_F_GON_01_ASEReadCounter.table","NW_015090842.1:10188816",159,303,144
"MC1R","s1650_F_GON_01_ASEReadCounter.table","NW_015090842.1:10202160",1,2,1
"DBNDD1","s1650_F_GON_01_ASEReadCounter.table","NW_015090842.1:10223105",165,387,222
"GAS8","s1650_F_GON_01_ASEReadCounter.table","NW_015090842.1:10228982",644,1374,730
"GAS8","s1650_F_GON_01_ASEReadCounter.table","NW_015090842.1:10229832",520,1081,561
"GAS8","s1650_F_GON_01_ASEReadCounter.table","NW_015090842.1:10232375",512,1098,586
"GAS8","s1650_F_GON_01_ASEReadCounter.table","NW_015090842.1:10232901",385,790,405
"GAS8","s1650_F_GON_01_ASEReadCounter.table","NW_015090842.1:10232928",333,696,363
"GAS8","s1650_F_GON_01_ASEReadCounter.table","NW_015090842.1:10232967",278,563,285
"GAS8","s1650_F_GON_01_ASEReadCounter.table","NW_015090842.1:10233032",171,352,181
"GAS8","s1650_F_GON_01_ASEReadCounter.table","NW_015090842.1:10233057",137,292,155
"GAS8","s1650_F_GON_01_ASEReadCounter.table","NW_015090842.1:10233058",138,301,163
"GAS8","s1650_F_GON_01_ASEReadCounter.table","NW_015090842.1:10233176",119,261,142
"GAS8","s1650_F_GON_01_ASEReadCounter.table","NW_015090842.1:10233196",126,272,146
"GAS8","s1650_F_GON_01_ASEReadCounter.table","NW_015090842.1:10233252",84,206,122
"GAS8","s1650_F_GON_01_ASEReadCounter.table","NW_015090842.1:10233303",28,89,61
"LOC106888094","s1650_F_GON_01_ASEReadCounter.table","NW_015090842.1:10233334",6,12,6
"LOC106888094","s1650_F_GON_01_ASEReadCounter.table","NW_015090842.1:10233362",10,23,13
"LOC106888094","s1650_F_GON_01_ASEReadCounter.table","NW_015090842.1:10233373",10,25,15
"LOC106888094","s1650_F_GON_01_ASEReadCounter.table","NW_015090842.1:10233388",13,29,16
"LOC106888094","s1650_F_GON_01_ASEReadCounter.table","NW_015090842.1:10233402",13,29,16
"LOC106888094","s1650_F_GON_01_ASEReadCounter.table","NW_015090842.1:10233465",14,40,26
"LOC106888094","s1650_F_GON_01_ASEReadCounter.table","NW_015090842.1:10233803",18,52,34
"LOC106888094","s1650_F_GON_01_ASEReadCounter.table","NW_015090842.1:10233815",19,51,32
"LOC106888094","s1650_F_GON_01_ASEReadCounter.table","NW_015090842.1:10235484",15,23,8
"LOC106888094","s1650_F_GON_01_ASEReadCounter.table","NW_015090842.1:10235611",15,31,16
"LOC106888094","s1650_F_GON_01_ASEReadCounter.table","NW_015090842.1:10236098",2,6,4
"LOC106888094","s1650_F_GON_01_ASEReadCounter.table","NW_015090842.1:10236161",2,4,2
"LOC106888094","s1650_F_GON_01_ASEReadCounter.table","NW_015090842.1:10236380",5,5,0
"LOC106888094","s1650_F_GON_01_ASEReadCounter.table","NW_015090842.1:10236388",4,5,1
"LOC106888094","s1650_F_GON_01_ASEReadCounter.table","NW_015090842.1:10236425",2,3,1
"LOC106888094","s1650_F_GON_01_ASEReadCounter.table","NW_015090842.1:10236426",1,2,1
"LOC106888094","s1650_F_GON_01_ASEReadCounter.table","NW_015090842.1:10236603",4,6,2
"LOC106888173","s1650_F_GON_01_ASEReadCounter.table","NW_015090842.1:10239596",1,7,6
"LOC106888173","s1650_F_GON_01_ASEReadCounter.table","NW_015090842.1:10240036",2,9,7
"LOC106888173","s1650_F_GON_01_ASEReadCounter.table","NW_015090842.1:10240095",7,16,9
"LOC106888173","s1650_F_GON_01_ASEReadCounter.table","NW_015090842.1:10240280",5,18,13
"LOC106888173","s1650_F_GON_01_ASEReadCounter.table","NW_015090842.1:10240557",14,22,8
"LOC106888173","s1650_F_GON_01_ASEReadCounter.table","NW_015090842.1:10240603",10,25,15
"LOC106888173","s1650_F_GON_01_ASEReadCounter.table","NW_015090842.1:10240609",10,25,15
"LOC106888173","s1650_F_GON_01_ASEReadCounter.table","NW_015090842.1:10240690",12,25,13
"LOC106888173","s1650_F_GON_01_ASEReadCounter.table","NW_015090842.1:10240924",6,23,17
"LOC106888173","s1650_F_GON_01_ASEReadCounter.table","NW_015090842.1:10241037",6,29,23
"LOC106888173","s1650_F_GON_01_ASEReadCounter.table","NW_015090842.1:10241046",8,30,22
"LOC106888173","s1650_F_GON_01_ASEReadCounter.table","NW_015090842.1:10241058",9,29,20
"LOC106888173","s1650_F_GON_01_ASEReadCounter.table","NW_015090842.1:10241064",12,31,19
"LOC106888173","s1650_F_GON_01_ASEReadCounter.table","NW_015090842.1:10241103",39,39,0
"LOC106888173","s1650_F_GON_01_ASEReadCounter.table","NW_015090842.1:10241163",15,34,19
"LOC106888173","s1650_F_GON_01_ASEReadCounter.table","NW_015090842.1:10241803",13,26,13
"LOC106888173","s1650_F_GON_01_ASEReadCounter.table","NW_015090842.1:10241827",12,26,14
"LOC106888173","s1650_F_GON_01_ASEReadCounter.table","NW_015090842.1:10241869",12,28,16
"LOC106888173","s1650_F_GON_01_ASEReadCounter.table","NW_015090842.1:10242079",12,31,19
"LOC106888173","s1650_F_GON_01_ASEReadCounter.table","NW_015090842.1:10242103",11,30,19
"LOC106888173","s1650_F_GON_01_ASEReadCounter.table","NW_015090842.1:10242157",16,40,24
"LOC106888173","s1650_F_GON_01_ASEReadCounter.table","NW_015090842.1:10242455",14,35,21
"LOC106888173","s1650_F_GON_01_ASEReadCounter.table","NW_015090842.1:10242481",13,36,23
"LOC106888173","s1650_F_GON_01_ASEReadCounter.table","NW_015090842.1:10242590",15,35,20
"LOC106888173","s1650_F_GON_01_ASEReadCounter.table","NW_015090842.1:10242794",7,32,25
"LOC106888173","s1650_F_GON_01_ASEReadCounter.table","NW_015090842.1:10242909",9,27,18
"LOC106888173","s1650_F_GON_01_ASEReadCounter.table","NW_015090842.1:10243094",12,42,30
"LOC106888173","s1650_F_GON_01_ASEReadCounter.table","NW_015090842.1:10243133",12,36,24
"LOC106888173","s1650_F_GON_01_ASEReadCounter.table","NW_015090842.1:10243273",18,58,40
"LOC106888173","s1650_F_GON_01_ASEReadCounter.table","NW_015090842.1:10243278",19,57,38
"LOC106888173","s1650_F_GON_01_ASEReadCounter.table","NW_015090842.1:10243281",19,58,39
"LOC106888173","s1650_F_GON_01_ASEReadCounter.table","NW_015090842.1:10243347",32,32,0
"LOC106888173","s1650_F_GON_01_ASEReadCounter.table","NW_015090842.1:10243353",14,30,16
"LOC106888173","s1650_F_GON_01_ASEReadCounter.table","NW_015090842.1:10243363",7,21,14
"LOC106888173","s1650_F_GON_01_ASEReadCounter.table","NW_015090842.1:10243365",8,22,14
"LOC106888173","s1650_F_GON_01_ASEReadCounter.table","NW_015090842.1:10243566",16,51,35
"LOC106888173","s1650_F_GON_01_ASEReadCounter.table","NW_015090842.1:10243605",16,57,41
"LOC106888173","s1650_F_GON_01_ASEReadCounter.table","NW_015090842.1:10243614",13,52,39
"LOC106888173","s1650_F_GON_01_ASEReadCounter.table","NW_015090842.1:10243615",13,52,39
"LOC106888173","s1650_F_GON_01_ASEReadCounter.table","NW_015090842.1:10243640",18,51,33
"LOC106888173","s1650_F_GON_01_ASEReadCounter.table","NW_015090842.1:10243680",21,47,26
"LOC106888173","s1650_F_GON_01_ASEReadCounter.table","NW_015090842.1:10243742",23,53,30
"LOC106888173","s1650_F_GON_01_ASEReadCounter.table","NW_015090842.1:10243804",22,43,21
"LOC106888173","s1650_F_GON_01_ASEReadCounter.table","NW_015090842.1:10243913",8,18,10
"LOC106888173","s1650_F_GON_01_ASEReadCounter.table","NW_015090842.1:10243921",8,15,7
"LOC106888384","s1650_F_GON_01_ASEReadCounter.table","NW_015090842.1:10244714",1,3,2
"LOC106888384","s1650_F_GON_01_ASEReadCounter.table","NW_015090842.1:10250743",3,5,2
"LOC106888384","s1650_F_GON_01_ASEReadCounter.table","NW_015090842.1:10250771",3,5,2
"LOC106888384","s1650_F_GON_01_ASEReadCounter.table","NW_015090842.1:10251339",1,1,0
"LOC106888384","s1650_F_GON_01_ASEReadCounter.table","NW_015090842.1:10251343",1,1,0
"LOC106888384","s1650_F_GON_01_ASEReadCounter.table","NW_015090842.1:10251344",1,1,0
"LOC106888384","s1650_F_GON_01_ASEReadCounter.table","NW_015090842.1:10251349",1,2,1
"LOC106888384","s1650_F_GON_01_ASEReadCounter.table","NW_015090842.1:10251354",1,6,5
"LOC106888384","s1650_F_GON_01_ASEReadCounter.table","NW_015090842.1:10251358",1,6,5
"LOC106888384","s1650_F_GON_01_ASEReadCounter.table","NW_015090842.1:10251369",1,6,5
"LOC106888384","s1650_F_GON_01_ASEReadCounter.table","NW_015090842.1:10251370",1,6,5
"LOC106888384","s1650_F_GON_01_ASEReadCounter.table","NW_015090842.1:10251375",0,4,4
"LOC106888384","s1650_F_GON_01_ASEReadCounter.table","NW_015090842.1:10251388",0,3,3
"LOC106888384","s1650_F_GON_01_ASEReadCounter.table","NW_015090842.1:10251390",0,3,3
"LOC106888384","s1650_F_GON_01_ASEReadCounter.table","NW_015090842.1:10251393",0,3,3
"LOC106888384","s1650_F_GON_01_ASEReadCounter.table","NW_015090842.1:10251399",0,3,3
"LOC106888384","s1650_F_GON_01_ASEReadCounter.table","NW_015090842.1:10253165",6,7,1
"LOC106888384","s1650_F_GON_01_ASEReadCounter.table","NW_015090842.1:10253284",4,7,3
"LOC106888384","s1650_F_GON_01_ASEReadCounter.table","NW_015090842.1:10254028",3,4,1
"LOC106888384","s1650_F_GON_01_ASEReadCounter.table","NW_015090842.1:10254227",1,2,1
"LOC106888384","s1650_F_GON_01_ASEReadCounter.table","NW_015090842.1:10254233",1,2,1
"LOC106888384","s1650_F_GON_01_ASEReadCounter.table","NW_015090842.1:10254263",3,3,0
"LOC106888384","s1650_F_GON_01_ASEReadCounter.table","NW_015090842.1:10254293",3,3,0
"LOC106888384","s1650_F_GON_01_ASEReadCounter.table","NW_015090842.1:10254570",1,4,3
"LOC106888384","s1650_F_GON_01_ASEReadCounter.table","NW_015090842.1:10254605",5,5,0
"LOC106888384","s1650_F_GON_01_ASEReadCounter.table","NW_015090842.1:10254608",5,5,0
"LOC106888384","s1650_F_GON_01_ASEReadCounter.table","NW_015090842.1:10254618",4,4,0
"LOC106888384","s1650_F_GON_01_ASEReadCounter.table","NW_015090842.1:10254620",4,4,0
"LOC106888384","s1650_F_GON_01_ASEReadCounter.table","NW_015090842.1:10254623",4,4,0
"LOC106888384","s1650_F_GON_01_ASEReadCounter.table","NW_015090842.1:10254624",4,4,0
"LOC106888384","s1650_F_GON_01_ASEReadCounter.table","NW_015090842.1:10254627",4,4,0
"LOC106888384","s1650_F_GON_01_ASEReadCounter.table","NW_015090842.1:10254629",4,4,0
"LOC106888384","s1650_F_GON_01_ASEReadCounter.table","NW_015090842.1:10254647",0,3,3
"LOC106888384","s1650_F_GON_01_ASEReadCounter.table","NW_015090842.1:10254663",0,2,2
"LOC106888384","s1650_F_GON_01_ASEReadCounter.table","NW_015090842.1:10254891",2,2,0
"LOC106888384","s1650_F_GON_01_ASEReadCounter.table","NW_015090842.1:10254900",0,3,3
"LOC106888384","s1650_F_GON_01_ASEReadCounter.table","NW_015090842.1:10254915",0,3,3
"LOC106888384","s1650_F_GON_01_ASEReadCounter.table","NW_015090842.1:10254965",4,4,0
"LOC106888384","s1650_F_GON_01_ASEReadCounter.table","NW_015090842.1:10254975",1,4,3
"LOC106888384","s1650_F_GON_01_ASEReadCounter.table","NW_015090842.1:10255077",2,6,4
"LOC106888384","s1650_F_GON_01_ASEReadCounter.table","NW_015090842.1:10255117",2,7,5
"LOC106888384","s1650_F_GON_01_ASEReadCounter.table","NW_015090842.1:10255138",1,7,6
"LOC106888384","s1650_F_GON_01_ASEReadCounter.table","NW_015090842.1:10255139",1,7,6
"LOC106888384","s1650_F_GON_01_ASEReadCounter.table","NW_015090842.1:10255209",0,4,4
"LOC106888384","s1650_F_GON_01_ASEReadCounter.table","NW_015090842.1:10255211",0,4,4
"LOC106888384","s1650_F_GON_01_ASEReadCounter.table","NW_015090842.1:10255236",1,6,5
"LOC106888384","s1650_F_GON_01_ASEReadCounter.table","NW_015090842.1:10255262",1,7,6
"LOC106888384","s1650_F_GON_01_ASEReadCounter.table","NW_015090842.1:10255264",1,7,6
"LOC106888384","s1650_F_GON_01_ASEReadCounter.table","NW_015090842.1:10255306",2,7,5
"LOC106888384","s1650_F_GON_01_ASEReadCounter.table","NW_015090842.1:10255340",3,5,2
"LOC106888384","s1650_F_GON_01_ASEReadCounter.table","NW_015090842.1:10255410",3,6,3
"LOC106888384","s1650_F_GON_01_ASEReadCounter.table","NW_015090842.1:10255449",2,5,3
"LOC106888384","s1650_F_GON_01_ASEReadCounter.table","NW_015090842.1:10255496",2,5,3
"LOC106888384","s1650_F_GON_01_ASEReadCounter.table","NW_015090842.1:10255505",2,4,2
"LOC106888384","s1650_F_GON_01_ASEReadCounter.table","NW_015090842.1:10255531",3,6,3
"LOC106888384","s1650_F_GON_01_ASEReadCounter.table","NW_015090842.1:10255608",9,16,7
"LOC106888384","s1650_F_GON_01_ASEReadCounter.table","NW_015090842.1:10255704",161,174,13
"LOC106888384","s1650_F_GON_01_ASEReadCounter.table","NW_015090842.1:10255731",175,187,12
"LOC106888384","s1650_F_GON_01_ASEReadCounter.table","NW_015090842.1:10255771",136,154,18
"TANGO6","s1650_F_GON_01_ASEReadCounter.table","NW_015090842.1:10257782",62,98,36
"TANGO6","s1650_F_GON_01_ASEReadCounter.table","NW_015090842.1:10258162",24,59,35
"TANGO6","s1650_F_GON_01_ASEReadCounter.table","NW_015090842.1:10258185",25,56,31
"TANGO6","s1650_F_GON_01_ASEReadCounter.table","NW_015090842.1:10259267",35,76,41
"TANGO6","s1650_F_GON_01_ASEReadCounter.table","NW_015090842.1:10260250",87,194,107
"TANGO6","s1650_F_GON_01_ASEReadCounter.table","NW_015090842.1:10260289",84,177,93
"TANGO6","s1650_F_GON_01_ASEReadCounter.table","NW_015090842.1:10260309",64,149,85
"TANGO6","s1650_F_GON_01_ASEReadCounter.table","NW_015090842.1:10260979",52,116,64
"TANGO6","s1650_F_GON_01_ASEReadCounter.table","NW_015090842.1:10261599",76,156,80
"TANGO6","s1650_F_GON_01_ASEReadCounter.table","NW_015090842.1:10268425",133,247,114
"TANGO6","s1650_F_GON_01_ASEReadCounter.table","NW_015090842.1:10269831",80,183,103
"TANGO6","s1650_F_GON_01_ASEReadCounter.table","NW_015090842.1:10270813",63,155,92
"TANGO6","s1650_F_GON_01_ASEReadCounter.table","NW_015090842.1:10274018",22,38,16
"TANGO6","s1650_F_GON_01_ASEReadCounter.table","NW_015090842.1:10275974",26,41,15
"TANGO6","s1650_F_GON_01_ASEReadCounter.table","NW_015090842.1:10275976",25,40,15
"TANGO6","s1650_F_GON_01_ASEReadCounter.table","NW_015090842.1:10276123",20,32,12
"TANGO6","s1650_F_GON_01_ASEReadCounter.table","NW_015090842.1:10276271",13,26,13
"TANGO6","s1650_F_GON_01_ASEReadCounter.table","NW_015090842.1:10276272",12,25,13
"TANGO6","s1650_F_GON_01_ASEReadCounter.table","NW_015090842.1:10276275",12,25,13
"TANGO6","s1650_F_GON_01_ASEReadCounter.table","NW_015090842.1:10276278",13,26,13
"TANGO6","s1650_F_GON_01_ASEReadCounter.table","NW_015090842.1:10276368",13,20,7
"TANGO6","s1650_F_GON_01_ASEReadCounter.table","NW_015090842.1:10276373",11,16,5
"TANGO6","s1650_F_GON_01_ASEReadCounter.table","NW_015090842.1:10276630",22,30,8
"TANGO6","s1650_F_GON_01_ASEReadCounter.table","NW_015090842.1:10281498",15,33,18
"TANGO6","s1650_F_GON_01_ASEReadCounter.table","NW_015090842.1:10281516",19,39,20
"TANGO6","s1650_F_GON_01_ASEReadCounter.table","NW_015090842.1:10282842",21,37,16
"TANGO6","s1650_F_GON_01_ASEReadCounter.table","NW_015090842.1:10282863",17,30,13
"TANGO6","s1650_F_GON_01_ASEReadCounter.table","NW_015090842.1:10282869",16,31,15
"TANGO6","s1650_F_GON_01_ASEReadCounter.table","NW_015090842.1:10282903",27,47,20
"TANGO6","s1650_F_GON_01_ASEReadCounter.table","NW_015090842.1:10283757",21,42,21
"TANGO6","s1650_F_GON_01_ASEReadCounter.table","NW_015090842.1:10283785",22,39,17
"HAS3","s1650_F_GON_01_ASEReadCounter.table","NW_015090842.1:10288093",0,3,3
"HAS3","s1650_F_GON_01_ASEReadCounter.table","NW_015090842.1:10288266",0,1,1
"HAS3","s1650_F_GON_01_ASEReadCounter.table","NW_015090842.1:10288274",0,2,2
"HAS3","s1650_F_GON_01_ASEReadCounter.table","NW_015090842.1:10288364",0,1,1
"HAS3","s1650_F_GON_01_ASEReadCounter.table","NW_015090842.1:10289269",1,2,1
"HAS3","s1650_F_GON_01_ASEReadCounter.table","NW_015090842.1:10289272",1,2,1
"HAS3","s1650_F_GON_01_ASEReadCounter.table","NW_015090842.1:10289469",0,1,1
"HAS3","s1650_F_GON_01_ASEReadCounter.table","NW_015090842.1:10290375",0,4,4
"HAS3","s1650_F_GON_01_ASEReadCounter.table","NW_015090842.1:10290395",0,3,3
"HAS3","s1650_F_GON_01_ASEReadCounter.table","NW_015090842.1:10290439",1,5,4
"HAS3","s1650_F_GON_01_ASEReadCounter.table","NW_015090842.1:10290561",1,3,2
"HAS3","s1650_F_GON_01_ASEReadCounter.table","NW_015090842.1:10290609",2,6,4
"HAS3","s1650_F_GON_01_ASEReadCounter.table","NW_015090842.1:10290666",3,11,8
"HAS3","s1650_F_GON_01_ASEReadCounter.table","NW_015090842.1:10290723",3,9,6
"HAS3","s1650_F_GON_01_ASEReadCounter.table","NW_015090842.1:10290927",2,5,3
"HAS3","s1650_F_GON_01_ASEReadCounter.table","NW_015090842.1:10291004",3,8,5
"CHTF8","s1650_F_GON_01_ASEReadCounter.table","NW_015090842.1:10291319",19,35,16
"CHTF8","s1650_F_GON_01_ASEReadCounter.table","NW_015090842.1:10291491",95,127,32
"CHTF8","s1650_F_GON_01_ASEReadCounter.table","NW_015090842.1:10291520",103,157,54
"CHTF8","s1650_F_GON_01_ASEReadCounter.table","NW_015090842.1:10291593",125,201,76
"CHTF8","s1650_F_GON_01_ASEReadCounter.table","NW_015090842.1:10291600",116,196,80
"CHTF8","s1650_F_GON_01_ASEReadCounter.table","NW_015090842.1:10291609",113,189,76
"CHTF8","s1650_F_GON_01_ASEReadCounter.table","NW_015090842.1:10291639",113,190,77
"CHTF8","s1650_F_GON_01_ASEReadCounter.table","NW_015090842.1:10291641",109,187,78
"CHTF8","s1650_F_GON_01_ASEReadCounter.table","NW_015090842.1:10291648",126,208,82
"CHTF8","s1650_F_GON_01_ASEReadCounter.table","NW_015090842.1:10291656",129,209,80
"CHTF8","s1650_F_GON_01_ASEReadCounter.table","NW_015090842.1:10291675",125,208,83
"CHTF8","s1650_F_GON_01_ASEReadCounter.table","NW_015090842.1:10291696",120,190,70
"CHTF8","s1650_F_GON_01_ASEReadCounter.table","NW_015090842.1:10291714",114,183,69
"CHTF8","s1650_F_GON_01_ASEReadCounter.table","NW_015090842.1:10291732",133,214,81
"CHTF8","s1650_F_GON_01_ASEReadCounter.table","NW_015090842.1:10291755",110,185,75
"CHTF8","s1650_F_GON_01_ASEReadCounter.table","NW_015090842.1:10291756",113,188,75
"CHTF8","s1650_F_GON_01_ASEReadCounter.table","NW_015090842.1:10291758",114,195,81
"CHTF8","s1650_F_GON_01_ASEReadCounter.table","NW_015090842.1:10291792",128,208,80
"CHTF8","s1650_F_GON_01_ASEReadCounter.table","NW_015090842.1:10291895",120,200,80
"CHTF8","s1650_F_GON_01_ASEReadCounter.table","NW_015090842.1:10292132",120,193,73
"CHTF8","s1650_F_GON_01_ASEReadCounter.table","NW_015090842.1:10292314",117,197,80
"CHTF8","s1650_F_GON_01_ASEReadCounter.table","NW_015090842.1:10292317",115,198,83
"CHTF8","s1650_F_GON_01_ASEReadCounter.table","NW_015090842.1:10292928",21,34,13
"UTP4","s1650_F_GON_01_ASEReadCounter.table","NW_015090842.1:10293146",14,44,30
"UTP4","s1650_F_GON_01_ASEReadCounter.table","NW_015090842.1:10293151",17,47,30
"UTP4","s1650_F_GON_01_ASEReadCounter.table","NW_015090842.1:10293191",9,27,18
"UTP4","s1650_F_GON_01_ASEReadCounter.table","NW_015090842.1:10293362",19,40,21
"UTP4","s1650_F_GON_01_ASEReadCounter.table","NW_015090842.1:10293430",19,44,25
"UTP4","s1650_F_GON_01_ASEReadCounter.table","NW_015090842.1:10293625",13,37,24
"UTP4","s1650_F_GON_01_ASEReadCounter.table","NW_015090842.1:10293684",17,37,20
"UTP4","s1650_F_GON_01_ASEReadCounter.table","NW_015090842.1:10294093",10,32,22
"UTP4","s1650_F_GON_01_ASEReadCounter.table","NW_015090842.1:10294622",13,33,20
"UTP4","s1650_F_GON_01_ASEReadCounter.table","NW_015090842.1:10294632",14,35,21
"UTP4","s1650_F_GON_01_ASEReadCounter.table","NW_015090842.1:10295238",12,42,30
"UTP4","s1650_F_GON_01_ASEReadCounter.table","NW_015090842.1:10295880",20,61,41
"UTP4","s1650_F_GON_01_ASEReadCounter.table","NW_015090842.1:10295884",20,62,42
"UTP4","s1650_F_GON_01_ASEReadCounter.table","NW_015090842.1:10295903",20,55,35
"UTP4","s1650_F_GON_01_ASEReadCounter.table","NW_015090842.1:10295906",20,55,35
"UTP4","s1650_F_GON_01_ASEReadCounter.table","NW_015090842.1:10295915",21,60,39
"UTP4","s1650_F_GON_01_ASEReadCounter.table","NW_015090842.1:10295938",16,58,42
"UTP4","s1650_F_GON_01_ASEReadCounter.table","NW_015090842.1:10296175",13,44,31
"UTP4","s1650_F_GON_01_ASEReadCounter.table","NW_015090842.1:10296660",23,48,25
"UTP4","s1650_F_GON_01_ASEReadCounter.table","NW_015090842.1:10296679",23,48,25
"UTP4","s1650_F_GON_01_ASEReadCounter.table","NW_015090842.1:10297193",25,58,33
"UTP4","s1650_F_GON_01_ASEReadCounter.table","NW_015090842.1:10297220",24,65,41
"UTP4","s1650_F_GON_01_ASEReadCounter.table","NW_015090842.1:10297307",27,80,53
"UTP4","s1650_F_GON_01_ASEReadCounter.table","NW_015090842.1:10297558",33,77,44
"UTP4","s1650_F_GON_01_ASEReadCounter.table","NW_015090842.1:10297943",23,62,39
"UTP4","s1650_F_GON_01_ASEReadCounter.table","NW_015090842.1:10297979",23,60,37
"UTP4","s1650_F_GON_01_ASEReadCounter.table","NW_015090842.1:10298022",20,52,32
"UTP4","s1650_F_GON_01_ASEReadCounter.table","NW_015090842.1:10298079",1,11,10
"UTP4","s1650_F_GON_01_ASEReadCounter.table","NW_015090842.1:10298081",0,10,10
"UTP4","s1650_F_GON_01_ASEReadCounter.table","NW_015090842.1:10298082",1,10,9
"SNTB2","s1650_F_GON_01_ASEReadCounter.table","NW_015090842.1:10298905",1,3,2
"SNTB2","s1650_F_GON_01_ASEReadCounter.table","NW_015090842.1:10298928",1,7,6
"SNTB2","s1650_F_GON_01_ASEReadCounter.table","NW_015090842.1:10303506",19,37,18
"SNTB2","s1650_F_GON_01_ASEReadCounter.table","NW_015090842.1:10303524",17,32,15
"SNTB2","s1650_F_GON_01_ASEReadCounter.table","NW_015090842.1:10304059",11,22,11
"SNTB2","s1650_F_GON_01_ASEReadCounter.table","NW_015090842.1:10304089",12,28,16
"SNTB2","s1650_F_GON_01_ASEReadCounter.table","NW_015090842.1:10304167",6,25,19
"SNTB2","s1650_F_GON_01_ASEReadCounter.table","NW_015090842.1:10304176",3,19,16
"SNTB2","s1650_F_GON_01_ASEReadCounter.table","NW_015090842.1:10305069",14,24,10
"SNTB2","s1650_F_GON_01_ASEReadCounter.table","NW_015090842.1:10305099",13,27,14
"SNTB2","s1650_F_GON_01_ASEReadCounter.table","NW_015090842.1:10305171",10,24,14
"SNTB2","s1650_F_GON_01_ASEReadCounter.table","NW_015090842.1:10305177",9,23,14
"SNTB2","s1650_F_GON_01_ASEReadCounter.table","NW_015090842.1:10305451",8,19,11
"SNTB2","s1650_F_GON_01_ASEReadCounter.table","NW_015090842.1:10305547",14,34,20
"SNTB2","s1650_F_GON_01_ASEReadCounter.table","NW_015090842.1:10305847",10,19,9
"SNTB2","s1650_F_GON_01_ASEReadCounter.table","NW_015090842.1:10306173",13,26,13
"SNTB2","s1650_F_GON_01_ASEReadCounter.table","NW_015090842.1:10306275",7,15,8
"SNTB2","s1650_F_GON_01_ASEReadCounter.table","NW_015090842.1:10306457",10,22,12
"SNTB2","s1650_F_GON_01_ASEReadCounter.table","NW_015090842.1:10306496",12,23,11
"SNTB2","s1650_F_GON_01_ASEReadCounter.table","NW_015090842.1:10306499",11,21,10
"VPS4A","s1650_F_GON_01_ASEReadCounter.table","NW_015090842.1:10308566",126,327,201
"VPS4A","s1650_F_GON_01_ASEReadCounter.table","NW_015090842.1:10308573",129,336,207
"VPS4A","s1650_F_GON_01_ASEReadCounter.table","NW_015090842.1:10308856",173,498,325
"VPS4A","s1650_F_GON_01_ASEReadCounter.table","NW_015090842.1:10309056",215,604,389
"VPS4A","s1650_F_GON_01_ASEReadCounter.table","NW_015090842.1:10309089",256,656,400
"VPS4A","s1650_F_GON_01_ASEReadCounter.table","NW_015090842.1:10309392",269,639,370
"VPS4A","s1650_F_GON_01_ASEReadCounter.table","NW_015090842.1:10309413",275,686,411
"VPS4A","s1650_F_GON_01_ASEReadCounter.table","NW_015090842.1:10309467",316,797,481
"VPS4A","s1650_F_GON_01_ASEReadCounter.table","NW_015090842.1:10310230",232,693,461
"VPS4A","s1650_F_GON_01_ASEReadCounter.table","NW_015090842.1:10310425",222,633,411
"VPS4A","s1650_F_GON_01_ASEReadCounter.table","NW_015090842.1:10310639",254,642,388
"VPS4A","s1650_F_GON_01_ASEReadCounter.table","NW_015090842.1:10310734",212,575,363
"VPS4A","s1650_F_GON_01_ASEReadCounter.table","NW_015090842.1:10310737",208,583,375
"VPS4A","s1650_F_GON_01_ASEReadCounter.table","NW_015090842.1:10310746",208,601,393
"VPS4A","s1650_F_GON_01_ASEReadCounter.table","NW_015090842.1:10310767",211,592,381
"VPS4A","s1650_F_GON_01_ASEReadCounter.table","NW_015090842.1:10310995",240,606,366
"VPS4A","s1650_F_GON_01_ASEReadCounter.table","NW_015090842.1:10311004",231,568,337
"VPS4A","s1650_F_GON_01_ASEReadCounter.table","NW_015090842.1:10311007",233,591,358
"VPS4A","s1650_F_GON_01_ASEReadCounter.table","NW_015090842.1:10311013",243,589,346
"VPS4A","s1650_F_GON_01_ASEReadCounter.table","NW_015090842.1:10311022",226,569,343
"VPS4A","s1650_F_GON_01_ASEReadCounter.table","NW_015090842.1:10311023",227,566,339
"VPS4A","s1650_F_GON_01_ASEReadCounter.table","NW_015090842.1:10311426",221,628,407
"VPS4A","s1650_F_GON_01_ASEReadCounter.table","NW_015090842.1:10311489",3,15,12
"VPS4A","s1650_F_GON_01_ASEReadCounter.table","NW_015090842.1:10311490",3,10,7
"VPS4A","s1650_F_GON_01_ASEReadCounter.table","NW_015090842.1:10311525",24,39,15
"VPS4A","s1650_F_GON_01_ASEReadCounter.table","NW_015090842.1:10311529",27,54,27
"VPS4A","s1650_F_GON_01_ASEReadCounter.table","NW_015090842.1:10311530",27,58,31
"VPS4A","s1650_F_GON_01_ASEReadCounter.table","NW_015090842.1:10311552",95,142,47
"VPS4A","s1650_F_GON_01_ASEReadCounter.table","NW_015090842.1:10311689",96,157,61
"VPS4A","s1650_F_GON_01_ASEReadCounter.table","NW_015090842.1:10311700",110,175,65
"VPS4A","s1650_F_GON_01_ASEReadCounter.table","NW_015090842.1:10311701",110,175,65
"VPS4A","s1650_F_GON_01_ASEReadCounter.table","NW_015090842.1:10311703",109,174,65
"COG8","s1650_F_GON_01_ASEReadCounter.table","NW_015090842.1:10313487",14,40,26
"COG8","s1650_F_GON_01_ASEReadCounter.table","NW_015090842.1:10313559",24,53,29
"COG8","s1650_F_GON_01_ASEReadCounter.table","NW_015090842.1:10313579",29,57,28
"COG8","s1650_F_GON_01_ASEReadCounter.table","NW_015090842.1:10313665",17,54,37
"COG8","s1650_F_GON_01_ASEReadCounter.table","NW_015090842.1:10313681",13,49,36
"COG8","s1650_F_GON_01_ASEReadCounter.table","NW_015090842.1:10313768",30,66,36
"COG8","s1650_F_GON_01_ASEReadCounter.table","NW_015090842.1:10313775",33,68,35
"COG8","s1650_F_GON_01_ASEReadCounter.table","NW_015090842.1:10313811",29,63,34
"COG8","s1650_F_GON_01_ASEReadCounter.table","NW_015090842.1:10313858",23,45,22
"COG8","s1650_F_GON_01_ASEReadCounter.table","NW_015090842.1:10314100",27,62,35
"COG8","s1650_F_GON_01_ASEReadCounter.table","NW_015090842.1:10314213",31,73,42
"COG8","s1650_F_GON_01_ASEReadCounter.table","NW_015090842.1:10315093",30,56,26
"COG8","s1650_F_GON_01_ASEReadCounter.table","NW_015090842.1:10315162",25,52,27
"COG8","s1650_F_GON_01_ASEReadCounter.table","NW_015090842.1:10315285",37,64,27
"COG8","s1650_F_GON_01_ASEReadCounter.table","NW_015090842.1:10315360",24,51,27
"COG8","s1650_F_GON_01_ASEReadCounter.table","NW_015090842.1:10315369",25,54,29
"COG8","s1650_F_GON_01_ASEReadCounter.table","NW_015090842.1:10315504",7,30,23
"COG8","s1650_F_GON_01_ASEReadCounter.table","NW_015090842.1:10315508",7,31,24
"COG8","s1650_F_GON_01_ASEReadCounter.table","NW_015090842.1:10315624",20,57,37
"COG8","s1650_F_GON_01_ASEReadCounter.table","NW_015090842.1:10315693",18,38,20
"COG8","s1650_F_GON_01_ASEReadCounter.table","NW_015090842.1:10315698",18,39,21
"COG8","s1650_F_GON_01_ASEReadCounter.table","NW_015090842.1:10315768",18,39,21
"COG8","s1650_F_GON_01_ASEReadCounter.table","NW_015090842.1:10315769",19,40,21
"COG8","s1650_F_GON_01_ASEReadCounter.table","NW_015090842.1:10315784",20,41,21
"COG8","s1650_F_GON_01_ASEReadCounter.table","NW_015090842.1:10316093",20,49,29
"COG8","s1650_F_GON_01_ASEReadCounter.table","NW_015090842.1:10316133",19,47,28
"NIP7","s1650_F_GON_01_ASEReadCounter.table","NW_015090842.1:10316759",43,74,31
"NIP7","s1650_F_GON_01_ASEReadCounter.table","NW_015090842.1:10316967",280,482,202
"NIP7","s1650_F_GON_01_ASEReadCounter.table","NW_015090842.1:10316995",318,535,217
"NIP7","s1650_F_GON_01_ASEReadCounter.table","NW_015090842.1:10317240",354,649,295
"NIP7","s1650_F_GON_01_ASEReadCounter.table","NW_015090842.1:10317247",355,633,278
"NIP7","s1650_F_GON_01_ASEReadCounter.table","NW_015090842.1:10317264",351,606,255
"NIP7","s1650_F_GON_01_ASEReadCounter.table","NW_015090842.1:10317433",365,670,305
"NIP7","s1650_F_GON_01_ASEReadCounter.table","NW_015090842.1:10317738",290,550,260
"NIP7","s1650_F_GON_01_ASEReadCounter.table","NW_015090842.1:10317769",313,560,247
"NIP7","s1650_F_GON_01_ASEReadCounter.table","NW_015090842.1:10317808",224,406,182
"NIP7","s1650_F_GON_01_ASEReadCounter.table","NW_015090842.1:10317870",128,248,120
"NIP7","s1650_F_GON_01_ASEReadCounter.table","NW_015090842.1:10317871",126,238,112
"NIP7","s1650_F_GON_01_ASEReadCounter.table","NW_015090842.1:10317898",90,177,87
"NIP7","s1650_F_GON_01_ASEReadCounter.table","NW_015090842.1:10317911",89,166,77
"TMED6","s1650_F_GON_01_ASEReadCounter.table","NW_015090842.1:10318731",2,2,0
"TERF2","s1650_F_GON_01_ASEReadCounter.table","NW_015090842.1:10321665",13,13,0
"TERF2","s1650_F_GON_01_ASEReadCounter.table","NW_015090842.1:10321768",54,130,76
"TERF2","s1650_F_GON_01_ASEReadCounter.table","NW_015090842.1:10321777",54,125,71
"TERF2","s1650_F_GON_01_ASEReadCounter.table","NW_015090842.1:10321805",51,140,89
"TERF2","s1650_F_GON_01_ASEReadCounter.table","NW_015090842.1:10321878",79,180,101
"TERF2","s1650_F_GON_01_ASEReadCounter.table","NW_015090842.1:10321893",75,170,95
"TERF2","s1650_F_GON_01_ASEReadCounter.table","NW_015090842.1:10321897",73,160,87
"TERF2","s1650_F_GON_01_ASEReadCounter.table","NW_015090842.1:10321908",70,150,80
"TERF2","s1650_F_GON_01_ASEReadCounter.table","NW_015090842.1:10322001",99,221,122
"TERF2","s1650_F_GON_01_ASEReadCounter.table","NW_015090842.1:10322035",80,171,91
"TERF2","s1650_F_GON_01_ASEReadCounter.table","NW_015090842.1:10322051",80,180,100
"TERF2","s1650_F_GON_01_ASEReadCounter.table","NW_015090842.1:10322137",70,158,88
"TERF2","s1650_F_GON_01_ASEReadCounter.table","NW_015090842.1:10322144",73,158,85
"TERF2","s1650_F_GON_01_ASEReadCounter.table","NW_015090842.1:10322388",46,178,132
"TERF2","s1650_F_GON_01_ASEReadCounter.table","NW_015090842.1:10322396",50,177,127
"TERF2","s1650_F_GON_01_ASEReadCounter.table","NW_015090842.1:10322502",73,212,139
"TERF2","s1650_F_GON_01_ASEReadCounter.table","NW_015090842.1:10322504",75,218,143
"TERF2","s1650_F_GON_01_ASEReadCounter.table","NW_015090842.1:10322510",74,227,153
"TERF2","s1650_F_GON_01_ASEReadCounter.table","NW_015090842.1:10323580",82,240,158
"TERF2","s1650_F_GON_01_ASEReadCounter.table","NW_015090842.1:10324314",75,223,148
"TERF2","s1650_F_GON_01_ASEReadCounter.table","NW_015090842.1:10326832",61,164,103
"TERF2","s1650_F_GON_01_ASEReadCounter.table","NW_015090842.1:10327787",50,113,63
"TERF2","s1650_F_GON_01_ASEReadCounter.table","NW_015090842.1:10328588",58,140,82
"TERF2","s1650_F_GON_01_ASEReadCounter.table","NW_015090842.1:10328644",45,111,66
"TERF2","s1650_F_GON_01_ASEReadCounter.table","NW_015090842.1:10329813",39,95,56
"TERF2","s1650_F_GON_01_ASEReadCounter.table","NW_015090842.1:10330749",24,70,46
"TERF2","s1650_F_GON_01_ASEReadCounter.table","NW_015090842.1:10330789",29,88,59
"CYB5B","s1650_F_GON_01_ASEReadCounter.table","NW_015090842.1:10336595",16,49,33
"CYB5B","s1650_F_GON_01_ASEReadCounter.table","NW_015090842.1:10336667",144,289,145
"CYB5B","s1650_F_GON_01_ASEReadCounter.table","NW_015090842.1:10336689",208,407,199
"CYB5B","s1650_F_GON_01_ASEReadCounter.table","NW_015090842.1:10336728",294,581,287
"CYB5B","s1650_F_GON_01_ASEReadCounter.table","NW_015090842.1:10345068",273,600,327
"CYB5B","s1650_F_GON_01_ASEReadCounter.table","NW_015090842.1:10348800",338,747,409
"CYB5B","s1650_F_GON_01_ASEReadCounter.table","NW_015090842.1:10348888",279,594,315
"CYB5B","s1650_F_GON_01_ASEReadCounter.table","NW_015090842.1:10349046",260,574,314
"CYB5B","s1650_F_GON_01_ASEReadCounter.table","NW_015090842.1:10349119",156,433,277
"CYB5B","s1650_F_GON_01_ASEReadCounter.table","NW_015090842.1:10349146",71,333,262
"CYB5B","s1650_F_GON_01_ASEReadCounter.table","NW_015090842.1:10349157",131,399,268
