"gene","id","snp","ref_count","total_count","alt_count"
"CENPN","s1650_F_VTA_03_ASEReadCounter.table","NW_015090842.1:5801655",0,1,1
"CENPN","s1650_F_VTA_03_ASEReadCounter.table","NW_015090842.1:5801662",0,1,1
"CENPN","s1650_F_VTA_03_ASEReadCounter.table","NW_015090842.1:5801670",0,1,1
"CENPN","s1650_F_VTA_03_ASEReadCounter.table","NW_015090842.1:5801674",0,1,1
"CENPN","s1650_F_VTA_03_ASEReadCounter.table","NW_015090842.1:5801692",0,2,2
"CENPN","s1650_F_VTA_03_ASEReadCounter.table","NW_015090842.1:5801697",0,2,2
"CENPN","s1650_F_VTA_03_ASEReadCounter.table","NW_015090842.1:5802008",0,4,4
"CENPN","s1650_F_VTA_03_ASEReadCounter.table","NW_015090842.1:5802012",0,4,4
"CENPN","s1650_F_VTA_03_ASEReadCounter.table","NW_015090842.1:5802087",1,9,8
"CENPN","s1650_F_VTA_03_ASEReadCounter.table","NW_015090842.1:5810113",4,4,0
"CENPN","s1650_F_VTA_03_ASEReadCounter.table","NW_015090842.1:5810147",11,11,0
"CENPN","s1650_F_VTA_03_ASEReadCounter.table","NW_015090842.1:5810148",11,11,0
"ATMIN","s1650_F_VTA_03_ASEReadCounter.table","NW_015090842.1:5818789",0,3,3
"ATMIN","s1650_F_VTA_03_ASEReadCounter.table","NW_015090842.1:5819958",0,7,7
"ATMIN","s1650_F_VTA_03_ASEReadCounter.table","NW_015090842.1:5820004",0,5,5
"ATMIN","s1650_F_VTA_03_ASEReadCounter.table","NW_015090842.1:5820217",4,5,1
"ATMIN","s1650_F_VTA_03_ASEReadCounter.table","NW_015090842.1:5820250",4,4,0
"ATMIN","s1650_F_VTA_03_ASEReadCounter.table","NW_015090842.1:5820298",5,6,1
"ATMIN","s1650_F_VTA_03_ASEReadCounter.table","NW_015090842.1:5820417",6,8,2
"ATMIN","s1650_F_VTA_03_ASEReadCounter.table","NW_015090842.1:5820421",3,5,2
"ATMIN","s1650_F_VTA_03_ASEReadCounter.table","NW_015090842.1:5820448",3,4,1
"ATMIN","s1650_F_VTA_03_ASEReadCounter.table","NW_015090842.1:5820457",3,5,2
"ATMIN","s1650_F_VTA_03_ASEReadCounter.table","NW_015090842.1:5820510",2,7,5
"ATMIN","s1650_F_VTA_03_ASEReadCounter.table","NW_015090842.1:5820673",1,3,2
"ATMIN","s1650_F_VTA_03_ASEReadCounter.table","NW_015090842.1:5820754",1,7,6
"ATMIN","s1650_F_VTA_03_ASEReadCounter.table","NW_015090842.1:5820820",0,3,3
"ATMIN","s1650_F_VTA_03_ASEReadCounter.table","NW_015090842.1:5820865",1,3,2
"ATMIN","s1650_F_VTA_03_ASEReadCounter.table","NW_015090842.1:5820889",1,3,2
"ATMIN","s1650_F_VTA_03_ASEReadCounter.table","NW_015090842.1:5820891",1,3,2
"ATMIN","s1650_F_VTA_03_ASEReadCounter.table","NW_015090842.1:5820997",2,6,4
"ATMIN","s1650_F_VTA_03_ASEReadCounter.table","NW_015090842.1:5821063",2,5,3
"ATMIN","s1650_F_VTA_03_ASEReadCounter.table","NW_015090842.1:5821132",2,5,3
"ATMIN","s1650_F_VTA_03_ASEReadCounter.table","NW_015090842.1:5821645",2,4,2
"ATMIN","s1650_F_VTA_03_ASEReadCounter.table","NW_015090842.1:5825066",9,21,12
"ATMIN","s1650_F_VTA_03_ASEReadCounter.table","NW_015090842.1:5825106",7,21,14
"ATMIN","s1650_F_VTA_03_ASEReadCounter.table","NW_015090842.1:5825122",7,20,13
"ATMIN","s1650_F_VTA_03_ASEReadCounter.table","NW_015090842.1:5825178",8,22,14
"ATMIN","s1650_F_VTA_03_ASEReadCounter.table","NW_015090842.1:5825194",7,20,13
"ATMIN","s1650_F_VTA_03_ASEReadCounter.table","NW_015090842.1:5825195",7,21,14
"ATMIN","s1650_F_VTA_03_ASEReadCounter.table","NW_015090842.1:5825220",5,19,14
"ATMIN","s1650_F_VTA_03_ASEReadCounter.table","NW_015090842.1:5825240",7,22,15
"ATMIN","s1650_F_VTA_03_ASEReadCounter.table","NW_015090842.1:5825303",9,29,20
"ATMIN","s1650_F_VTA_03_ASEReadCounter.table","NW_015090842.1:5825304",9,28,19
"ATMIN","s1650_F_VTA_03_ASEReadCounter.table","NW_015090842.1:5825310",9,29,20
"ATMIN","s1650_F_VTA_03_ASEReadCounter.table","NW_015090842.1:5825406",10,20,10
"ATMIN","s1650_F_VTA_03_ASEReadCounter.table","NW_015090842.1:5825415",11,21,10
"ATMIN","s1650_F_VTA_03_ASEReadCounter.table","NW_015090842.1:5825438",13,26,13
"ATMIN","s1650_F_VTA_03_ASEReadCounter.table","NW_015090842.1:5825485",16,31,15
"ATMIN","s1650_F_VTA_03_ASEReadCounter.table","NW_015090842.1:5825524",18,33,15
"ATMIN","s1650_F_VTA_03_ASEReadCounter.table","NW_015090842.1:5825557",18,30,12
"ATMIN","s1650_F_VTA_03_ASEReadCounter.table","NW_015090842.1:5825571",17,31,14
"ATMIN","s1650_F_VTA_03_ASEReadCounter.table","NW_015090842.1:5825579",17,31,14
"ATMIN","s1650_F_VTA_03_ASEReadCounter.table","NW_015090842.1:5825590",14,25,11
"ATMIN","s1650_F_VTA_03_ASEReadCounter.table","NW_015090842.1:5825689",16,27,11
"ATMIN","s1650_F_VTA_03_ASEReadCounter.table","NW_015090842.1:5825703",18,29,11
"ATMIN","s1650_F_VTA_03_ASEReadCounter.table","NW_015090842.1:5825787",16,28,12
"ATMIN","s1650_F_VTA_03_ASEReadCounter.table","NW_015090842.1:5825833",19,31,12
"ATMIN","s1650_F_VTA_03_ASEReadCounter.table","NW_015090842.1:5825841",20,33,13
"ATMIN","s1650_F_VTA_03_ASEReadCounter.table","NW_015090842.1:5825895",20,35,15
"ATMIN","s1650_F_VTA_03_ASEReadCounter.table","NW_015090842.1:5825984",17,32,15
"ATMIN","s1650_F_VTA_03_ASEReadCounter.table","NW_015090842.1:5826162",24,51,27
"ATMIN","s1650_F_VTA_03_ASEReadCounter.table","NW_015090842.1:5826194",24,50,26
"ATMIN","s1650_F_VTA_03_ASEReadCounter.table","NW_015090842.1:5826235",23,49,26
"ATMIN","s1650_F_VTA_03_ASEReadCounter.table","NW_015090842.1:5826245",22,46,24
"ATMIN","s1650_F_VTA_03_ASEReadCounter.table","NW_015090842.1:5826335",14,34,20
"ATMIN","s1650_F_VTA_03_ASEReadCounter.table","NW_015090842.1:5826417",13,37,24
"ATMIN","s1650_F_VTA_03_ASEReadCounter.table","NW_015090842.1:5826431",14,46,32
"ATMIN","s1650_F_VTA_03_ASEReadCounter.table","NW_015090842.1:5826438",15,43,28
"ATMIN","s1650_F_VTA_03_ASEReadCounter.table","NW_015090842.1:5826463",21,60,39
"ATMIN","s1650_F_VTA_03_ASEReadCounter.table","NW_015090842.1:5826502",26,70,44
"ATMIN","s1650_F_VTA_03_ASEReadCounter.table","NW_015090842.1:5826511",27,75,48
"ATMIN","s1650_F_VTA_03_ASEReadCounter.table","NW_015090842.1:5826659",21,61,40
"ATMIN","s1650_F_VTA_03_ASEReadCounter.table","NW_015090842.1:5826701",37,84,47
"ATMIN","s1650_F_VTA_03_ASEReadCounter.table","NW_015090842.1:5826702",37,81,44
"ATMIN","s1650_F_VTA_03_ASEReadCounter.table","NW_015090842.1:5826732",41,92,51
"ATMIN","s1650_F_VTA_03_ASEReadCounter.table","NW_015090842.1:5826745",43,92,49
"ATMIN","s1650_F_VTA_03_ASEReadCounter.table","NW_015090842.1:5826835",40,80,40
"ATMIN","s1650_F_VTA_03_ASEReadCounter.table","NW_015090842.1:5826942",25,70,45
"ATMIN","s1650_F_VTA_03_ASEReadCounter.table","NW_015090842.1:5827193",62,132,70
"ATMIN","s1650_F_VTA_03_ASEReadCounter.table","NW_015090842.1:5827196",58,128,70
"ATMIN","s1650_F_VTA_03_ASEReadCounter.table","NW_015090842.1:5827269",36,111,75
"ATMIN","s1650_F_VTA_03_ASEReadCounter.table","NW_015090842.1:5827315",30,85,55
"ATMIN","s1650_F_VTA_03_ASEReadCounter.table","NW_015090842.1:5827316",29,90,61
"ATMIN","s1650_F_VTA_03_ASEReadCounter.table","NW_015090842.1:5827333",34,95,61
"PPP1R3E","s1650_F_VTA_03_ASEReadCounter.table","NW_015090842.1:5837733",0,1,1
"PPP1R3E","s1650_F_VTA_03_ASEReadCounter.table","NW_015090842.1:5837947",2,2,0
"PKD1L2","s1650_F_VTA_03_ASEReadCounter.table","NW_015090842.1:5867597",2,3,1
"PKD1L2","s1650_F_VTA_03_ASEReadCounter.table","NW_015090842.1:5867600",2,3,1
"PKD1L2","s1650_F_VTA_03_ASEReadCounter.table","NW_015090842.1:5867660",1,2,1
"PKD1L2","s1650_F_VTA_03_ASEReadCounter.table","NW_015090842.1:5867675",1,2,1
"PKD1L2","s1650_F_VTA_03_ASEReadCounter.table","NW_015090842.1:5872825",1,1,0
"PKD1L2","s1650_F_VTA_03_ASEReadCounter.table","NW_015090842.1:5872876",1,1,0
"PKD1L2","s1650_F_VTA_03_ASEReadCounter.table","NW_015090842.1:5872924",1,1,0
"BCO1","s1650_F_VTA_03_ASEReadCounter.table","NW_015090842.1:5915610",3,4,1
"BCO1","s1650_F_VTA_03_ASEReadCounter.table","NW_015090842.1:5915646",2,3,1
"BCO1","s1650_F_VTA_03_ASEReadCounter.table","NW_015090842.1:5917836",3,4,1
"BCO1","s1650_F_VTA_03_ASEReadCounter.table","NW_015090842.1:5917912",3,4,1
"BCO1","s1650_F_VTA_03_ASEReadCounter.table","NW_015090842.1:5917941",3,4,1
"BCO1","s1650_F_VTA_03_ASEReadCounter.table","NW_015090842.1:5917971",4,5,1
"BCO1","s1650_F_VTA_03_ASEReadCounter.table","NW_015090842.1:5921679",5,5,0
"BCO1","s1650_F_VTA_03_ASEReadCounter.table","NW_015090842.1:5921726",4,6,2
"BCO1","s1650_F_VTA_03_ASEReadCounter.table","NW_015090842.1:5925669",1,3,2
"BCO1","s1650_F_VTA_03_ASEReadCounter.table","NW_015090842.1:5926937",4,4,0
"BCO1","s1650_F_VTA_03_ASEReadCounter.table","NW_015090842.1:5927921",8,9,1
"BCO1","s1650_F_VTA_03_ASEReadCounter.table","NW_015090842.1:5927948",8,9,1
"BCO1","s1650_F_VTA_03_ASEReadCounter.table","NW_015090842.1:5927968",8,9,1
"BCO1","s1650_F_VTA_03_ASEReadCounter.table","NW_015090842.1:5928052",10,11,1
"BCO1","s1650_F_VTA_03_ASEReadCounter.table","NW_015090842.1:5932726",8,13,5
"BCO1","s1650_F_VTA_03_ASEReadCounter.table","NW_015090842.1:5932801",7,10,3
"BCO1","s1650_F_VTA_03_ASEReadCounter.table","NW_015090842.1:5934558",15,20,5
"BCO1","s1650_F_VTA_03_ASEReadCounter.table","NW_015090842.1:5934575",13,17,4
"BCO1","s1650_F_VTA_03_ASEReadCounter.table","NW_015090842.1:5934608",17,23,6
"BCO1","s1650_F_VTA_03_ASEReadCounter.table","NW_015090842.1:5934647",17,21,4
"BCO1","s1650_F_VTA_03_ASEReadCounter.table","NW_015090842.1:5934725",13,18,5
"BCO1","s1650_F_VTA_03_ASEReadCounter.table","NW_015090842.1:5934726",13,17,4
"BCO1","s1650_F_VTA_03_ASEReadCounter.table","NW_015090842.1:5934733",8,12,4
"BCO1","s1650_F_VTA_03_ASEReadCounter.table","NW_015090842.1:5934821",6,7,1
"BCO1","s1650_F_VTA_03_ASEReadCounter.table","NW_015090842.1:5934826",6,9,3
"BCO1","s1650_F_VTA_03_ASEReadCounter.table","NW_015090842.1:5934844",7,10,3
"BCO1","s1650_F_VTA_03_ASEReadCounter.table","NW_015090842.1:5934958",19,25,6
"BCO1","s1650_F_VTA_03_ASEReadCounter.table","NW_015090842.1:5934976",20,27,7
"GAN","s1650_F_VTA_03_ASEReadCounter.table","NW_015090842.1:5939249",0,3,3
"GAN","s1650_F_VTA_03_ASEReadCounter.table","NW_015090842.1:5953759",5,10,5
"GAN","s1650_F_VTA_03_ASEReadCounter.table","NW_015090842.1:5957502",10,23,13
"GAN","s1650_F_VTA_03_ASEReadCounter.table","NW_015090842.1:5957578",11,24,13
"GAN","s1650_F_VTA_03_ASEReadCounter.table","NW_015090842.1:5966047",11,32,21
"GAN","s1650_F_VTA_03_ASEReadCounter.table","NW_015090842.1:5966126",6,24,18
"GAN","s1650_F_VTA_03_ASEReadCounter.table","NW_015090842.1:5966127",5,23,18
"GAN","s1650_F_VTA_03_ASEReadCounter.table","NW_015090842.1:5966162",16,40,24
"GAN","s1650_F_VTA_03_ASEReadCounter.table","NW_015090842.1:5966483",47,88,41
"CMIP","s1650_F_VTA_03_ASEReadCounter.table","NW_015090842.1:6109159",22,26,4
"CMIP","s1650_F_VTA_03_ASEReadCounter.table","NW_015090842.1:6109166",18,23,5
"CMIP","s1650_F_VTA_03_ASEReadCounter.table","NW_015090842.1:6114641",34,59,25
"CMIP","s1650_F_VTA_03_ASEReadCounter.table","NW_015090842.1:6114751",18,38,20
"CMIP","s1650_F_VTA_03_ASEReadCounter.table","NW_015090842.1:6114824",20,40,20
"CMIP","s1650_F_VTA_03_ASEReadCounter.table","NW_015090842.1:6126295",81,81,0
"CMIP","s1650_F_VTA_03_ASEReadCounter.table","NW_015090842.1:6128998",38,82,44
"CMIP","s1650_F_VTA_03_ASEReadCounter.table","NW_015090842.1:6130562",77,146,69
"CMIP","s1650_F_VTA_03_ASEReadCounter.table","NW_015090842.1:6132522",57,121,64
"CMIP","s1650_F_VTA_03_ASEReadCounter.table","NW_015090842.1:6138265",124,305,181
"CMIP","s1650_F_VTA_03_ASEReadCounter.table","NW_015090842.1:6138300",134,329,195
"CMIP","s1650_F_VTA_03_ASEReadCounter.table","NW_015090842.1:6138342",112,264,152
"CMIP","s1650_F_VTA_03_ASEReadCounter.table","NW_015090842.1:6138343",110,262,152
"CMIP","s1650_F_VTA_03_ASEReadCounter.table","NW_015090842.1:6138345",110,260,150
"CMIP","s1650_F_VTA_03_ASEReadCounter.table","NW_015090842.1:6138647",92,217,125
"CMIP","s1650_F_VTA_03_ASEReadCounter.table","NW_015090842.1:6138745",91,235,144
"CMIP","s1650_F_VTA_03_ASEReadCounter.table","NW_015090842.1:6138832",10,74,64
"CMIP","s1650_F_VTA_03_ASEReadCounter.table","NW_015090842.1:6138967",84,193,109
"CMIP","s1650_F_VTA_03_ASEReadCounter.table","NW_015090842.1:6139131",49,136,87
"CMIP","s1650_F_VTA_03_ASEReadCounter.table","NW_015090842.1:6139163",17,100,83
"CMIP","s1650_F_VTA_03_ASEReadCounter.table","NW_015090842.1:6139212",162,177,15
"CMIP","s1650_F_VTA_03_ASEReadCounter.table","NW_015090842.1:6139360",39,89,50
"CMIP","s1650_F_VTA_03_ASEReadCounter.table","NW_015090842.1:6139572",22,42,20
"PLCG2","s1650_F_VTA_03_ASEReadCounter.table","NW_015090842.1:6179613",1,2,1
"PLCG2","s1650_F_VTA_03_ASEReadCounter.table","NW_015090842.1:6179658",6,7,1
"PLCG2","s1650_F_VTA_03_ASEReadCounter.table","NW_015090842.1:6203766",1,2,1
"PLCG2","s1650_F_VTA_03_ASEReadCounter.table","NW_015090842.1:6203775",1,1,0
"PLCG2","s1650_F_VTA_03_ASEReadCounter.table","NW_015090842.1:6203787",2,2,0
"PLCG2","s1650_F_VTA_03_ASEReadCounter.table","NW_015090842.1:6209741",2,2,0
"PLCG2","s1650_F_VTA_03_ASEReadCounter.table","NW_015090842.1:6209798",1,1,0
"PLCG2","s1650_F_VTA_03_ASEReadCounter.table","NW_015090842.1:6209816",1,1,0
"PLCG2","s1650_F_VTA_03_ASEReadCounter.table","NW_015090842.1:6217547",1,8,7
"PLCG2","s1650_F_VTA_03_ASEReadCounter.table","NW_015090842.1:6218641",0,2,2
"PLCG2","s1650_F_VTA_03_ASEReadCounter.table","NW_015090842.1:6220552",2,4,2
"PLCG2","s1650_F_VTA_03_ASEReadCounter.table","NW_015090842.1:6221969",1,4,3
"PLCG2","s1650_F_VTA_03_ASEReadCounter.table","NW_015090842.1:6228672",4,6,2
"PLCG2","s1650_F_VTA_03_ASEReadCounter.table","NW_015090842.1:6228694",3,5,2
"PLCG2","s1650_F_VTA_03_ASEReadCounter.table","NW_015090842.1:6228722",3,5,2
"PLCG2","s1650_F_VTA_03_ASEReadCounter.table","NW_015090842.1:6228747",3,5,2
"PLCG2","s1650_F_VTA_03_ASEReadCounter.table","NW_015090842.1:6228835",0,3,3
"PLCG2","s1650_F_VTA_03_ASEReadCounter.table","NW_015090842.1:6228841",0,3,3
"PLCG2","s1650_F_VTA_03_ASEReadCounter.table","NW_015090842.1:6228865",1,4,3
"PLCG2","s1650_F_VTA_03_ASEReadCounter.table","NW_015090842.1:6228917",2,5,3
"PLCG2","s1650_F_VTA_03_ASEReadCounter.table","NW_015090842.1:6228926",3,5,2
"PLCG2","s1650_F_VTA_03_ASEReadCounter.table","NW_015090842.1:6228954",4,5,1
"PLCG2","s1650_F_VTA_03_ASEReadCounter.table","NW_015090842.1:6229002",4,5,1
"PLCG2","s1650_F_VTA_03_ASEReadCounter.table","NW_015090842.1:6229006",3,4,1
"PLCG2","s1650_F_VTA_03_ASEReadCounter.table","NW_015090842.1:6229081",1,1,0
"PLCG2","s1650_F_VTA_03_ASEReadCounter.table","NW_015090842.1:6229160",3,4,1
"PLCG2","s1650_F_VTA_03_ASEReadCounter.table","NW_015090842.1:6229213",3,4,1
"PLCG2","s1650_F_VTA_03_ASEReadCounter.table","NW_015090842.1:6229231",3,4,1
"PLCG2","s1650_F_VTA_03_ASEReadCounter.table","NW_015090842.1:6229663",4,4,0
"PLCG2","s1650_F_VTA_03_ASEReadCounter.table","NW_015090842.1:6229748",3,3,0
"PLCG2","s1650_F_VTA_03_ASEReadCounter.table","NW_015090842.1:6229892",3,4,1
"PLCG2","s1650_F_VTA_03_ASEReadCounter.table","NW_015090842.1:6230248",2,4,2
"PLCG2","s1650_F_VTA_03_ASEReadCounter.table","NW_015090842.1:6230255",2,4,2
"PLCG2","s1650_F_VTA_03_ASEReadCounter.table","NW_015090842.1:6230276",3,3,0
"PLCG2","s1650_F_VTA_03_ASEReadCounter.table","NW_015090842.1:6230296",2,2,0
"PLCG2","s1650_F_VTA_03_ASEReadCounter.table","NW_015090842.1:6230349",1,1,0
"PLCG2","s1650_F_VTA_03_ASEReadCounter.table","NW_015090842.1:6230408",3,5,2
"PLCG2","s1650_F_VTA_03_ASEReadCounter.table","NW_015090842.1:6230439",2,5,3
"PLCG2","s1650_F_VTA_03_ASEReadCounter.table","NW_015090842.1:6230757",1,2,1
"PLCG2","s1650_F_VTA_03_ASEReadCounter.table","NW_015090842.1:6230758",1,2,1
"PLCG2","s1650_F_VTA_03_ASEReadCounter.table","NW_015090842.1:6230898",8,9,1
"PLCG2","s1650_F_VTA_03_ASEReadCounter.table","NW_015090842.1:6230976",5,7,2
"PLCG2","s1650_F_VTA_03_ASEReadCounter.table","NW_015090842.1:6231078",8,9,1
"PLCG2","s1650_F_VTA_03_ASEReadCounter.table","NW_015090842.1:6231138",5,6,1
"PLCG2","s1650_F_VTA_03_ASEReadCounter.table","NW_015090842.1:6231177",7,8,1
"PLCG2","s1650_F_VTA_03_ASEReadCounter.table","NW_015090842.1:6231263",10,11,1
"SDR42E1","s1650_F_VTA_03_ASEReadCounter.table","NW_015090842.1:6235292",2,5,3
"SDR42E1","s1650_F_VTA_03_ASEReadCounter.table","NW_015090842.1:6235315",3,9,6
"SDR42E1","s1650_F_VTA_03_ASEReadCounter.table","NW_015090842.1:6235348",3,13,10
"SDR42E1","s1650_F_VTA_03_ASEReadCounter.table","NW_015090842.1:6235355",3,12,9
"SDR42E1","s1650_F_VTA_03_ASEReadCounter.table","NW_015090842.1:6235417",1,12,11
"SDR42E1","s1650_F_VTA_03_ASEReadCounter.table","NW_015090842.1:6235558",2,17,15
"SDR42E1","s1650_F_VTA_03_ASEReadCounter.table","NW_015090842.1:6235741",5,14,9
"SDR42E1","s1650_F_VTA_03_ASEReadCounter.table","NW_015090842.1:6235777",3,14,11
"SDR42E1","s1650_F_VTA_03_ASEReadCounter.table","NW_015090842.1:6235806",2,13,11
"SDR42E1","s1650_F_VTA_03_ASEReadCounter.table","NW_015090842.1:6235809",2,14,12
"SDR42E1","s1650_F_VTA_03_ASEReadCounter.table","NW_015090842.1:6235816",2,14,12
"SDR42E1","s1650_F_VTA_03_ASEReadCounter.table","NW_015090842.1:6235914",2,11,9
"SDR42E1","s1650_F_VTA_03_ASEReadCounter.table","NW_015090842.1:6235935",3,9,6
"SDR42E1","s1650_F_VTA_03_ASEReadCounter.table","NW_015090842.1:6235957",3,8,5
"SDR42E1","s1650_F_VTA_03_ASEReadCounter.table","NW_015090842.1:6236040",6,16,10
"SDR42E1","s1650_F_VTA_03_ASEReadCounter.table","NW_015090842.1:6236260",4,10,6
"SDR42E1","s1650_F_VTA_03_ASEReadCounter.table","NW_015090842.1:6236281",4,9,5
"SDR42E1","s1650_F_VTA_03_ASEReadCounter.table","NW_015090842.1:6236305",5,11,6
"SDR42E1","s1650_F_VTA_03_ASEReadCounter.table","NW_015090842.1:6236458",2,8,6
"SDR42E1","s1650_F_VTA_03_ASEReadCounter.table","NW_015090842.1:6236476",2,7,5
"SDR42E1","s1650_F_VTA_03_ASEReadCounter.table","NW_015090842.1:6236608",0,3,3
"SDR42E1","s1650_F_VTA_03_ASEReadCounter.table","NW_015090842.1:6238244",0,2,2
"SDR42E1","s1650_F_VTA_03_ASEReadCounter.table","NW_015090842.1:6238829",1,2,1
"HSD17B2","s1650_F_VTA_03_ASEReadCounter.table","NW_015090842.1:6257758",0,1,1
"HSD17B2","s1650_F_VTA_03_ASEReadCounter.table","NW_015090842.1:6257767",0,1,1
"HSD17B2","s1650_F_VTA_03_ASEReadCounter.table","NW_015090842.1:6257829",0,1,1
"HSD17B2","s1650_F_VTA_03_ASEReadCounter.table","NW_015090842.1:6262951",0,1,1
"HSD17B2","s1650_F_VTA_03_ASEReadCounter.table","NW_015090842.1:6262974",0,1,1
"HSD17B2","s1650_F_VTA_03_ASEReadCounter.table","NW_015090842.1:6266125",0,2,2
"HSD17B2","s1650_F_VTA_03_ASEReadCounter.table","NW_015090842.1:6266135",0,2,2
"HSD17B2","s1650_F_VTA_03_ASEReadCounter.table","NW_015090842.1:6266795",0,1,1
"HSD17B2","s1650_F_VTA_03_ASEReadCounter.table","NW_015090842.1:6266944",0,1,1
"HSD17B2","s1650_F_VTA_03_ASEReadCounter.table","NW_015090842.1:6267053",0,1,1
"HSD17B2","s1650_F_VTA_03_ASEReadCounter.table","NW_015090842.1:6267273",0,3,3
"HSD17B2","s1650_F_VTA_03_ASEReadCounter.table","NW_015090842.1:6267913",0,2,2
"HSD17B2","s1650_F_VTA_03_ASEReadCounter.table","NW_015090842.1:6268098",0,2,2
"HSD17B2","s1650_F_VTA_03_ASEReadCounter.table","NW_015090842.1:6268203",0,2,2
"ARY2","s1650_F_VTA_03_ASEReadCounter.table","NW_015090842.1:6303922",22,32,10
"ARY2","s1650_F_VTA_03_ASEReadCounter.table","NW_015090842.1:6303954",23,34,11
"ARY2","s1650_F_VTA_03_ASEReadCounter.table","NW_015090842.1:6303979",19,33,14
"ARY2","s1650_F_VTA_03_ASEReadCounter.table","NW_015090842.1:6305848",20,27,7
"ARY2","s1650_F_VTA_03_ASEReadCounter.table","NW_015090842.1:6305856",18,26,8
"ARY2","s1650_F_VTA_03_ASEReadCounter.table","NW_015090842.1:6305857",18,26,8
"ARY2","s1650_F_VTA_03_ASEReadCounter.table","NW_015090842.1:6306017",14,22,8
"ARY2","s1650_F_VTA_03_ASEReadCounter.table","NW_015090842.1:6306052",17,28,11
"ARY2","s1650_F_VTA_03_ASEReadCounter.table","NW_015090842.1:6306094",19,28,9
"ARY2","s1650_F_VTA_03_ASEReadCounter.table","NW_015090842.1:6306100",18,27,9
"ARY2","s1650_F_VTA_03_ASEReadCounter.table","NW_015090842.1:6306146",20,25,5
"ARY2","s1650_F_VTA_03_ASEReadCounter.table","NW_015090842.1:6306147",19,24,5
"ARY2","s1650_F_VTA_03_ASEReadCounter.table","NW_015090842.1:6306390",27,42,15
"ARY2","s1650_F_VTA_03_ASEReadCounter.table","NW_015090842.1:6306567",21,35,14
"ARY2","s1650_F_VTA_03_ASEReadCounter.table","NW_015090842.1:6306705",31,45,14
"ARY2","s1650_F_VTA_03_ASEReadCounter.table","NW_015090842.1:6306773",23,30,7
"ARY2","s1650_F_VTA_03_ASEReadCounter.table","NW_015090842.1:6307039",39,53,14
"ARY2","s1650_F_VTA_03_ASEReadCounter.table","NW_015090842.1:6307043",39,53,14
"ARY2","s1650_F_VTA_03_ASEReadCounter.table","NW_015090842.1:6307093",32,41,9
"ARY2","s1650_F_VTA_03_ASEReadCounter.table","NW_015090842.1:6307138",35,42,7
"ARY2","s1650_F_VTA_03_ASEReadCounter.table","NW_015090842.1:6307157",35,43,8
"ARY2","s1650_F_VTA_03_ASEReadCounter.table","NW_015090842.1:6307187",40,49,9
"ARY2","s1650_F_VTA_03_ASEReadCounter.table","NW_015090842.1:6307204",34,42,8
"ARY2","s1650_F_VTA_03_ASEReadCounter.table","NW_015090842.1:6307278",25,37,12
"ARY2","s1650_F_VTA_03_ASEReadCounter.table","NW_015090842.1:6307305",30,44,14
"ARY2","s1650_F_VTA_03_ASEReadCounter.table","NW_015090842.1:6307318",29,43,14
"ARY2","s1650_F_VTA_03_ASEReadCounter.table","NW_015090842.1:6307429",36,47,11
"ARY2","s1650_F_VTA_03_ASEReadCounter.table","NW_015090842.1:6307487",30,43,13
"ARY2","s1650_F_VTA_03_ASEReadCounter.table","NW_015090842.1:6307670",22,27,5
"ARYL","s1650_F_VTA_03_ASEReadCounter.table","NW_015090842.1:6313360",1,2,1
"ARYL","s1650_F_VTA_03_ASEReadCounter.table","NW_015090842.1:6313377",1,2,1
"ARYL","s1650_F_VTA_03_ASEReadCounter.table","NW_015090842.1:6313767",4,5,1
"ARY1","s1650_F_VTA_03_ASEReadCounter.table","NW_015090842.1:6314296",0,3,3
"ARY1","s1650_F_VTA_03_ASEReadCounter.table","NW_015090842.1:6314541",2,3,1
"ARY1","s1650_F_VTA_03_ASEReadCounter.table","NW_015090842.1:6314597",2,4,2
"ARY1","s1650_F_VTA_03_ASEReadCounter.table","NW_015090842.1:6314750",8,10,2
"ARY1","s1650_F_VTA_03_ASEReadCounter.table","NW_015090842.1:6314794",3,5,2
"ARY1","s1650_F_VTA_03_ASEReadCounter.table","NW_015090842.1:6314827",4,7,3
"ARY1","s1650_F_VTA_03_ASEReadCounter.table","NW_015090842.1:6314859",4,8,4
"ARY1","s1650_F_VTA_03_ASEReadCounter.table","NW_015090842.1:6314886",5,8,3
"ARY1","s1650_F_VTA_03_ASEReadCounter.table","NW_015090842.1:6315022",7,11,4
"ARY1","s1650_F_VTA_03_ASEReadCounter.table","NW_015090842.1:6315026",7,11,4
"ARY1","s1650_F_VTA_03_ASEReadCounter.table","NW_015090842.1:6315043",7,11,4
"ARY1","s1650_F_VTA_03_ASEReadCounter.table","NW_015090842.1:6315065",5,10,5
"ARY1","s1650_F_VTA_03_ASEReadCounter.table","NW_015090842.1:6315409",5,8,3
"ARY1","s1650_F_VTA_03_ASEReadCounter.table","NW_015090842.1:6315479",3,5,2
"ARY1","s1650_F_VTA_03_ASEReadCounter.table","NW_015090842.1:6318342",9,15,6
"ARY1","s1650_F_VTA_03_ASEReadCounter.table","NW_015090842.1:6318427",9,18,9
"ARY1","s1650_F_VTA_03_ASEReadCounter.table","NW_015090842.1:6318603",10,15,5
"ARY1","s1650_F_VTA_03_ASEReadCounter.table","NW_015090842.1:6318708",9,17,8
"ARY1","s1650_F_VTA_03_ASEReadCounter.table","NW_015090842.1:6318858",9,16,7
"ARY1","s1650_F_VTA_03_ASEReadCounter.table","NW_015090842.1:6318952",13,21,8
"MPHOSPH6","s1650_F_VTA_03_ASEReadCounter.table","NW_015090842.1:6324063",45,89,44
"MPHOSPH6","s1650_F_VTA_03_ASEReadCounter.table","NW_015090842.1:6324174",85,187,102
"MPHOSPH6","s1650_F_VTA_03_ASEReadCounter.table","NW_015090842.1:6324270",93,213,120
"MPHOSPH6","s1650_F_VTA_03_ASEReadCounter.table","NW_015090842.1:6324762",75,155,80
"MPHOSPH6","s1650_F_VTA_03_ASEReadCounter.table","NW_015090842.1:6324780",70,142,72
"MPHOSPH6","s1650_F_VTA_03_ASEReadCounter.table","NW_015090842.1:6324902",86,149,63
"MPHOSPH6","s1650_F_VTA_03_ASEReadCounter.table","NW_015090842.1:6325066",72,144,72
"MPHOSPH6","s1650_F_VTA_03_ASEReadCounter.table","NW_015090842.1:6325089",62,159,97
"MPHOSPH6","s1650_F_VTA_03_ASEReadCounter.table","NW_015090842.1:6325877",65,141,76
"MPHOSPH6","s1650_F_VTA_03_ASEReadCounter.table","NW_015090842.1:6326976",45,106,61
"CDH13","s1650_F_VTA_03_ASEReadCounter.table","NW_015090842.1:6662283",7,11,4
"CDH13","s1650_F_VTA_03_ASEReadCounter.table","NW_015090842.1:6693665",12,21,9
"CDH13","s1650_F_VTA_03_ASEReadCounter.table","NW_015090842.1:6693697",7,15,8
"CDH13","s1650_F_VTA_03_ASEReadCounter.table","NW_015090842.1:6693712",4,11,7
"CDH13","s1650_F_VTA_03_ASEReadCounter.table","NW_015090842.1:6693723",6,15,9
"CDH13","s1650_F_VTA_03_ASEReadCounter.table","NW_015090842.1:6693738",6,14,8
"CDH13","s1650_F_VTA_03_ASEReadCounter.table","NW_015090842.1:6823730",5,16,11
"CDH13","s1650_F_VTA_03_ASEReadCounter.table","NW_015090842.1:6889713",12,23,11
"CDH13","s1650_F_VTA_03_ASEReadCounter.table","NW_015090842.1:6955167",20,37,17
"MLYCD","s1650_F_VTA_03_ASEReadCounter.table","NW_015090842.1:7150054",69,143,74
"MLYCD","s1650_F_VTA_03_ASEReadCounter.table","NW_015090842.1:7150131",117,238,121
"MLYCD","s1650_F_VTA_03_ASEReadCounter.table","NW_015090842.1:7150585",85,138,53
"MLYCD","s1650_F_VTA_03_ASEReadCounter.table","NW_015090842.1:7150686",67,117,50
"MLYCD","s1650_F_VTA_03_ASEReadCounter.table","NW_015090842.1:7150696",72,125,53
"MLYCD","s1650_F_VTA_03_ASEReadCounter.table","NW_015090842.1:7150869",46,90,44
"MLYCD","s1650_F_VTA_03_ASEReadCounter.table","NW_015090842.1:7151100",67,122,55
"MLYCD","s1650_F_VTA_03_ASEReadCounter.table","NW_015090842.1:7151127",55,111,56
"MLYCD","s1650_F_VTA_03_ASEReadCounter.table","NW_015090842.1:7157538",41,68,27
"MLYCD","s1650_F_VTA_03_ASEReadCounter.table","NW_015090842.1:7167662",19,32,13
"MLYCD","s1650_F_VTA_03_ASEReadCounter.table","NW_015090842.1:7167675",16,30,14
"MLYCD","s1650_F_VTA_03_ASEReadCounter.table","NW_015090842.1:7167710",13,29,16
"MLYCD","s1650_F_VTA_03_ASEReadCounter.table","NW_015090842.1:7167781",13,25,12
"MLYCD","s1650_F_VTA_03_ASEReadCounter.table","NW_015090842.1:7167803",10,19,9
"MLYCD","s1650_F_VTA_03_ASEReadCounter.table","NW_015090842.1:7167812",8,17,9
"MLYCD","s1650_F_VTA_03_ASEReadCounter.table","NW_015090842.1:7167845",6,19,13
"MLYCD","s1650_F_VTA_03_ASEReadCounter.table","NW_015090842.1:7167862",6,21,15
"MLYCD","s1650_F_VTA_03_ASEReadCounter.table","NW_015090842.1:7167929",7,15,8
"MLYCD","s1650_F_VTA_03_ASEReadCounter.table","NW_015090842.1:7167995",8,8,0
"MLYCD","s1650_F_VTA_03_ASEReadCounter.table","NW_015090842.1:7168005",8,8,0
"MLYCD","s1650_F_VTA_03_ASEReadCounter.table","NW_015090842.1:7168037",4,5,1
"HSBP1","s1650_F_VTA_03_ASEReadCounter.table","NW_015090842.1:7245192",358,608,250
"HSBP1","s1650_F_VTA_03_ASEReadCounter.table","NW_015090842.1:7245226",411,709,298
"HSBP1","s1650_F_VTA_03_ASEReadCounter.table","NW_015090842.1:7245257",351,599,248
"HSBP1","s1650_F_VTA_03_ASEReadCounter.table","NW_015090842.1:7245296",302,583,281
"HSBP1","s1650_F_VTA_03_ASEReadCounter.table","NW_015090842.1:7245389",442,777,335
"HSBP1","s1650_F_VTA_03_ASEReadCounter.table","NW_015090842.1:7245400",460,758,298
"HSBP1","s1650_F_VTA_03_ASEReadCounter.table","NW_015090842.1:7245445",411,737,326
"HSBP1","s1650_F_VTA_03_ASEReadCounter.table","NW_015090842.1:7245495",338,638,300
"HSBP1","s1650_F_VTA_03_ASEReadCounter.table","NW_015090842.1:7245733",253,474,221
"HSBP1","s1650_F_VTA_03_ASEReadCounter.table","NW_015090842.1:7245771",277,475,198
"HSBP1","s1650_F_VTA_03_ASEReadCounter.table","NW_015090842.1:7245813",268,462,194
"HSBP1","s1650_F_VTA_03_ASEReadCounter.table","NW_015090842.1:7245926",314,543,229
"HSBP1","s1650_F_VTA_03_ASEReadCounter.table","NW_015090842.1:7245927",311,541,230
"HSBP1","s1650_F_VTA_03_ASEReadCounter.table","NW_015090842.1:7245933",307,525,218
"HSBP1","s1650_F_VTA_03_ASEReadCounter.table","NW_015090842.1:7246002",221,426,205
"HSBP1","s1650_F_VTA_03_ASEReadCounter.table","NW_015090842.1:7246094",292,496,204
"HSBP1","s1650_F_VTA_03_ASEReadCounter.table","NW_015090842.1:7246167",254,435,181
"HSBP1","s1650_F_VTA_03_ASEReadCounter.table","NW_015090842.1:7246183",235,417,182
"HSBP1","s1650_F_VTA_03_ASEReadCounter.table","NW_015090842.1:7247285",28,38,10
"HSBP1","s1650_F_VTA_03_ASEReadCounter.table","NW_015090842.1:7247651",293,607,314
"HSBP1","s1650_F_VTA_03_ASEReadCounter.table","NW_015090842.1:7247657",290,605,315
"HSBP1","s1650_F_VTA_03_ASEReadCounter.table","NW_015090842.1:7248520",204,407,203
"HSBP1","s1650_F_VTA_03_ASEReadCounter.table","NW_015090842.1:7248535",173,341,168
"KCNG4","s1650_F_VTA_03_ASEReadCounter.table","NW_015090842.1:7282481",5,11,6
"KCNG4","s1650_F_VTA_03_ASEReadCounter.table","NW_015090842.1:7282500",4,9,5
"KCNG4","s1650_F_VTA_03_ASEReadCounter.table","NW_015090842.1:7282542",3,4,1
"KCNG4","s1650_F_VTA_03_ASEReadCounter.table","NW_015090842.1:7282579",3,5,2
"KCNG4","s1650_F_VTA_03_ASEReadCounter.table","NW_015090842.1:7282630",3,7,4
"KCNG4","s1650_F_VTA_03_ASEReadCounter.table","NW_015090842.1:7283056",2,4,2
"KCNG4","s1650_F_VTA_03_ASEReadCounter.table","NW_015090842.1:7283245",0,1,1
"KCNG4","s1650_F_VTA_03_ASEReadCounter.table","NW_015090842.1:7301195",0,1,1
"KCNG4","s1650_F_VTA_03_ASEReadCounter.table","NW_015090842.1:7301413",2,4,2
"WFDC1","s1650_F_VTA_03_ASEReadCounter.table","NW_015090842.1:7366517",1,4,3
"WFDC1","s1650_F_VTA_03_ASEReadCounter.table","NW_015090842.1:7373367",1,2,1
"WFDC1","s1650_F_VTA_03_ASEReadCounter.table","NW_015090842.1:7375828",5,9,4
"WFDC1","s1650_F_VTA_03_ASEReadCounter.table","NW_015090842.1:7378036",2,4,2
"WFDC1","s1650_F_VTA_03_ASEReadCounter.table","NW_015090842.1:7379125",3,8,5
"WFDC1","s1650_F_VTA_03_ASEReadCounter.table","NW_015090842.1:7379451",2,12,10
"WFDC1","s1650_F_VTA_03_ASEReadCounter.table","NW_015090842.1:7379471",1,8,7
"WFDC1","s1650_F_VTA_03_ASEReadCounter.table","NW_015090842.1:7379576",0,8,8
"WFDC1","s1650_F_VTA_03_ASEReadCounter.table","NW_015090842.1:7379596",0,8,8
"WFDC1","s1650_F_VTA_03_ASEReadCounter.table","NW_015090842.1:7379605",0,8,8
"WFDC1","s1650_F_VTA_03_ASEReadCounter.table","NW_015090842.1:7379626",0,7,7
"WFDC1","s1650_F_VTA_03_ASEReadCounter.table","NW_015090842.1:7379631",0,8,8
"WFDC1","s1650_F_VTA_03_ASEReadCounter.table","NW_015090842.1:7379632",0,8,8
"WFDC1","s1650_F_VTA_03_ASEReadCounter.table","NW_015090842.1:7379652",0,8,8
"WFDC1","s1650_F_VTA_03_ASEReadCounter.table","NW_015090842.1:7379669",0,4,4
"WFDC1","s1650_F_VTA_03_ASEReadCounter.table","NW_015090842.1:7379674",0,4,4
"WFDC1","s1650_F_VTA_03_ASEReadCounter.table","NW_015090842.1:7379719",0,8,8
"WFDC1","s1650_F_VTA_03_ASEReadCounter.table","NW_015090842.1:7379735",0,5,5
"WFDC1","s1650_F_VTA_03_ASEReadCounter.table","NW_015090842.1:7379739",0,5,5
"WFDC1","s1650_F_VTA_03_ASEReadCounter.table","NW_015090842.1:7379821",1,5,4
"WFDC1","s1650_F_VTA_03_ASEReadCounter.table","NW_015090842.1:7379840",2,7,5
"WFDC1","s1650_F_VTA_03_ASEReadCounter.table","NW_015090842.1:7379933",0,9,9
"WFDC1","s1650_F_VTA_03_ASEReadCounter.table","NW_015090842.1:7379935",0,10,10
"WFDC1","s1650_F_VTA_03_ASEReadCounter.table","NW_015090842.1:7379983",2,11,9
"WFDC1","s1650_F_VTA_03_ASEReadCounter.table","NW_015090842.1:7380060",1,7,6
"WFDC1","s1650_F_VTA_03_ASEReadCounter.table","NW_015090842.1:7380136",1,1,0
"WFDC1","s1650_F_VTA_03_ASEReadCounter.table","NW_015090842.1:7380150",1,2,1
"WFDC1","s1650_F_VTA_03_ASEReadCounter.table","NW_015090842.1:7380164",3,5,2
"WFDC1","s1650_F_VTA_03_ASEReadCounter.table","NW_015090842.1:7380237",5,11,6
"WFDC1","s1650_F_VTA_03_ASEReadCounter.table","NW_015090842.1:7380261",5,9,4
"WFDC1","s1650_F_VTA_03_ASEReadCounter.table","NW_015090842.1:7380322",5,11,6
"WFDC1","s1650_F_VTA_03_ASEReadCounter.table","NW_015090842.1:7380491",1,10,9
"WFDC1","s1650_F_VTA_03_ASEReadCounter.table","NW_015090842.1:7380567",4,14,10
"WFDC1","s1650_F_VTA_03_ASEReadCounter.table","NW_015090842.1:7380672",4,12,8
"WFDC1","s1650_F_VTA_03_ASEReadCounter.table","NW_015090842.1:7380721",4,14,10
"WFDC1","s1650_F_VTA_03_ASEReadCounter.table","NW_015090842.1:7380743",5,14,9
"WFDC1","s1650_F_VTA_03_ASEReadCounter.table","NW_015090842.1:7380852",3,6,3
"WFDC1","s1650_F_VTA_03_ASEReadCounter.table","NW_015090842.1:7380878",1,6,5
"WFDC1","s1650_F_VTA_03_ASEReadCounter.table","NW_015090842.1:7381081",10,22,12
"WFDC1","s1650_F_VTA_03_ASEReadCounter.table","NW_015090842.1:7381127",4,13,9
"WFDC1","s1650_F_VTA_03_ASEReadCounter.table","NW_015090842.1:7381195",2,7,5
"WFDC1","s1650_F_VTA_03_ASEReadCounter.table","NW_015090842.1:7381253",7,16,9
"WFDC1","s1650_F_VTA_03_ASEReadCounter.table","NW_015090842.1:7381378",4,12,8
"WFDC1","s1650_F_VTA_03_ASEReadCounter.table","NW_015090842.1:7381433",9,14,5
"WFDC1","s1650_F_VTA_03_ASEReadCounter.table","NW_015090842.1:7381434",9,15,6
"WFDC1","s1650_F_VTA_03_ASEReadCounter.table","NW_015090842.1:7381442",11,17,6
"WFDC1","s1650_F_VTA_03_ASEReadCounter.table","NW_015090842.1:7381517",5,16,11
"WFDC1","s1650_F_VTA_03_ASEReadCounter.table","NW_015090842.1:7381520",5,16,11
"WFDC1","s1650_F_VTA_03_ASEReadCounter.table","NW_015090842.1:7381677",1,8,7
"WFDC1","s1650_F_VTA_03_ASEReadCounter.table","NW_015090842.1:7381709",1,4,3
"ATP2C2","s1650_F_VTA_03_ASEReadCounter.table","NW_015090842.1:7386804",0,1,1
"ATP2C2","s1650_F_VTA_03_ASEReadCounter.table","NW_015090842.1:7386836",0,1,1
"ATP2C2","s1650_F_VTA_03_ASEReadCounter.table","NW_015090842.1:7395230",0,1,1
"ATP2C2","s1650_F_VTA_03_ASEReadCounter.table","NW_015090842.1:7395366",0,2,2
"ATP2C2","s1650_F_VTA_03_ASEReadCounter.table","NW_015090842.1:7396756",0,1,1
"ATP2C2","s1650_F_VTA_03_ASEReadCounter.table","NW_015090842.1:7397049",0,1,1
"ATP2C2","s1650_F_VTA_03_ASEReadCounter.table","NW_015090842.1:7399774",0,1,1
"ATP2C2","s1650_F_VTA_03_ASEReadCounter.table","NW_015090842.1:7402554",1,2,1
"ATP2C2","s1650_F_VTA_03_ASEReadCounter.table","NW_015090842.1:7402578",1,2,1
"ATP2C2","s1650_F_VTA_03_ASEReadCounter.table","NW_015090842.1:7413855",0,10,10
"ATP2C2","s1650_F_VTA_03_ASEReadCounter.table","NW_015090842.1:7413869",0,9,9
"ATP2C2","s1650_F_VTA_03_ASEReadCounter.table","NW_015090842.1:7413875",0,9,9
"TLDC1","s1650_F_VTA_03_ASEReadCounter.table","NW_015090842.1:7421137",47,72,25
"TLDC1","s1650_F_VTA_03_ASEReadCounter.table","NW_015090842.1:7421155",45,68,23
"TLDC1","s1650_F_VTA_03_ASEReadCounter.table","NW_015090842.1:7421218",66,89,23
"TLDC1","s1650_F_VTA_03_ASEReadCounter.table","NW_015090842.1:7421399",56,78,22
"TLDC1","s1650_F_VTA_03_ASEReadCounter.table","NW_015090842.1:7421402",59,81,22
"TLDC1","s1650_F_VTA_03_ASEReadCounter.table","NW_015090842.1:7421528",52,74,22
"TLDC1","s1650_F_VTA_03_ASEReadCounter.table","NW_015090842.1:7421532",51,73,22
"TLDC1","s1650_F_VTA_03_ASEReadCounter.table","NW_015090842.1:7421621",61,84,23
"TLDC1","s1650_F_VTA_03_ASEReadCounter.table","NW_015090842.1:7421647",57,75,18
"TLDC1","s1650_F_VTA_03_ASEReadCounter.table","NW_015090842.1:7421657",51,68,17
"TLDC1","s1650_F_VTA_03_ASEReadCounter.table","NW_015090842.1:7421693",54,76,22
"TLDC1","s1650_F_VTA_03_ASEReadCounter.table","NW_015090842.1:7421796",50,75,25
"TLDC1","s1650_F_VTA_03_ASEReadCounter.table","NW_015090842.1:7421810",54,86,32
"TLDC1","s1650_F_VTA_03_ASEReadCounter.table","NW_015090842.1:7421833",54,83,29
"TLDC1","s1650_F_VTA_03_ASEReadCounter.table","NW_015090842.1:7421879",52,81,29
"TLDC1","s1650_F_VTA_03_ASEReadCounter.table","NW_015090842.1:7421914",50,72,22
"TLDC1","s1650_F_VTA_03_ASEReadCounter.table","NW_015090842.1:7421969",42,56,14
"TLDC1","s1650_F_VTA_03_ASEReadCounter.table","NW_015090842.1:7422015",37,51,14
"TLDC1","s1650_F_VTA_03_ASEReadCounter.table","NW_015090842.1:7422042",43,63,20
"TLDC1","s1650_F_VTA_03_ASEReadCounter.table","NW_015090842.1:7422230",53,68,15
"TLDC1","s1650_F_VTA_03_ASEReadCounter.table","NW_015090842.1:7423349",64,83,19
"TLDC1","s1650_F_VTA_03_ASEReadCounter.table","NW_015090842.1:7423362",53,73,20
"TLDC1","s1650_F_VTA_03_ASEReadCounter.table","NW_015090842.1:7426091",37,54,17
"TLDC1","s1650_F_VTA_03_ASEReadCounter.table","NW_015090842.1:7426485",30,47,17
"TLDC1","s1650_F_VTA_03_ASEReadCounter.table","NW_015090842.1:7427211",30,47,17
"TLDC1","s1650_F_VTA_03_ASEReadCounter.table","NW_015090842.1:7428179",30,39,9
"COTL1","s1650_F_VTA_03_ASEReadCounter.table","NW_015090842.1:7490744",485,1037,552
"COTL1","s1650_F_VTA_03_ASEReadCounter.table","NW_015090842.1:7491051",368,776,408
"COTL1","s1650_F_VTA_03_ASEReadCounter.table","NW_015090842.1:7491124",374,743,369
"COTL1","s1650_F_VTA_03_ASEReadCounter.table","NW_015090842.1:7491418",204,415,211
"COTL1","s1650_F_VTA_03_ASEReadCounter.table","NW_015090842.1:7491539",114,284,170
"COTL1","s1650_F_VTA_03_ASEReadCounter.table","NW_015090842.1:7491585",216,444,228
"COTL1","s1650_F_VTA_03_ASEReadCounter.table","NW_015090842.1:7491586",213,461,248
"COTL1","s1650_F_VTA_03_ASEReadCounter.table","NW_015090842.1:7491646",266,582,316
"COTL1","s1650_F_VTA_03_ASEReadCounter.table","NW_015090842.1:7491747",201,447,246
"COTL1","s1650_F_VTA_03_ASEReadCounter.table","NW_015090842.1:7491803",191,426,235
"COTL1","s1650_F_VTA_03_ASEReadCounter.table","NW_015090842.1:7506078",0,1,1
"COTL1","s1650_F_VTA_03_ASEReadCounter.table","NW_015090842.1:7507551",1,2,1
"COTL1","s1650_F_VTA_03_ASEReadCounter.table","NW_015090842.1:7507563",1,2,1
"COTL1","s1650_F_VTA_03_ASEReadCounter.table","NW_015090842.1:7510900",0,1,1
"COTL1","s1650_F_VTA_03_ASEReadCounter.table","NW_015090842.1:7513196",0,1,1
"COTL1","s1650_F_VTA_03_ASEReadCounter.table","NW_015090842.1:7513223",0,1,1
"COTL1","s1650_F_VTA_03_ASEReadCounter.table","NW_015090842.1:7513239",0,1,1
"KLHL36","s1650_F_VTA_03_ASEReadCounter.table","NW_015090842.1:7514700",14,24,10
"KLHL36","s1650_F_VTA_03_ASEReadCounter.table","NW_015090842.1:7519691",2,3,1
"KLHL36","s1650_F_VTA_03_ASEReadCounter.table","NW_015090842.1:7519696",2,3,1
"KLHL36","s1650_F_VTA_03_ASEReadCounter.table","NW_015090842.1:7526160",12,25,13
"KLHL36","s1650_F_VTA_03_ASEReadCounter.table","NW_015090842.1:7526469",7,23,16
"KLHL36","s1650_F_VTA_03_ASEReadCounter.table","NW_015090842.1:7526587",10,27,17
"KLHL36","s1650_F_VTA_03_ASEReadCounter.table","NW_015090842.1:7526997",7,20,13
"KLHL36","s1650_F_VTA_03_ASEReadCounter.table","NW_015090842.1:7527142",9,25,16
"KLHL36","s1650_F_VTA_03_ASEReadCounter.table","NW_015090842.1:7535174",22,44,22
"KLHL36","s1650_F_VTA_03_ASEReadCounter.table","NW_015090842.1:7535384",14,34,20
"KLHL36","s1650_F_VTA_03_ASEReadCounter.table","NW_015090842.1:7535420",16,42,26
"KLHL36","s1650_F_VTA_03_ASEReadCounter.table","NW_015090842.1:7535545",11,22,11
"KLHL36","s1650_F_VTA_03_ASEReadCounter.table","NW_015090842.1:7535829",20,46,26
"KLHL36","s1650_F_VTA_03_ASEReadCounter.table","NW_015090842.1:7535977",15,36,21
"KLHL36","s1650_F_VTA_03_ASEReadCounter.table","NW_015090842.1:7536010",15,41,26
"KLHL36","s1650_F_VTA_03_ASEReadCounter.table","NW_015090842.1:7536051",19,47,28
"KLHL36","s1650_F_VTA_03_ASEReadCounter.table","NW_015090842.1:7536096",23,48,25
"KLHL36","s1650_F_VTA_03_ASEReadCounter.table","NW_015090842.1:7536135",20,49,29
"KLHL36","s1650_F_VTA_03_ASEReadCounter.table","NW_015090842.1:7536136",19,45,26
"KLHL36","s1650_F_VTA_03_ASEReadCounter.table","NW_015090842.1:7536160",24,51,27
"KLHL36","s1650_F_VTA_03_ASEReadCounter.table","NW_015090842.1:7536336",22,52,30
"KLHL36","s1650_F_VTA_03_ASEReadCounter.table","NW_015090842.1:7536352",23,54,31
"KLHL36","s1650_F_VTA_03_ASEReadCounter.table","NW_015090842.1:7536412",17,51,34
"KLHL36","s1650_F_VTA_03_ASEReadCounter.table","NW_015090842.1:7536418",16,48,32
"KLHL36","s1650_F_VTA_03_ASEReadCounter.table","NW_015090842.1:7536465",19,48,29
"KLHL36","s1650_F_VTA_03_ASEReadCounter.table","NW_015090842.1:7536466",18,46,28
"KLHL36","s1650_F_VTA_03_ASEReadCounter.table","NW_015090842.1:7536553",35,60,25
"KLHL36","s1650_F_VTA_03_ASEReadCounter.table","NW_015090842.1:7536698",34,68,34
"KLHL36","s1650_F_VTA_03_ASEReadCounter.table","NW_015090842.1:7536713",19,65,46
"KLHL36","s1650_F_VTA_03_ASEReadCounter.table","NW_015090842.1:7536720",33,61,28
"KLHL36","s1650_F_VTA_03_ASEReadCounter.table","NW_015090842.1:7536791",41,73,32
"KLHL36","s1650_F_VTA_03_ASEReadCounter.table","NW_015090842.1:7536849",43,76,33
"KLHL36","s1650_F_VTA_03_ASEReadCounter.table","NW_015090842.1:7536872",37,72,35
"KLHL36","s1650_F_VTA_03_ASEReadCounter.table","NW_015090842.1:7536878",35,61,26
"KLHL36","s1650_F_VTA_03_ASEReadCounter.table","NW_015090842.1:7536916",40,66,26
"KLHL36","s1650_F_VTA_03_ASEReadCounter.table","NW_015090842.1:7536927",38,76,38
"KLHL36","s1650_F_VTA_03_ASEReadCounter.table","NW_015090842.1:7537315",43,82,39
"KLHL36","s1650_F_VTA_03_ASEReadCounter.table","NW_015090842.1:7537352",40,76,36
"KLHL36","s1650_F_VTA_03_ASEReadCounter.table","NW_015090842.1:7537631",48,103,55
"KLHL36","s1650_F_VTA_03_ASEReadCounter.table","NW_015090842.1:7537830",79,137,58
"KLHL36","s1650_F_VTA_03_ASEReadCounter.table","NW_015090842.1:7537838",75,134,59
"KLHL36","s1650_F_VTA_03_ASEReadCounter.table","NW_015090842.1:7538153",50,113,63
"KLHL36","s1650_F_VTA_03_ASEReadCounter.table","NW_015090842.1:7538256",21,72,51
"KLHL36","s1650_F_VTA_03_ASEReadCounter.table","NW_015090842.1:7538265",22,73,51
"KLHL36","s1650_F_VTA_03_ASEReadCounter.table","NW_015090842.1:7538300",25,74,49
"USP10","s1650_F_VTA_03_ASEReadCounter.table","NW_015090842.1:7563972",7,11,4
"USP10","s1650_F_VTA_03_ASEReadCounter.table","NW_015090842.1:7571816",22,31,9
"USP10","s1650_F_VTA_03_ASEReadCounter.table","NW_015090842.1:7571993",15,34,19
"USP10","s1650_F_VTA_03_ASEReadCounter.table","NW_015090842.1:7572580",28,62,34
"USP10","s1650_F_VTA_03_ASEReadCounter.table","NW_015090842.1:7587372",78,150,72
"CRISPLD2","s1650_F_VTA_03_ASEReadCounter.table","NW_015090842.1:7604605",1,1,0
"CRISPLD2","s1650_F_VTA_03_ASEReadCounter.table","NW_015090842.1:7609883",1,1,0
"CRISPLD2","s1650_F_VTA_03_ASEReadCounter.table","NW_015090842.1:7610084",4,4,0
"CRISPLD2","s1650_F_VTA_03_ASEReadCounter.table","NW_015090842.1:7617757",1,1,0
"CRISPLD2","s1650_F_VTA_03_ASEReadCounter.table","NW_015090842.1:7617781",3,3,0
"CRISPLD2","s1650_F_VTA_03_ASEReadCounter.table","NW_015090842.1:7617790",3,3,0
"CRISPLD2","s1650_F_VTA_03_ASEReadCounter.table","NW_015090842.1:7621452",1,1,0
"CRISPLD2","s1650_F_VTA_03_ASEReadCounter.table","NW_015090842.1:7625451",8,8,0
"CRISPLD2","s1650_F_VTA_03_ASEReadCounter.table","NW_015090842.1:7626214",7,8,1
"CRISPLD2","s1650_F_VTA_03_ASEReadCounter.table","NW_015090842.1:7630784",5,6,1
"CRISPLD2","s1650_F_VTA_03_ASEReadCounter.table","NW_015090842.1:7630823",5,7,2
"CRISPLD2","s1650_F_VTA_03_ASEReadCounter.table","NW_015090842.1:7633172",7,7,0
"CRISPLD2","s1650_F_VTA_03_ASEReadCounter.table","NW_015090842.1:7633326",3,3,0
"CRISPLD2","s1650_F_VTA_03_ASEReadCounter.table","NW_015090842.1:7633336",3,3,0
"CRISPLD2","s1650_F_VTA_03_ASEReadCounter.table","NW_015090842.1:7633381",6,7,1
"CRISPLD2","s1650_F_VTA_03_ASEReadCounter.table","NW_015090842.1:7633388",6,7,1
"CRISPLD2","s1650_F_VTA_03_ASEReadCounter.table","NW_015090842.1:7633400",5,6,1
"CRISPLD2","s1650_F_VTA_03_ASEReadCounter.table","NW_015090842.1:7633486",3,3,0
"CRISPLD2","s1650_F_VTA_03_ASEReadCounter.table","NW_015090842.1:7633503",4,4,0
"CRISPLD2","s1650_F_VTA_03_ASEReadCounter.table","NW_015090842.1:7633504",4,4,0
"CRISPLD2","s1650_F_VTA_03_ASEReadCounter.table","NW_015090842.1:7633557",3,3,0
"CRISPLD2","s1650_F_VTA_03_ASEReadCounter.table","NW_015090842.1:7633571",4,4,0
"CRISPLD2","s1650_F_VTA_03_ASEReadCounter.table","NW_015090842.1:7633588",5,5,0
"CRISPLD2","s1650_F_VTA_03_ASEReadCounter.table","NW_015090842.1:7633617",4,5,1
"CRISPLD2","s1650_F_VTA_03_ASEReadCounter.table","NW_015090842.1:7633695",5,6,1
"CRISPLD2","s1650_F_VTA_03_ASEReadCounter.table","NW_015090842.1:7633721",8,8,0
"CRISPLD2","s1650_F_VTA_03_ASEReadCounter.table","NW_015090842.1:7633888",3,4,1
"CRISPLD2","s1650_F_VTA_03_ASEReadCounter.table","NW_015090842.1:7633910",3,5,2
"CRISPLD2","s1650_F_VTA_03_ASEReadCounter.table","NW_015090842.1:7634142",4,7,3
"CRISPLD2","s1650_F_VTA_03_ASEReadCounter.table","NW_015090842.1:7634417",2,4,2
"CRISPLD2","s1650_F_VTA_03_ASEReadCounter.table","NW_015090842.1:7634825",7,8,1
"CRISPLD2","s1650_F_VTA_03_ASEReadCounter.table","NW_015090842.1:7634852",5,5,0
"CRISPLD2","s1650_F_VTA_03_ASEReadCounter.table","NW_015090842.1:7635009",4,5,1
"CRISPLD2","s1650_F_VTA_03_ASEReadCounter.table","NW_015090842.1:7635208",8,10,2
"CRISPLD2","s1650_F_VTA_03_ASEReadCounter.table","NW_015090842.1:7635373",8,9,1
"CRISPLD2","s1650_F_VTA_03_ASEReadCounter.table","NW_015090842.1:7635525",8,9,1
"CRISPLD2","s1650_F_VTA_03_ASEReadCounter.table","NW_015090842.1:7635583",6,7,1
"CRISPLD2","s1650_F_VTA_03_ASEReadCounter.table","NW_015090842.1:7635924",7,10,3
"LOC106888312","s1650_F_VTA_03_ASEReadCounter.table","NW_015090842.1:7727001",1,1,0
"LOC106888312","s1650_F_VTA_03_ASEReadCounter.table","NW_015090842.1:7727961",1,1,0
"LOC106888312","s1650_F_VTA_03_ASEReadCounter.table","NW_015090842.1:7731961",0,1,1
"LOC106888312","s1650_F_VTA_03_ASEReadCounter.table","NW_015090842.1:7732244",0,1,1
"LOC106888312","s1650_F_VTA_03_ASEReadCounter.table","NW_015090842.1:7732538",1,1,0
"LOC106888312","s1650_F_VTA_03_ASEReadCounter.table","NW_015090842.1:7732548",1,1,0
"LOC106888312","s1650_F_VTA_03_ASEReadCounter.table","NW_015090842.1:7732629",1,2,1
"LOC106888312","s1650_F_VTA_03_ASEReadCounter.table","NW_015090842.1:7732630",1,2,1
"LOC106888312","s1650_F_VTA_03_ASEReadCounter.table","NW_015090842.1:7732637",1,2,1
"LOC106888312","s1650_F_VTA_03_ASEReadCounter.table","NW_015090842.1:7732682",0,1,1
"LOC106888312","s1650_F_VTA_03_ASEReadCounter.table","NW_015090842.1:7732709",1,1,0
"LOC106888312","s1650_F_VTA_03_ASEReadCounter.table","NW_015090842.1:7732718",1,1,0
"LOC106888312","s1650_F_VTA_03_ASEReadCounter.table","NW_015090842.1:7732739",1,1,0
"LOC106888312","s1650_F_VTA_03_ASEReadCounter.table","NW_015090842.1:7732743",1,1,0
"LOC106888312","s1650_F_VTA_03_ASEReadCounter.table","NW_015090842.1:7732744",1,1,0
"LOC106888312","s1650_F_VTA_03_ASEReadCounter.table","NW_015090842.1:7732756",1,1,0
"LOC106888312","s1650_F_VTA_03_ASEReadCounter.table","NW_015090842.1:7732757",1,1,0
"LOC106888312","s1650_F_VTA_03_ASEReadCounter.table","NW_015090842.1:7732918",0,1,1
"LOC106888312","s1650_F_VTA_03_ASEReadCounter.table","NW_015090842.1:7732997",1,1,0
"LOC106888312","s1650_F_VTA_03_ASEReadCounter.table","NW_015090842.1:7733011",1,2,1
"LOC106888312","s1650_F_VTA_03_ASEReadCounter.table","NW_015090842.1:7733046",0,1,1
"LOC106888312","s1650_F_VTA_03_ASEReadCounter.table","NW_015090842.1:7733068",0,1,1
"LOC106888312","s1650_F_VTA_03_ASEReadCounter.table","NW_015090842.1:7733077",0,1,1
"LOC106888312","s1650_F_VTA_03_ASEReadCounter.table","NW_015090842.1:7733096",0,1,1
"LOC106888312","s1650_F_VTA_03_ASEReadCounter.table","NW_015090842.1:7733142",0,1,1
"LOC106888312","s1650_F_VTA_03_ASEReadCounter.table","NW_015090842.1:7733196",0,1,1
"LOC106888312","s1650_F_VTA_03_ASEReadCounter.table","NW_015090842.1:7733507",1,1,0
"LOC106888312","s1650_F_VTA_03_ASEReadCounter.table","NW_015090842.1:7733508",1,1,0
"LOC106888312","s1650_F_VTA_03_ASEReadCounter.table","NW_015090842.1:7733518",1,1,0
"ZDHHC7","s1650_F_VTA_03_ASEReadCounter.table","NW_015090842.1:7737199",26,66,40
"ZDHHC7","s1650_F_VTA_03_ASEReadCounter.table","NW_015090842.1:7737332",27,51,24
"ZDHHC7","s1650_F_VTA_03_ASEReadCounter.table","NW_015090842.1:7737553",41,77,36
"ZDHHC7","s1650_F_VTA_03_ASEReadCounter.table","NW_015090842.1:7737920",23,48,25
"ZDHHC7","s1650_F_VTA_03_ASEReadCounter.table","NW_015090842.1:7737953",19,37,18
"ZDHHC7","s1650_F_VTA_03_ASEReadCounter.table","NW_015090842.1:7737987",17,32,15
"ZDHHC7","s1650_F_VTA_03_ASEReadCounter.table","NW_015090842.1:7738068",16,36,20
"ZDHHC7","s1650_F_VTA_03_ASEReadCounter.table","NW_015090842.1:7738204",11,32,21
"LOC106888097","s1650_F_VTA_03_ASEReadCounter.table","NW_015090842.1:7767178",9,20,11
"LOC106888097","s1650_F_VTA_03_ASEReadCounter.table","NW_015090842.1:7767187",10,19,9
"LOC106888097","s1650_F_VTA_03_ASEReadCounter.table","NW_015090842.1:7768144",17,35,18
"LOC106888097","s1650_F_VTA_03_ASEReadCounter.table","NW_015090842.1:7768196",14,33,19
"LOC106888097","s1650_F_VTA_03_ASEReadCounter.table","NW_015090842.1:7769884",20,43,23
"LOC106888097","s1650_F_VTA_03_ASEReadCounter.table","NW_015090842.1:7769893",18,38,20
"LOC106888097","s1650_F_VTA_03_ASEReadCounter.table","NW_015090842.1:7770245",23,49,26
"LOC106888097","s1650_F_VTA_03_ASEReadCounter.table","NW_015090842.1:7772402",23,55,32
"LOC106888097","s1650_F_VTA_03_ASEReadCounter.table","NW_015090842.1:7772483",28,60,32
"LOC106888097","s1650_F_VTA_03_ASEReadCounter.table","NW_015090842.1:7772490",27,60,33
"LOC106888097","s1650_F_VTA_03_ASEReadCounter.table","NW_015090842.1:7774281",26,75,49
"LOC106888097","s1650_F_VTA_03_ASEReadCounter.table","NW_015090842.1:7774552",54,133,79
"LOC106888097","s1650_F_VTA_03_ASEReadCounter.table","NW_015090842.1:7774564",54,131,77
"LOC106888097","s1650_F_VTA_03_ASEReadCounter.table","NW_015090842.1:7774611",30,90,60
"LOC106888097","s1650_F_VTA_03_ASEReadCounter.table","NW_015090842.1:7774681",37,104,67
"LOC106888097","s1650_F_VTA_03_ASEReadCounter.table","NW_015090842.1:7774698",37,95,58
"LOC106888097","s1650_F_VTA_03_ASEReadCounter.table","NW_015090842.1:7774730",25,57,32
"LOC106888097","s1650_F_VTA_03_ASEReadCounter.table","NW_015090842.1:7774778",6,7,1
"LOC106888097","s1650_F_VTA_03_ASEReadCounter.table","NW_015090842.1:7774793",4,5,1
"FOXL1","s1650_F_VTA_03_ASEReadCounter.table","NW_015090842.1:8113043",0,2,2
"FOXC2","s1650_F_VTA_03_ASEReadCounter.table","NW_015090842.1:8129599",8,24,16
"FOXC2","s1650_F_VTA_03_ASEReadCounter.table","NW_015090842.1:8129616",10,30,20
"FOXC2","s1650_F_VTA_03_ASEReadCounter.table","NW_015090842.1:8129715",10,30,20
"FOXC2","s1650_F_VTA_03_ASEReadCounter.table","NW_015090842.1:8129719",10,31,21
"FOXC2","s1650_F_VTA_03_ASEReadCounter.table","NW_015090842.1:8130244",10,30,20
"FOXC2","s1650_F_VTA_03_ASEReadCounter.table","NW_015090842.1:8130472",5,12,7
"FOXC2","s1650_F_VTA_03_ASEReadCounter.table","NW_015090842.1:8130490",6,18,12
"FOXC2","s1650_F_VTA_03_ASEReadCounter.table","NW_015090842.1:8130547",3,13,10
"FOXC2","s1650_F_VTA_03_ASEReadCounter.table","NW_015090842.1:8130550",3,13,10
"FOXC2","s1650_F_VTA_03_ASEReadCounter.table","NW_015090842.1:8130573",3,11,8
"FOXC2","s1650_F_VTA_03_ASEReadCounter.table","NW_015090842.1:8130575",3,10,7
"MTHFSD","s1650_F_VTA_03_ASEReadCounter.table","NW_015090842.1:8140051",6,10,4
"MTHFSD","s1650_F_VTA_03_ASEReadCounter.table","NW_015090842.1:8142923",18,36,18
"MTHFSD","s1650_F_VTA_03_ASEReadCounter.table","NW_015090842.1:8143029",21,46,25
"MTHFSD","s1650_F_VTA_03_ASEReadCounter.table","NW_015090842.1:8152035",19,44,25
"MTHFSD","s1650_F_VTA_03_ASEReadCounter.table","NW_015090842.1:8152315",13,29,16
"MTHFSD","s1650_F_VTA_03_ASEReadCounter.table","NW_015090842.1:8152511",11,25,14
"MTHFSD","s1650_F_VTA_03_ASEReadCounter.table","NW_015090842.1:8152518",11,27,16
"MTHFSD","s1650_F_VTA_03_ASEReadCounter.table","NW_015090842.1:8152553",10,25,15
"MTHFSD","s1650_F_VTA_03_ASEReadCounter.table","NW_015090842.1:8152773",19,34,15
"MTHFSD","s1650_F_VTA_03_ASEReadCounter.table","NW_015090842.1:8152805",21,36,15
"FOXF1","s1650_F_VTA_03_ASEReadCounter.table","NW_015090842.1:8164789",1,3,2
"FOXF1","s1650_F_VTA_03_ASEReadCounter.table","NW_015090842.1:8167588",1,1,0
"IRF8","s1650_F_VTA_03_ASEReadCounter.table","NW_015090842.1:8406652",8,25,17
"IRF8","s1650_F_VTA_03_ASEReadCounter.table","NW_015090842.1:8406703",20,30,10
"IRF8","s1650_F_VTA_03_ASEReadCounter.table","NW_015090842.1:8406704",20,31,11
"IRF8","s1650_F_VTA_03_ASEReadCounter.table","NW_015090842.1:8406757",19,38,19
"IRF8","s1650_F_VTA_03_ASEReadCounter.table","NW_015090842.1:8406778",17,40,23
"IRF8","s1650_F_VTA_03_ASEReadCounter.table","NW_015090842.1:8406819",13,40,27
"IRF8","s1650_F_VTA_03_ASEReadCounter.table","NW_015090842.1:8406941",19,32,13
"IRF8","s1650_F_VTA_03_ASEReadCounter.table","NW_015090842.1:8407008",12,19,7
"IRF8","s1650_F_VTA_03_ASEReadCounter.table","NW_015090842.1:8407057",12,21,9
"IRF8","s1650_F_VTA_03_ASEReadCounter.table","NW_015090842.1:8407064",12,20,8
"IRF8","s1650_F_VTA_03_ASEReadCounter.table","NW_015090842.1:8407069",13,24,11
"IRF8","s1650_F_VTA_03_ASEReadCounter.table","NW_015090842.1:8407120",13,23,10
"IRF8","s1650_F_VTA_03_ASEReadCounter.table","NW_015090842.1:8407157",15,23,8
"IRF8","s1650_F_VTA_03_ASEReadCounter.table","NW_015090842.1:8407203",11,22,11
"IRF8","s1650_F_VTA_03_ASEReadCounter.table","NW_015090842.1:8407272",9,24,15
"IRF8","s1650_F_VTA_03_ASEReadCounter.table","NW_015090842.1:8407276",10,21,11
"IRF8","s1650_F_VTA_03_ASEReadCounter.table","NW_015090842.1:8407303",13,26,13
"IRF8","s1650_F_VTA_03_ASEReadCounter.table","NW_015090842.1:8407451",11,19,8
"IRF8","s1650_F_VTA_03_ASEReadCounter.table","NW_015090842.1:8407456",9,18,9
"IRF8","s1650_F_VTA_03_ASEReadCounter.table","NW_015090842.1:8408564",14,20,6
"IRF8","s1650_F_VTA_03_ASEReadCounter.table","NW_015090842.1:8408585",21,21,0
"IRF8","s1650_F_VTA_03_ASEReadCounter.table","NW_015090842.1:8408973",11,21,10
"IRF8","s1650_F_VTA_03_ASEReadCounter.table","NW_015090842.1:8409060",5,7,2
"IRF8","s1650_F_VTA_03_ASEReadCounter.table","NW_015090842.1:8409065",5,7,2
"IRF8","s1650_F_VTA_03_ASEReadCounter.table","NW_015090842.1:8409254",7,12,5
"IRF8","s1650_F_VTA_03_ASEReadCounter.table","NW_015090842.1:8409255",6,11,5
"IRF8","s1650_F_VTA_03_ASEReadCounter.table","NW_015090842.1:8409258",7,12,5
"IRF8","s1650_F_VTA_03_ASEReadCounter.table","NW_015090842.1:8409312",9,15,6
"IRF8","s1650_F_VTA_03_ASEReadCounter.table","NW_015090842.1:8410216",9,15,6
"IRF8","s1650_F_VTA_03_ASEReadCounter.table","NW_015090842.1:8410237",7,14,7
"IRF8","s1650_F_VTA_03_ASEReadCounter.table","NW_015090842.1:8410276",16,16,0
"IRF8","s1650_F_VTA_03_ASEReadCounter.table","NW_015090842.1:8410813",9,12,3
"IRF8","s1650_F_VTA_03_ASEReadCounter.table","NW_015090842.1:8410861",7,9,2
"IRF8","s1650_F_VTA_03_ASEReadCounter.table","NW_015090842.1:8411940",5,8,3
"IRF8","s1650_F_VTA_03_ASEReadCounter.table","NW_015090842.1:8412006",8,13,5
"IRF8","s1650_F_VTA_03_ASEReadCounter.table","NW_015090842.1:8412042",6,10,4
"DUSP15","s1650_F_VTA_03_ASEReadCounter.table","NW_015090842.1:8422787",3,5,2
"DUSP15","s1650_F_VTA_03_ASEReadCounter.table","NW_015090842.1:8422832",2,2,0
"DUSP15","s1650_F_VTA_03_ASEReadCounter.table","NW_015090842.1:8422898",0,1,1
"DUSP15","s1650_F_VTA_03_ASEReadCounter.table","NW_015090842.1:8422909",0,1,1
"COX4I1","s1650_F_VTA_03_ASEReadCounter.table","NW_015090842.1:8442258",1363,2574,1211
"COX4I1","s1650_F_VTA_03_ASEReadCounter.table","NW_015090842.1:8442333",1197,2103,906
"EMC8","s1650_F_VTA_03_ASEReadCounter.table","NW_015090842.1:8444046",40,82,42
"EMC8","s1650_F_VTA_03_ASEReadCounter.table","NW_015090842.1:8444064",38,69,31
"EMC8","s1650_F_VTA_03_ASEReadCounter.table","NW_015090842.1:8452029",18,70,52
"EMC8","s1650_F_VTA_03_ASEReadCounter.table","NW_015090842.1:8452116",28,79,51
"EMC8","s1650_F_VTA_03_ASEReadCounter.table","NW_015090842.1:8452121",27,80,53
"EMC8","s1650_F_VTA_03_ASEReadCounter.table","NW_015090842.1:8452222",23,50,27
"EMC8","s1650_F_VTA_03_ASEReadCounter.table","NW_015090842.1:8452244",20,47,27
"EMC8","s1650_F_VTA_03_ASEReadCounter.table","NW_015090842.1:8452477",12,30,18
"EMC8","s1650_F_VTA_03_ASEReadCounter.table","NW_015090842.1:8452498",10,26,16
"EMC8","s1650_F_VTA_03_ASEReadCounter.table","NW_015090842.1:8452535",9,22,13
"EMC8","s1650_F_VTA_03_ASEReadCounter.table","NW_015090842.1:8452575",6,14,8
"EMC8","s1650_F_VTA_03_ASEReadCounter.table","NW_015090842.1:8452600",8,17,9
"EMC8","s1650_F_VTA_03_ASEReadCounter.table","NW_015090842.1:8452616",8,17,9
"EMC8","s1650_F_VTA_03_ASEReadCounter.table","NW_015090842.1:8452630",9,14,5
"EMC8","s1650_F_VTA_03_ASEReadCounter.table","NW_015090842.1:8452650",7,11,4
"EMC8","s1650_F_VTA_03_ASEReadCounter.table","NW_015090842.1:8452678",8,22,14
"EMC8","s1650_F_VTA_03_ASEReadCounter.table","NW_015090842.1:8452724",8,22,14
"EMC8","s1650_F_VTA_03_ASEReadCounter.table","NW_015090842.1:8452731",8,24,16
"EMC8","s1650_F_VTA_03_ASEReadCounter.table","NW_015090842.1:8452743",8,26,18
"EMC8","s1650_F_VTA_03_ASEReadCounter.table","NW_015090842.1:8452750",8,28,20
"EMC8","s1650_F_VTA_03_ASEReadCounter.table","NW_015090842.1:8452778",7,19,12
"EMC8","s1650_F_VTA_03_ASEReadCounter.table","NW_015090842.1:8452783",5,22,17
"EMC8","s1650_F_VTA_03_ASEReadCounter.table","NW_015090842.1:8452800",10,26,16
"EMC8","s1650_F_VTA_03_ASEReadCounter.table","NW_015090842.1:8452804",11,26,15
"EMC8","s1650_F_VTA_03_ASEReadCounter.table","NW_015090842.1:8452812",11,25,14
"EMC8","s1650_F_VTA_03_ASEReadCounter.table","NW_015090842.1:8452858",14,28,14
"EMC8","s1650_F_VTA_03_ASEReadCounter.table","NW_015090842.1:8452906",15,24,9
"EMC8","s1650_F_VTA_03_ASEReadCounter.table","NW_015090842.1:8452913",15,23,8
"EMC8","s1650_F_VTA_03_ASEReadCounter.table","NW_015090842.1:8453000",18,36,18
"EMC8","s1650_F_VTA_03_ASEReadCounter.table","NW_015090842.1:8453007",20,40,20
"EMC8","s1650_F_VTA_03_ASEReadCounter.table","NW_015090842.1:8453058",22,40,18
"EMC8","s1650_F_VTA_03_ASEReadCounter.table","NW_015090842.1:8453106",14,29,15
"GINS2","s1650_F_VTA_03_ASEReadCounter.table","NW_015090842.1:8466420",9,11,2
"GINS2","s1650_F_VTA_03_ASEReadCounter.table","NW_015090842.1:8466424",9,11,2
"GINS2","s1650_F_VTA_03_ASEReadCounter.table","NW_015090842.1:8466518",11,13,2
"GINS2","s1650_F_VTA_03_ASEReadCounter.table","NW_015090842.1:8468482",18,19,1
"GINS2","s1650_F_VTA_03_ASEReadCounter.table","NW_015090842.1:8470290",31,42,11
"GINS2","s1650_F_VTA_03_ASEReadCounter.table","NW_015090842.1:8470305",33,45,12
"GINS2","s1650_F_VTA_03_ASEReadCounter.table","NW_015090842.1:8470381",26,31,5
"GINS2","s1650_F_VTA_03_ASEReadCounter.table","NW_015090842.1:8470418",28,33,5
"GINS2","s1650_F_VTA_03_ASEReadCounter.table","NW_015090842.1:8470421",25,29,4
"GINS2","s1650_F_VTA_03_ASEReadCounter.table","NW_015090842.1:8470430",20,25,5
"GINS2","s1650_F_VTA_03_ASEReadCounter.table","NW_015090842.1:8470433",17,22,5
"GINS2","s1650_F_VTA_03_ASEReadCounter.table","NW_015090842.1:8470457",13,20,7
"GINS2","s1650_F_VTA_03_ASEReadCounter.table","NW_015090842.1:8470491",6,13,7
"GINS2","s1650_F_VTA_03_ASEReadCounter.table","NW_015090842.1:8470548",14,19,5
"GINS2","s1650_F_VTA_03_ASEReadCounter.table","NW_015090842.1:8470649",12,17,5
"GSE1","s1650_F_VTA_03_ASEReadCounter.table","NW_015090842.1:8475362",52,98,46
"GSE1","s1650_F_VTA_03_ASEReadCounter.table","NW_015090842.1:8475961",29,39,10
"GSE1","s1650_F_VTA_03_ASEReadCounter.table","NW_015090842.1:8476027",17,36,19
"GSE1","s1650_F_VTA_03_ASEReadCounter.table","NW_015090842.1:8476159",6,11,5
"GSE1","s1650_F_VTA_03_ASEReadCounter.table","NW_015090842.1:8477442",0,10,10
"GSE1","s1650_F_VTA_03_ASEReadCounter.table","NW_015090842.1:8477448",0,11,11
"GSE1","s1650_F_VTA_03_ASEReadCounter.table","NW_015090842.1:8477662",0,6,6
"GSE1","s1650_F_VTA_03_ASEReadCounter.table","NW_015090842.1:8477933",12,31,19
"GSE1","s1650_F_VTA_03_ASEReadCounter.table","NW_015090842.1:8477945",13,32,19
"GSE1","s1650_F_VTA_03_ASEReadCounter.table","NW_015090842.1:8483272",4,22,18
"GSE1","s1650_F_VTA_03_ASEReadCounter.table","NW_015090842.1:8483367",0,6,6
"GSE1","s1650_F_VTA_03_ASEReadCounter.table","NW_015090842.1:8483411",2,9,7
"GSE1","s1650_F_VTA_03_ASEReadCounter.table","NW_015090842.1:8483756",4,25,21
"GSE1","s1650_F_VTA_03_ASEReadCounter.table","NW_015090842.1:8486867",14,22,8
"GSE1","s1650_F_VTA_03_ASEReadCounter.table","NW_015090842.1:8486939",14,23,9
"GSE1","s1650_F_VTA_03_ASEReadCounter.table","NW_015090842.1:8486945",12,28,16
"GSE1","s1650_F_VTA_03_ASEReadCounter.table","NW_015090842.1:8486993",7,14,7
"GSE1","s1650_F_VTA_03_ASEReadCounter.table","NW_015090842.1:8487062",7,18,11
"GSE1","s1650_F_VTA_03_ASEReadCounter.table","NW_015090842.1:8488065",14,28,14
"GSE1","s1650_F_VTA_03_ASEReadCounter.table","NW_015090842.1:8488457",7,19,12
"GSE1","s1650_F_VTA_03_ASEReadCounter.table","NW_015090842.1:8488463",7,18,11
"GSE1","s1650_F_VTA_03_ASEReadCounter.table","NW_015090842.1:8488490",14,14,0
"GSE1","s1650_F_VTA_03_ASEReadCounter.table","NW_015090842.1:8488505",8,14,6
"GSE1","s1650_F_VTA_03_ASEReadCounter.table","NW_015090842.1:8490180",0,14,14
"KIAA0513","s1650_F_VTA_03_ASEReadCounter.table","NW_015090842.1:8668363",74,172,98
"KIAA0513","s1650_F_VTA_03_ASEReadCounter.table","NW_015090842.1:8668387",88,167,79
"KIAA0513","s1650_F_VTA_03_ASEReadCounter.table","NW_015090842.1:8668390",92,173,81
"KIAA0513","s1650_F_VTA_03_ASEReadCounter.table","NW_015090842.1:8673107",77,151,74
"KIAA0513","s1650_F_VTA_03_ASEReadCounter.table","NW_015090842.1:8673147",75,160,85
"KIAA0513","s1650_F_VTA_03_ASEReadCounter.table","NW_015090842.1:8674661",44,102,58
"KIAA0513","s1650_F_VTA_03_ASEReadCounter.table","NW_015090842.1:8674685",48,105,57
"KIAA0513","s1650_F_VTA_03_ASEReadCounter.table","NW_015090842.1:8674730",45,94,49
"KIAA0513","s1650_F_VTA_03_ASEReadCounter.table","NW_015090842.1:8675525",38,85,47
"KIAA0513","s1650_F_VTA_03_ASEReadCounter.table","NW_015090842.1:8675561",39,78,39
"KIAA0513","s1650_F_VTA_03_ASEReadCounter.table","NW_015090842.1:8678608",0,9,9
"KIAA0513","s1650_F_VTA_03_ASEReadCounter.table","NW_015090842.1:8686455",0,7,7
"KIAA0513","s1650_F_VTA_03_ASEReadCounter.table","NW_015090842.1:8686508",0,10,10
"KIAA0513","s1650_F_VTA_03_ASEReadCounter.table","NW_015090842.1:8686521",0,9,9
"KIAA0513","s1650_F_VTA_03_ASEReadCounter.table","NW_015090842.1:8693642",4,7,3
"KIAA0513","s1650_F_VTA_03_ASEReadCounter.table","NW_015090842.1:8693712",4,7,3
"FBXO31","s1650_F_VTA_03_ASEReadCounter.table","NW_015090842.1:8710240",23,44,21
"FBXO31","s1650_F_VTA_03_ASEReadCounter.table","NW_015090842.1:8710372",20,40,20
"FBXO31","s1650_F_VTA_03_ASEReadCounter.table","NW_015090842.1:8711239",23,38,15
"FBXO31","s1650_F_VTA_03_ASEReadCounter.table","NW_015090842.1:8714565",20,40,20
"FBXO31","s1650_F_VTA_03_ASEReadCounter.table","NW_015090842.1:8716001",16,25,9
"FBXO31","s1650_F_VTA_03_ASEReadCounter.table","NW_015090842.1:8725057",1,1,0
"FBXO31","s1650_F_VTA_03_ASEReadCounter.table","NW_015090842.1:8725162",2,2,0
"FBXO31","s1650_F_VTA_03_ASEReadCounter.table","NW_015090842.1:8725163",2,2,0
"FBXO31","s1650_F_VTA_03_ASEReadCounter.table","NW_015090842.1:8725170",2,2,0
"FBXO31","s1650_F_VTA_03_ASEReadCounter.table","NW_015090842.1:8725187",1,1,0
"FBXO31","s1650_F_VTA_03_ASEReadCounter.table","NW_015090842.1:8725188",1,1,0
"FBXO31","s1650_F_VTA_03_ASEReadCounter.table","NW_015090842.1:8725190",1,1,0
"FBXO31","s1650_F_VTA_03_ASEReadCounter.table","NW_015090842.1:8725370",1,1,0
"ZCCHC14","s1650_F_VTA_03_ASEReadCounter.table","NW_015090842.1:8750174",27,47,20
"ZCCHC14","s1650_F_VTA_03_ASEReadCounter.table","NW_015090842.1:8750189",42,53,11
"ZCCHC14","s1650_F_VTA_03_ASEReadCounter.table","NW_015090842.1:8750365",26,48,22
"ZCCHC14","s1650_F_VTA_03_ASEReadCounter.table","NW_015090842.1:8750433",10,27,17
"ZCCHC14","s1650_F_VTA_03_ASEReadCounter.table","NW_015090842.1:8750449",10,29,19
"ZCCHC14","s1650_F_VTA_03_ASEReadCounter.table","NW_015090842.1:8750456",10,30,20
"ZCCHC14","s1650_F_VTA_03_ASEReadCounter.table","NW_015090842.1:8750497",14,28,14
"ZCCHC14","s1650_F_VTA_03_ASEReadCounter.table","NW_015090842.1:8750547",20,32,12
"ZCCHC14","s1650_F_VTA_03_ASEReadCounter.table","NW_015090842.1:8751100",7,10,3
"ZCCHC14","s1650_F_VTA_03_ASEReadCounter.table","NW_015090842.1:8751374",19,31,12
"ZCCHC14","s1650_F_VTA_03_ASEReadCounter.table","NW_015090842.1:8751403",20,35,15
"ZCCHC14","s1650_F_VTA_03_ASEReadCounter.table","NW_015090842.1:8751517",19,33,14
"ZCCHC14","s1650_F_VTA_03_ASEReadCounter.table","NW_015090842.1:8752060",12,18,6
"ZCCHC14","s1650_F_VTA_03_ASEReadCounter.table","NW_015090842.1:8752172",13,35,22
"ZCCHC14","s1650_F_VTA_03_ASEReadCounter.table","NW_015090842.1:8752183",14,38,24
"ZCCHC14","s1650_F_VTA_03_ASEReadCounter.table","NW_015090842.1:8752198",16,42,26
"ZCCHC14","s1650_F_VTA_03_ASEReadCounter.table","NW_015090842.1:8752248",13,37,24
"ZCCHC14","s1650_F_VTA_03_ASEReadCounter.table","NW_015090842.1:8752326",21,44,23
"ZCCHC14","s1650_F_VTA_03_ASEReadCounter.table","NW_015090842.1:8752393",16,37,21
"ZCCHC14","s1650_F_VTA_03_ASEReadCounter.table","NW_015090842.1:8752914",28,54,26
"ZCCHC14","s1650_F_VTA_03_ASEReadCounter.table","NW_015090842.1:8753528",9,14,5
"ZCCHC14","s1650_F_VTA_03_ASEReadCounter.table","NW_015090842.1:8753892",5,8,3
"ZCCHC14","s1650_F_VTA_03_ASEReadCounter.table","NW_015090842.1:8753910",5,9,4
"ZCCHC14","s1650_F_VTA_03_ASEReadCounter.table","NW_015090842.1:8755096",8,16,8
"ZCCHC14","s1650_F_VTA_03_ASEReadCounter.table","NW_015090842.1:8755327",6,9,3
"ZCCHC14","s1650_F_VTA_03_ASEReadCounter.table","NW_015090842.1:8755723",2,5,3
"ZCCHC14","s1650_F_VTA_03_ASEReadCounter.table","NW_015090842.1:8755739",4,6,2
"ZCCHC14","s1650_F_VTA_03_ASEReadCounter.table","NW_015090842.1:8756149",1,4,3
"ZCCHC14","s1650_F_VTA_03_ASEReadCounter.table","NW_015090842.1:8756347",4,6,2
"ZCCHC14","s1650_F_VTA_03_ASEReadCounter.table","NW_015090842.1:8756361",4,7,3
"ZCCHC14","s1650_F_VTA_03_ASEReadCounter.table","NW_015090842.1:8756388",4,7,3
"ZCCHC14","s1650_F_VTA_03_ASEReadCounter.table","NW_015090842.1:8756389",4,7,3
"ZCCHC14","s1650_F_VTA_03_ASEReadCounter.table","NW_015090842.1:8757160",5,7,2
"ZCCHC14","s1650_F_VTA_03_ASEReadCounter.table","NW_015090842.1:8804511",3,4,1
"ZCCHC14","s1650_F_VTA_03_ASEReadCounter.table","NW_015090842.1:8804979",1,3,2
"JPH3","s1650_F_VTA_03_ASEReadCounter.table","NW_015090842.1:8845375",19,33,14
"JPH3","s1650_F_VTA_03_ASEReadCounter.table","NW_015090842.1:8845640",24,55,31
"JPH3","s1650_F_VTA_03_ASEReadCounter.table","NW_015090842.1:8845654",21,53,32
"JPH3","s1650_F_VTA_03_ASEReadCounter.table","NW_015090842.1:8872283",35,68,33
"JPH3","s1650_F_VTA_03_ASEReadCounter.table","NW_015090842.1:8872294",35,72,37
"JPH3","s1650_F_VTA_03_ASEReadCounter.table","NW_015090842.1:8872730",41,87,46
"JPH3","s1650_F_VTA_03_ASEReadCounter.table","NW_015090842.1:8885260",81,173,92
"JPH3","s1650_F_VTA_03_ASEReadCounter.table","NW_015090842.1:8885315",67,166,99
"JPH3","s1650_F_VTA_03_ASEReadCounter.table","NW_015090842.1:8885328",62,154,92
"JPH3","s1650_F_VTA_03_ASEReadCounter.table","NW_015090842.1:8885438",62,149,87
"JPH3","s1650_F_VTA_03_ASEReadCounter.table","NW_015090842.1:8885525",23,82,59
"KLHDC4","s1650_F_VTA_03_ASEReadCounter.table","NW_015090842.1:8890729",43,67,24
"KLHDC4","s1650_F_VTA_03_ASEReadCounter.table","NW_015090842.1:8890749",51,74,23
"KLHDC4","s1650_F_VTA_03_ASEReadCounter.table","NW_015090842.1:8890761",52,76,24
"KLHDC4","s1650_F_VTA_03_ASEReadCounter.table","NW_015090842.1:8891123",66,104,38
"KLHDC4","s1650_F_VTA_03_ASEReadCounter.table","NW_015090842.1:8893124",38,70,32
"KLHDC4","s1650_F_VTA_03_ASEReadCounter.table","NW_015090842.1:8894542",28,54,26
"KLHDC4","s1650_F_VTA_03_ASEReadCounter.table","NW_015090842.1:8896726",21,43,22
"KLHDC4","s1650_F_VTA_03_ASEReadCounter.table","NW_015090842.1:8896767",19,44,25
"KLHDC4","s1650_F_VTA_03_ASEReadCounter.table","NW_015090842.1:8904174",19,30,11
"KLHDC4","s1650_F_VTA_03_ASEReadCounter.table","NW_015090842.1:8904231",24,39,15
"KLHDC4","s1650_F_VTA_03_ASEReadCounter.table","NW_015090842.1:8905251",15,32,17
"KLHDC4","s1650_F_VTA_03_ASEReadCounter.table","NW_015090842.1:8905263",15,31,16
"KLHDC4","s1650_F_VTA_03_ASEReadCounter.table","NW_015090842.1:8919626",1,1,0
"SLC7A5","s1650_F_VTA_03_ASEReadCounter.table","NW_015090842.1:8938782",263,677,414
"SLC7A5","s1650_F_VTA_03_ASEReadCounter.table","NW_015090842.1:8938943",170,468,298
"SLC7A5","s1650_F_VTA_03_ASEReadCounter.table","NW_015090842.1:8939611",123,223,100
"SLC7A5","s1650_F_VTA_03_ASEReadCounter.table","NW_015090842.1:8939738",115,296,181
"SLC7A5","s1650_F_VTA_03_ASEReadCounter.table","NW_015090842.1:8939739",117,294,177
"SLC7A5","s1650_F_VTA_03_ASEReadCounter.table","NW_015090842.1:8939740",113,296,183
"SLC7A5","s1650_F_VTA_03_ASEReadCounter.table","NW_015090842.1:8939795",134,287,153
"SLC7A5","s1650_F_VTA_03_ASEReadCounter.table","NW_015090842.1:8939815",116,286,170
"SLC7A5","s1650_F_VTA_03_ASEReadCounter.table","NW_015090842.1:8939816",117,283,166
"SLC7A5","s1650_F_VTA_03_ASEReadCounter.table","NW_015090842.1:8939817",117,295,178
"SLC7A5","s1650_F_VTA_03_ASEReadCounter.table","NW_015090842.1:8939845",119,282,163
"SLC7A5","s1650_F_VTA_03_ASEReadCounter.table","NW_015090842.1:8939894",107,262,155
"SLC7A5","s1650_F_VTA_03_ASEReadCounter.table","NW_015090842.1:8939895",108,256,148
"SLC7A5","s1650_F_VTA_03_ASEReadCounter.table","NW_015090842.1:8939997",417,417,0
"SLC7A5","s1650_F_VTA_03_ASEReadCounter.table","NW_015090842.1:8940172",134,301,167
"SLC7A5","s1650_F_VTA_03_ASEReadCounter.table","NW_015090842.1:8940331",93,184,91
"SLC7A5","s1650_F_VTA_03_ASEReadCounter.table","NW_015090842.1:8940696",74,143,69
"SLC7A5","s1650_F_VTA_03_ASEReadCounter.table","NW_015090842.1:8940719",36,136,100
"SLC7A5","s1650_F_VTA_03_ASEReadCounter.table","NW_015090842.1:8940737",41,136,95
"SLC7A5","s1650_F_VTA_03_ASEReadCounter.table","NW_015090842.1:8940743",42,135,93
"SLC7A5","s1650_F_VTA_03_ASEReadCounter.table","NW_015090842.1:8940766",53,151,98
"SLC7A5","s1650_F_VTA_03_ASEReadCounter.table","NW_015090842.1:8940769",54,168,114
"SLC7A5","s1650_F_VTA_03_ASEReadCounter.table","NW_015090842.1:8940861",66,164,98
"SLC7A5","s1650_F_VTA_03_ASEReadCounter.table","NW_015090842.1:8941068",77,191,114
"SLC7A5","s1650_F_VTA_03_ASEReadCounter.table","NW_015090842.1:8941467",56,155,99
"SLC7A5","s1650_F_VTA_03_ASEReadCounter.table","NW_015090842.1:8941531",63,175,112
"SLC7A5","s1650_F_VTA_03_ASEReadCounter.table","NW_015090842.1:8941588",79,211,132
"SLC7A5","s1650_F_VTA_03_ASEReadCounter.table","NW_015090842.1:8941698",42,110,68
"SLC7A5","s1650_F_VTA_03_ASEReadCounter.table","NW_015090842.1:8941717",48,133,85
"SLC7A5","s1650_F_VTA_03_ASEReadCounter.table","NW_015090842.1:8941745",51,137,86
"SLC7A5","s1650_F_VTA_03_ASEReadCounter.table","NW_015090842.1:8941781",56,161,105
"SLC7A5","s1650_F_VTA_03_ASEReadCounter.table","NW_015090842.1:8941887",41,104,63
"SLC7A5","s1650_F_VTA_03_ASEReadCounter.table","NW_015090842.1:8941968",21,85,64
"SLC7A5","s1650_F_VTA_03_ASEReadCounter.table","NW_015090842.1:8942025",40,110,70
"SLC7A5","s1650_F_VTA_03_ASEReadCounter.table","NW_015090842.1:8942069",38,109,71
"SLC7A5","s1650_F_VTA_03_ASEReadCounter.table","NW_015090842.1:8942170",52,134,82
"SLC7A5","s1650_F_VTA_03_ASEReadCounter.table","NW_015090842.1:8942241",60,136,76
"SLC7A5","s1650_F_VTA_03_ASEReadCounter.table","NW_015090842.1:8942283",58,135,77
"SLC7A5","s1650_F_VTA_03_ASEReadCounter.table","NW_015090842.1:8942717",118,287,169
"SLC7A5","s1650_F_VTA_03_ASEReadCounter.table","NW_015090842.1:8942756",170,416,246
"SLC7A5","s1650_F_VTA_03_ASEReadCounter.table","NW_015090842.1:8942766",170,414,244
"SLC7A5","s1650_F_VTA_03_ASEReadCounter.table","NW_015090842.1:8943271",62,144,82
"SLC7A5","s1650_F_VTA_03_ASEReadCounter.table","NW_015090842.1:8943524",44,101,57
"SLC7A5","s1650_F_VTA_03_ASEReadCounter.table","NW_015090842.1:8943530",45,102,57
"SLC7A5","s1650_F_VTA_03_ASEReadCounter.table","NW_015090842.1:8943602",50,109,59
"SLC7A5","s1650_F_VTA_03_ASEReadCounter.table","NW_015090842.1:8943622",45,103,58
"SLC7A5","s1650_F_VTA_03_ASEReadCounter.table","NW_015090842.1:8943661",41,95,54
"SLC7A5","s1650_F_VTA_03_ASEReadCounter.table","NW_015090842.1:8943686",41,95,54
"SLC7A5","s1650_F_VTA_03_ASEReadCounter.table","NW_015090842.1:8943788",34,85,51
"SLC7A5","s1650_F_VTA_03_ASEReadCounter.table","NW_015090842.1:8943814",33,78,45
"SLC7A5","s1650_F_VTA_03_ASEReadCounter.table","NW_015090842.1:8943876",28,62,34
"SLC7A5","s1650_F_VTA_03_ASEReadCounter.table","NW_015090842.1:8943892",30,71,41
"SLC7A5","s1650_F_VTA_03_ASEReadCounter.table","NW_015090842.1:8944097",29,75,46
"SLC7A5","s1650_F_VTA_03_ASEReadCounter.table","NW_015090842.1:8944104",29,74,45
"SLC7A5","s1650_F_VTA_03_ASEReadCounter.table","NW_015090842.1:8944293",15,36,21
"SLC7A5","s1650_F_VTA_03_ASEReadCounter.table","NW_015090842.1:8944297",13,34,21
"SLC7A5","s1650_F_VTA_03_ASEReadCounter.table","NW_015090842.1:8944397",22,46,24
"SLC7A5","s1650_F_VTA_03_ASEReadCounter.table","NW_015090842.1:8944552",22,58,36
"SLC7A5","s1650_F_VTA_03_ASEReadCounter.table","NW_015090842.1:8944629",27,61,34
"CA5A","s1650_F_VTA_03_ASEReadCounter.table","NW_015090842.1:8989479",92,157,65
"CA5A","s1650_F_VTA_03_ASEReadCounter.table","NW_015090842.1:8989562",128,211,83
"CA5A","s1650_F_VTA_03_ASEReadCounter.table","NW_015090842.1:8989609",128,229,101
"CA5A","s1650_F_VTA_03_ASEReadCounter.table","NW_015090842.1:8989693",119,236,117
"CA5A","s1650_F_VTA_03_ASEReadCounter.table","NW_015090842.1:8989702",119,232,113
"CA5A","s1650_F_VTA_03_ASEReadCounter.table","NW_015090842.1:8989746",130,249,119
"CA5A","s1650_F_VTA_03_ASEReadCounter.table","NW_015090842.1:8989880",80,173,93
"CA5A","s1650_F_VTA_03_ASEReadCounter.table","NW_015090842.1:8989885",84,182,98
"CA5A","s1650_F_VTA_03_ASEReadCounter.table","NW_015090842.1:8989929",84,189,105
"CA5A","s1650_F_VTA_03_ASEReadCounter.table","NW_015090842.1:8990002",81,188,107
"CA5A","s1650_F_VTA_03_ASEReadCounter.table","NW_015090842.1:8990004",82,190,108
"CA5A","s1650_F_VTA_03_ASEReadCounter.table","NW_015090842.1:8990005",79,191,112
"CA5A","s1650_F_VTA_03_ASEReadCounter.table","NW_015090842.1:8990017",83,172,89
"CA5A","s1650_F_VTA_03_ASEReadCounter.table","NW_015090842.1:8990043",69,141,72
"CA5A","s1650_F_VTA_03_ASEReadCounter.table","NW_015090842.1:8990060",159,159,0
"CA5A","s1650_F_VTA_03_ASEReadCounter.table","NW_015090842.1:8990080",63,147,84
"CA5A","s1650_F_VTA_03_ASEReadCounter.table","NW_015090842.1:8990084",58,143,85
"CA5A","s1650_F_VTA_03_ASEReadCounter.table","NW_015090842.1:8990090",61,150,89
"CA5A","s1650_F_VTA_03_ASEReadCounter.table","NW_015090842.1:8990095",59,147,88
"CA5A","s1650_F_VTA_03_ASEReadCounter.table","NW_015090842.1:8990111",45,126,81
"CA5A","s1650_F_VTA_03_ASEReadCounter.table","NW_015090842.1:8990112",46,129,83
"CA5A","s1650_F_VTA_03_ASEReadCounter.table","NW_015090842.1:8990115",53,133,80
"CA5A","s1650_F_VTA_03_ASEReadCounter.table","NW_015090842.1:8990166",58,122,64
"CA5A","s1650_F_VTA_03_ASEReadCounter.table","NW_015090842.1:8990169",68,132,64
"CA5A","s1650_F_VTA_03_ASEReadCounter.table","NW_015090842.1:8990193",124,124,0
"CA5A","s1650_F_VTA_03_ASEReadCounter.table","NW_015090842.1:8990222",60,112,52
"CA5A","s1650_F_VTA_03_ASEReadCounter.table","NW_015090842.1:8990289",51,113,62
"CA5A","s1650_F_VTA_03_ASEReadCounter.table","NW_015090842.1:8990314",57,123,66
"CA5A","s1650_F_VTA_03_ASEReadCounter.table","NW_015090842.1:8990361",60,114,54
"CA5A","s1650_F_VTA_03_ASEReadCounter.table","NW_015090842.1:8990368",60,112,52
"CA5A","s1650_F_VTA_03_ASEReadCounter.table","NW_015090842.1:8990429",54,106,52
"CA5A","s1650_F_VTA_03_ASEReadCounter.table","NW_015090842.1:8990466",46,86,40
"CA5A","s1650_F_VTA_03_ASEReadCounter.table","NW_015090842.1:8990663",57,100,43
"CA5A","s1650_F_VTA_03_ASEReadCounter.table","NW_015090842.1:8990797",47,85,38
"CA5A","s1650_F_VTA_03_ASEReadCounter.table","NW_015090842.1:8990836",55,91,36
"CA5A","s1650_F_VTA_03_ASEReadCounter.table","NW_015090842.1:8990842",54,90,36
"CA5A","s1650_F_VTA_03_ASEReadCounter.table","NW_015090842.1:8990851",51,86,35
"CA5A","s1650_F_VTA_03_ASEReadCounter.table","NW_015090842.1:8990918",40,77,37
"CA5A","s1650_F_VTA_03_ASEReadCounter.table","NW_015090842.1:8990921",34,77,43
"CA5A","s1650_F_VTA_03_ASEReadCounter.table","NW_015090842.1:8990942",47,86,39
"CA5A","s1650_F_VTA_03_ASEReadCounter.table","NW_015090842.1:8991001",55,108,53
"CA5A","s1650_F_VTA_03_ASEReadCounter.table","NW_015090842.1:8991038",58,103,45
"CA5A","s1650_F_VTA_03_ASEReadCounter.table","NW_015090842.1:8991149",65,105,40
"CA5A","s1650_F_VTA_03_ASEReadCounter.table","NW_015090842.1:8991176",69,114,45
"CA5A","s1650_F_VTA_03_ASEReadCounter.table","NW_015090842.1:8991241",55,101,46
"CA5A","s1650_F_VTA_03_ASEReadCounter.table","NW_015090842.1:8991262",49,90,41
"CA5A","s1650_F_VTA_03_ASEReadCounter.table","NW_015090842.1:8991316",44,47,3
"CA5A","s1650_F_VTA_03_ASEReadCounter.table","NW_015090842.1:8991319",41,44,3
"CA5A","s1650_F_VTA_03_ASEReadCounter.table","NW_015090842.1:8991330",43,44,1
"CA5A","s1650_F_VTA_03_ASEReadCounter.table","NW_015090842.1:8991334",41,45,4
"CA5A","s1650_F_VTA_03_ASEReadCounter.table","NW_015090842.1:8991362",47,69,22
"CA5A","s1650_F_VTA_03_ASEReadCounter.table","NW_015090842.1:8991368",42,65,23
"CA5A","s1650_F_VTA_03_ASEReadCounter.table","NW_015090842.1:8991390",49,77,28
"CA5A","s1650_F_VTA_03_ASEReadCounter.table","NW_015090842.1:8991395",47,75,28
"CA5A","s1650_F_VTA_03_ASEReadCounter.table","NW_015090842.1:8991422",42,77,35
"CA5A","s1650_F_VTA_03_ASEReadCounter.table","NW_015090842.1:8991467",39,73,34
"CA5A","s1650_F_VTA_03_ASEReadCounter.table","NW_015090842.1:8991576",24,54,30
"CA5A","s1650_F_VTA_03_ASEReadCounter.table","NW_015090842.1:8991587",30,64,34
"CA5A","s1650_F_VTA_03_ASEReadCounter.table","NW_015090842.1:8991655",37,71,34
"CA5A","s1650_F_VTA_03_ASEReadCounter.table","NW_015090842.1:8991717",24,60,36
"CA5A","s1650_F_VTA_03_ASEReadCounter.table","NW_015090842.1:8991726",26,63,37
"CA5A","s1650_F_VTA_03_ASEReadCounter.table","NW_015090842.1:8991799",30,72,42
"CA5A","s1650_F_VTA_03_ASEReadCounter.table","NW_015090842.1:8991809",24,64,40
"CA5A","s1650_F_VTA_03_ASEReadCounter.table","NW_015090842.1:8991848",25,58,33
"CA5A","s1650_F_VTA_03_ASEReadCounter.table","NW_015090842.1:8991849",24,58,34
"CA5A","s1650_F_VTA_03_ASEReadCounter.table","NW_015090842.1:8991927",41,73,32
"CA5A","s1650_F_VTA_03_ASEReadCounter.table","NW_015090842.1:8991941",38,71,33
"CA5A","s1650_F_VTA_03_ASEReadCounter.table","NW_015090842.1:8992121",26,62,36
"CA5A","s1650_F_VTA_03_ASEReadCounter.table","NW_015090842.1:8992224",30,53,23
"CA5A","s1650_F_VTA_03_ASEReadCounter.table","NW_015090842.1:9002570",18,34,16
"CA5A","s1650_F_VTA_03_ASEReadCounter.table","NW_015090842.1:9002600",15,32,17
"CA5A","s1650_F_VTA_03_ASEReadCounter.table","NW_015090842.1:9004312",12,19,7
"CA5A","s1650_F_VTA_03_ASEReadCounter.table","NW_015090842.1:9005116",4,7,3
"CA5A","s1650_F_VTA_03_ASEReadCounter.table","NW_015090842.1:9005120",4,7,3
"CA5A","s1650_F_VTA_03_ASEReadCounter.table","NW_015090842.1:9005140",5,9,4
"CA5A","s1650_F_VTA_03_ASEReadCounter.table","NW_015090842.1:9005152",5,8,3
"BANP","s1650_F_VTA_03_ASEReadCounter.table","NW_015090842.1:9033407",4,9,5
"BANP","s1650_F_VTA_03_ASEReadCounter.table","NW_015090842.1:9033409",4,9,5
"BANP","s1650_F_VTA_03_ASEReadCounter.table","NW_015090842.1:9033420",2,8,6
"BANP","s1650_F_VTA_03_ASEReadCounter.table","NW_015090842.1:9067974",0,6,6
"BANP","s1650_F_VTA_03_ASEReadCounter.table","NW_015090842.1:9102510",11,29,18
"BANP","s1650_F_VTA_03_ASEReadCounter.table","NW_015090842.1:9168534",15,40,25
"BANP","s1650_F_VTA_03_ASEReadCounter.table","NW_015090842.1:9168818",17,40,23
"ZNF469","s1650_F_VTA_03_ASEReadCounter.table","NW_015090842.1:9425089",0,1,1
"ZNF469","s1650_F_VTA_03_ASEReadCounter.table","NW_015090842.1:9425108",0,1,1
"ZNF469","s1650_F_VTA_03_ASEReadCounter.table","NW_015090842.1:9425182",0,1,1
"ZNF469","s1650_F_VTA_03_ASEReadCounter.table","NW_015090842.1:9426585",0,1,1
"ZNF469","s1650_F_VTA_03_ASEReadCounter.table","NW_015090842.1:9428122",0,1,1
"ZNF469","s1650_F_VTA_03_ASEReadCounter.table","NW_015090842.1:9428178",0,1,1
"ZNF469","s1650_F_VTA_03_ASEReadCounter.table","NW_015090842.1:9428419",0,1,1
"ZNF469","s1650_F_VTA_03_ASEReadCounter.table","NW_015090842.1:9429758",0,1,1
"ZNF469","s1650_F_VTA_03_ASEReadCounter.table","NW_015090842.1:9429759",0,1,1
"ZNF469","s1650_F_VTA_03_ASEReadCounter.table","NW_015090842.1:9429794",0,1,1
"ZNF469","s1650_F_VTA_03_ASEReadCounter.table","NW_015090842.1:9430560",1,1,0
"ZNF469","s1650_F_VTA_03_ASEReadCounter.table","NW_015090842.1:9430700",2,2,0
"ZNF469","s1650_F_VTA_03_ASEReadCounter.table","NW_015090842.1:9431073",0,1,1
"ZNF469","s1650_F_VTA_03_ASEReadCounter.table","NW_015090842.1:9431091",0,1,1
"ZNF469","s1650_F_VTA_03_ASEReadCounter.table","NW_015090842.1:9431150",0,2,2
"ZNF469","s1650_F_VTA_03_ASEReadCounter.table","NW_015090842.1:9431162",0,1,1
"ZNF469","s1650_F_VTA_03_ASEReadCounter.table","NW_015090842.1:9431317",0,2,2
"ZNF469","s1650_F_VTA_03_ASEReadCounter.table","NW_015090842.1:9431325",0,2,2
"ZNF469","s1650_F_VTA_03_ASEReadCounter.table","NW_015090842.1:9431700",0,1,1
"ZNF469","s1650_F_VTA_03_ASEReadCounter.table","NW_015090842.1:9432110",1,2,1
"ZNF469","s1650_F_VTA_03_ASEReadCounter.table","NW_015090842.1:9432302",1,5,4
"ZNF469","s1650_F_VTA_03_ASEReadCounter.table","NW_015090842.1:9432361",1,2,1
"ZNF469","s1650_F_VTA_03_ASEReadCounter.table","NW_015090842.1:9432374",1,2,1
"ZNF469","s1650_F_VTA_03_ASEReadCounter.table","NW_015090842.1:9432382",0,1,1
"ZNF469","s1650_F_VTA_03_ASEReadCounter.table","NW_015090842.1:9432481",0,1,1
"ZNF469","s1650_F_VTA_03_ASEReadCounter.table","NW_015090842.1:9432498",1,2,1
"ZNF469","s1650_F_VTA_03_ASEReadCounter.table","NW_015090842.1:9433268",0,1,1
"ZNF469","s1650_F_VTA_03_ASEReadCounter.table","NW_015090842.1:9433678",2,3,1
"ZNF469","s1650_F_VTA_03_ASEReadCounter.table","NW_015090842.1:9433902",1,1,0
"ZNF469","s1650_F_VTA_03_ASEReadCounter.table","NW_015090842.1:9433980",1,2,1
"ZNF469","s1650_F_VTA_03_ASEReadCounter.table","NW_015090842.1:9434259",0,1,1
"ZNF469","s1650_F_VTA_03_ASEReadCounter.table","NW_015090842.1:9435221",1,4,3
"ZFPM1","s1650_F_VTA_03_ASEReadCounter.table","NW_015090842.1:9458862",1,8,7
"ZFPM1","s1650_F_VTA_03_ASEReadCounter.table","NW_015090842.1:9458888",4,13,9
"ZFPM1","s1650_F_VTA_03_ASEReadCounter.table","NW_015090842.1:9458904",4,13,9
"ZFPM1","s1650_F_VTA_03_ASEReadCounter.table","NW_015090842.1:9458916",4,13,9
"ZFPM1","s1650_F_VTA_03_ASEReadCounter.table","NW_015090842.1:9468568",3,13,10
"ZFPM1","s1650_F_VTA_03_ASEReadCounter.table","NW_015090842.1:9468593",3,10,7
"ZFPM1","s1650_F_VTA_03_ASEReadCounter.table","NW_015090842.1:9471561",2,6,4
"ZFPM1","s1650_F_VTA_03_ASEReadCounter.table","NW_015090842.1:9472557",2,7,5
"ZFPM1","s1650_F_VTA_03_ASEReadCounter.table","NW_015090842.1:9472565",2,7,5
"ZFPM1","s1650_F_VTA_03_ASEReadCounter.table","NW_015090842.1:9472608",3,9,6
"ZFPM1","s1650_F_VTA_03_ASEReadCounter.table","NW_015090842.1:9472627",4,9,5
"ZFPM1","s1650_F_VTA_03_ASEReadCounter.table","NW_015090842.1:9472668",3,6,3
"ZFPM1","s1650_F_VTA_03_ASEReadCounter.table","NW_015090842.1:9473655",2,7,5
"ZFPM1","s1650_F_VTA_03_ASEReadCounter.table","NW_015090842.1:9475827",8,16,8
"ZFPM1","s1650_F_VTA_03_ASEReadCounter.table","NW_015090842.1:9475842",11,20,9
"ZFPM1","s1650_F_VTA_03_ASEReadCounter.table","NW_015090842.1:9476119",6,11,5
"ZFPM1","s1650_F_VTA_03_ASEReadCounter.table","NW_015090842.1:9476161",4,13,9
"ZFPM1","s1650_F_VTA_03_ASEReadCounter.table","NW_015090842.1:9476219",3,8,5
"ZFPM1","s1650_F_VTA_03_ASEReadCounter.table","NW_015090842.1:9476233",4,8,4
"ZFPM1","s1650_F_VTA_03_ASEReadCounter.table","NW_015090842.1:9476305",5,16,11
"ZFPM1","s1650_F_VTA_03_ASEReadCounter.table","NW_015090842.1:9476395",6,13,7
"ZFPM1","s1650_F_VTA_03_ASEReadCounter.table","NW_015090842.1:9476421",5,13,8
"ZFPM1","s1650_F_VTA_03_ASEReadCounter.table","NW_015090842.1:9476539",6,15,9
"ZFPM1","s1650_F_VTA_03_ASEReadCounter.table","NW_015090842.1:9476576",2,12,10
"ZFPM1","s1650_F_VTA_03_ASEReadCounter.table","NW_015090842.1:9476599",14,14,0
"ZFPM1","s1650_F_VTA_03_ASEReadCounter.table","NW_015090842.1:9476792",11,26,15
"ZFPM1","s1650_F_VTA_03_ASEReadCounter.table","NW_015090842.1:9476803",10,25,15
"ZFPM1","s1650_F_VTA_03_ASEReadCounter.table","NW_015090842.1:9477115",6,16,10
"ZFPM1","s1650_F_VTA_03_ASEReadCounter.table","NW_015090842.1:9477299",2,14,12
"ZFPM1","s1650_F_VTA_03_ASEReadCounter.table","NW_015090842.1:9477398",24,24,0
"ZFPM1","s1650_F_VTA_03_ASEReadCounter.table","NW_015090842.1:9477422",7,22,15
"ZFPM1","s1650_F_VTA_03_ASEReadCounter.table","NW_015090842.1:9477554",12,29,17
"ZFPM1","s1650_F_VTA_03_ASEReadCounter.table","NW_015090842.1:9477575",27,27,0
"ZFPM1","s1650_F_VTA_03_ASEReadCounter.table","NW_015090842.1:9477595",14,29,15
"ZFPM1","s1650_F_VTA_03_ASEReadCounter.table","NW_015090842.1:9477611",12,29,17
"ZFPM1","s1650_F_VTA_03_ASEReadCounter.table","NW_015090842.1:9477659",18,38,20
"ZFPM1","s1650_F_VTA_03_ASEReadCounter.table","NW_015090842.1:9477737",11,26,15
"ZFPM1","s1650_F_VTA_03_ASEReadCounter.table","NW_015090842.1:9477791",6,24,18
"ZFPM1","s1650_F_VTA_03_ASEReadCounter.table","NW_015090842.1:9477844",11,33,22
"ZFPM1","s1650_F_VTA_03_ASEReadCounter.table","NW_015090842.1:9477917",16,30,14
"ZFPM1","s1650_F_VTA_03_ASEReadCounter.table","NW_015090842.1:9478295",11,34,23
"ZFPM1","s1650_F_VTA_03_ASEReadCounter.table","NW_015090842.1:9478349",14,41,27
"ZFPM1","s1650_F_VTA_03_ASEReadCounter.table","NW_015090842.1:9478524",13,35,22
"ZFPM1","s1650_F_VTA_03_ASEReadCounter.table","NW_015090842.1:9478546",17,44,27
"ZFPM1","s1650_F_VTA_03_ASEReadCounter.table","NW_015090842.1:9478573",17,43,26
"ZFPM1","s1650_F_VTA_03_ASEReadCounter.table","NW_015090842.1:9478582",14,34,20
"ZFPM1","s1650_F_VTA_03_ASEReadCounter.table","NW_015090842.1:9478684",6,20,14
"ZFPM1","s1650_F_VTA_03_ASEReadCounter.table","NW_015090842.1:9478711",6,15,9
"ZFPM1","s1650_F_VTA_03_ASEReadCounter.table","NW_015090842.1:9478761",9,26,17
"ZFPM1","s1650_F_VTA_03_ASEReadCounter.table","NW_015090842.1:9478829",11,11,0
"CIDEC","s1650_F_VTA_03_ASEReadCounter.table","NW_015090842.1:9480756",0,1,1
"ZC3H18","s1650_F_VTA_03_ASEReadCounter.table","NW_015090842.1:9494271",9,15,6
"ZC3H18","s1650_F_VTA_03_ASEReadCounter.table","NW_015090842.1:9501427",11,27,16
"ZC3H18","s1650_F_VTA_03_ASEReadCounter.table","NW_015090842.1:9501442",6,24,18
"ZC3H18","s1650_F_VTA_03_ASEReadCounter.table","NW_015090842.1:9505538",16,34,18
"ZC3H18","s1650_F_VTA_03_ASEReadCounter.table","NW_015090842.1:9506778",14,40,26
"ZC3H18","s1650_F_VTA_03_ASEReadCounter.table","NW_015090842.1:9522538",11,29,18
"ZC3H18","s1650_F_VTA_03_ASEReadCounter.table","NW_015090842.1:9524350",20,30,10
"ZC3H18","s1650_F_VTA_03_ASEReadCounter.table","NW_015090842.1:9524366",22,36,14
"ZC3H18","s1650_F_VTA_03_ASEReadCounter.table","NW_015090842.1:9524424",20,36,16
"ZC3H18","s1650_F_VTA_03_ASEReadCounter.table","NW_015090842.1:9529649",26,62,36
"ZC3H18","s1650_F_VTA_03_ASEReadCounter.table","NW_015090842.1:9529688",26,64,38
"ZC3H18","s1650_F_VTA_03_ASEReadCounter.table","NW_015090842.1:9529691",24,58,34
"ZC3H18","s1650_F_VTA_03_ASEReadCounter.table","NW_015090842.1:9530977",21,66,45
"ZC3H18","s1650_F_VTA_03_ASEReadCounter.table","NW_015090842.1:9536699",0,43,43
"CYBA","s1650_F_VTA_03_ASEReadCounter.table","NW_015090842.1:9547281",18,25,7
"CYBA","s1650_F_VTA_03_ASEReadCounter.table","NW_015090842.1:9547402",38,67,29
"CYBA","s1650_F_VTA_03_ASEReadCounter.table","NW_015090842.1:9547553",34,68,34
"CYBA","s1650_F_VTA_03_ASEReadCounter.table","NW_015090842.1:9548052",22,42,20
"CYBA","s1650_F_VTA_03_ASEReadCounter.table","NW_015090842.1:9548436",30,41,11
"CYBA","s1650_F_VTA_03_ASEReadCounter.table","NW_015090842.1:9548442",30,43,13
"CYBA","s1650_F_VTA_03_ASEReadCounter.table","NW_015090842.1:9548478",38,47,9
"CYBA","s1650_F_VTA_03_ASEReadCounter.table","NW_015090842.1:9548487",37,47,10
"CYBA","s1650_F_VTA_03_ASEReadCounter.table","NW_015090842.1:9548490",35,45,10
"CYBA","s1650_F_VTA_03_ASEReadCounter.table","NW_015090842.1:9548717",31,42,11
"CYBA","s1650_F_VTA_03_ASEReadCounter.table","NW_015090842.1:9548750",27,35,8
"CYBA","s1650_F_VTA_03_ASEReadCounter.table","NW_015090842.1:9548766",19,25,6
"MVD","s1650_F_VTA_03_ASEReadCounter.table","NW_015090842.1:9550678",17,28,11
"MVD","s1650_F_VTA_03_ASEReadCounter.table","NW_015090842.1:9550690",18,35,17
"MVD","s1650_F_VTA_03_ASEReadCounter.table","NW_015090842.1:9550691",18,35,17
"MVD","s1650_F_VTA_03_ASEReadCounter.table","NW_015090842.1:9550699",21,42,21
"MVD","s1650_F_VTA_03_ASEReadCounter.table","NW_015090842.1:9550719",19,44,25
"MVD","s1650_F_VTA_03_ASEReadCounter.table","NW_015090842.1:9551596",40,84,44
"MVD","s1650_F_VTA_03_ASEReadCounter.table","NW_015090842.1:9551638",41,91,50
"MVD","s1650_F_VTA_03_ASEReadCounter.table","NW_015090842.1:9551899",0,3,3
"MVD","s1650_F_VTA_03_ASEReadCounter.table","NW_015090842.1:9552193",32,60,28
"MVD","s1650_F_VTA_03_ASEReadCounter.table","NW_015090842.1:9552202",30,61,31
"MVD","s1650_F_VTA_03_ASEReadCounter.table","NW_015090842.1:9552208",30,62,32
"MVD","s1650_F_VTA_03_ASEReadCounter.table","NW_015090842.1:9552625",30,50,20
"MVD","s1650_F_VTA_03_ASEReadCounter.table","NW_015090842.1:9552629",51,51,0
"MVD","s1650_F_VTA_03_ASEReadCounter.table","NW_015090842.1:9552644",26,47,21
"MVD","s1650_F_VTA_03_ASEReadCounter.table","NW_015090842.1:9553093",24,52,28
"MVD","s1650_F_VTA_03_ASEReadCounter.table","NW_015090842.1:9553114",24,53,29
"RNF166","s1650_F_VTA_03_ASEReadCounter.table","NW_015090842.1:9557900",16,44,28
"RNF166","s1650_F_VTA_03_ASEReadCounter.table","NW_015090842.1:9558048",10,40,30
"RNF166","s1650_F_VTA_03_ASEReadCounter.table","NW_015090842.1:9558116",15,42,27
"RNF166","s1650_F_VTA_03_ASEReadCounter.table","NW_015090842.1:9558308",18,37,19
"RNF166","s1650_F_VTA_03_ASEReadCounter.table","NW_015090842.1:9558405",16,39,23
"RNF166","s1650_F_VTA_03_ASEReadCounter.table","NW_015090842.1:9558549",17,54,37
"RNF166","s1650_F_VTA_03_ASEReadCounter.table","NW_015090842.1:9558556",10,45,35
"RNF166","s1650_F_VTA_03_ASEReadCounter.table","NW_015090842.1:9558579",15,48,33
"RNF166","s1650_F_VTA_03_ASEReadCounter.table","NW_015090842.1:9558599",16,42,26
"RNF166","s1650_F_VTA_03_ASEReadCounter.table","NW_015090842.1:9558688",19,42,23
"RNF166","s1650_F_VTA_03_ASEReadCounter.table","NW_015090842.1:9558711",19,44,25
"RNF166","s1650_F_VTA_03_ASEReadCounter.table","NW_015090842.1:9558733",19,41,22
"RNF166","s1650_F_VTA_03_ASEReadCounter.table","NW_015090842.1:9558847",13,26,13
"RNF166","s1650_F_VTA_03_ASEReadCounter.table","NW_015090842.1:9559798",16,29,13
"RNF166","s1650_F_VTA_03_ASEReadCounter.table","NW_015090842.1:9560575",12,38,26
"RNF166","s1650_F_VTA_03_ASEReadCounter.table","NW_015090842.1:9561055",10,28,18
"RNF166","s1650_F_VTA_03_ASEReadCounter.table","NW_015090842.1:9562458",7,20,13
"RNF166","s1650_F_VTA_03_ASEReadCounter.table","NW_015090842.1:9562497",7,19,12
"RNF166","s1650_F_VTA_03_ASEReadCounter.table","NW_015090842.1:9562539",6,15,9
"RNF166","s1650_F_VTA_03_ASEReadCounter.table","NW_015090842.1:9564056",6,14,8
"CTU2","s1650_F_VTA_03_ASEReadCounter.table","NW_015090842.1:9565149",10,19,9
"CTU2","s1650_F_VTA_03_ASEReadCounter.table","NW_015090842.1:9565193",11,22,11
"CTU2","s1650_F_VTA_03_ASEReadCounter.table","NW_015090842.1:9565300",12,27,15
"CTU2","s1650_F_VTA_03_ASEReadCounter.table","NW_015090842.1:9565321",12,28,16
"CTU2","s1650_F_VTA_03_ASEReadCounter.table","NW_015090842.1:9565721",8,31,23
"CTU2","s1650_F_VTA_03_ASEReadCounter.table","NW_015090842.1:9565739",12,34,22
"CTU2","s1650_F_VTA_03_ASEReadCounter.table","NW_015090842.1:9565905",14,32,18
"CTU2","s1650_F_VTA_03_ASEReadCounter.table","NW_015090842.1:9566013",43,43,0
"CTU2","s1650_F_VTA_03_ASEReadCounter.table","NW_015090842.1:9566055",21,49,28
"CTU2","s1650_F_VTA_03_ASEReadCounter.table","NW_015090842.1:9566056",21,48,27
"CTU2","s1650_F_VTA_03_ASEReadCounter.table","NW_015090842.1:9566151",22,33,11
"CTU2","s1650_F_VTA_03_ASEReadCounter.table","NW_015090842.1:9566300",17,34,17
"CTU2","s1650_F_VTA_03_ASEReadCounter.table","NW_015090842.1:9566342",10,30,20
"CTU2","s1650_F_VTA_03_ASEReadCounter.table","NW_015090842.1:9566548",15,32,17
"CTU2","s1650_F_VTA_03_ASEReadCounter.table","NW_015090842.1:9566625",21,40,19
"CTU2","s1650_F_VTA_03_ASEReadCounter.table","NW_015090842.1:9566633",20,38,18
"CTU2","s1650_F_VTA_03_ASEReadCounter.table","NW_015090842.1:9566807",25,40,15
"CTU2","s1650_F_VTA_03_ASEReadCounter.table","NW_015090842.1:9567139",26,53,27
"CTU2","s1650_F_VTA_03_ASEReadCounter.table","NW_015090842.1:9567156",23,47,24
"CTU2","s1650_F_VTA_03_ASEReadCounter.table","NW_015090842.1:9567614",28,56,28
"CTU2","s1650_F_VTA_03_ASEReadCounter.table","NW_015090842.1:9567677",28,52,24
"CTU2","s1650_F_VTA_03_ASEReadCounter.table","NW_015090842.1:9567747",17,41,24
"CTU2","s1650_F_VTA_03_ASEReadCounter.table","NW_015090842.1:9567828",17,32,15
"CTU2","s1650_F_VTA_03_ASEReadCounter.table","NW_015090842.1:9567829",17,34,17
"CTU2","s1650_F_VTA_03_ASEReadCounter.table","NW_015090842.1:9567885",13,25,12
"PIEZO1","s1650_F_VTA_03_ASEReadCounter.table","NW_015090842.1:9568093",37,98,61
"PIEZO1","s1650_F_VTA_03_ASEReadCounter.table","NW_015090842.1:9568672",41,97,56
"PIEZO1","s1650_F_VTA_03_ASEReadCounter.table","NW_015090842.1:9568948",29,88,59
"PIEZO1","s1650_F_VTA_03_ASEReadCounter.table","NW_015090842.1:9568987",63,63,0
"PIEZO1","s1650_F_VTA_03_ASEReadCounter.table","NW_015090842.1:9569040",20,60,40
"PIEZO1","s1650_F_VTA_03_ASEReadCounter.table","NW_015090842.1:9569180",24,64,40
"PIEZO1","s1650_F_VTA_03_ASEReadCounter.table","NW_015090842.1:9569192",27,68,41
"PIEZO1","s1650_F_VTA_03_ASEReadCounter.table","NW_015090842.1:9570088",23,55,32
"PIEZO1","s1650_F_VTA_03_ASEReadCounter.table","NW_015090842.1:9570480",17,47,30
"PIEZO1","s1650_F_VTA_03_ASEReadCounter.table","NW_015090842.1:9570639",18,49,31
"PIEZO1","s1650_F_VTA_03_ASEReadCounter.table","NW_015090842.1:9571847",14,43,29
"PIEZO1","s1650_F_VTA_03_ASEReadCounter.table","NW_015090842.1:9572371",16,31,15
"PIEZO1","s1650_F_VTA_03_ASEReadCounter.table","NW_015090842.1:9572638",11,26,15
"PIEZO1","s1650_F_VTA_03_ASEReadCounter.table","NW_015090842.1:9573156",12,42,30
"PIEZO1","s1650_F_VTA_03_ASEReadCounter.table","NW_015090842.1:9573280",8,23,15
"PIEZO1","s1650_F_VTA_03_ASEReadCounter.table","NW_015090842.1:9573566",11,30,19
"PIEZO1","s1650_F_VTA_03_ASEReadCounter.table","NW_015090842.1:9575341",11,23,12
"PIEZO1","s1650_F_VTA_03_ASEReadCounter.table","NW_015090842.1:9575367",12,22,10
"PIEZO1","s1650_F_VTA_03_ASEReadCounter.table","NW_015090842.1:9575645",8,21,13
"PIEZO1","s1650_F_VTA_03_ASEReadCounter.table","NW_015090842.1:9575696",7,24,17
"PIEZO1","s1650_F_VTA_03_ASEReadCounter.table","NW_015090842.1:9575897",5,20,15
"PIEZO1","s1650_F_VTA_03_ASEReadCounter.table","NW_015090842.1:9576060",12,21,9
"PIEZO1","s1650_F_VTA_03_ASEReadCounter.table","NW_015090842.1:9576087",12,20,8
"PIEZO1","s1650_F_VTA_03_ASEReadCounter.table","NW_015090842.1:9576093",14,23,9
"PIEZO1","s1650_F_VTA_03_ASEReadCounter.table","NW_015090842.1:9576120",12,24,12
"PIEZO1","s1650_F_VTA_03_ASEReadCounter.table","NW_015090842.1:9576687",4,12,8
"PIEZO1","s1650_F_VTA_03_ASEReadCounter.table","NW_015090842.1:9576710",4,14,10
"PIEZO1","s1650_F_VTA_03_ASEReadCounter.table","NW_015090842.1:9576723",4,15,11
"PIEZO1","s1650_F_VTA_03_ASEReadCounter.table","NW_015090842.1:9578268",5,17,12
"PIEZO1","s1650_F_VTA_03_ASEReadCounter.table","NW_015090842.1:9578770",2,11,9
"PIEZO1","s1650_F_VTA_03_ASEReadCounter.table","NW_015090842.1:9578806",3,13,10
"PIEZO1","s1650_F_VTA_03_ASEReadCounter.table","NW_015090842.1:9579064",5,13,8
"PIEZO1","s1650_F_VTA_03_ASEReadCounter.table","NW_015090842.1:9579065",5,13,8
"PIEZO1","s1650_F_VTA_03_ASEReadCounter.table","NW_015090842.1:9579347",12,24,12
"PIEZO1","s1650_F_VTA_03_ASEReadCounter.table","NW_015090842.1:9580765",4,10,6
"PIEZO1","s1650_F_VTA_03_ASEReadCounter.table","NW_015090842.1:9580996",9,14,5
"PIEZO1","s1650_F_VTA_03_ASEReadCounter.table","NW_015090842.1:9581101",6,10,4
"PIEZO1","s1650_F_VTA_03_ASEReadCounter.table","NW_015090842.1:9581299",4,7,3
"PIEZO1","s1650_F_VTA_03_ASEReadCounter.table","NW_015090842.1:9581875",4,10,6
"PIEZO1","s1650_F_VTA_03_ASEReadCounter.table","NW_015090842.1:9582046",4,10,6
"PIEZO1","s1650_F_VTA_03_ASEReadCounter.table","NW_015090842.1:9582961",3,9,6
"PIEZO1","s1650_F_VTA_03_ASEReadCounter.table","NW_015090842.1:9583298",2,5,3
"PIEZO1","s1650_F_VTA_03_ASEReadCounter.table","NW_015090842.1:9584337",3,6,3
"PIEZO1","s1650_F_VTA_03_ASEReadCounter.table","NW_015090842.1:9584425",4,6,2
"PIEZO1","s1650_F_VTA_03_ASEReadCounter.table","NW_015090842.1:9584435",4,6,2
"PIEZO1","s1650_F_VTA_03_ASEReadCounter.table","NW_015090842.1:9584438",4,6,2
"PIEZO1","s1650_F_VTA_03_ASEReadCounter.table","NW_015090842.1:9584441",4,6,2
"CDT1","s1650_F_VTA_03_ASEReadCounter.table","NW_015090842.1:9596766",2,5,3
"CDT1","s1650_F_VTA_03_ASEReadCounter.table","NW_015090842.1:9597054",6,9,3
"CDT1","s1650_F_VTA_03_ASEReadCounter.table","NW_015090842.1:9597074",6,8,2
"CDT1","s1650_F_VTA_03_ASEReadCounter.table","NW_015090842.1:9597137",7,9,2
"CDT1","s1650_F_VTA_03_ASEReadCounter.table","NW_015090842.1:9597756",7,15,8
"CDT1","s1650_F_VTA_03_ASEReadCounter.table","NW_015090842.1:9597766",7,15,8
"CDT1","s1650_F_VTA_03_ASEReadCounter.table","NW_015090842.1:9598496",4,8,4
"CDT1","s1650_F_VTA_03_ASEReadCounter.table","NW_015090842.1:9598498",4,9,5
"CDT1","s1650_F_VTA_03_ASEReadCounter.table","NW_015090842.1:9598816",4,12,8
"CDT1","s1650_F_VTA_03_ASEReadCounter.table","NW_015090842.1:9598879",7,11,4
"CDT1","s1650_F_VTA_03_ASEReadCounter.table","NW_015090842.1:9598912",9,10,1
"CDT1","s1650_F_VTA_03_ASEReadCounter.table","NW_015090842.1:9598959",6,8,2
"CDT1","s1650_F_VTA_03_ASEReadCounter.table","NW_015090842.1:9599807",7,12,5
"CDT1","s1650_F_VTA_03_ASEReadCounter.table","NW_015090842.1:9599819",7,12,5
"CDT1","s1650_F_VTA_03_ASEReadCounter.table","NW_015090842.1:9599845",6,13,7
"CDT1","s1650_F_VTA_03_ASEReadCounter.table","NW_015090842.1:9600148",4,15,11
"CDT1","s1650_F_VTA_03_ASEReadCounter.table","NW_015090842.1:9600151",4,14,10
"CDT1","s1650_F_VTA_03_ASEReadCounter.table","NW_015090842.1:9600217",9,23,14
"CDT1","s1650_F_VTA_03_ASEReadCounter.table","NW_015090842.1:9600226",9,21,12
"CDT1","s1650_F_VTA_03_ASEReadCounter.table","NW_015090842.1:9600260",5,13,8
"CDT1","s1650_F_VTA_03_ASEReadCounter.table","NW_015090842.1:9600268",5,12,7
"CDT1","s1650_F_VTA_03_ASEReadCounter.table","NW_015090842.1:9600305",6,8,2
"CDT1","s1650_F_VTA_03_ASEReadCounter.table","NW_015090842.1:9600397",6,15,9
"CDT1","s1650_F_VTA_03_ASEReadCounter.table","NW_015090842.1:9600447",6,14,8
"CDT1","s1650_F_VTA_03_ASEReadCounter.table","NW_015090842.1:9600450",7,15,8
"CDT1","s1650_F_VTA_03_ASEReadCounter.table","NW_015090842.1:9600485",7,12,5
"CDT1","s1650_F_VTA_03_ASEReadCounter.table","NW_015090842.1:9600579",7,12,5
"APRT","s1650_F_VTA_03_ASEReadCounter.table","NW_015090842.1:9602308",34,77,43
"APRT","s1650_F_VTA_03_ASEReadCounter.table","NW_015090842.1:9602440",54,146,92
"APRT","s1650_F_VTA_03_ASEReadCounter.table","NW_015090842.1:9602449",56,150,94
"APRT","s1650_F_VTA_03_ASEReadCounter.table","NW_015090842.1:9602451",55,155,100
"APRT","s1650_F_VTA_03_ASEReadCounter.table","NW_015090842.1:9602455",53,154,101
"APRT","s1650_F_VTA_03_ASEReadCounter.table","NW_015090842.1:9602462",54,152,98
"APRT","s1650_F_VTA_03_ASEReadCounter.table","NW_015090842.1:9602507",33,126,93
"APRT","s1650_F_VTA_03_ASEReadCounter.table","NW_015090842.1:9602514",37,129,92
"APRT","s1650_F_VTA_03_ASEReadCounter.table","NW_015090842.1:9602530",36,114,78
"APRT","s1650_F_VTA_03_ASEReadCounter.table","NW_015090842.1:9602582",48,134,86
"APRT","s1650_F_VTA_03_ASEReadCounter.table","NW_015090842.1:9602583",48,132,84
"APRT","s1650_F_VTA_03_ASEReadCounter.table","NW_015090842.1:9602650",52,132,80
"APRT","s1650_F_VTA_03_ASEReadCounter.table","NW_015090842.1:9602655",52,125,73
"APRT","s1650_F_VTA_03_ASEReadCounter.table","NW_015090842.1:9602712",35,116,81
"APRT","s1650_F_VTA_03_ASEReadCounter.table","NW_015090842.1:9602764",41,129,88
"APRT","s1650_F_VTA_03_ASEReadCounter.table","NW_015090842.1:9602821",45,121,76
"APRT","s1650_F_VTA_03_ASEReadCounter.table","NW_015090842.1:9602867",56,110,54
"APRT","s1650_F_VTA_03_ASEReadCounter.table","NW_015090842.1:9602883",57,113,56
"APRT","s1650_F_VTA_03_ASEReadCounter.table","NW_015090842.1:9602886",60,118,58
"APRT","s1650_F_VTA_03_ASEReadCounter.table","NW_015090842.1:9602948",45,113,68
"APRT","s1650_F_VTA_03_ASEReadCounter.table","NW_015090842.1:9602958",42,109,67
"APRT","s1650_F_VTA_03_ASEReadCounter.table","NW_015090842.1:9603020",56,133,77
"APRT","s1650_F_VTA_03_ASEReadCounter.table","NW_015090842.1:9603025",55,133,78
"APRT","s1650_F_VTA_03_ASEReadCounter.table","NW_015090842.1:9603154",50,110,60
"APRT","s1650_F_VTA_03_ASEReadCounter.table","NW_015090842.1:9603166",56,123,67
"APRT","s1650_F_VTA_03_ASEReadCounter.table","NW_015090842.1:9603326",46,102,56
"APRT","s1650_F_VTA_03_ASEReadCounter.table","NW_015090842.1:9603419",41,87,46
"APRT","s1650_F_VTA_03_ASEReadCounter.table","NW_015090842.1:9603420",42,87,45
"APRT","s1650_F_VTA_03_ASEReadCounter.table","NW_015090842.1:9603464",33,66,33
"APRT","s1650_F_VTA_03_ASEReadCounter.table","NW_015090842.1:9603528",33,71,38
"APRT","s1650_F_VTA_03_ASEReadCounter.table","NW_015090842.1:9603607",23,60,37
"APRT","s1650_F_VTA_03_ASEReadCounter.table","NW_015090842.1:9603622",22,61,39
"APRT","s1650_F_VTA_03_ASEReadCounter.table","NW_015090842.1:9604361",20,60,40
"APRT","s1650_F_VTA_03_ASEReadCounter.table","NW_015090842.1:9605317",12,32,20
"APRT","s1650_F_VTA_03_ASEReadCounter.table","NW_015090842.1:9605336",13,38,25
"GALNS","s1650_F_VTA_03_ASEReadCounter.table","NW_015090842.1:9612872",3,10,7
"GALNS","s1650_F_VTA_03_ASEReadCounter.table","NW_015090842.1:9612873",2,9,7
"GALNS","s1650_F_VTA_03_ASEReadCounter.table","NW_015090842.1:9612877",2,10,8
"GALNS","s1650_F_VTA_03_ASEReadCounter.table","NW_015090842.1:9612942",8,25,17
"GALNS","s1650_F_VTA_03_ASEReadCounter.table","NW_015090842.1:9612987",23,23,0
"GALNS","s1650_F_VTA_03_ASEReadCounter.table","NW_015090842.1:9613064",18,35,17
"GALNS","s1650_F_VTA_03_ASEReadCounter.table","NW_015090842.1:9613096",32,54,22
"GALNS","s1650_F_VTA_03_ASEReadCounter.table","NW_015090842.1:9613123",32,58,26
"GALNS","s1650_F_VTA_03_ASEReadCounter.table","NW_015090842.1:9613125",32,57,25
"GALNS","s1650_F_VTA_03_ASEReadCounter.table","NW_015090842.1:9613193",32,63,31
"GALNS","s1650_F_VTA_03_ASEReadCounter.table","NW_015090842.1:9613226",30,66,36
"GALNS","s1650_F_VTA_03_ASEReadCounter.table","NW_015090842.1:9613249",35,76,41
"GALNS","s1650_F_VTA_03_ASEReadCounter.table","NW_015090842.1:9613256",38,80,42
"GALNS","s1650_F_VTA_03_ASEReadCounter.table","NW_015090842.1:9613317",26,58,32
"GALNS","s1650_F_VTA_03_ASEReadCounter.table","NW_015090842.1:9613343",27,53,26
"GALNS","s1650_F_VTA_03_ASEReadCounter.table","NW_015090842.1:9613344",26,50,24
"GALNS","s1650_F_VTA_03_ASEReadCounter.table","NW_015090842.1:9613371",27,44,17
"GALNS","s1650_F_VTA_03_ASEReadCounter.table","NW_015090842.1:9613378",25,42,17
"GALNS","s1650_F_VTA_03_ASEReadCounter.table","NW_015090842.1:9613379",25,41,16
"GALNS","s1650_F_VTA_03_ASEReadCounter.table","NW_015090842.1:9613516",33,58,25
"GALNS","s1650_F_VTA_03_ASEReadCounter.table","NW_015090842.1:9613572",36,60,24
"GALNS","s1650_F_VTA_03_ASEReadCounter.table","NW_015090842.1:9613597",38,69,31
"GALNS","s1650_F_VTA_03_ASEReadCounter.table","NW_015090842.1:9613627",26,50,24
"GALNS","s1650_F_VTA_03_ASEReadCounter.table","NW_015090842.1:9613640",19,52,33
"GALNS","s1650_F_VTA_03_ASEReadCounter.table","NW_015090842.1:9614025",23,49,26
"GALNS","s1650_F_VTA_03_ASEReadCounter.table","NW_015090842.1:9614169",20,38,18
"GALNS","s1650_F_VTA_03_ASEReadCounter.table","NW_015090842.1:9614232",36,36,0
"GALNS","s1650_F_VTA_03_ASEReadCounter.table","NW_015090842.1:9614667",15,24,9
"GALNS","s1650_F_VTA_03_ASEReadCounter.table","NW_015090842.1:9614709",17,29,12
"GALNS","s1650_F_VTA_03_ASEReadCounter.table","NW_015090842.1:9614880",17,27,10
"GALNS","s1650_F_VTA_03_ASEReadCounter.table","NW_015090842.1:9614902",18,25,7
"GALNS","s1650_F_VTA_03_ASEReadCounter.table","NW_015090842.1:9614960",11,18,7
"GALNS","s1650_F_VTA_03_ASEReadCounter.table","NW_015090842.1:9615114",21,36,15
"GALNS","s1650_F_VTA_03_ASEReadCounter.table","NW_015090842.1:9615199",16,24,8
"GALNS","s1650_F_VTA_03_ASEReadCounter.table","NW_015090842.1:9615217",11,20,9
"GALNS","s1650_F_VTA_03_ASEReadCounter.table","NW_015090842.1:9615277",7,20,13
"GALNS","s1650_F_VTA_03_ASEReadCounter.table","NW_015090842.1:9615377",12,28,16
"GALNS","s1650_F_VTA_03_ASEReadCounter.table","NW_015090842.1:9647858",7,15,8
"GALNS","s1650_F_VTA_03_ASEReadCounter.table","NW_015090842.1:9649186",7,12,5
"GALNS","s1650_F_VTA_03_ASEReadCounter.table","NW_015090842.1:9649237",2,7,5
"GALNS","s1650_F_VTA_03_ASEReadCounter.table","NW_015090842.1:9661193",3,6,3
"TRAPPC2L","s1650_F_VTA_03_ASEReadCounter.table","NW_015090842.1:9662951",157,263,106
"TRAPPC2L","s1650_F_VTA_03_ASEReadCounter.table","NW_015090842.1:9663014",160,260,100
"TRAPPC2L","s1650_F_VTA_03_ASEReadCounter.table","NW_015090842.1:9664305",275,276,1
"TRAPPC2L","s1650_F_VTA_03_ASEReadCounter.table","NW_015090842.1:9665155",135,267,132
"TRAPPC2L","s1650_F_VTA_03_ASEReadCounter.table","NW_015090842.1:9665211",45,98,53
"PABPN1L","s1650_F_VTA_03_ASEReadCounter.table","NW_015090842.1:9669959",0,1,1
"CBFA2T3","s1650_F_VTA_03_ASEReadCounter.table","NW_015090842.1:9709469",2,33,31
"CBFA2T3","s1650_F_VTA_03_ASEReadCounter.table","NW_015090842.1:9709475",1,32,31
"CBFA2T3","s1650_F_VTA_03_ASEReadCounter.table","NW_015090842.1:9711845",0,10,10
"CBFA2T3","s1650_F_VTA_03_ASEReadCounter.table","NW_015090842.1:9712157",0,15,15
"CBFA2T3","s1650_F_VTA_03_ASEReadCounter.table","NW_015090842.1:9712160",0,15,15
"CBFA2T3","s1650_F_VTA_03_ASEReadCounter.table","NW_015090842.1:9712166",0,17,17
"CBFA2T3","s1650_F_VTA_03_ASEReadCounter.table","NW_015090842.1:9712536",4,14,10
"CBFA2T3","s1650_F_VTA_03_ASEReadCounter.table","NW_015090842.1:9712673",8,15,7
"CBFA2T3","s1650_F_VTA_03_ASEReadCounter.table","NW_015090842.1:9712787",9,18,9
"CBFA2T3","s1650_F_VTA_03_ASEReadCounter.table","NW_015090842.1:9712791",10,18,8
"CBFA2T3","s1650_F_VTA_03_ASEReadCounter.table","NW_015090842.1:9712805",7,15,8
"CBFA2T3","s1650_F_VTA_03_ASEReadCounter.table","NW_015090842.1:9712811",6,16,10
"CBFA2T3","s1650_F_VTA_03_ASEReadCounter.table","NW_015090842.1:9712848",12,18,6
"CBFA2T3","s1650_F_VTA_03_ASEReadCounter.table","NW_015090842.1:9713088",13,24,11
"CBFA2T3","s1650_F_VTA_03_ASEReadCounter.table","NW_015090842.1:9713121",8,19,11
"CBFA2T3","s1650_F_VTA_03_ASEReadCounter.table","NW_015090842.1:9717058",13,30,17
"CBFA2T3","s1650_F_VTA_03_ASEReadCounter.table","NW_015090842.1:9717093",11,28,17
"CBFA2T3","s1650_F_VTA_03_ASEReadCounter.table","NW_015090842.1:9717114",13,34,21
"CBFA2T3","s1650_F_VTA_03_ASEReadCounter.table","NW_015090842.1:9717139",12,30,18
"CBFA2T3","s1650_F_VTA_03_ASEReadCounter.table","NW_015090842.1:9719788",6,17,11
"CBFA2T3","s1650_F_VTA_03_ASEReadCounter.table","NW_015090842.1:9728522",1,1,0
"CBFA2T3","s1650_F_VTA_03_ASEReadCounter.table","NW_015090842.1:9728525",1,1,0
"CBFA2T3","s1650_F_VTA_03_ASEReadCounter.table","NW_015090842.1:9728588",0,1,1
"CBFA2T3","s1650_F_VTA_03_ASEReadCounter.table","NW_015090842.1:9728654",1,1,0
"ACSF3","s1650_F_VTA_03_ASEReadCounter.table","NW_015090842.1:9773379",0,1,1
"ACSF3","s1650_F_VTA_03_ASEReadCounter.table","NW_015090842.1:9773382",0,1,1
"ACSF3","s1650_F_VTA_03_ASEReadCounter.table","NW_015090842.1:9773384",0,1,1
"ACSF3","s1650_F_VTA_03_ASEReadCounter.table","NW_015090842.1:9773388",0,3,3
"ACSF3","s1650_F_VTA_03_ASEReadCounter.table","NW_015090842.1:9776753",6,7,1
"ACSF3","s1650_F_VTA_03_ASEReadCounter.table","NW_015090842.1:9776783",7,7,0
"ACSF3","s1650_F_VTA_03_ASEReadCounter.table","NW_015090842.1:9776879",5,7,2
"ACSF3","s1650_F_VTA_03_ASEReadCounter.table","NW_015090842.1:9776965",15,21,6
"ACSF3","s1650_F_VTA_03_ASEReadCounter.table","NW_015090842.1:9777091",8,14,6
"ACSF3","s1650_F_VTA_03_ASEReadCounter.table","NW_015090842.1:9777206",16,26,10
"ACSF3","s1650_F_VTA_03_ASEReadCounter.table","NW_015090842.1:9777283",9,15,6
"ACSF3","s1650_F_VTA_03_ASEReadCounter.table","NW_015090842.1:9778955",12,22,10
"ACSF3","s1650_F_VTA_03_ASEReadCounter.table","NW_015090842.1:9778997",17,40,23
"ACSF3","s1650_F_VTA_03_ASEReadCounter.table","NW_015090842.1:9789311",27,52,25
"ACSF3","s1650_F_VTA_03_ASEReadCounter.table","NW_015090842.1:9789906",3,29,26
"ACSF3","s1650_F_VTA_03_ASEReadCounter.table","NW_015090842.1:9834743",45,83,38
"ACSF3","s1650_F_VTA_03_ASEReadCounter.table","NW_015090842.1:9834852",39,80,41
"ACSF3","s1650_F_VTA_03_ASEReadCounter.table","NW_015090842.1:9834861",36,72,36
"ACSF3","s1650_F_VTA_03_ASEReadCounter.table","NW_015090842.1:9839359",26,55,29
"ACSF3","s1650_F_VTA_03_ASEReadCounter.table","NW_015090842.1:9839378",27,61,34
"ACSF3","s1650_F_VTA_03_ASEReadCounter.table","NW_015090842.1:9839455",28,62,34
"ACSF3","s1650_F_VTA_03_ASEReadCounter.table","NW_015090842.1:9839457",29,63,34
"ACSF3","s1650_F_VTA_03_ASEReadCounter.table","NW_015090842.1:9839489",20,52,32
"ACSF3","s1650_F_VTA_03_ASEReadCounter.table","NW_015090842.1:9839500",15,42,27
"ACSF3","s1650_F_VTA_03_ASEReadCounter.table","NW_015090842.1:9839501",15,44,29
"ACSF3","s1650_F_VTA_03_ASEReadCounter.table","NW_015090842.1:9839504",20,49,29
"ACSF3","s1650_F_VTA_03_ASEReadCounter.table","NW_015090842.1:9839512",18,41,23
"ACSF3","s1650_F_VTA_03_ASEReadCounter.table","NW_015090842.1:9839527",13,31,18
"ACSF3","s1650_F_VTA_03_ASEReadCounter.table","NW_015090842.1:9839533",8,25,17
"ACSF3","s1650_F_VTA_03_ASEReadCounter.table","NW_015090842.1:9839535",8,22,14
"ACSF3","s1650_F_VTA_03_ASEReadCounter.table","NW_015090842.1:9839545",7,21,14
"ACSF3","s1650_F_VTA_03_ASEReadCounter.table","NW_015090842.1:9839550",6,20,14
"ACSF3","s1650_F_VTA_03_ASEReadCounter.table","NW_015090842.1:9839551",6,19,13
"CDH15","s1650_F_VTA_03_ASEReadCounter.table","NW_015090842.1:9847163",0,1,1
"CDH15","s1650_F_VTA_03_ASEReadCounter.table","NW_015090842.1:9847174",0,1,1
"CDH15","s1650_F_VTA_03_ASEReadCounter.table","NW_015090842.1:9848004",0,3,3
"CDH15","s1650_F_VTA_03_ASEReadCounter.table","NW_015090842.1:9848220",1,1,0
"CDH15","s1650_F_VTA_03_ASEReadCounter.table","NW_015090842.1:9848265",1,2,1
"CDH15","s1650_F_VTA_03_ASEReadCounter.table","NW_015090842.1:9848307",2,3,1
"CDH15","s1650_F_VTA_03_ASEReadCounter.table","NW_015090842.1:9848310",2,3,1
"CDH15","s1650_F_VTA_03_ASEReadCounter.table","NW_015090842.1:9848313",2,3,1
"CDH15","s1650_F_VTA_03_ASEReadCounter.table","NW_015090842.1:9848531",3,3,0
"CDH15","s1650_F_VTA_03_ASEReadCounter.table","NW_015090842.1:9848552",1,1,0
"CDH15","s1650_F_VTA_03_ASEReadCounter.table","NW_015090842.1:9848888",1,1,0
"CDH15","s1650_F_VTA_03_ASEReadCounter.table","NW_015090842.1:9848936",2,2,0
"CDH15","s1650_F_VTA_03_ASEReadCounter.table","NW_015090842.1:9849086",0,1,1
"CDH15","s1650_F_VTA_03_ASEReadCounter.table","NW_015090842.1:9849119",0,1,1
"CDH15","s1650_F_VTA_03_ASEReadCounter.table","NW_015090842.1:9849140",0,1,1
"CDH15","s1650_F_VTA_03_ASEReadCounter.table","NW_015090842.1:9849473",1,3,2
"CDH15","s1650_F_VTA_03_ASEReadCounter.table","NW_015090842.1:9850141",0,2,2
"CDH15","s1650_F_VTA_03_ASEReadCounter.table","NW_015090842.1:9850609",1,1,0
"SLC22A31","s1650_F_VTA_03_ASEReadCounter.table","NW_015090842.1:9850797",0,1,1
"SLC22A31","s1650_F_VTA_03_ASEReadCounter.table","NW_015090842.1:9850818",0,1,1
"SLC22A31","s1650_F_VTA_03_ASEReadCounter.table","NW_015090842.1:9850929",0,1,1
"SLC22A31","s1650_F_VTA_03_ASEReadCounter.table","NW_015090842.1:9850936",0,1,1
"SLC22A31","s1650_F_VTA_03_ASEReadCounter.table","NW_015090842.1:9850940",0,1,1
"SLC22A31","s1650_F_VTA_03_ASEReadCounter.table","NW_015090842.1:9850948",0,1,1
"SLC22A31","s1650_F_VTA_03_ASEReadCounter.table","NW_015090842.1:9850961",0,1,1
"SLC22A31","s1650_F_VTA_03_ASEReadCounter.table","NW_015090842.1:9850970",0,1,1
"SLC22A31","s1650_F_VTA_03_ASEReadCounter.table","NW_015090842.1:9850978",0,1,1
"SLC22A31","s1650_F_VTA_03_ASEReadCounter.table","NW_015090842.1:9850981",0,1,1
"SLC22A31","s1650_F_VTA_03_ASEReadCounter.table","NW_015090842.1:9851117",6,8,2
"SLC22A31","s1650_F_VTA_03_ASEReadCounter.table","NW_015090842.1:9851130",7,9,2
"SLC22A31","s1650_F_VTA_03_ASEReadCounter.table","NW_015090842.1:9851139",7,9,2
"SLC22A31","s1650_F_VTA_03_ASEReadCounter.table","NW_015090842.1:9851265",6,18,12
"SLC22A31","s1650_F_VTA_03_ASEReadCounter.table","NW_015090842.1:9851302",7,13,6
"SLC22A31","s1650_F_VTA_03_ASEReadCounter.table","NW_015090842.1:9851303",7,13,6
"SLC22A31","s1650_F_VTA_03_ASEReadCounter.table","NW_015090842.1:9851305",7,13,6
"SLC22A31","s1650_F_VTA_03_ASEReadCounter.table","NW_015090842.1:9851343",5,8,3
"SLC22A31","s1650_F_VTA_03_ASEReadCounter.table","NW_015090842.1:9851344",5,8,3
"SLC22A31","s1650_F_VTA_03_ASEReadCounter.table","NW_015090842.1:9851361",8,8,0
"SLC22A31","s1650_F_VTA_03_ASEReadCounter.table","NW_015090842.1:9851381",7,12,5
"SLC22A31","s1650_F_VTA_03_ASEReadCounter.table","NW_015090842.1:9851421",6,12,6
"SLC22A31","s1650_F_VTA_03_ASEReadCounter.table","NW_015090842.1:9851501",5,10,5
"SLC22A31","s1650_F_VTA_03_ASEReadCounter.table","NW_015090842.1:9851526",10,17,7
"SLC22A31","s1650_F_VTA_03_ASEReadCounter.table","NW_015090842.1:9851589",3,19,16
"SLC22A31","s1650_F_VTA_03_ASEReadCounter.table","NW_015090842.1:9851712",6,15,9
"SLC22A31","s1650_F_VTA_03_ASEReadCounter.table","NW_015090842.1:9851899",5,19,14
"SLC22A31","s1650_F_VTA_03_ASEReadCounter.table","NW_015090842.1:9852139",7,18,11
"SLC22A31","s1650_F_VTA_03_ASEReadCounter.table","NW_015090842.1:9852380",3,18,15
"SLC22A31","s1650_F_VTA_03_ASEReadCounter.table","NW_015090842.1:9852431",2,11,9
"SLC22A31","s1650_F_VTA_03_ASEReadCounter.table","NW_015090842.1:9852630",2,13,11
"SLC22A31","s1650_F_VTA_03_ASEReadCounter.table","NW_015090842.1:9852711",2,9,7
"SLC22A31","s1650_F_VTA_03_ASEReadCounter.table","NW_015090842.1:9853099",5,14,9
"SLC22A31","s1650_F_VTA_03_ASEReadCounter.table","NW_015090842.1:9853102",5,13,8
"SLC22A31","s1650_F_VTA_03_ASEReadCounter.table","NW_015090842.1:9853421",1,1,0
"SLC22A31","s1650_F_VTA_03_ASEReadCounter.table","NW_015090842.1:9853457",0,2,2
"SLC22A31","s1650_F_VTA_03_ASEReadCounter.table","NW_015090842.1:9853502",1,3,2
"ANKRD11","s1650_F_VTA_03_ASEReadCounter.table","NW_015090842.1:9858863",11,22,11
"ANKRD11","s1650_F_VTA_03_ASEReadCounter.table","NW_015090842.1:9859101",113,263,150
"ANKRD11","s1650_F_VTA_03_ASEReadCounter.table","NW_015090842.1:9859352",109,292,183
"ANKRD11","s1650_F_VTA_03_ASEReadCounter.table","NW_015090842.1:9859381",25,159,134
"ANKRD11","s1650_F_VTA_03_ASEReadCounter.table","NW_015090842.1:9859679",129,264,135
"ANKRD11","s1650_F_VTA_03_ASEReadCounter.table","NW_015090842.1:9861097",115,199,84
"ANKRD11","s1650_F_VTA_03_ASEReadCounter.table","NW_015090842.1:9862571",68,130,62
"ANKRD11","s1650_F_VTA_03_ASEReadCounter.table","NW_015090842.1:9862652",47,92,45
"ANKRD11","s1650_F_VTA_03_ASEReadCounter.table","NW_015090842.1:9866071",0,91,91
"ANKRD11","s1650_F_VTA_03_ASEReadCounter.table","NW_015090842.1:9866200",0,57,57
"ANKRD11","s1650_F_VTA_03_ASEReadCounter.table","NW_015090842.1:9867391",21,39,18
"ANKRD11","s1650_F_VTA_03_ASEReadCounter.table","NW_015090842.1:9867472",38,67,29
"ANKRD11","s1650_F_VTA_03_ASEReadCounter.table","NW_015090842.1:9867559",34,63,29
"ANKRD11","s1650_F_VTA_03_ASEReadCounter.table","NW_015090842.1:9867667",40,76,36
"ANKRD11","s1650_F_VTA_03_ASEReadCounter.table","NW_015090842.1:9867934",23,59,36
"ANKRD11","s1650_F_VTA_03_ASEReadCounter.table","NW_015090842.1:9868064",41,85,44
"ANKRD11","s1650_F_VTA_03_ASEReadCounter.table","NW_015090842.1:9868093",38,79,41
"ANKRD11","s1650_F_VTA_03_ASEReadCounter.table","NW_015090842.1:9868222",28,54,26
"ANKRD11","s1650_F_VTA_03_ASEReadCounter.table","NW_015090842.1:9868327",43,91,48
"ANKRD11","s1650_F_VTA_03_ASEReadCounter.table","NW_015090842.1:9868414",43,104,61
"ANKRD11","s1650_F_VTA_03_ASEReadCounter.table","NW_015090842.1:9868441",42,96,54
"ANKRD11","s1650_F_VTA_03_ASEReadCounter.table","NW_015090842.1:9868444",42,100,58
"ANKRD11","s1650_F_VTA_03_ASEReadCounter.table","NW_015090842.1:9868519",61,123,62
"ANKRD11","s1650_F_VTA_03_ASEReadCounter.table","NW_015090842.1:9868609",71,140,69
"ANKRD11","s1650_F_VTA_03_ASEReadCounter.table","NW_015090842.1:9868666",87,174,87
"ANKRD11","s1650_F_VTA_03_ASEReadCounter.table","NW_015090842.1:9868738",207,207,0
"ANKRD11","s1650_F_VTA_03_ASEReadCounter.table","NW_015090842.1:9869431",157,306,149
"ANKRD11","s1650_F_VTA_03_ASEReadCounter.table","NW_015090842.1:9869578",241,433,192
"ANKRD11","s1650_F_VTA_03_ASEReadCounter.table","NW_015090842.1:9869734",212,425,213
"ANKRD11","s1650_F_VTA_03_ASEReadCounter.table","NW_015090842.1:9870070",185,427,242
"ANKRD11","s1650_F_VTA_03_ASEReadCounter.table","NW_015090842.1:9870349",214,466,252
"ANKRD11","s1650_F_VTA_03_ASEReadCounter.table","NW_015090842.1:9870604",227,511,284
"ANKRD11","s1650_F_VTA_03_ASEReadCounter.table","NW_015090842.1:9870613",242,529,287
"ANKRD11","s1650_F_VTA_03_ASEReadCounter.table","NW_015090842.1:9870685",285,633,348
"ANKRD11","s1650_F_VTA_03_ASEReadCounter.table","NW_015090842.1:9870760",264,580,316
"ANKRD11","s1650_F_VTA_03_ASEReadCounter.table","NW_015090842.1:9870847",233,506,273
"ANKRD11","s1650_F_VTA_03_ASEReadCounter.table","NW_015090842.1:9871103",206,379,173
"ANKRD11","s1650_F_VTA_03_ASEReadCounter.table","NW_015090842.1:9871165",185,394,209
"ANKRD11","s1650_F_VTA_03_ASEReadCounter.table","NW_015090842.1:9871508",278,279,1
"ANKRD11","s1650_F_VTA_03_ASEReadCounter.table","NW_015090842.1:9871820",42,97,55
"ANKRD11","s1650_F_VTA_03_ASEReadCounter.table","NW_015090842.1:9872118",51,125,74
"ANKRD11","s1650_F_VTA_03_ASEReadCounter.table","NW_015090842.1:9877406",24,41,17
"SPG7","s1650_F_VTA_03_ASEReadCounter.table","NW_015090842.1:10051190",50,111,61
"SPG7","s1650_F_VTA_03_ASEReadCounter.table","NW_015090842.1:10051218",58,130,72
"SPG7","s1650_F_VTA_03_ASEReadCounter.table","NW_015090842.1:10052348",77,143,66
"SPG7","s1650_F_VTA_03_ASEReadCounter.table","NW_015090842.1:10052366",70,136,66
"SPG7","s1650_F_VTA_03_ASEReadCounter.table","NW_015090842.1:10065173",96,182,86
"SPG7","s1650_F_VTA_03_ASEReadCounter.table","NW_015090842.1:10065215",99,180,81
"SPG7","s1650_F_VTA_03_ASEReadCounter.table","NW_015090842.1:10066365",92,190,98
"SPG7","s1650_F_VTA_03_ASEReadCounter.table","NW_015090842.1:10069752",111,227,116
"SPG7","s1650_F_VTA_03_ASEReadCounter.table","NW_015090842.1:10069800",116,270,154
"SPG7","s1650_F_VTA_03_ASEReadCounter.table","NW_015090842.1:10071192",127,297,170
"SPG7","s1650_F_VTA_03_ASEReadCounter.table","NW_015090842.1:10071219",128,283,155
"SPG7","s1650_F_VTA_03_ASEReadCounter.table","NW_015090842.1:10071967",100,222,122
"SPG7","s1650_F_VTA_03_ASEReadCounter.table","NW_015090842.1:10075109",207,414,207
"SPG7","s1650_F_VTA_03_ASEReadCounter.table","NW_015090842.1:10075114",210,410,200
"SPG7","s1650_F_VTA_03_ASEReadCounter.table","NW_015090842.1:10075198",172,342,170
"SPG7","s1650_F_VTA_03_ASEReadCounter.table","NW_015090842.1:10075487",142,307,165
"SPG7","s1650_F_VTA_03_ASEReadCounter.table","NW_015090842.1:10075488",145,312,167
"SPG7","s1650_F_VTA_03_ASEReadCounter.table","NW_015090842.1:10075548",94,210,116
"RPL13","s1650_F_VTA_03_ASEReadCounter.table","NW_015090842.1:10077387",516,1033,517
"RPL13","s1650_F_VTA_03_ASEReadCounter.table","NW_015090842.1:10077978",728,1546,818
"RPL13","s1650_F_VTA_03_ASEReadCounter.table","NW_015090842.1:10077992",719,1501,782
"CPNE7","s1650_F_VTA_03_ASEReadCounter.table","NW_015090842.1:10084001",5,6,1
"CPNE7","s1650_F_VTA_03_ASEReadCounter.table","NW_015090842.1:10084856",5,6,1
"CPNE7","s1650_F_VTA_03_ASEReadCounter.table","NW_015090842.1:10084872",5,6,1
"CPNE7","s1650_F_VTA_03_ASEReadCounter.table","NW_015090842.1:10084892",4,6,2
"CPNE7","s1650_F_VTA_03_ASEReadCounter.table","NW_015090842.1:10084921",4,6,2
"CPNE7","s1650_F_VTA_03_ASEReadCounter.table","NW_015090842.1:10084935",5,7,2
"CPNE7","s1650_F_VTA_03_ASEReadCounter.table","NW_015090842.1:10085000",5,6,1
"CPNE7","s1650_F_VTA_03_ASEReadCounter.table","NW_015090842.1:10085089",6,10,4
"CPNE7","s1650_F_VTA_03_ASEReadCounter.table","NW_015090842.1:10085096",6,10,4
"CPNE7","s1650_F_VTA_03_ASEReadCounter.table","NW_015090842.1:10085126",6,10,4
"CPNE7","s1650_F_VTA_03_ASEReadCounter.table","NW_015090842.1:10085167",10,10,0
"CPNE7","s1650_F_VTA_03_ASEReadCounter.table","NW_015090842.1:10085180",4,6,2
"CPNE7","s1650_F_VTA_03_ASEReadCounter.table","NW_015090842.1:10085201",4,6,2
"CPNE7","s1650_F_VTA_03_ASEReadCounter.table","NW_015090842.1:10088134",13,15,2
"CPNE7","s1650_F_VTA_03_ASEReadCounter.table","NW_015090842.1:10088146",12,14,2
"CPNE7","s1650_F_VTA_03_ASEReadCounter.table","NW_015090842.1:10088806",10,14,4
"CPNE7","s1650_F_VTA_03_ASEReadCounter.table","NW_015090842.1:10088940",9,13,4
"CPNE7","s1650_F_VTA_03_ASEReadCounter.table","NW_015090842.1:10088965",10,14,4
"CPNE7","s1650_F_VTA_03_ASEReadCounter.table","NW_015090842.1:10088967",10,14,4
"CPNE7","s1650_F_VTA_03_ASEReadCounter.table","NW_015090842.1:10088973",10,13,3
"CPNE7","s1650_F_VTA_03_ASEReadCounter.table","NW_015090842.1:10090924",24,30,6
"CPNE7","s1650_F_VTA_03_ASEReadCounter.table","NW_015090842.1:10090930",25,33,8
"CPNE7","s1650_F_VTA_03_ASEReadCounter.table","NW_015090842.1:10091075",21,31,10
"CPNE7","s1650_F_VTA_03_ASEReadCounter.table","NW_015090842.1:10091389",23,40,17
"CPNE7","s1650_F_VTA_03_ASEReadCounter.table","NW_015090842.1:10091407",21,36,15
"CPNE7","s1650_F_VTA_03_ASEReadCounter.table","NW_015090842.1:10091488",37,37,0
"CPNE7","s1650_F_VTA_03_ASEReadCounter.table","NW_015090842.1:10091491",38,38,0
"CPNE7","s1650_F_VTA_03_ASEReadCounter.table","NW_015090842.1:10091530",21,29,8
"CPNE7","s1650_F_VTA_03_ASEReadCounter.table","NW_015090842.1:10091875",24,46,22
"CPNE7","s1650_F_VTA_03_ASEReadCounter.table","NW_015090842.1:10091983",29,43,14
"CPNE7","s1650_F_VTA_03_ASEReadCounter.table","NW_015090842.1:10091997",30,43,13
"CPNE7","s1650_F_VTA_03_ASEReadCounter.table","NW_015090842.1:10092038",18,28,10
"CPNE7","s1650_F_VTA_03_ASEReadCounter.table","NW_015090842.1:10092140",18,32,14
"CPNE7","s1650_F_VTA_03_ASEReadCounter.table","NW_015090842.1:10092183",16,24,8
"CPNE7","s1650_F_VTA_03_ASEReadCounter.table","NW_015090842.1:10092201",15,21,6
"CPNE7","s1650_F_VTA_03_ASEReadCounter.table","NW_015090842.1:10092230",14,19,5
"CPNE7","s1650_F_VTA_03_ASEReadCounter.table","NW_015090842.1:10092246",7,12,5
"LOC106888185","s1650_F_VTA_03_ASEReadCounter.table","NW_015090842.1:10094965",0,5,5
"LOC106888185","s1650_F_VTA_03_ASEReadCounter.table","NW_015090842.1:10094966",0,5,5
"LOC106888185","s1650_F_VTA_03_ASEReadCounter.table","NW_015090842.1:10094985",0,4,4
"LOC106888185","s1650_F_VTA_03_ASEReadCounter.table","NW_015090842.1:10095055",0,4,4
"LOC106888185","s1650_F_VTA_03_ASEReadCounter.table","NW_015090842.1:10095062",0,2,2
"LOC106888185","s1650_F_VTA_03_ASEReadCounter.table","NW_015090842.1:10095130",0,7,7
"LOC106888185","s1650_F_VTA_03_ASEReadCounter.table","NW_015090842.1:10095265",13,24,11
"LOC106888185","s1650_F_VTA_03_ASEReadCounter.table","NW_015090842.1:10095586",12,25,13
"LOC106888185","s1650_F_VTA_03_ASEReadCounter.table","NW_015090842.1:10095593",12,27,15
"LOC106888185","s1650_F_VTA_03_ASEReadCounter.table","NW_015090842.1:10095616",9,27,18
"LOC106888185","s1650_F_VTA_03_ASEReadCounter.table","NW_015090842.1:10095662",6,20,14
"LOC106888185","s1650_F_VTA_03_ASEReadCounter.table","NW_015090842.1:10095674",5,20,15
"LOC106888185","s1650_F_VTA_03_ASEReadCounter.table","NW_015090842.1:10095786",2,17,15
"LOC106888185","s1650_F_VTA_03_ASEReadCounter.table","NW_015090842.1:10095831",5,21,16
"LOC106888185","s1650_F_VTA_03_ASEReadCounter.table","NW_015090842.1:10096230",7,23,16
"LOC106888185","s1650_F_VTA_03_ASEReadCounter.table","NW_015090842.1:10096249",7,23,16
"LOC106888185","s1650_F_VTA_03_ASEReadCounter.table","NW_015090842.1:10096272",7,26,19
"LOC106888185","s1650_F_VTA_03_ASEReadCounter.table","NW_015090842.1:10096288",8,26,18
"LOC106888185","s1650_F_VTA_03_ASEReadCounter.table","NW_015090842.1:10097248",3,15,12
"LOC106888185","s1650_F_VTA_03_ASEReadCounter.table","NW_015090842.1:10097265",6,18,12
"LOC106888185","s1650_F_VTA_03_ASEReadCounter.table","NW_015090842.1:10097446",0,3,3
"DPEP1","s1650_F_VTA_03_ASEReadCounter.table","NW_015090842.1:10098518",0,2,2
"DPEP1","s1650_F_VTA_03_ASEReadCounter.table","NW_015090842.1:10098608",0,1,1
"DPEP1","s1650_F_VTA_03_ASEReadCounter.table","NW_015090842.1:10098630",0,1,1
"DPEP1","s1650_F_VTA_03_ASEReadCounter.table","NW_015090842.1:10098659",0,1,1
"DPEP1","s1650_F_VTA_03_ASEReadCounter.table","NW_015090842.1:10099765",0,1,1
"DPEP1","s1650_F_VTA_03_ASEReadCounter.table","NW_015090842.1:10099985",0,1,1
"DPEP1","s1650_F_VTA_03_ASEReadCounter.table","NW_015090842.1:10099986",0,1,1
"DPEP1","s1650_F_VTA_03_ASEReadCounter.table","NW_015090842.1:10099991",0,1,1
"DPEP1","s1650_F_VTA_03_ASEReadCounter.table","NW_015090842.1:10100044",0,1,1
"DPEP1","s1650_F_VTA_03_ASEReadCounter.table","NW_015090842.1:10100045",0,1,1
"DPEP1","s1650_F_VTA_03_ASEReadCounter.table","NW_015090842.1:10100084",0,2,2
"DPEP1","s1650_F_VTA_03_ASEReadCounter.table","NW_015090842.1:10100295",0,1,1
"DPEP1","s1650_F_VTA_03_ASEReadCounter.table","NW_015090842.1:10100893",0,2,2
"DPEP1","s1650_F_VTA_03_ASEReadCounter.table","NW_015090842.1:10100902",0,2,2
"DPEP1","s1650_F_VTA_03_ASEReadCounter.table","NW_015090842.1:10101072",0,1,1
"DPEP1","s1650_F_VTA_03_ASEReadCounter.table","NW_015090842.1:10101199",0,1,1
"DPEP1","s1650_F_VTA_03_ASEReadCounter.table","NW_015090842.1:10101483",0,1,1
"DPEP1","s1650_F_VTA_03_ASEReadCounter.table","NW_015090842.1:10101497",0,1,1
"DPEP1","s1650_F_VTA_03_ASEReadCounter.table","NW_015090842.1:10101525",0,1,1
"DPEP1","s1650_F_VTA_03_ASEReadCounter.table","NW_015090842.1:10101875",0,1,1
"CHMP1A","s1650_F_VTA_03_ASEReadCounter.table","NW_015090842.1:10102901",49,140,91
"CHMP1A","s1650_F_VTA_03_ASEReadCounter.table","NW_015090842.1:10102961",51,170,119
"CHMP1A","s1650_F_VTA_03_ASEReadCounter.table","NW_015090842.1:10102996",47,172,125
"CHMP1A","s1650_F_VTA_03_ASEReadCounter.table","NW_015090842.1:10103004",55,185,130
"CHMP1A","s1650_F_VTA_03_ASEReadCounter.table","NW_015090842.1:10103006",55,184,129
"CHMP1A","s1650_F_VTA_03_ASEReadCounter.table","NW_015090842.1:10103052",92,224,132
"CHMP1A","s1650_F_VTA_03_ASEReadCounter.table","NW_015090842.1:10103095",92,209,117
"CHMP1A","s1650_F_VTA_03_ASEReadCounter.table","NW_015090842.1:10103096",93,209,116
"CHMP1A","s1650_F_VTA_03_ASEReadCounter.table","NW_015090842.1:10103152",69,159,90
"CHMP1A","s1650_F_VTA_03_ASEReadCounter.table","NW_015090842.1:10103173",69,162,93
"CHMP1A","s1650_F_VTA_03_ASEReadCounter.table","NW_015090842.1:10103334",59,141,82
"CHMP1A","s1650_F_VTA_03_ASEReadCounter.table","NW_015090842.1:10103373",29,117,88
"CHMP1A","s1650_F_VTA_03_ASEReadCounter.table","NW_015090842.1:10103408",52,126,74
"CHMP1A","s1650_F_VTA_03_ASEReadCounter.table","NW_015090842.1:10103412",54,127,73
"CHMP1A","s1650_F_VTA_03_ASEReadCounter.table","NW_015090842.1:10103512",91,181,90
"CHMP1A","s1650_F_VTA_03_ASEReadCounter.table","NW_015090842.1:10103513",91,180,89
"CHMP1A","s1650_F_VTA_03_ASEReadCounter.table","NW_015090842.1:10103583",55,128,73
"CHMP1A","s1650_F_VTA_03_ASEReadCounter.table","NW_015090842.1:10103614",55,138,83
"CHMP1A","s1650_F_VTA_03_ASEReadCounter.table","NW_015090842.1:10103657",47,130,83
"CHMP1A","s1650_F_VTA_03_ASEReadCounter.table","NW_015090842.1:10103669",46,124,78
"CHMP1A","s1650_F_VTA_03_ASEReadCounter.table","NW_015090842.1:10103674",42,113,71
"CHMP1A","s1650_F_VTA_03_ASEReadCounter.table","NW_015090842.1:10103677",42,110,68
"CHMP1A","s1650_F_VTA_03_ASEReadCounter.table","NW_015090842.1:10103729",60,125,65
"CHMP1A","s1650_F_VTA_03_ASEReadCounter.table","NW_015090842.1:10103758",66,125,59
"CHMP1A","s1650_F_VTA_03_ASEReadCounter.table","NW_015090842.1:10103761",64,123,59
"CHMP1A","s1650_F_VTA_03_ASEReadCounter.table","NW_015090842.1:10103788",67,149,82
"CHMP1A","s1650_F_VTA_03_ASEReadCounter.table","NW_015090842.1:10103789",65,145,80
"CHMP1A","s1650_F_VTA_03_ASEReadCounter.table","NW_015090842.1:10103790",68,151,83
"CHMP1A","s1650_F_VTA_03_ASEReadCounter.table","NW_015090842.1:10103950",71,120,49
"CHMP1A","s1650_F_VTA_03_ASEReadCounter.table","NW_015090842.1:10104335",34,79,45
"CHMP1A","s1650_F_VTA_03_ASEReadCounter.table","NW_015090842.1:10104429",59,115,56
"CHMP1A","s1650_F_VTA_03_ASEReadCounter.table","NW_015090842.1:10104532",55,113,58
"CHMP1A","s1650_F_VTA_03_ASEReadCounter.table","NW_015090842.1:10104633",33,75,42
"CHMP1A","s1650_F_VTA_03_ASEReadCounter.table","NW_015090842.1:10104759",23,72,49
"CHMP1A","s1650_F_VTA_03_ASEReadCounter.table","NW_015090842.1:10104794",38,90,52
"CHMP1A","s1650_F_VTA_03_ASEReadCounter.table","NW_015090842.1:10104841",62,62,0
"CHMP1A","s1650_F_VTA_03_ASEReadCounter.table","NW_015090842.1:10104844",23,61,38
"CHMP1A","s1650_F_VTA_03_ASEReadCounter.table","NW_015090842.1:10106242",26,73,47
"CHMP1A","s1650_F_VTA_03_ASEReadCounter.table","NW_015090842.1:10106290",30,72,42
"CHMP1A","s1650_F_VTA_03_ASEReadCounter.table","NW_015090842.1:10106335",41,81,40
"CHMP1A","s1650_F_VTA_03_ASEReadCounter.table","NW_015090842.1:10106383",46,99,53
"CHMP1A","s1650_F_VTA_03_ASEReadCounter.table","NW_015090842.1:10106747",53,100,47
"CHMP1A","s1650_F_VTA_03_ASEReadCounter.table","NW_015090842.1:10107404",43,97,54
"CHMP1A","s1650_F_VTA_03_ASEReadCounter.table","NW_015090842.1:10107876",47,86,39
"CDK10","s1650_F_VTA_03_ASEReadCounter.table","NW_015090842.1:10109030",5,6,1
"CDK10","s1650_F_VTA_03_ASEReadCounter.table","NW_015090842.1:10109963",24,66,42
"CDK10","s1650_F_VTA_03_ASEReadCounter.table","NW_015090842.1:10110887",18,58,40
"CDK10","s1650_F_VTA_03_ASEReadCounter.table","NW_015090842.1:10111254",17,66,49
"CDK10","s1650_F_VTA_03_ASEReadCounter.table","NW_015090842.1:10111380",19,79,60
"CDK10","s1650_F_VTA_03_ASEReadCounter.table","NW_015090842.1:10111395",21,81,60
"CDK10","s1650_F_VTA_03_ASEReadCounter.table","NW_015090842.1:10111437",12,73,61
"CDK10","s1650_F_VTA_03_ASEReadCounter.table","NW_015090842.1:10111798",30,88,58
"CDK10","s1650_F_VTA_03_ASEReadCounter.table","NW_015090842.1:10111840",26,107,81
"CDK10","s1650_F_VTA_03_ASEReadCounter.table","NW_015090842.1:10112031",34,122,88
"CDK10","s1650_F_VTA_03_ASEReadCounter.table","NW_015090842.1:10112285",24,125,101
"CDK10","s1650_F_VTA_03_ASEReadCounter.table","NW_015090842.1:10112398",30,141,111
"CDK10","s1650_F_VTA_03_ASEReadCounter.table","NW_015090842.1:10112455",30,133,103
"CDK10","s1650_F_VTA_03_ASEReadCounter.table","NW_015090842.1:10112461",29,126,97
"CDK10","s1650_F_VTA_03_ASEReadCounter.table","NW_015090842.1:10112497",25,111,86
"CDK10","s1650_F_VTA_03_ASEReadCounter.table","NW_015090842.1:10112508",23,117,94
"CDK10","s1650_F_VTA_03_ASEReadCounter.table","NW_015090842.1:10112518",16,103,87
"CDK10","s1650_F_VTA_03_ASEReadCounter.table","NW_015090842.1:10112540",8,90,82
"CDK10","s1650_F_VTA_03_ASEReadCounter.table","NW_015090842.1:10112556",18,89,71
"CDK10","s1650_F_VTA_03_ASEReadCounter.table","NW_015090842.1:10112561",23,99,76
"CDK10","s1650_F_VTA_03_ASEReadCounter.table","NW_015090842.1:10112596",31,113,82
"CDK10","s1650_F_VTA_03_ASEReadCounter.table","NW_015090842.1:10112630",33,111,78
"CDK10","s1650_F_VTA_03_ASEReadCounter.table","NW_015090842.1:10112656",35,104,69
"CDK10","s1650_F_VTA_03_ASEReadCounter.table","NW_015090842.1:10112665",28,86,58
"CDK10","s1650_F_VTA_03_ASEReadCounter.table","NW_015090842.1:10112668",25,85,60
"CDK10","s1650_F_VTA_03_ASEReadCounter.table","NW_015090842.1:10112781",24,53,29
"CDK10","s1650_F_VTA_03_ASEReadCounter.table","NW_015090842.1:10112782",23,54,31
"CDK10","s1650_F_VTA_03_ASEReadCounter.table","NW_015090842.1:10112795",22,49,27
"CDK10","s1650_F_VTA_03_ASEReadCounter.table","NW_015090842.1:10112841",5,9,4
"CDK10","s1650_F_VTA_03_ASEReadCounter.table","NW_015090842.1:10112861",4,7,3
"SPATA2L","s1650_F_VTA_03_ASEReadCounter.table","NW_015090842.1:10113212",16,63,47
"SPATA2L","s1650_F_VTA_03_ASEReadCounter.table","NW_015090842.1:10113280",32,104,72
"SPATA2L","s1650_F_VTA_03_ASEReadCounter.table","NW_015090842.1:10113296",35,113,78
"SPATA2L","s1650_F_VTA_03_ASEReadCounter.table","NW_015090842.1:10113321",48,133,85
"SPATA2L","s1650_F_VTA_03_ASEReadCounter.table","NW_015090842.1:10113332",50,141,91
"SPATA2L","s1650_F_VTA_03_ASEReadCounter.table","NW_015090842.1:10113380",50,130,80
"SPATA2L","s1650_F_VTA_03_ASEReadCounter.table","NW_015090842.1:10113381",50,134,84
"SPATA2L","s1650_F_VTA_03_ASEReadCounter.table","NW_015090842.1:10113412",41,125,84
"SPATA2L","s1650_F_VTA_03_ASEReadCounter.table","NW_015090842.1:10113421",45,128,83
"SPATA2L","s1650_F_VTA_03_ASEReadCounter.table","NW_015090842.1:10113465",42,120,78
"SPATA2L","s1650_F_VTA_03_ASEReadCounter.table","NW_015090842.1:10113535",53,119,66
"SPATA2L","s1650_F_VTA_03_ASEReadCounter.table","NW_015090842.1:10113645",52,139,87
"SPATA2L","s1650_F_VTA_03_ASEReadCounter.table","NW_015090842.1:10113682",61,179,118
"SPATA2L","s1650_F_VTA_03_ASEReadCounter.table","NW_015090842.1:10113696",54,156,102
"SPATA2L","s1650_F_VTA_03_ASEReadCounter.table","NW_015090842.1:10113727",59,172,113
"SPATA2L","s1650_F_VTA_03_ASEReadCounter.table","NW_015090842.1:10113799",59,156,97
"SPATA2L","s1650_F_VTA_03_ASEReadCounter.table","NW_015090842.1:10113809",59,156,97
"SPATA2L","s1650_F_VTA_03_ASEReadCounter.table","NW_015090842.1:10113827",60,153,93
"SPATA2L","s1650_F_VTA_03_ASEReadCounter.table","NW_015090842.1:10113831",58,155,97
"SPATA2L","s1650_F_VTA_03_ASEReadCounter.table","NW_015090842.1:10113894",51,131,80
"SPATA2L","s1650_F_VTA_03_ASEReadCounter.table","NW_015090842.1:10113905",45,119,74
"SPATA2L","s1650_F_VTA_03_ASEReadCounter.table","NW_015090842.1:10113914",47,125,78
"SPATA2L","s1650_F_VTA_03_ASEReadCounter.table","NW_015090842.1:10113920",52,125,73
"SPATA2L","s1650_F_VTA_03_ASEReadCounter.table","NW_015090842.1:10113937",59,141,82
"SPATA2L","s1650_F_VTA_03_ASEReadCounter.table","NW_015090842.1:10113971",38,114,76
"SPATA2L","s1650_F_VTA_03_ASEReadCounter.table","NW_015090842.1:10113976",29,112,83
"SPATA2L","s1650_F_VTA_03_ASEReadCounter.table","NW_015090842.1:10113985",32,103,71
"SPATA2L","s1650_F_VTA_03_ASEReadCounter.table","NW_015090842.1:10113994",44,118,74
"SPATA2L","s1650_F_VTA_03_ASEReadCounter.table","NW_015090842.1:10114063",49,121,72
"SPATA2L","s1650_F_VTA_03_ASEReadCounter.table","NW_015090842.1:10114066",45,115,70
"SPATA2L","s1650_F_VTA_03_ASEReadCounter.table","NW_015090842.1:10114069",45,116,71
"SPATA2L","s1650_F_VTA_03_ASEReadCounter.table","NW_015090842.1:10114121",27,80,53
"SPATA2L","s1650_F_VTA_03_ASEReadCounter.table","NW_015090842.1:10114159",25,78,53
"SPATA2L","s1650_F_VTA_03_ASEReadCounter.table","NW_015090842.1:10114282",30,80,50
"SPATA2L","s1650_F_VTA_03_ASEReadCounter.table","NW_015090842.1:10114470",20,66,46
"SPATA2L","s1650_F_VTA_03_ASEReadCounter.table","NW_015090842.1:10114524",13,50,37
"VPS9D1","s1650_F_VTA_03_ASEReadCounter.table","NW_015090842.1:10116377",31,77,46
"VPS9D1","s1650_F_VTA_03_ASEReadCounter.table","NW_015090842.1:10116415",35,90,55
"VPS9D1","s1650_F_VTA_03_ASEReadCounter.table","NW_015090842.1:10116607",31,77,46
"VPS9D1","s1650_F_VTA_03_ASEReadCounter.table","NW_015090842.1:10116816",57,57,0
"VPS9D1","s1650_F_VTA_03_ASEReadCounter.table","NW_015090842.1:10116821",19,61,42
"VPS9D1","s1650_F_VTA_03_ASEReadCounter.table","NW_015090842.1:10116825",16,60,44
"VPS9D1","s1650_F_VTA_03_ASEReadCounter.table","NW_015090842.1:10116882",19,59,40
"VPS9D1","s1650_F_VTA_03_ASEReadCounter.table","NW_015090842.1:10116885",18,57,39
"VPS9D1","s1650_F_VTA_03_ASEReadCounter.table","NW_015090842.1:10116933",13,47,34
"VPS9D1","s1650_F_VTA_03_ASEReadCounter.table","NW_015090842.1:10116942",12,48,36
"VPS9D1","s1650_F_VTA_03_ASEReadCounter.table","NW_015090842.1:10117152",22,52,30
"VPS9D1","s1650_F_VTA_03_ASEReadCounter.table","NW_015090842.1:10117396",33,33,0
"VPS9D1","s1650_F_VTA_03_ASEReadCounter.table","NW_015090842.1:10117405",21,21,0
"VPS9D1","s1650_F_VTA_03_ASEReadCounter.table","NW_015090842.1:10117480",19,41,22
"VPS9D1","s1650_F_VTA_03_ASEReadCounter.table","NW_015090842.1:10117497",19,43,24
"VPS9D1","s1650_F_VTA_03_ASEReadCounter.table","NW_015090842.1:10117499",18,42,24
"VPS9D1","s1650_F_VTA_03_ASEReadCounter.table","NW_015090842.1:10117516",24,55,31
"VPS9D1","s1650_F_VTA_03_ASEReadCounter.table","NW_015090842.1:10117525",24,53,29
"VPS9D1","s1650_F_VTA_03_ASEReadCounter.table","NW_015090842.1:10117579",22,52,30
"VPS9D1","s1650_F_VTA_03_ASEReadCounter.table","NW_015090842.1:10117627",23,50,27
"VPS9D1","s1650_F_VTA_03_ASEReadCounter.table","NW_015090842.1:10117678",12,43,31
"VPS9D1","s1650_F_VTA_03_ASEReadCounter.table","NW_015090842.1:10117773",22,49,27
"VPS9D1","s1650_F_VTA_03_ASEReadCounter.table","NW_015090842.1:10117937",18,50,32
"VPS9D1","s1650_F_VTA_03_ASEReadCounter.table","NW_015090842.1:10117961",21,55,34
"VPS9D1","s1650_F_VTA_03_ASEReadCounter.table","NW_015090842.1:10118236",19,60,41
"VPS9D1","s1650_F_VTA_03_ASEReadCounter.table","NW_015090842.1:10118414",16,56,40
"VPS9D1","s1650_F_VTA_03_ASEReadCounter.table","NW_015090842.1:10118973",21,49,28
"VPS9D1","s1650_F_VTA_03_ASEReadCounter.table","NW_015090842.1:10119500",12,41,29
"ZNF276","s1650_F_VTA_03_ASEReadCounter.table","NW_015090842.1:10121760",3,7,4
"ZNF276","s1650_F_VTA_03_ASEReadCounter.table","NW_015090842.1:10121769",3,8,5
"ZNF276","s1650_F_VTA_03_ASEReadCounter.table","NW_015090842.1:10121802",6,13,7
"ZNF276","s1650_F_VTA_03_ASEReadCounter.table","NW_015090842.1:10121971",7,10,3
"ZNF276","s1650_F_VTA_03_ASEReadCounter.table","NW_015090842.1:10122883",11,17,6
"ZNF276","s1650_F_VTA_03_ASEReadCounter.table","NW_015090842.1:10123069",13,25,12
"ZNF276","s1650_F_VTA_03_ASEReadCounter.table","NW_015090842.1:10123207",12,35,23
"ZNF276","s1650_F_VTA_03_ASEReadCounter.table","NW_015090842.1:10125787",22,40,18
"ZNF276","s1650_F_VTA_03_ASEReadCounter.table","NW_015090842.1:10126309",28,43,15
"ZNF276","s1650_F_VTA_03_ASEReadCounter.table","NW_015090842.1:10126348",27,50,23
"ZNF276","s1650_F_VTA_03_ASEReadCounter.table","NW_015090842.1:10126978",31,52,21
"ZNF276","s1650_F_VTA_03_ASEReadCounter.table","NW_015090842.1:10126991",30,50,20
"ZNF276","s1650_F_VTA_03_ASEReadCounter.table","NW_015090842.1:10127023",30,47,17
"ZNF276","s1650_F_VTA_03_ASEReadCounter.table","NW_015090842.1:10127063",20,39,19
"ZNF276","s1650_F_VTA_03_ASEReadCounter.table","NW_015090842.1:10127373",27,53,26
"ZNF276","s1650_F_VTA_03_ASEReadCounter.table","NW_015090842.1:10127931",23,63,40
"ZNF276","s1650_F_VTA_03_ASEReadCounter.table","NW_015090842.1:10128070",37,80,43
"ZNF276","s1650_F_VTA_03_ASEReadCounter.table","NW_015090842.1:10128102",29,74,45
"ZNF276","s1650_F_VTA_03_ASEReadCounter.table","NW_015090842.1:10128356",30,67,37
"ZNF276","s1650_F_VTA_03_ASEReadCounter.table","NW_015090842.1:10128497",18,32,14
"FANCA","s1650_F_VTA_03_ASEReadCounter.table","NW_015090842.1:10128743",2,6,4
"FANCA","s1650_F_VTA_03_ASEReadCounter.table","NW_015090842.1:10128822",1,8,7
"FANCA","s1650_F_VTA_03_ASEReadCounter.table","NW_015090842.1:10129383",1,4,3
"FANCA","s1650_F_VTA_03_ASEReadCounter.table","NW_015090842.1:10129390",0,2,2
"FANCA","s1650_F_VTA_03_ASEReadCounter.table","NW_015090842.1:10129422",0,3,3
"FANCA","s1650_F_VTA_03_ASEReadCounter.table","NW_015090842.1:10129969",1,3,2
"FANCA","s1650_F_VTA_03_ASEReadCounter.table","NW_015090842.1:10130399",2,2,0
"FANCA","s1650_F_VTA_03_ASEReadCounter.table","NW_015090842.1:10130857",0,1,1
"FANCA","s1650_F_VTA_03_ASEReadCounter.table","NW_015090842.1:10130878",0,1,1
"FANCA","s1650_F_VTA_03_ASEReadCounter.table","NW_015090842.1:10133530",0,1,1
"FANCA","s1650_F_VTA_03_ASEReadCounter.table","NW_015090842.1:10133533",0,1,1
"FANCA","s1650_F_VTA_03_ASEReadCounter.table","NW_015090842.1:10133601",1,1,0
"FANCA","s1650_F_VTA_03_ASEReadCounter.table","NW_015090842.1:10134492",1,2,1
"FANCA","s1650_F_VTA_03_ASEReadCounter.table","NW_015090842.1:10134531",2,3,1
"FANCA","s1650_F_VTA_03_ASEReadCounter.table","NW_015090842.1:10136957",1,2,1
"FANCA","s1650_F_VTA_03_ASEReadCounter.table","NW_015090842.1:10136982",1,2,1
"FANCA","s1650_F_VTA_03_ASEReadCounter.table","NW_015090842.1:10136999",1,2,1
"FANCA","s1650_F_VTA_03_ASEReadCounter.table","NW_015090842.1:10137019",1,2,1
"FANCA","s1650_F_VTA_03_ASEReadCounter.table","NW_015090842.1:10137673",1,1,0
"FANCA","s1650_F_VTA_03_ASEReadCounter.table","NW_015090842.1:10139140",0,1,1
"FANCA","s1650_F_VTA_03_ASEReadCounter.table","NW_015090842.1:10141234",0,1,1
"FANCA","s1650_F_VTA_03_ASEReadCounter.table","NW_015090842.1:10152863",0,3,3
"FANCA","s1650_F_VTA_03_ASEReadCounter.table","NW_015090842.1:10154490",0,1,1
"FANCA","s1650_F_VTA_03_ASEReadCounter.table","NW_015090842.1:10162980",0,1,1
"FANCA","s1650_F_VTA_03_ASEReadCounter.table","NW_015090842.1:10164257",0,1,1
"FANCA","s1650_F_VTA_03_ASEReadCounter.table","NW_015090842.1:10165331",0,1,1
"SPIRE2","s1650_F_VTA_03_ASEReadCounter.table","NW_015090842.1:10172284",15,18,3
"SPIRE2","s1650_F_VTA_03_ASEReadCounter.table","NW_015090842.1:10175262",21,36,15
"SPIRE2","s1650_F_VTA_03_ASEReadCounter.table","NW_015090842.1:10175352",10,15,5
"SPIRE2","s1650_F_VTA_03_ASEReadCounter.table","NW_015090842.1:10175400",39,71,32
"SPIRE2","s1650_F_VTA_03_ASEReadCounter.table","NW_015090842.1:10175418",43,78,35
"SPIRE2","s1650_F_VTA_03_ASEReadCounter.table","NW_015090842.1:10175704",47,80,33
"SPIRE2","s1650_F_VTA_03_ASEReadCounter.table","NW_015090842.1:10176115",64,135,71
"SPIRE2","s1650_F_VTA_03_ASEReadCounter.table","NW_015090842.1:10176561",76,151,75
"SPIRE2","s1650_F_VTA_03_ASEReadCounter.table","NW_015090842.1:10176817",88,162,74
"SPIRE2","s1650_F_VTA_03_ASEReadCounter.table","NW_015090842.1:10177084",46,97,51
"SPIRE2","s1650_F_VTA_03_ASEReadCounter.table","NW_015090842.1:10177110",49,107,58
"SPIRE2","s1650_F_VTA_03_ASEReadCounter.table","NW_015090842.1:10177838",75,150,75
"SPIRE2","s1650_F_VTA_03_ASEReadCounter.table","NW_015090842.1:10178000",82,158,76
"SPIRE2","s1650_F_VTA_03_ASEReadCounter.table","NW_015090842.1:10178164",95,197,102
"SPIRE2","s1650_F_VTA_03_ASEReadCounter.table","NW_015090842.1:10178216",116,238,122
"SPIRE2","s1650_F_VTA_03_ASEReadCounter.table","NW_015090842.1:10178403",116,215,99
"SPIRE2","s1650_F_VTA_03_ASEReadCounter.table","NW_015090842.1:10178409",117,217,100
"SPIRE2","s1650_F_VTA_03_ASEReadCounter.table","NW_015090842.1:10178524",132,244,112
"SPIRE2","s1650_F_VTA_03_ASEReadCounter.table","NW_015090842.1:10178526",134,248,114
"SPIRE2","s1650_F_VTA_03_ASEReadCounter.table","NW_015090842.1:10178531",136,248,112
"SPIRE2","s1650_F_VTA_03_ASEReadCounter.table","NW_015090842.1:10178565",109,226,117
"SPIRE2","s1650_F_VTA_03_ASEReadCounter.table","NW_015090842.1:10178587",96,195,99
"SPIRE2","s1650_F_VTA_03_ASEReadCounter.table","NW_015090842.1:10178640",85,153,68
"SPIRE2","s1650_F_VTA_03_ASEReadCounter.table","NW_015090842.1:10178651",100,173,73
"SPIRE2","s1650_F_VTA_03_ASEReadCounter.table","NW_015090842.1:10178682",93,152,59
"TCF25","s1650_F_VTA_03_ASEReadCounter.table","NW_015090842.1:10180912",44,72,28
"TCF25","s1650_F_VTA_03_ASEReadCounter.table","NW_015090842.1:10180924",47,76,29
"TCF25","s1650_F_VTA_03_ASEReadCounter.table","NW_015090842.1:10180931",48,81,33
"TCF25","s1650_F_VTA_03_ASEReadCounter.table","NW_015090842.1:10185332",113,206,93
"TCF25","s1650_F_VTA_03_ASEReadCounter.table","NW_015090842.1:10188816",81,132,51
"MC1R","s1650_F_VTA_03_ASEReadCounter.table","NW_015090842.1:10202160",1,1,0
"MC1R","s1650_F_VTA_03_ASEReadCounter.table","NW_015090842.1:10202460",1,2,1
"MC1R","s1650_F_VTA_03_ASEReadCounter.table","NW_015090842.1:10202465",1,2,1
"DBNDD1","s1650_F_VTA_03_ASEReadCounter.table","NW_015090842.1:10223105",67,169,102
"GAS8","s1650_F_VTA_03_ASEReadCounter.table","NW_015090842.1:10228982",18,29,11
"GAS8","s1650_F_VTA_03_ASEReadCounter.table","NW_015090842.1:10229832",14,25,11
"GAS8","s1650_F_VTA_03_ASEReadCounter.table","NW_015090842.1:10232375",31,67,36
"GAS8","s1650_F_VTA_03_ASEReadCounter.table","NW_015090842.1:10232901",39,75,36
"GAS8","s1650_F_VTA_03_ASEReadCounter.table","NW_015090842.1:10232928",39,72,33
"GAS8","s1650_F_VTA_03_ASEReadCounter.table","NW_015090842.1:10232967",36,72,36
"GAS8","s1650_F_VTA_03_ASEReadCounter.table","NW_015090842.1:10233032",26,53,27
"GAS8","s1650_F_VTA_03_ASEReadCounter.table","NW_015090842.1:10233057",21,42,21
"GAS8","s1650_F_VTA_03_ASEReadCounter.table","NW_015090842.1:10233058",21,44,23
"GAS8","s1650_F_VTA_03_ASEReadCounter.table","NW_015090842.1:10233176",16,30,14
"GAS8","s1650_F_VTA_03_ASEReadCounter.table","NW_015090842.1:10233196",16,33,17
"GAS8","s1650_F_VTA_03_ASEReadCounter.table","NW_015090842.1:10233252",11,27,16
"GAS8","s1650_F_VTA_03_ASEReadCounter.table","NW_015090842.1:10233303",5,12,7
"LOC106888094","s1650_F_VTA_03_ASEReadCounter.table","NW_015090842.1:10233334",2,10,8
"LOC106888094","s1650_F_VTA_03_ASEReadCounter.table","NW_015090842.1:10233362",7,24,17
"LOC106888094","s1650_F_VTA_03_ASEReadCounter.table","NW_015090842.1:10233373",7,26,19
"LOC106888094","s1650_F_VTA_03_ASEReadCounter.table","NW_015090842.1:10233388",8,33,25
"LOC106888094","s1650_F_VTA_03_ASEReadCounter.table","NW_015090842.1:10233402",10,36,26
"LOC106888094","s1650_F_VTA_03_ASEReadCounter.table","NW_015090842.1:10233465",14,44,30
"LOC106888094","s1650_F_VTA_03_ASEReadCounter.table","NW_015090842.1:10233803",14,53,39
"LOC106888094","s1650_F_VTA_03_ASEReadCounter.table","NW_015090842.1:10233815",17,54,37
"LOC106888094","s1650_F_VTA_03_ASEReadCounter.table","NW_015090842.1:10235484",2,7,5
"LOC106888094","s1650_F_VTA_03_ASEReadCounter.table","NW_015090842.1:10235611",0,3,3
"LOC106888094","s1650_F_VTA_03_ASEReadCounter.table","NW_015090842.1:10236098",1,3,2
"LOC106888094","s1650_F_VTA_03_ASEReadCounter.table","NW_015090842.1:10236161",0,2,2
"LOC106888094","s1650_F_VTA_03_ASEReadCounter.table","NW_015090842.1:10236380",0,1,1
"LOC106888094","s1650_F_VTA_03_ASEReadCounter.table","NW_015090842.1:10236388",0,1,1
"LOC106888094","s1650_F_VTA_03_ASEReadCounter.table","NW_015090842.1:10236425",0,1,1
"LOC106888094","s1650_F_VTA_03_ASEReadCounter.table","NW_015090842.1:10236426",0,1,1
"LOC106888094","s1650_F_VTA_03_ASEReadCounter.table","NW_015090842.1:10236603",1,1,0
"LOC106888173","s1650_F_VTA_03_ASEReadCounter.table","NW_015090842.1:10239596",0,14,14
"LOC106888173","s1650_F_VTA_03_ASEReadCounter.table","NW_015090842.1:10240036",3,52,49
"LOC106888173","s1650_F_VTA_03_ASEReadCounter.table","NW_015090842.1:10240095",9,57,48
"LOC106888173","s1650_F_VTA_03_ASEReadCounter.table","NW_015090842.1:10240280",5,63,58
"LOC106888173","s1650_F_VTA_03_ASEReadCounter.table","NW_015090842.1:10240557",9,68,59
"LOC106888173","s1650_F_VTA_03_ASEReadCounter.table","NW_015090842.1:10240603",9,74,65
"LOC106888173","s1650_F_VTA_03_ASEReadCounter.table","NW_015090842.1:10240609",9,73,64
"LOC106888173","s1650_F_VTA_03_ASEReadCounter.table","NW_015090842.1:10240690",6,68,62
"LOC106888173","s1650_F_VTA_03_ASEReadCounter.table","NW_015090842.1:10240924",7,61,54
"LOC106888173","s1650_F_VTA_03_ASEReadCounter.table","NW_015090842.1:10241037",2,61,59
"LOC106888173","s1650_F_VTA_03_ASEReadCounter.table","NW_015090842.1:10241046",3,59,56
"LOC106888173","s1650_F_VTA_03_ASEReadCounter.table","NW_015090842.1:10241058",3,62,59
"LOC106888173","s1650_F_VTA_03_ASEReadCounter.table","NW_015090842.1:10241064",3,67,64
"LOC106888173","s1650_F_VTA_03_ASEReadCounter.table","NW_015090842.1:10241103",80,80,0
"LOC106888173","s1650_F_VTA_03_ASEReadCounter.table","NW_015090842.1:10241163",8,68,60
"LOC106888173","s1650_F_VTA_03_ASEReadCounter.table","NW_015090842.1:10241803",10,74,64
"LOC106888173","s1650_F_VTA_03_ASEReadCounter.table","NW_015090842.1:10241827",10,72,62
"LOC106888173","s1650_F_VTA_03_ASEReadCounter.table","NW_015090842.1:10241869",10,67,57
"LOC106888173","s1650_F_VTA_03_ASEReadCounter.table","NW_015090842.1:10242079",7,70,63
"LOC106888173","s1650_F_VTA_03_ASEReadCounter.table","NW_015090842.1:10242103",4,80,76
"LOC106888173","s1650_F_VTA_03_ASEReadCounter.table","NW_015090842.1:10242157",12,94,82
"LOC106888173","s1650_F_VTA_03_ASEReadCounter.table","NW_015090842.1:10242455",14,92,78
"LOC106888173","s1650_F_VTA_03_ASEReadCounter.table","NW_015090842.1:10242481",16,92,76
"LOC106888173","s1650_F_VTA_03_ASEReadCounter.table","NW_015090842.1:10242590",14,93,79
"LOC106888173","s1650_F_VTA_03_ASEReadCounter.table","NW_015090842.1:10242794",15,94,79
"LOC106888173","s1650_F_VTA_03_ASEReadCounter.table","NW_015090842.1:10242909",14,89,75
"LOC106888173","s1650_F_VTA_03_ASEReadCounter.table","NW_015090842.1:10243094",24,124,100
"LOC106888173","s1650_F_VTA_03_ASEReadCounter.table","NW_015090842.1:10243133",13,103,90
"LOC106888173","s1650_F_VTA_03_ASEReadCounter.table","NW_015090842.1:10243273",23,145,122
"LOC106888173","s1650_F_VTA_03_ASEReadCounter.table","NW_015090842.1:10243278",22,138,116
"LOC106888173","s1650_F_VTA_03_ASEReadCounter.table","NW_015090842.1:10243281",23,142,119
"LOC106888173","s1650_F_VTA_03_ASEReadCounter.table","NW_015090842.1:10243347",78,78,0
"LOC106888173","s1650_F_VTA_03_ASEReadCounter.table","NW_015090842.1:10243353",16,70,54
"LOC106888173","s1650_F_VTA_03_ASEReadCounter.table","NW_015090842.1:10243363",12,51,39
"LOC106888173","s1650_F_VTA_03_ASEReadCounter.table","NW_015090842.1:10243365",11,52,41
"LOC106888173","s1650_F_VTA_03_ASEReadCounter.table","NW_015090842.1:10243566",29,149,120
"LOC106888173","s1650_F_VTA_03_ASEReadCounter.table","NW_015090842.1:10243605",24,145,121
"LOC106888173","s1650_F_VTA_03_ASEReadCounter.table","NW_015090842.1:10243614",23,144,121
"LOC106888173","s1650_F_VTA_03_ASEReadCounter.table","NW_015090842.1:10243615",23,143,120
"LOC106888173","s1650_F_VTA_03_ASEReadCounter.table","NW_015090842.1:10243640",14,121,107
"LOC106888173","s1650_F_VTA_03_ASEReadCounter.table","NW_015090842.1:10243680",18,116,98
"LOC106888173","s1650_F_VTA_03_ASEReadCounter.table","NW_015090842.1:10243742",33,139,106
"LOC106888173","s1650_F_VTA_03_ASEReadCounter.table","NW_015090842.1:10243804",27,104,77
"LOC106888173","s1650_F_VTA_03_ASEReadCounter.table","NW_015090842.1:10243913",11,53,42
"LOC106888173","s1650_F_VTA_03_ASEReadCounter.table","NW_015090842.1:10243921",11,47,36
"LOC106888384","s1650_F_VTA_03_ASEReadCounter.table","NW_015090842.1:10244942",1,1,0
"LOC106888384","s1650_F_VTA_03_ASEReadCounter.table","NW_015090842.1:10251354",0,7,7
"LOC106888384","s1650_F_VTA_03_ASEReadCounter.table","NW_015090842.1:10251358",0,6,6
"LOC106888384","s1650_F_VTA_03_ASEReadCounter.table","NW_015090842.1:10251369",0,6,6
"LOC106888384","s1650_F_VTA_03_ASEReadCounter.table","NW_015090842.1:10251370",0,6,6
"LOC106888384","s1650_F_VTA_03_ASEReadCounter.table","NW_015090842.1:10251375",0,6,6
"LOC106888384","s1650_F_VTA_03_ASEReadCounter.table","NW_015090842.1:10251388",0,5,5
"LOC106888384","s1650_F_VTA_03_ASEReadCounter.table","NW_015090842.1:10251390",0,4,4
"LOC106888384","s1650_F_VTA_03_ASEReadCounter.table","NW_015090842.1:10251393",0,5,5
"LOC106888384","s1650_F_VTA_03_ASEReadCounter.table","NW_015090842.1:10251399",0,5,5
"LOC106888384","s1650_F_VTA_03_ASEReadCounter.table","NW_015090842.1:10251492",1,1,0
"LOC106888384","s1650_F_VTA_03_ASEReadCounter.table","NW_015090842.1:10253165",1,2,1
"LOC106888384","s1650_F_VTA_03_ASEReadCounter.table","NW_015090842.1:10254028",5,5,0
"LOC106888384","s1650_F_VTA_03_ASEReadCounter.table","NW_015090842.1:10254227",3,3,0
"LOC106888384","s1650_F_VTA_03_ASEReadCounter.table","NW_015090842.1:10254233",3,3,0
"LOC106888384","s1650_F_VTA_03_ASEReadCounter.table","NW_015090842.1:10254263",3,3,0
"LOC106888384","s1650_F_VTA_03_ASEReadCounter.table","NW_015090842.1:10254293",2,2,0
"LOC106888384","s1650_F_VTA_03_ASEReadCounter.table","NW_015090842.1:10254570",1,2,1
"LOC106888384","s1650_F_VTA_03_ASEReadCounter.table","NW_015090842.1:10254605",1,2,1
"LOC106888384","s1650_F_VTA_03_ASEReadCounter.table","NW_015090842.1:10254608",1,3,2
"LOC106888384","s1650_F_VTA_03_ASEReadCounter.table","NW_015090842.1:10254618",1,3,2
"LOC106888384","s1650_F_VTA_03_ASEReadCounter.table","NW_015090842.1:10254620",1,3,2
"LOC106888384","s1650_F_VTA_03_ASEReadCounter.table","NW_015090842.1:10254623",1,3,2
"LOC106888384","s1650_F_VTA_03_ASEReadCounter.table","NW_015090842.1:10254624",1,3,2
"LOC106888384","s1650_F_VTA_03_ASEReadCounter.table","NW_015090842.1:10254627",1,3,2
"LOC106888384","s1650_F_VTA_03_ASEReadCounter.table","NW_015090842.1:10254629",1,2,1
"LOC106888384","s1650_F_VTA_03_ASEReadCounter.table","NW_015090842.1:10254647",2,3,1
"LOC106888384","s1650_F_VTA_03_ASEReadCounter.table","NW_015090842.1:10254663",0,1,1
"LOC106888384","s1650_F_VTA_03_ASEReadCounter.table","NW_015090842.1:10254840",1,1,0
"LOC106888384","s1650_F_VTA_03_ASEReadCounter.table","NW_015090842.1:10254891",1,1,0
"LOC106888384","s1650_F_VTA_03_ASEReadCounter.table","NW_015090842.1:10254900",1,1,0
"LOC106888384","s1650_F_VTA_03_ASEReadCounter.table","NW_015090842.1:10254915",1,1,0
"LOC106888384","s1650_F_VTA_03_ASEReadCounter.table","NW_015090842.1:10254965",1,2,1
"LOC106888384","s1650_F_VTA_03_ASEReadCounter.table","NW_015090842.1:10254975",1,2,1
"LOC106888384","s1650_F_VTA_03_ASEReadCounter.table","NW_015090842.1:10255077",3,3,0
"LOC106888384","s1650_F_VTA_03_ASEReadCounter.table","NW_015090842.1:10255117",3,3,0
"LOC106888384","s1650_F_VTA_03_ASEReadCounter.table","NW_015090842.1:10255138",4,4,0
"LOC106888384","s1650_F_VTA_03_ASEReadCounter.table","NW_015090842.1:10255139",4,4,0
"LOC106888384","s1650_F_VTA_03_ASEReadCounter.table","NW_015090842.1:10255209",2,2,0
"LOC106888384","s1650_F_VTA_03_ASEReadCounter.table","NW_015090842.1:10255211",2,2,0
"LOC106888384","s1650_F_VTA_03_ASEReadCounter.table","NW_015090842.1:10255236",1,1,0
"LOC106888384","s1650_F_VTA_03_ASEReadCounter.table","NW_015090842.1:10255262",1,1,0
"LOC106888384","s1650_F_VTA_03_ASEReadCounter.table","NW_015090842.1:10255264",1,1,0
"LOC106888384","s1650_F_VTA_03_ASEReadCounter.table","NW_015090842.1:10255306",1,1,0
"LOC106888384","s1650_F_VTA_03_ASEReadCounter.table","NW_015090842.1:10255340",3,3,0
"LOC106888384","s1650_F_VTA_03_ASEReadCounter.table","NW_015090842.1:10255410",4,4,0
"LOC106888384","s1650_F_VTA_03_ASEReadCounter.table","NW_015090842.1:10255449",2,2,0
"LOC106888384","s1650_F_VTA_03_ASEReadCounter.table","NW_015090842.1:10255496",2,2,0
"LOC106888384","s1650_F_VTA_03_ASEReadCounter.table","NW_015090842.1:10255505",4,4,0
"LOC106888384","s1650_F_VTA_03_ASEReadCounter.table","NW_015090842.1:10255531",5,6,1
"LOC106888384","s1650_F_VTA_03_ASEReadCounter.table","NW_015090842.1:10255608",3,4,1
"LOC106888384","s1650_F_VTA_03_ASEReadCounter.table","NW_015090842.1:10255704",6,7,1
"LOC106888384","s1650_F_VTA_03_ASEReadCounter.table","NW_015090842.1:10255731",7,8,1
"LOC106888384","s1650_F_VTA_03_ASEReadCounter.table","NW_015090842.1:10255771",3,4,1
"TANGO6","s1650_F_VTA_03_ASEReadCounter.table","NW_015090842.1:10257782",4,5,1
"TANGO6","s1650_F_VTA_03_ASEReadCounter.table","NW_015090842.1:10258162",4,10,6
"TANGO6","s1650_F_VTA_03_ASEReadCounter.table","NW_015090842.1:10258185",6,13,7
"TANGO6","s1650_F_VTA_03_ASEReadCounter.table","NW_015090842.1:10259267",7,14,7
"TANGO6","s1650_F_VTA_03_ASEReadCounter.table","NW_015090842.1:10260250",31,49,18
"TANGO6","s1650_F_VTA_03_ASEReadCounter.table","NW_015090842.1:10260289",28,44,16
"TANGO6","s1650_F_VTA_03_ASEReadCounter.table","NW_015090842.1:10260309",19,29,10
"TANGO6","s1650_F_VTA_03_ASEReadCounter.table","NW_015090842.1:10260979",15,22,7
"TANGO6","s1650_F_VTA_03_ASEReadCounter.table","NW_015090842.1:10261599",17,28,11
"TANGO6","s1650_F_VTA_03_ASEReadCounter.table","NW_015090842.1:10268425",34,51,17
"TANGO6","s1650_F_VTA_03_ASEReadCounter.table","NW_015090842.1:10269831",18,37,19
"TANGO6","s1650_F_VTA_03_ASEReadCounter.table","NW_015090842.1:10270813",19,53,34
"TANGO6","s1650_F_VTA_03_ASEReadCounter.table","NW_015090842.1:10274018",14,32,18
"TANGO6","s1650_F_VTA_03_ASEReadCounter.table","NW_015090842.1:10275974",21,41,20
"TANGO6","s1650_F_VTA_03_ASEReadCounter.table","NW_015090842.1:10275976",21,40,19
"TANGO6","s1650_F_VTA_03_ASEReadCounter.table","NW_015090842.1:10276123",24,53,29
"TANGO6","s1650_F_VTA_03_ASEReadCounter.table","NW_015090842.1:10276271",30,61,31
"TANGO6","s1650_F_VTA_03_ASEReadCounter.table","NW_015090842.1:10276272",27,60,33
"TANGO6","s1650_F_VTA_03_ASEReadCounter.table","NW_015090842.1:10276275",31,66,35
"TANGO6","s1650_F_VTA_03_ASEReadCounter.table","NW_015090842.1:10276278",32,67,35
"TANGO6","s1650_F_VTA_03_ASEReadCounter.table","NW_015090842.1:10276368",31,52,21
"TANGO6","s1650_F_VTA_03_ASEReadCounter.table","NW_015090842.1:10276373",27,44,17
"TANGO6","s1650_F_VTA_03_ASEReadCounter.table","NW_015090842.1:10276630",39,59,20
"TANGO6","s1650_F_VTA_03_ASEReadCounter.table","NW_015090842.1:10281498",22,53,31
"TANGO6","s1650_F_VTA_03_ASEReadCounter.table","NW_015090842.1:10281516",29,60,31
"TANGO6","s1650_F_VTA_03_ASEReadCounter.table","NW_015090842.1:10282842",40,78,38
"TANGO6","s1650_F_VTA_03_ASEReadCounter.table","NW_015090842.1:10282863",27,63,36
"TANGO6","s1650_F_VTA_03_ASEReadCounter.table","NW_015090842.1:10282869",26,63,37
"TANGO6","s1650_F_VTA_03_ASEReadCounter.table","NW_015090842.1:10282903",29,70,41
"TANGO6","s1650_F_VTA_03_ASEReadCounter.table","NW_015090842.1:10283757",39,83,44
"TANGO6","s1650_F_VTA_03_ASEReadCounter.table","NW_015090842.1:10283785",37,82,45
"HAS3","s1650_F_VTA_03_ASEReadCounter.table","NW_015090842.1:10288093",1,1,0
"HAS3","s1650_F_VTA_03_ASEReadCounter.table","NW_015090842.1:10288266",0,2,2
"HAS3","s1650_F_VTA_03_ASEReadCounter.table","NW_015090842.1:10288274",0,2,2
"HAS3","s1650_F_VTA_03_ASEReadCounter.table","NW_015090842.1:10288364",0,3,3
"HAS3","s1650_F_VTA_03_ASEReadCounter.table","NW_015090842.1:10289269",1,3,2
"HAS3","s1650_F_VTA_03_ASEReadCounter.table","NW_015090842.1:10289272",1,2,1
"HAS3","s1650_F_VTA_03_ASEReadCounter.table","NW_015090842.1:10289469",0,1,1
"HAS3","s1650_F_VTA_03_ASEReadCounter.table","NW_015090842.1:10290375",1,3,2
"HAS3","s1650_F_VTA_03_ASEReadCounter.table","NW_015090842.1:10290395",0,2,2
"HAS3","s1650_F_VTA_03_ASEReadCounter.table","NW_015090842.1:10290439",2,2,0
"HAS3","s1650_F_VTA_03_ASEReadCounter.table","NW_015090842.1:10290561",1,1,0
"HAS3","s1650_F_VTA_03_ASEReadCounter.table","NW_015090842.1:10290609",1,2,1
"HAS3","s1650_F_VTA_03_ASEReadCounter.table","NW_015090842.1:10290666",1,2,1
"HAS3","s1650_F_VTA_03_ASEReadCounter.table","NW_015090842.1:10290723",0,3,3
"HAS3","s1650_F_VTA_03_ASEReadCounter.table","NW_015090842.1:10290927",1,4,3
"HAS3","s1650_F_VTA_03_ASEReadCounter.table","NW_015090842.1:10291004",1,2,1
"CHTF8","s1650_F_VTA_03_ASEReadCounter.table","NW_015090842.1:10291319",3,9,6
"CHTF8","s1650_F_VTA_03_ASEReadCounter.table","NW_015090842.1:10291491",7,16,9
"CHTF8","s1650_F_VTA_03_ASEReadCounter.table","NW_015090842.1:10291520",8,16,8
"CHTF8","s1650_F_VTA_03_ASEReadCounter.table","NW_015090842.1:10291593",6,14,8
"CHTF8","s1650_F_VTA_03_ASEReadCounter.table","NW_015090842.1:10291600",5,11,6
"CHTF8","s1650_F_VTA_03_ASEReadCounter.table","NW_015090842.1:10291609",4,10,6
"CHTF8","s1650_F_VTA_03_ASEReadCounter.table","NW_015090842.1:10291639",6,12,6
"CHTF8","s1650_F_VTA_03_ASEReadCounter.table","NW_015090842.1:10291641",6,12,6
"CHTF8","s1650_F_VTA_03_ASEReadCounter.table","NW_015090842.1:10291648",7,13,6
"CHTF8","s1650_F_VTA_03_ASEReadCounter.table","NW_015090842.1:10291656",7,12,5
"CHTF8","s1650_F_VTA_03_ASEReadCounter.table","NW_015090842.1:10291675",7,10,3
"CHTF8","s1650_F_VTA_03_ASEReadCounter.table","NW_015090842.1:10291696",7,11,4
"CHTF8","s1650_F_VTA_03_ASEReadCounter.table","NW_015090842.1:10291714",8,12,4
"CHTF8","s1650_F_VTA_03_ASEReadCounter.table","NW_015090842.1:10291732",6,10,4
"CHTF8","s1650_F_VTA_03_ASEReadCounter.table","NW_015090842.1:10291755",6,12,6
"CHTF8","s1650_F_VTA_03_ASEReadCounter.table","NW_015090842.1:10291756",6,12,6
"CHTF8","s1650_F_VTA_03_ASEReadCounter.table","NW_015090842.1:10291758",6,13,7
"CHTF8","s1650_F_VTA_03_ASEReadCounter.table","NW_015090842.1:10291792",6,11,5
"CHTF8","s1650_F_VTA_03_ASEReadCounter.table","NW_015090842.1:10291895",9,18,9
"CHTF8","s1650_F_VTA_03_ASEReadCounter.table","NW_015090842.1:10292132",8,11,3
"CHTF8","s1650_F_VTA_03_ASEReadCounter.table","NW_015090842.1:10292314",10,17,7
"CHTF8","s1650_F_VTA_03_ASEReadCounter.table","NW_015090842.1:10292317",9,17,8
"CHTF8","s1650_F_VTA_03_ASEReadCounter.table","NW_015090842.1:10292928",1,2,1
"UTP4","s1650_F_VTA_03_ASEReadCounter.table","NW_015090842.1:10293146",15,26,11
"UTP4","s1650_F_VTA_03_ASEReadCounter.table","NW_015090842.1:10293151",15,26,11
"UTP4","s1650_F_VTA_03_ASEReadCounter.table","NW_015090842.1:10293191",11,20,9
"UTP4","s1650_F_VTA_03_ASEReadCounter.table","NW_015090842.1:10293362",10,23,13
"UTP4","s1650_F_VTA_03_ASEReadCounter.table","NW_015090842.1:10293430",11,28,17
"UTP4","s1650_F_VTA_03_ASEReadCounter.table","NW_015090842.1:10293625",7,18,11
"UTP4","s1650_F_VTA_03_ASEReadCounter.table","NW_015090842.1:10293684",13,28,15
"UTP4","s1650_F_VTA_03_ASEReadCounter.table","NW_015090842.1:10294093",5,10,5
"UTP4","s1650_F_VTA_03_ASEReadCounter.table","NW_015090842.1:10294622",7,18,11
"UTP4","s1650_F_VTA_03_ASEReadCounter.table","NW_015090842.1:10294632",6,17,11
"UTP4","s1650_F_VTA_03_ASEReadCounter.table","NW_015090842.1:10295238",8,22,14
"UTP4","s1650_F_VTA_03_ASEReadCounter.table","NW_015090842.1:10295880",6,22,16
"UTP4","s1650_F_VTA_03_ASEReadCounter.table","NW_015090842.1:10295884",6,23,17
"UTP4","s1650_F_VTA_03_ASEReadCounter.table","NW_015090842.1:10295903",3,17,14
"UTP4","s1650_F_VTA_03_ASEReadCounter.table","NW_015090842.1:10295906",4,19,15
"UTP4","s1650_F_VTA_03_ASEReadCounter.table","NW_015090842.1:10295915",4,19,15
"UTP4","s1650_F_VTA_03_ASEReadCounter.table","NW_015090842.1:10295938",4,20,16
"UTP4","s1650_F_VTA_03_ASEReadCounter.table","NW_015090842.1:10296175",9,29,20
"UTP4","s1650_F_VTA_03_ASEReadCounter.table","NW_015090842.1:10296660",13,29,16
"UTP4","s1650_F_VTA_03_ASEReadCounter.table","NW_015090842.1:10296679",19,34,15
"UTP4","s1650_F_VTA_03_ASEReadCounter.table","NW_015090842.1:10297193",21,43,22
"UTP4","s1650_F_VTA_03_ASEReadCounter.table","NW_015090842.1:10297220",19,46,27
"UTP4","s1650_F_VTA_03_ASEReadCounter.table","NW_015090842.1:10297307",23,58,35
"UTP4","s1650_F_VTA_03_ASEReadCounter.table","NW_015090842.1:10297558",22,56,34
"UTP4","s1650_F_VTA_03_ASEReadCounter.table","NW_015090842.1:10297943",26,52,26
"UTP4","s1650_F_VTA_03_ASEReadCounter.table","NW_015090842.1:10297979",18,47,29
"UTP4","s1650_F_VTA_03_ASEReadCounter.table","NW_015090842.1:10298022",11,28,17
"UTP4","s1650_F_VTA_03_ASEReadCounter.table","NW_015090842.1:10298079",1,3,2
"UTP4","s1650_F_VTA_03_ASEReadCounter.table","NW_015090842.1:10298081",1,3,2
"UTP4","s1650_F_VTA_03_ASEReadCounter.table","NW_015090842.1:10298082",1,3,2
"SNTB2","s1650_F_VTA_03_ASEReadCounter.table","NW_015090842.1:10303506",3,6,3
"SNTB2","s1650_F_VTA_03_ASEReadCounter.table","NW_015090842.1:10303524",2,4,2
"SNTB2","s1650_F_VTA_03_ASEReadCounter.table","NW_015090842.1:10304059",5,8,3
"SNTB2","s1650_F_VTA_03_ASEReadCounter.table","NW_015090842.1:10304089",6,10,4
"SNTB2","s1650_F_VTA_03_ASEReadCounter.table","NW_015090842.1:10304167",5,8,3
"SNTB2","s1650_F_VTA_03_ASEReadCounter.table","NW_015090842.1:10304176",3,6,3
"SNTB2","s1650_F_VTA_03_ASEReadCounter.table","NW_015090842.1:10305069",6,8,2
"SNTB2","s1650_F_VTA_03_ASEReadCounter.table","NW_015090842.1:10305099",5,7,2
"SNTB2","s1650_F_VTA_03_ASEReadCounter.table","NW_015090842.1:10305171",2,6,4
"SNTB2","s1650_F_VTA_03_ASEReadCounter.table","NW_015090842.1:10305177",2,5,3
"SNTB2","s1650_F_VTA_03_ASEReadCounter.table","NW_015090842.1:10305451",2,5,3
"SNTB2","s1650_F_VTA_03_ASEReadCounter.table","NW_015090842.1:10305547",4,9,5
"SNTB2","s1650_F_VTA_03_ASEReadCounter.table","NW_015090842.1:10305847",2,3,1
"SNTB2","s1650_F_VTA_03_ASEReadCounter.table","NW_015090842.1:10306173",2,3,1
"SNTB2","s1650_F_VTA_03_ASEReadCounter.table","NW_015090842.1:10306275",3,4,1
"SNTB2","s1650_F_VTA_03_ASEReadCounter.table","NW_015090842.1:10306457",1,2,1
"SNTB2","s1650_F_VTA_03_ASEReadCounter.table","NW_015090842.1:10306496",2,3,1
"SNTB2","s1650_F_VTA_03_ASEReadCounter.table","NW_015090842.1:10306499",2,3,1
"VPS4A","s1650_F_VTA_03_ASEReadCounter.table","NW_015090842.1:10308566",53,113,60
"VPS4A","s1650_F_VTA_03_ASEReadCounter.table","NW_015090842.1:10308573",56,118,62
"VPS4A","s1650_F_VTA_03_ASEReadCounter.table","NW_015090842.1:10308856",74,176,102
"VPS4A","s1650_F_VTA_03_ASEReadCounter.table","NW_015090842.1:10309056",106,245,139
"VPS4A","s1650_F_VTA_03_ASEReadCounter.table","NW_015090842.1:10309089",118,269,151
"VPS4A","s1650_F_VTA_03_ASEReadCounter.table","NW_015090842.1:10309392",117,244,127
"VPS4A","s1650_F_VTA_03_ASEReadCounter.table","NW_015090842.1:10309413",138,273,135
"VPS4A","s1650_F_VTA_03_ASEReadCounter.table","NW_015090842.1:10309467",167,339,172
"VPS4A","s1650_F_VTA_03_ASEReadCounter.table","NW_015090842.1:10310230",154,339,185
"VPS4A","s1650_F_VTA_03_ASEReadCounter.table","NW_015090842.1:10310425",147,292,145
"VPS4A","s1650_F_VTA_03_ASEReadCounter.table","NW_015090842.1:10310639",171,342,171
"VPS4A","s1650_F_VTA_03_ASEReadCounter.table","NW_015090842.1:10310734",144,308,164
"VPS4A","s1650_F_VTA_03_ASEReadCounter.table","NW_015090842.1:10310737",158,326,168
"VPS4A","s1650_F_VTA_03_ASEReadCounter.table","NW_015090842.1:10310746",152,327,175
"VPS4A","s1650_F_VTA_03_ASEReadCounter.table","NW_015090842.1:10310767",156,334,178
"VPS4A","s1650_F_VTA_03_ASEReadCounter.table","NW_015090842.1:10310995",192,374,182
"VPS4A","s1650_F_VTA_03_ASEReadCounter.table","NW_015090842.1:10311004",189,371,182
"VPS4A","s1650_F_VTA_03_ASEReadCounter.table","NW_015090842.1:10311007",189,381,192
"VPS4A","s1650_F_VTA_03_ASEReadCounter.table","NW_015090842.1:10311013",203,390,187
"VPS4A","s1650_F_VTA_03_ASEReadCounter.table","NW_015090842.1:10311022",185,388,203
"VPS4A","s1650_F_VTA_03_ASEReadCounter.table","NW_015090842.1:10311023",183,378,195
"VPS4A","s1650_F_VTA_03_ASEReadCounter.table","NW_015090842.1:10311426",181,390,209
"VPS4A","s1650_F_VTA_03_ASEReadCounter.table","NW_015090842.1:10311489",4,13,9
"VPS4A","s1650_F_VTA_03_ASEReadCounter.table","NW_015090842.1:10311490",5,9,4
"VPS4A","s1650_F_VTA_03_ASEReadCounter.table","NW_015090842.1:10311525",11,30,19
"VPS4A","s1650_F_VTA_03_ASEReadCounter.table","NW_015090842.1:10311529",12,33,21
"VPS4A","s1650_F_VTA_03_ASEReadCounter.table","NW_015090842.1:10311530",11,36,25
"VPS4A","s1650_F_VTA_03_ASEReadCounter.table","NW_015090842.1:10311552",55,87,32
"VPS4A","s1650_F_VTA_03_ASEReadCounter.table","NW_015090842.1:10311689",69,105,36
"VPS4A","s1650_F_VTA_03_ASEReadCounter.table","NW_015090842.1:10311700",84,121,37
"VPS4A","s1650_F_VTA_03_ASEReadCounter.table","NW_015090842.1:10311701",81,120,39
"VPS4A","s1650_F_VTA_03_ASEReadCounter.table","NW_015090842.1:10311703",81,120,39
"COG8","s1650_F_VTA_03_ASEReadCounter.table","NW_015090842.1:10313487",11,36,25
"COG8","s1650_F_VTA_03_ASEReadCounter.table","NW_015090842.1:10313559",22,51,29
"COG8","s1650_F_VTA_03_ASEReadCounter.table","NW_015090842.1:10313579",18,45,27
"COG8","s1650_F_VTA_03_ASEReadCounter.table","NW_015090842.1:10313665",21,50,29
"COG8","s1650_F_VTA_03_ASEReadCounter.table","NW_015090842.1:10313681",19,47,28
"COG8","s1650_F_VTA_03_ASEReadCounter.table","NW_015090842.1:10313768",18,46,28
"COG8","s1650_F_VTA_03_ASEReadCounter.table","NW_015090842.1:10313775",22,50,28
"COG8","s1650_F_VTA_03_ASEReadCounter.table","NW_015090842.1:10313811",20,43,23
"COG8","s1650_F_VTA_03_ASEReadCounter.table","NW_015090842.1:10313858",18,44,26
"COG8","s1650_F_VTA_03_ASEReadCounter.table","NW_015090842.1:10314100",18,41,23
"COG8","s1650_F_VTA_03_ASEReadCounter.table","NW_015090842.1:10314213",15,39,24
"COG8","s1650_F_VTA_03_ASEReadCounter.table","NW_015090842.1:10315093",15,32,17
"COG8","s1650_F_VTA_03_ASEReadCounter.table","NW_015090842.1:10315162",21,43,22
"COG8","s1650_F_VTA_03_ASEReadCounter.table","NW_015090842.1:10315285",20,43,23
"COG8","s1650_F_VTA_03_ASEReadCounter.table","NW_015090842.1:10315360",9,23,14
"COG8","s1650_F_VTA_03_ASEReadCounter.table","NW_015090842.1:10315369",10,25,15
"COG8","s1650_F_VTA_03_ASEReadCounter.table","NW_015090842.1:10315504",7,22,15
"COG8","s1650_F_VTA_03_ASEReadCounter.table","NW_015090842.1:10315508",9,23,14
"COG8","s1650_F_VTA_03_ASEReadCounter.table","NW_015090842.1:10315624",12,33,21
"COG8","s1650_F_VTA_03_ASEReadCounter.table","NW_015090842.1:10315693",17,31,14
"COG8","s1650_F_VTA_03_ASEReadCounter.table","NW_015090842.1:10315698",16,31,15
"COG8","s1650_F_VTA_03_ASEReadCounter.table","NW_015090842.1:10315768",14,24,10
"COG8","s1650_F_VTA_03_ASEReadCounter.table","NW_015090842.1:10315769",14,24,10
"COG8","s1650_F_VTA_03_ASEReadCounter.table","NW_015090842.1:10315784",13,22,9
"COG8","s1650_F_VTA_03_ASEReadCounter.table","NW_015090842.1:10316093",10,22,12
"COG8","s1650_F_VTA_03_ASEReadCounter.table","NW_015090842.1:10316133",7,17,10
"NIP7","s1650_F_VTA_03_ASEReadCounter.table","NW_015090842.1:10316759",13,28,15
"NIP7","s1650_F_VTA_03_ASEReadCounter.table","NW_015090842.1:10316967",66,153,87
"NIP7","s1650_F_VTA_03_ASEReadCounter.table","NW_015090842.1:10316995",82,175,93
"NIP7","s1650_F_VTA_03_ASEReadCounter.table","NW_015090842.1:10317240",136,284,148
"NIP7","s1650_F_VTA_03_ASEReadCounter.table","NW_015090842.1:10317247",140,288,148
"NIP7","s1650_F_VTA_03_ASEReadCounter.table","NW_015090842.1:10317264",136,277,141
"NIP7","s1650_F_VTA_03_ASEReadCounter.table","NW_015090842.1:10317433",150,351,201
"NIP7","s1650_F_VTA_03_ASEReadCounter.table","NW_015090842.1:10317738",112,275,163
"NIP7","s1650_F_VTA_03_ASEReadCounter.table","NW_015090842.1:10317769",115,266,151
"NIP7","s1650_F_VTA_03_ASEReadCounter.table","NW_015090842.1:10317808",82,200,118
"NIP7","s1650_F_VTA_03_ASEReadCounter.table","NW_015090842.1:10317870",43,135,92
"NIP7","s1650_F_VTA_03_ASEReadCounter.table","NW_015090842.1:10317871",43,136,93
"NIP7","s1650_F_VTA_03_ASEReadCounter.table","NW_015090842.1:10317898",31,90,59
"NIP7","s1650_F_VTA_03_ASEReadCounter.table","NW_015090842.1:10317911",25,72,47
"TMED6","s1650_F_VTA_03_ASEReadCounter.table","NW_015090842.1:10318731",1,1,0
"TERF2","s1650_F_VTA_03_ASEReadCounter.table","NW_015090842.1:10321665",12,12,0
"TERF2","s1650_F_VTA_03_ASEReadCounter.table","NW_015090842.1:10321768",24,64,40
"TERF2","s1650_F_VTA_03_ASEReadCounter.table","NW_015090842.1:10321777",21,62,41
"TERF2","s1650_F_VTA_03_ASEReadCounter.table","NW_015090842.1:10321805",19,69,50
"TERF2","s1650_F_VTA_03_ASEReadCounter.table","NW_015090842.1:10321878",36,89,53
"TERF2","s1650_F_VTA_03_ASEReadCounter.table","NW_015090842.1:10321893",40,82,42
"TERF2","s1650_F_VTA_03_ASEReadCounter.table","NW_015090842.1:10321897",39,81,42
"TERF2","s1650_F_VTA_03_ASEReadCounter.table","NW_015090842.1:10321908",33,71,38
"TERF2","s1650_F_VTA_03_ASEReadCounter.table","NW_015090842.1:10322001",43,105,62
"TERF2","s1650_F_VTA_03_ASEReadCounter.table","NW_015090842.1:10322035",35,86,51
"TERF2","s1650_F_VTA_03_ASEReadCounter.table","NW_015090842.1:10322051",30,93,63
"TERF2","s1650_F_VTA_03_ASEReadCounter.table","NW_015090842.1:10322137",24,69,45
"TERF2","s1650_F_VTA_03_ASEReadCounter.table","NW_015090842.1:10322144",27,71,44
"TERF2","s1650_F_VTA_03_ASEReadCounter.table","NW_015090842.1:10322388",26,72,46
"TERF2","s1650_F_VTA_03_ASEReadCounter.table","NW_015090842.1:10322396",27,70,43
"TERF2","s1650_F_VTA_03_ASEReadCounter.table","NW_015090842.1:10322502",34,81,47
"TERF2","s1650_F_VTA_03_ASEReadCounter.table","NW_015090842.1:10322504",33,83,50
"TERF2","s1650_F_VTA_03_ASEReadCounter.table","NW_015090842.1:10322510",30,80,50
"TERF2","s1650_F_VTA_03_ASEReadCounter.table","NW_015090842.1:10323580",28,83,55
"TERF2","s1650_F_VTA_03_ASEReadCounter.table","NW_015090842.1:10324314",28,88,60
"TERF2","s1650_F_VTA_03_ASEReadCounter.table","NW_015090842.1:10326832",28,61,33
"TERF2","s1650_F_VTA_03_ASEReadCounter.table","NW_015090842.1:10327787",22,38,16
"TERF2","s1650_F_VTA_03_ASEReadCounter.table","NW_015090842.1:10328588",19,33,14
"TERF2","s1650_F_VTA_03_ASEReadCounter.table","NW_015090842.1:10328644",14,30,16
"TERF2","s1650_F_VTA_03_ASEReadCounter.table","NW_015090842.1:10329813",10,21,11
"TERF2","s1650_F_VTA_03_ASEReadCounter.table","NW_015090842.1:10330749",10,27,17
"TERF2","s1650_F_VTA_03_ASEReadCounter.table","NW_015090842.1:10330789",9,27,18
"CYB5B","s1650_F_VTA_03_ASEReadCounter.table","NW_015090842.1:10336595",6,12,6
"CYB5B","s1650_F_VTA_03_ASEReadCounter.table","NW_015090842.1:10336667",33,72,39
"CYB5B","s1650_F_VTA_03_ASEReadCounter.table","NW_015090842.1:10336689",59,114,55
"CYB5B","s1650_F_VTA_03_ASEReadCounter.table","NW_015090842.1:10336728",76,148,72
"CYB5B","s1650_F_VTA_03_ASEReadCounter.table","NW_015090842.1:10345068",80,164,84
"CYB5B","s1650_F_VTA_03_ASEReadCounter.table","NW_015090842.1:10348800",93,210,117
"CYB5B","s1650_F_VTA_03_ASEReadCounter.table","NW_015090842.1:10348888",97,198,101
"CYB5B","s1650_F_VTA_03_ASEReadCounter.table","NW_015090842.1:10349046",100,224,124
"CYB5B","s1650_F_VTA_03_ASEReadCounter.table","NW_015090842.1:10349119",60,175,115
"CYB5B","s1650_F_VTA_03_ASEReadCounter.table","NW_015090842.1:10349146",35,148,113
"CYB5B","s1650_F_VTA_03_ASEReadCounter.table","NW_015090842.1:10349157",57,180,123
