"gene","id","snp","ref_count","total_count","alt_count"
"CENPN","s1664_F_GON_01_ASEReadCounter.table","NW_015090842.1:5801612",18,401,383
"CENPN","s1664_F_GON_01_ASEReadCounter.table","NW_015090842.1:5801618",27,421,394
"CENPN","s1664_F_GON_01_ASEReadCounter.table","NW_015090842.1:5801623",38,433,395
"CENPN","s1664_F_GON_01_ASEReadCounter.table","NW_015090842.1:5801631",54,455,401
"CENPN","s1664_F_GON_01_ASEReadCounter.table","NW_015090842.1:5801632",54,455,401
"CENPN","s1664_F_GON_01_ASEReadCounter.table","NW_015090842.1:5801655",85,444,359
"CENPN","s1664_F_GON_01_ASEReadCounter.table","NW_015090842.1:5801662",96,508,412
"CENPN","s1664_F_GON_01_ASEReadCounter.table","NW_015090842.1:5801670",99,523,424
"CENPN","s1664_F_GON_01_ASEReadCounter.table","NW_015090842.1:5801674",101,532,431
"CENPN","s1664_F_GON_01_ASEReadCounter.table","NW_015090842.1:5801692",116,579,463
"CENPN","s1664_F_GON_01_ASEReadCounter.table","NW_015090842.1:5801697",116,575,459
"CENPN","s1664_F_GON_01_ASEReadCounter.table","NW_015090842.1:5802008",156,862,706
"CENPN","s1664_F_GON_01_ASEReadCounter.table","NW_015090842.1:5802012",161,863,702
"CENPN","s1664_F_GON_01_ASEReadCounter.table","NW_015090842.1:5802087",211,1182,971
"CENPN","s1664_F_GON_01_ASEReadCounter.table","NW_015090842.1:5810113",24,33,9
"CENPN","s1664_F_GON_01_ASEReadCounter.table","NW_015090842.1:5810147",32,40,8
"CENPN","s1664_F_GON_01_ASEReadCounter.table","NW_015090842.1:5810148",34,41,7
"ATMIN","s1664_F_GON_01_ASEReadCounter.table","NW_015090842.1:5818789",21,26,5
"ATMIN","s1664_F_GON_01_ASEReadCounter.table","NW_015090842.1:5819958",20,28,8
"ATMIN","s1664_F_GON_01_ASEReadCounter.table","NW_015090842.1:5820004",17,25,8
"ATMIN","s1664_F_GON_01_ASEReadCounter.table","NW_015090842.1:5820217",17,19,2
"ATMIN","s1664_F_GON_01_ASEReadCounter.table","NW_015090842.1:5820250",15,16,1
"ATMIN","s1664_F_GON_01_ASEReadCounter.table","NW_015090842.1:5820298",13,14,1
"ATMIN","s1664_F_GON_01_ASEReadCounter.table","NW_015090842.1:5820417",3,4,1
"ATMIN","s1664_F_GON_01_ASEReadCounter.table","NW_015090842.1:5820421",3,4,1
"ATMIN","s1664_F_GON_01_ASEReadCounter.table","NW_015090842.1:5820448",3,5,2
"ATMIN","s1664_F_GON_01_ASEReadCounter.table","NW_015090842.1:5820457",1,3,2
"ATMIN","s1664_F_GON_01_ASEReadCounter.table","NW_015090842.1:5820510",3,4,1
"ATMIN","s1664_F_GON_01_ASEReadCounter.table","NW_015090842.1:5820673",4,8,4
"ATMIN","s1664_F_GON_01_ASEReadCounter.table","NW_015090842.1:5820754",2,4,2
"ATMIN","s1664_F_GON_01_ASEReadCounter.table","NW_015090842.1:5820820",2,3,1
"ATMIN","s1664_F_GON_01_ASEReadCounter.table","NW_015090842.1:5820865",2,5,3
"ATMIN","s1664_F_GON_01_ASEReadCounter.table","NW_015090842.1:5820889",1,5,4
"ATMIN","s1664_F_GON_01_ASEReadCounter.table","NW_015090842.1:5820891",1,5,4
"ATMIN","s1664_F_GON_01_ASEReadCounter.table","NW_015090842.1:5820997",4,6,2
"ATMIN","s1664_F_GON_01_ASEReadCounter.table","NW_015090842.1:5821063",6,8,2
"ATMIN","s1664_F_GON_01_ASEReadCounter.table","NW_015090842.1:5821132",7,9,2
"ATMIN","s1664_F_GON_01_ASEReadCounter.table","NW_015090842.1:5821645",9,14,5
"ATMIN","s1664_F_GON_01_ASEReadCounter.table","NW_015090842.1:5825066",7,13,6
"ATMIN","s1664_F_GON_01_ASEReadCounter.table","NW_015090842.1:5825106",5,12,7
"ATMIN","s1664_F_GON_01_ASEReadCounter.table","NW_015090842.1:5825122",3,8,5
"ATMIN","s1664_F_GON_01_ASEReadCounter.table","NW_015090842.1:5825178",1,14,13
"ATMIN","s1664_F_GON_01_ASEReadCounter.table","NW_015090842.1:5825194",1,12,11
"ATMIN","s1664_F_GON_01_ASEReadCounter.table","NW_015090842.1:5825195",1,14,13
"ATMIN","s1664_F_GON_01_ASEReadCounter.table","NW_015090842.1:5825220",1,14,13
"ATMIN","s1664_F_GON_01_ASEReadCounter.table","NW_015090842.1:5825240",4,14,10
"ATMIN","s1664_F_GON_01_ASEReadCounter.table","NW_015090842.1:5825303",7,19,12
"ATMIN","s1664_F_GON_01_ASEReadCounter.table","NW_015090842.1:5825304",7,18,11
"ATMIN","s1664_F_GON_01_ASEReadCounter.table","NW_015090842.1:5825310",7,18,11
"ATMIN","s1664_F_GON_01_ASEReadCounter.table","NW_015090842.1:5825406",8,20,12
"ATMIN","s1664_F_GON_01_ASEReadCounter.table","NW_015090842.1:5825415",10,23,13
"ATMIN","s1664_F_GON_01_ASEReadCounter.table","NW_015090842.1:5825438",12,23,11
"ATMIN","s1664_F_GON_01_ASEReadCounter.table","NW_015090842.1:5825485",11,21,10
"ATMIN","s1664_F_GON_01_ASEReadCounter.table","NW_015090842.1:5825524",10,19,9
"ATMIN","s1664_F_GON_01_ASEReadCounter.table","NW_015090842.1:5825557",8,17,9
"ATMIN","s1664_F_GON_01_ASEReadCounter.table","NW_015090842.1:5825571",7,17,10
"ATMIN","s1664_F_GON_01_ASEReadCounter.table","NW_015090842.1:5825579",7,16,9
"ATMIN","s1664_F_GON_01_ASEReadCounter.table","NW_015090842.1:5825590",4,10,6
"ATMIN","s1664_F_GON_01_ASEReadCounter.table","NW_015090842.1:5825689",9,20,11
"ATMIN","s1664_F_GON_01_ASEReadCounter.table","NW_015090842.1:5825703",9,21,12
"ATMIN","s1664_F_GON_01_ASEReadCounter.table","NW_015090842.1:5825787",11,23,12
"ATMIN","s1664_F_GON_01_ASEReadCounter.table","NW_015090842.1:5825833",10,22,12
"ATMIN","s1664_F_GON_01_ASEReadCounter.table","NW_015090842.1:5825841",11,23,12
"ATMIN","s1664_F_GON_01_ASEReadCounter.table","NW_015090842.1:5825895",12,25,13
"ATMIN","s1664_F_GON_01_ASEReadCounter.table","NW_015090842.1:5825984",12,28,16
"ATMIN","s1664_F_GON_01_ASEReadCounter.table","NW_015090842.1:5826162",19,36,17
"ATMIN","s1664_F_GON_01_ASEReadCounter.table","NW_015090842.1:5826194",16,38,22
"ATMIN","s1664_F_GON_01_ASEReadCounter.table","NW_015090842.1:5826235",26,48,22
"ATMIN","s1664_F_GON_01_ASEReadCounter.table","NW_015090842.1:5826245",24,46,22
"ATMIN","s1664_F_GON_01_ASEReadCounter.table","NW_015090842.1:5826335",17,35,18
"ATMIN","s1664_F_GON_01_ASEReadCounter.table","NW_015090842.1:5826417",21,32,11
"ATMIN","s1664_F_GON_01_ASEReadCounter.table","NW_015090842.1:5826431",17,40,23
"ATMIN","s1664_F_GON_01_ASEReadCounter.table","NW_015090842.1:5826438",21,32,11
"ATMIN","s1664_F_GON_01_ASEReadCounter.table","NW_015090842.1:5826463",24,40,16
"ATMIN","s1664_F_GON_01_ASEReadCounter.table","NW_015090842.1:5826502",14,35,21
"ATMIN","s1664_F_GON_01_ASEReadCounter.table","NW_015090842.1:5826511",15,35,20
"ATMIN","s1664_F_GON_01_ASEReadCounter.table","NW_015090842.1:5826659",26,46,20
"ATMIN","s1664_F_GON_01_ASEReadCounter.table","NW_015090842.1:5826701",28,53,25
"ATMIN","s1664_F_GON_01_ASEReadCounter.table","NW_015090842.1:5826702",27,53,26
"ATMIN","s1664_F_GON_01_ASEReadCounter.table","NW_015090842.1:5826732",26,51,25
"ATMIN","s1664_F_GON_01_ASEReadCounter.table","NW_015090842.1:5826745",27,53,26
"ATMIN","s1664_F_GON_01_ASEReadCounter.table","NW_015090842.1:5826835",38,56,18
"ATMIN","s1664_F_GON_01_ASEReadCounter.table","NW_015090842.1:5826942",34,67,33
"ATMIN","s1664_F_GON_01_ASEReadCounter.table","NW_015090842.1:5827193",69,131,62
"ATMIN","s1664_F_GON_01_ASEReadCounter.table","NW_015090842.1:5827196",65,129,64
"ATMIN","s1664_F_GON_01_ASEReadCounter.table","NW_015090842.1:5827269",74,136,62
"ATMIN","s1664_F_GON_01_ASEReadCounter.table","NW_015090842.1:5827315",61,125,64
"ATMIN","s1664_F_GON_01_ASEReadCounter.table","NW_015090842.1:5827316",61,127,66
"ATMIN","s1664_F_GON_01_ASEReadCounter.table","NW_015090842.1:5827333",60,124,64
"PPP1R3E","s1664_F_GON_01_ASEReadCounter.table","NW_015090842.1:5837733",7,12,5
"PPP1R3E","s1664_F_GON_01_ASEReadCounter.table","NW_015090842.1:5837947",0,1,1
"PKD1L2","s1664_F_GON_01_ASEReadCounter.table","NW_015090842.1:5867509",8,20,12
"PKD1L2","s1664_F_GON_01_ASEReadCounter.table","NW_015090842.1:5867597",11,31,20
"PKD1L2","s1664_F_GON_01_ASEReadCounter.table","NW_015090842.1:5867600",14,35,21
"PKD1L2","s1664_F_GON_01_ASEReadCounter.table","NW_015090842.1:5867660",14,39,25
"PKD1L2","s1664_F_GON_01_ASEReadCounter.table","NW_015090842.1:5867675",16,46,30
"PKD1L2","s1664_F_GON_01_ASEReadCounter.table","NW_015090842.1:5867788",19,45,26
"PKD1L2","s1664_F_GON_01_ASEReadCounter.table","NW_015090842.1:5867843",15,44,29
"PKD1L2","s1664_F_GON_01_ASEReadCounter.table","NW_015090842.1:5871422",2,4,2
"PKD1L2","s1664_F_GON_01_ASEReadCounter.table","NW_015090842.1:5872825",1,6,5
"PKD1L2","s1664_F_GON_01_ASEReadCounter.table","NW_015090842.1:5872876",2,8,6
"PKD1L2","s1664_F_GON_01_ASEReadCounter.table","NW_015090842.1:5872924",2,8,6
"PKD1L2","s1664_F_GON_01_ASEReadCounter.table","NW_015090842.1:5872948",2,8,6
"BCO1","s1664_F_GON_01_ASEReadCounter.table","NW_015090842.1:5915610",7,20,13
"BCO1","s1664_F_GON_01_ASEReadCounter.table","NW_015090842.1:5915646",7,19,12
"BCO1","s1664_F_GON_01_ASEReadCounter.table","NW_015090842.1:5917836",6,24,18
"BCO1","s1664_F_GON_01_ASEReadCounter.table","NW_015090842.1:5917912",8,29,21
"BCO1","s1664_F_GON_01_ASEReadCounter.table","NW_015090842.1:5917941",7,24,17
"BCO1","s1664_F_GON_01_ASEReadCounter.table","NW_015090842.1:5917971",9,27,18
"BCO1","s1664_F_GON_01_ASEReadCounter.table","NW_015090842.1:5921679",12,34,22
"BCO1","s1664_F_GON_01_ASEReadCounter.table","NW_015090842.1:5921726",11,28,17
"BCO1","s1664_F_GON_01_ASEReadCounter.table","NW_015090842.1:5925669",5,17,12
"BCO1","s1664_F_GON_01_ASEReadCounter.table","NW_015090842.1:5926937",13,31,18
"BCO1","s1664_F_GON_01_ASEReadCounter.table","NW_015090842.1:5927921",15,31,16
"BCO1","s1664_F_GON_01_ASEReadCounter.table","NW_015090842.1:5927948",15,32,17
"BCO1","s1664_F_GON_01_ASEReadCounter.table","NW_015090842.1:5927968",14,32,18
"BCO1","s1664_F_GON_01_ASEReadCounter.table","NW_015090842.1:5928052",17,28,11
"BCO1","s1664_F_GON_01_ASEReadCounter.table","NW_015090842.1:5932726",34,61,27
"BCO1","s1664_F_GON_01_ASEReadCounter.table","NW_015090842.1:5932801",22,36,14
"BCO1","s1664_F_GON_01_ASEReadCounter.table","NW_015090842.1:5934558",46,86,40
"BCO1","s1664_F_GON_01_ASEReadCounter.table","NW_015090842.1:5934575",54,97,43
"BCO1","s1664_F_GON_01_ASEReadCounter.table","NW_015090842.1:5934608",59,106,47
"BCO1","s1664_F_GON_01_ASEReadCounter.table","NW_015090842.1:5934647",67,109,42
"BCO1","s1664_F_GON_01_ASEReadCounter.table","NW_015090842.1:5934725",74,123,49
"BCO1","s1664_F_GON_01_ASEReadCounter.table","NW_015090842.1:5934726",75,120,45
"BCO1","s1664_F_GON_01_ASEReadCounter.table","NW_015090842.1:5934733",63,106,43
"BCO1","s1664_F_GON_01_ASEReadCounter.table","NW_015090842.1:5934821",47,82,35
"BCO1","s1664_F_GON_01_ASEReadCounter.table","NW_015090842.1:5934826",42,76,34
"BCO1","s1664_F_GON_01_ASEReadCounter.table","NW_015090842.1:5934844",28,50,22
"BCO1","s1664_F_GON_01_ASEReadCounter.table","NW_015090842.1:5934958",64,93,29
"BCO1","s1664_F_GON_01_ASEReadCounter.table","NW_015090842.1:5934976",64,94,30
"GAN","s1664_F_GON_01_ASEReadCounter.table","NW_015090842.1:5953759",9,20,11
"GAN","s1664_F_GON_01_ASEReadCounter.table","NW_015090842.1:5957502",18,41,23
"GAN","s1664_F_GON_01_ASEReadCounter.table","NW_015090842.1:5957578",11,35,24
"GAN","s1664_F_GON_01_ASEReadCounter.table","NW_015090842.1:5966047",11,36,25
"GAN","s1664_F_GON_01_ASEReadCounter.table","NW_015090842.1:5966126",12,37,25
"GAN","s1664_F_GON_01_ASEReadCounter.table","NW_015090842.1:5966127",12,40,28
"GAN","s1664_F_GON_01_ASEReadCounter.table","NW_015090842.1:5966162",16,48,32
"GAN","s1664_F_GON_01_ASEReadCounter.table","NW_015090842.1:5966483",11,23,12
"CMIP","s1664_F_GON_01_ASEReadCounter.table","NW_015090842.1:6109159",12,20,8
"CMIP","s1664_F_GON_01_ASEReadCounter.table","NW_015090842.1:6109166",12,19,7
"CMIP","s1664_F_GON_01_ASEReadCounter.table","NW_015090842.1:6114641",8,11,3
"CMIP","s1664_F_GON_01_ASEReadCounter.table","NW_015090842.1:6114751",8,18,10
"CMIP","s1664_F_GON_01_ASEReadCounter.table","NW_015090842.1:6114824",10,17,7
"CMIP","s1664_F_GON_01_ASEReadCounter.table","NW_015090842.1:6126295",23,23,0
"CMIP","s1664_F_GON_01_ASEReadCounter.table","NW_015090842.1:6128998",11,25,14
"CMIP","s1664_F_GON_01_ASEReadCounter.table","NW_015090842.1:6130562",14,30,16
"CMIP","s1664_F_GON_01_ASEReadCounter.table","NW_015090842.1:6132522",10,28,18
"CMIP","s1664_F_GON_01_ASEReadCounter.table","NW_015090842.1:6138265",24,52,28
"CMIP","s1664_F_GON_01_ASEReadCounter.table","NW_015090842.1:6138300",31,56,25
"CMIP","s1664_F_GON_01_ASEReadCounter.table","NW_015090842.1:6138342",26,57,31
"CMIP","s1664_F_GON_01_ASEReadCounter.table","NW_015090842.1:6138343",26,55,29
"CMIP","s1664_F_GON_01_ASEReadCounter.table","NW_015090842.1:6138345",27,56,29
"CMIP","s1664_F_GON_01_ASEReadCounter.table","NW_015090842.1:6138647",25,37,12
"CMIP","s1664_F_GON_01_ASEReadCounter.table","NW_015090842.1:6138745",19,35,16
"CMIP","s1664_F_GON_01_ASEReadCounter.table","NW_015090842.1:6138832",2,11,9
"CMIP","s1664_F_GON_01_ASEReadCounter.table","NW_015090842.1:6138967",12,26,14
"CMIP","s1664_F_GON_01_ASEReadCounter.table","NW_015090842.1:6139131",6,12,6
"CMIP","s1664_F_GON_01_ASEReadCounter.table","NW_015090842.1:6139163",4,10,6
"CMIP","s1664_F_GON_01_ASEReadCounter.table","NW_015090842.1:6139212",27,29,2
"CMIP","s1664_F_GON_01_ASEReadCounter.table","NW_015090842.1:6139360",4,12,8
"CMIP","s1664_F_GON_01_ASEReadCounter.table","NW_015090842.1:6139572",9,14,5
"PLCG2","s1664_F_GON_01_ASEReadCounter.table","NW_015090842.1:6179613",3,4,1
"PLCG2","s1664_F_GON_01_ASEReadCounter.table","NW_015090842.1:6179658",8,9,1
"PLCG2","s1664_F_GON_01_ASEReadCounter.table","NW_015090842.1:6203766",2,2,0
"PLCG2","s1664_F_GON_01_ASEReadCounter.table","NW_015090842.1:6203775",2,3,1
"PLCG2","s1664_F_GON_01_ASEReadCounter.table","NW_015090842.1:6203787",3,4,1
"PLCG2","s1664_F_GON_01_ASEReadCounter.table","NW_015090842.1:6209741",3,3,0
"PLCG2","s1664_F_GON_01_ASEReadCounter.table","NW_015090842.1:6209798",3,4,1
"PLCG2","s1664_F_GON_01_ASEReadCounter.table","NW_015090842.1:6209816",2,3,1
"PLCG2","s1664_F_GON_01_ASEReadCounter.table","NW_015090842.1:6217547",4,11,7
"PLCG2","s1664_F_GON_01_ASEReadCounter.table","NW_015090842.1:6218641",4,11,7
"PLCG2","s1664_F_GON_01_ASEReadCounter.table","NW_015090842.1:6220552",4,5,1
"PLCG2","s1664_F_GON_01_ASEReadCounter.table","NW_015090842.1:6221969",10,11,1
"PLCG2","s1664_F_GON_01_ASEReadCounter.table","NW_015090842.1:6228672",4,8,4
"PLCG2","s1664_F_GON_01_ASEReadCounter.table","NW_015090842.1:6228694",4,7,3
"PLCG2","s1664_F_GON_01_ASEReadCounter.table","NW_015090842.1:6228722",5,9,4
"PLCG2","s1664_F_GON_01_ASEReadCounter.table","NW_015090842.1:6228747",2,6,4
"PLCG2","s1664_F_GON_01_ASEReadCounter.table","NW_015090842.1:6228835",6,10,4
"PLCG2","s1664_F_GON_01_ASEReadCounter.table","NW_015090842.1:6228841",7,12,5
"PLCG2","s1664_F_GON_01_ASEReadCounter.table","NW_015090842.1:6228865",7,11,4
"PLCG2","s1664_F_GON_01_ASEReadCounter.table","NW_015090842.1:6228917",9,12,3
"PLCG2","s1664_F_GON_01_ASEReadCounter.table","NW_015090842.1:6228926",6,11,5
"PLCG2","s1664_F_GON_01_ASEReadCounter.table","NW_015090842.1:6228954",6,10,4
"PLCG2","s1664_F_GON_01_ASEReadCounter.table","NW_015090842.1:6229002",4,7,3
"PLCG2","s1664_F_GON_01_ASEReadCounter.table","NW_015090842.1:6229006",4,6,2
"PLCG2","s1664_F_GON_01_ASEReadCounter.table","NW_015090842.1:6229081",5,6,1
"PLCG2","s1664_F_GON_01_ASEReadCounter.table","NW_015090842.1:6229097",6,6,0
"PLCG2","s1664_F_GON_01_ASEReadCounter.table","NW_015090842.1:6229160",6,7,1
"PLCG2","s1664_F_GON_01_ASEReadCounter.table","NW_015090842.1:6229213",7,9,2
"PLCG2","s1664_F_GON_01_ASEReadCounter.table","NW_015090842.1:6229231",8,11,3
"PLCG2","s1664_F_GON_01_ASEReadCounter.table","NW_015090842.1:6229663",9,9,0
"PLCG2","s1664_F_GON_01_ASEReadCounter.table","NW_015090842.1:6229748",7,7,0
"PLCG2","s1664_F_GON_01_ASEReadCounter.table","NW_015090842.1:6229892",9,9,0
"PLCG2","s1664_F_GON_01_ASEReadCounter.table","NW_015090842.1:6230248",14,15,1
"PLCG2","s1664_F_GON_01_ASEReadCounter.table","NW_015090842.1:6230255",14,15,1
"PLCG2","s1664_F_GON_01_ASEReadCounter.table","NW_015090842.1:6230276",10,10,0
"PLCG2","s1664_F_GON_01_ASEReadCounter.table","NW_015090842.1:6230296",6,6,0
"PLCG2","s1664_F_GON_01_ASEReadCounter.table","NW_015090842.1:6230349",12,13,1
"PLCG2","s1664_F_GON_01_ASEReadCounter.table","NW_015090842.1:6230408",19,20,1
"PLCG2","s1664_F_GON_01_ASEReadCounter.table","NW_015090842.1:6230439",15,15,0
"PLCG2","s1664_F_GON_01_ASEReadCounter.table","NW_015090842.1:6230757",11,13,2
"PLCG2","s1664_F_GON_01_ASEReadCounter.table","NW_015090842.1:6230758",11,12,1
"PLCG2","s1664_F_GON_01_ASEReadCounter.table","NW_015090842.1:6230898",31,32,1
"PLCG2","s1664_F_GON_01_ASEReadCounter.table","NW_015090842.1:6230976",28,28,0
"PLCG2","s1664_F_GON_01_ASEReadCounter.table","NW_015090842.1:6231078",25,27,2
"PLCG2","s1664_F_GON_01_ASEReadCounter.table","NW_015090842.1:6231138",39,40,1
"PLCG2","s1664_F_GON_01_ASEReadCounter.table","NW_015090842.1:6231177",32,32,0
"PLCG2","s1664_F_GON_01_ASEReadCounter.table","NW_015090842.1:6231263",24,24,0
"SDR42E1","s1664_F_GON_01_ASEReadCounter.table","NW_015090842.1:6235292",14,31,17
"SDR42E1","s1664_F_GON_01_ASEReadCounter.table","NW_015090842.1:6235315",22,60,38
"SDR42E1","s1664_F_GON_01_ASEReadCounter.table","NW_015090842.1:6235348",42,103,61
"SDR42E1","s1664_F_GON_01_ASEReadCounter.table","NW_015090842.1:6235355",42,106,64
"SDR42E1","s1664_F_GON_01_ASEReadCounter.table","NW_015090842.1:6235417",56,136,80
"SDR42E1","s1664_F_GON_01_ASEReadCounter.table","NW_015090842.1:6235558",53,150,97
"SDR42E1","s1664_F_GON_01_ASEReadCounter.table","NW_015090842.1:6235741",96,150,54
"SDR42E1","s1664_F_GON_01_ASEReadCounter.table","NW_015090842.1:6235777",80,144,64
"SDR42E1","s1664_F_GON_01_ASEReadCounter.table","NW_015090842.1:6235806",82,155,73
"SDR42E1","s1664_F_GON_01_ASEReadCounter.table","NW_015090842.1:6235809",81,155,74
"SDR42E1","s1664_F_GON_01_ASEReadCounter.table","NW_015090842.1:6235816",82,156,74
"SDR42E1","s1664_F_GON_01_ASEReadCounter.table","NW_015090842.1:6235914",50,116,66
"SDR42E1","s1664_F_GON_01_ASEReadCounter.table","NW_015090842.1:6235935",53,115,62
"SDR42E1","s1664_F_GON_01_ASEReadCounter.table","NW_015090842.1:6235957",55,116,61
"SDR42E1","s1664_F_GON_01_ASEReadCounter.table","NW_015090842.1:6236040",42,84,42
"SDR42E1","s1664_F_GON_01_ASEReadCounter.table","NW_015090842.1:6236260",33,73,40
"SDR42E1","s1664_F_GON_01_ASEReadCounter.table","NW_015090842.1:6236281",33,76,43
"SDR42E1","s1664_F_GON_01_ASEReadCounter.table","NW_015090842.1:6236305",36,88,52
"SDR42E1","s1664_F_GON_01_ASEReadCounter.table","NW_015090842.1:6236458",49,99,50
"SDR42E1","s1664_F_GON_01_ASEReadCounter.table","NW_015090842.1:6236476",57,109,52
"SDR42E1","s1664_F_GON_01_ASEReadCounter.table","NW_015090842.1:6236608",38,79,41
"SDR42E1","s1664_F_GON_01_ASEReadCounter.table","NW_015090842.1:6238244",28,58,30
"SDR42E1","s1664_F_GON_01_ASEReadCounter.table","NW_015090842.1:6238829",22,43,21
"HSD17B2","s1664_F_GON_01_ASEReadCounter.table","NW_015090842.1:6257758",0,1,1
"HSD17B2","s1664_F_GON_01_ASEReadCounter.table","NW_015090842.1:6257767",0,1,1
"HSD17B2","s1664_F_GON_01_ASEReadCounter.table","NW_015090842.1:6257829",0,1,1
"HSD17B2","s1664_F_GON_01_ASEReadCounter.table","NW_015090842.1:6257851",0,1,1
"HSD17B2","s1664_F_GON_01_ASEReadCounter.table","NW_015090842.1:6257889",0,1,1
"HSD17B2","s1664_F_GON_01_ASEReadCounter.table","NW_015090842.1:6262951",1,3,2
"HSD17B2","s1664_F_GON_01_ASEReadCounter.table","NW_015090842.1:6262974",0,1,1
"HSD17B2","s1664_F_GON_01_ASEReadCounter.table","NW_015090842.1:6266125",0,1,1
"HSD17B2","s1664_F_GON_01_ASEReadCounter.table","NW_015090842.1:6266135",1,2,1
"HSD17B2","s1664_F_GON_01_ASEReadCounter.table","NW_015090842.1:6266795",1,2,1
"HSD17B2","s1664_F_GON_01_ASEReadCounter.table","NW_015090842.1:6266944",2,3,1
"HSD17B2","s1664_F_GON_01_ASEReadCounter.table","NW_015090842.1:6267053",0,1,1
"HSD17B2","s1664_F_GON_01_ASEReadCounter.table","NW_015090842.1:6267196",0,1,1
"HSD17B2","s1664_F_GON_01_ASEReadCounter.table","NW_015090842.1:6267273",3,5,2
"HSD17B2","s1664_F_GON_01_ASEReadCounter.table","NW_015090842.1:6267913",1,1,0
"HSD17B2","s1664_F_GON_01_ASEReadCounter.table","NW_015090842.1:6268098",2,6,4
"HSD17B2","s1664_F_GON_01_ASEReadCounter.table","NW_015090842.1:6268203",2,4,2
"ARY2","s1664_F_GON_01_ASEReadCounter.table","NW_015090842.1:6303922",40,42,2
"ARY2","s1664_F_GON_01_ASEReadCounter.table","NW_015090842.1:6303954",33,35,2
"ARY2","s1664_F_GON_01_ASEReadCounter.table","NW_015090842.1:6303979",36,36,0
"ARY2","s1664_F_GON_01_ASEReadCounter.table","NW_015090842.1:6305848",42,45,3
"ARY2","s1664_F_GON_01_ASEReadCounter.table","NW_015090842.1:6305856",38,41,3
"ARY2","s1664_F_GON_01_ASEReadCounter.table","NW_015090842.1:6305857",37,40,3
"ARY2","s1664_F_GON_01_ASEReadCounter.table","NW_015090842.1:6306017",41,41,0
"ARY2","s1664_F_GON_01_ASEReadCounter.table","NW_015090842.1:6306052",45,46,1
"ARY2","s1664_F_GON_01_ASEReadCounter.table","NW_015090842.1:6306094",48,49,1
"ARY2","s1664_F_GON_01_ASEReadCounter.table","NW_015090842.1:6306100",46,47,1
"ARY2","s1664_F_GON_01_ASEReadCounter.table","NW_015090842.1:6306146",39,40,1
"ARY2","s1664_F_GON_01_ASEReadCounter.table","NW_015090842.1:6306147",39,40,1
"ARY2","s1664_F_GON_01_ASEReadCounter.table","NW_015090842.1:6306390",33,34,1
"ARY2","s1664_F_GON_01_ASEReadCounter.table","NW_015090842.1:6306567",22,23,1
"ARY2","s1664_F_GON_01_ASEReadCounter.table","NW_015090842.1:6307429",2,3,1
"ARYL","s1664_F_GON_01_ASEReadCounter.table","NW_015090842.1:6313360",2,3,1
"ARYL","s1664_F_GON_01_ASEReadCounter.table","NW_015090842.1:6313377",2,3,1
"ARYL","s1664_F_GON_01_ASEReadCounter.table","NW_015090842.1:6313767",1,3,2
"ARY1","s1664_F_GON_01_ASEReadCounter.table","NW_015090842.1:6314296",1,7,6
"ARY1","s1664_F_GON_01_ASEReadCounter.table","NW_015090842.1:6314541",1,5,4
"ARY1","s1664_F_GON_01_ASEReadCounter.table","NW_015090842.1:6314597",0,4,4
"ARY1","s1664_F_GON_01_ASEReadCounter.table","NW_015090842.1:6314750",2,7,5
"ARY1","s1664_F_GON_01_ASEReadCounter.table","NW_015090842.1:6314794",0,2,2
"ARY1","s1664_F_GON_01_ASEReadCounter.table","NW_015090842.1:6314827",1,3,2
"ARY1","s1664_F_GON_01_ASEReadCounter.table","NW_015090842.1:6314859",1,3,2
"ARY1","s1664_F_GON_01_ASEReadCounter.table","NW_015090842.1:6314886",1,3,2
"ARY1","s1664_F_GON_01_ASEReadCounter.table","NW_015090842.1:6315022",2,5,3
"ARY1","s1664_F_GON_01_ASEReadCounter.table","NW_015090842.1:6315026",2,4,2
"ARY1","s1664_F_GON_01_ASEReadCounter.table","NW_015090842.1:6315043",0,1,1
"ARY1","s1664_F_GON_01_ASEReadCounter.table","NW_015090842.1:6315065",1,2,1
"ARY1","s1664_F_GON_01_ASEReadCounter.table","NW_015090842.1:6315409",1,4,3
"ARY1","s1664_F_GON_01_ASEReadCounter.table","NW_015090842.1:6315479",0,3,3
"ARY1","s1664_F_GON_01_ASEReadCounter.table","NW_015090842.1:6318342",2,4,2
"ARY1","s1664_F_GON_01_ASEReadCounter.table","NW_015090842.1:6318427",2,5,3
"ARY1","s1664_F_GON_01_ASEReadCounter.table","NW_015090842.1:6318603",2,3,1
"ARY1","s1664_F_GON_01_ASEReadCounter.table","NW_015090842.1:6318708",3,6,3
"ARY1","s1664_F_GON_01_ASEReadCounter.table","NW_015090842.1:6318858",3,5,2
"ARY1","s1664_F_GON_01_ASEReadCounter.table","NW_015090842.1:6318952",3,5,2
"MPHOSPH6","s1664_F_GON_01_ASEReadCounter.table","NW_015090842.1:6324063",19,43,24
"MPHOSPH6","s1664_F_GON_01_ASEReadCounter.table","NW_015090842.1:6324174",40,85,45
"MPHOSPH6","s1664_F_GON_01_ASEReadCounter.table","NW_015090842.1:6324270",38,96,58
"MPHOSPH6","s1664_F_GON_01_ASEReadCounter.table","NW_015090842.1:6324762",58,97,39
"MPHOSPH6","s1664_F_GON_01_ASEReadCounter.table","NW_015090842.1:6324780",51,83,32
"MPHOSPH6","s1664_F_GON_01_ASEReadCounter.table","NW_015090842.1:6324902",52,103,51
"MPHOSPH6","s1664_F_GON_01_ASEReadCounter.table","NW_015090842.1:6325066",63,122,59
"MPHOSPH6","s1664_F_GON_01_ASEReadCounter.table","NW_015090842.1:6325089",78,145,67
"MPHOSPH6","s1664_F_GON_01_ASEReadCounter.table","NW_015090842.1:6325877",91,192,101
"MPHOSPH6","s1664_F_GON_01_ASEReadCounter.table","NW_015090842.1:6326976",79,166,87
"CDH13","s1664_F_GON_01_ASEReadCounter.table","NW_015090842.1:6662283",3,7,4
"CDH13","s1664_F_GON_01_ASEReadCounter.table","NW_015090842.1:6693665",5,5,0
"CDH13","s1664_F_GON_01_ASEReadCounter.table","NW_015090842.1:6693697",3,5,2
"CDH13","s1664_F_GON_01_ASEReadCounter.table","NW_015090842.1:6693712",2,4,2
"CDH13","s1664_F_GON_01_ASEReadCounter.table","NW_015090842.1:6693723",1,3,2
"CDH13","s1664_F_GON_01_ASEReadCounter.table","NW_015090842.1:6693738",1,3,2
"CDH13","s1664_F_GON_01_ASEReadCounter.table","NW_015090842.1:6823730",2,3,1
"CDH13","s1664_F_GON_01_ASEReadCounter.table","NW_015090842.1:6889713",4,7,3
"CDH13","s1664_F_GON_01_ASEReadCounter.table","NW_015090842.1:6955167",6,7,1
"MLYCD","s1664_F_GON_01_ASEReadCounter.table","NW_015090842.1:7150054",34,68,34
"MLYCD","s1664_F_GON_01_ASEReadCounter.table","NW_015090842.1:7150131",36,86,50
"MLYCD","s1664_F_GON_01_ASEReadCounter.table","NW_015090842.1:7150585",16,43,27
"MLYCD","s1664_F_GON_01_ASEReadCounter.table","NW_015090842.1:7150686",16,34,18
"MLYCD","s1664_F_GON_01_ASEReadCounter.table","NW_015090842.1:7150696",16,36,20
"MLYCD","s1664_F_GON_01_ASEReadCounter.table","NW_015090842.1:7150869",12,35,23
"MLYCD","s1664_F_GON_01_ASEReadCounter.table","NW_015090842.1:7151100",14,31,17
"MLYCD","s1664_F_GON_01_ASEReadCounter.table","NW_015090842.1:7151127",18,32,14
"MLYCD","s1664_F_GON_01_ASEReadCounter.table","NW_015090842.1:7157538",13,30,17
"MLYCD","s1664_F_GON_01_ASEReadCounter.table","NW_015090842.1:7167662",5,15,10
"MLYCD","s1664_F_GON_01_ASEReadCounter.table","NW_015090842.1:7167675",6,17,11
"MLYCD","s1664_F_GON_01_ASEReadCounter.table","NW_015090842.1:7167710",5,18,13
"MLYCD","s1664_F_GON_01_ASEReadCounter.table","NW_015090842.1:7167781",6,15,9
"MLYCD","s1664_F_GON_01_ASEReadCounter.table","NW_015090842.1:7167803",5,9,4
"MLYCD","s1664_F_GON_01_ASEReadCounter.table","NW_015090842.1:7167812",4,6,2
"MLYCD","s1664_F_GON_01_ASEReadCounter.table","NW_015090842.1:7167845",4,12,8
"MLYCD","s1664_F_GON_01_ASEReadCounter.table","NW_015090842.1:7167862",4,14,10
"MLYCD","s1664_F_GON_01_ASEReadCounter.table","NW_015090842.1:7167929",5,13,8
"MLYCD","s1664_F_GON_01_ASEReadCounter.table","NW_015090842.1:7167995",5,11,6
"MLYCD","s1664_F_GON_01_ASEReadCounter.table","NW_015090842.1:7168005",5,9,4
"MLYCD","s1664_F_GON_01_ASEReadCounter.table","NW_015090842.1:7168037",5,8,3
"HSBP1","s1664_F_GON_01_ASEReadCounter.table","NW_015090842.1:7245192",139,253,114
"HSBP1","s1664_F_GON_01_ASEReadCounter.table","NW_015090842.1:7245226",155,283,128
"HSBP1","s1664_F_GON_01_ASEReadCounter.table","NW_015090842.1:7245257",139,246,107
"HSBP1","s1664_F_GON_01_ASEReadCounter.table","NW_015090842.1:7245296",107,232,125
"HSBP1","s1664_F_GON_01_ASEReadCounter.table","NW_015090842.1:7245389",171,313,142
"HSBP1","s1664_F_GON_01_ASEReadCounter.table","NW_015090842.1:7245400",181,305,124
"HSBP1","s1664_F_GON_01_ASEReadCounter.table","NW_015090842.1:7245445",147,264,117
"HSBP1","s1664_F_GON_01_ASEReadCounter.table","NW_015090842.1:7245495",132,235,103
"HSBP1","s1664_F_GON_01_ASEReadCounter.table","NW_015090842.1:7245733",92,175,83
"HSBP1","s1664_F_GON_01_ASEReadCounter.table","NW_015090842.1:7245771",118,193,75
"HSBP1","s1664_F_GON_01_ASEReadCounter.table","NW_015090842.1:7245813",108,180,72
"HSBP1","s1664_F_GON_01_ASEReadCounter.table","NW_015090842.1:7245926",129,210,81
"HSBP1","s1664_F_GON_01_ASEReadCounter.table","NW_015090842.1:7245927",131,212,81
"HSBP1","s1664_F_GON_01_ASEReadCounter.table","NW_015090842.1:7245933",126,207,81
"HSBP1","s1664_F_GON_01_ASEReadCounter.table","NW_015090842.1:7246002",80,152,72
"HSBP1","s1664_F_GON_01_ASEReadCounter.table","NW_015090842.1:7246094",102,176,74
"HSBP1","s1664_F_GON_01_ASEReadCounter.table","NW_015090842.1:7246167",92,158,66
"HSBP1","s1664_F_GON_01_ASEReadCounter.table","NW_015090842.1:7246183",86,153,67
"HSBP1","s1664_F_GON_01_ASEReadCounter.table","NW_015090842.1:7247285",35,51,16
"HSBP1","s1664_F_GON_01_ASEReadCounter.table","NW_015090842.1:7247651",310,696,386
"HSBP1","s1664_F_GON_01_ASEReadCounter.table","NW_015090842.1:7247657",309,698,389
"HSBP1","s1664_F_GON_01_ASEReadCounter.table","NW_015090842.1:7248520",270,536,266
"HSBP1","s1664_F_GON_01_ASEReadCounter.table","NW_015090842.1:7248535",248,473,225
"KCNG4","s1664_F_GON_01_ASEReadCounter.table","NW_015090842.1:7282481",9,26,17
"KCNG4","s1664_F_GON_01_ASEReadCounter.table","NW_015090842.1:7282500",7,23,16
"KCNG4","s1664_F_GON_01_ASEReadCounter.table","NW_015090842.1:7282542",12,29,17
"KCNG4","s1664_F_GON_01_ASEReadCounter.table","NW_015090842.1:7282579",9,29,20
"KCNG4","s1664_F_GON_01_ASEReadCounter.table","NW_015090842.1:7282630",11,27,16
"KCNG4","s1664_F_GON_01_ASEReadCounter.table","NW_015090842.1:7283056",3,20,17
"KCNG4","s1664_F_GON_01_ASEReadCounter.table","NW_015090842.1:7283245",8,19,11
"KCNG4","s1664_F_GON_01_ASEReadCounter.table","NW_015090842.1:7301195",1,7,6
"KCNG4","s1664_F_GON_01_ASEReadCounter.table","NW_015090842.1:7301227",4,12,8
"KCNG4","s1664_F_GON_01_ASEReadCounter.table","NW_015090842.1:7301240",4,11,7
"KCNG4","s1664_F_GON_01_ASEReadCounter.table","NW_015090842.1:7301413",3,11,8
"WFDC1","s1664_F_GON_01_ASEReadCounter.table","NW_015090842.1:7366517",1,1,0
"WFDC1","s1664_F_GON_01_ASEReadCounter.table","NW_015090842.1:7373367",2,3,1
"WFDC1","s1664_F_GON_01_ASEReadCounter.table","NW_015090842.1:7375828",1,4,3
"WFDC1","s1664_F_GON_01_ASEReadCounter.table","NW_015090842.1:7378036",0,2,2
"WFDC1","s1664_F_GON_01_ASEReadCounter.table","NW_015090842.1:7379125",0,2,2
"WFDC1","s1664_F_GON_01_ASEReadCounter.table","NW_015090842.1:7379451",1,4,3
"WFDC1","s1664_F_GON_01_ASEReadCounter.table","NW_015090842.1:7379471",1,3,2
"WFDC1","s1664_F_GON_01_ASEReadCounter.table","NW_015090842.1:7379576",1,3,2
"WFDC1","s1664_F_GON_01_ASEReadCounter.table","NW_015090842.1:7379596",1,3,2
"WFDC1","s1664_F_GON_01_ASEReadCounter.table","NW_015090842.1:7379605",1,4,3
"WFDC1","s1664_F_GON_01_ASEReadCounter.table","NW_015090842.1:7379626",1,3,2
"WFDC1","s1664_F_GON_01_ASEReadCounter.table","NW_015090842.1:7379631",1,3,2
"WFDC1","s1664_F_GON_01_ASEReadCounter.table","NW_015090842.1:7379632",1,3,2
"WFDC1","s1664_F_GON_01_ASEReadCounter.table","NW_015090842.1:7379652",1,3,2
"WFDC1","s1664_F_GON_01_ASEReadCounter.table","NW_015090842.1:7379669",1,2,1
"WFDC1","s1664_F_GON_01_ASEReadCounter.table","NW_015090842.1:7379674",1,2,1
"WFDC1","s1664_F_GON_01_ASEReadCounter.table","NW_015090842.1:7379719",1,2,1
"WFDC1","s1664_F_GON_01_ASEReadCounter.table","NW_015090842.1:7379735",0,2,2
"WFDC1","s1664_F_GON_01_ASEReadCounter.table","NW_015090842.1:7379739",0,1,1
"WFDC1","s1664_F_GON_01_ASEReadCounter.table","NW_015090842.1:7379821",3,4,1
"WFDC1","s1664_F_GON_01_ASEReadCounter.table","NW_015090842.1:7379840",3,4,1
"WFDC1","s1664_F_GON_01_ASEReadCounter.table","NW_015090842.1:7379933",1,2,1
"WFDC1","s1664_F_GON_01_ASEReadCounter.table","NW_015090842.1:7379935",1,2,1
"WFDC1","s1664_F_GON_01_ASEReadCounter.table","NW_015090842.1:7379983",2,5,3
"WFDC1","s1664_F_GON_01_ASEReadCounter.table","NW_015090842.1:7380060",5,8,3
"WFDC1","s1664_F_GON_01_ASEReadCounter.table","NW_015090842.1:7380136",3,3,0
"WFDC1","s1664_F_GON_01_ASEReadCounter.table","NW_015090842.1:7380150",3,4,1
"WFDC1","s1664_F_GON_01_ASEReadCounter.table","NW_015090842.1:7380164",3,4,1
"WFDC1","s1664_F_GON_01_ASEReadCounter.table","NW_015090842.1:7380237",0,2,2
"WFDC1","s1664_F_GON_01_ASEReadCounter.table","NW_015090842.1:7380261",1,3,2
"WFDC1","s1664_F_GON_01_ASEReadCounter.table","NW_015090842.1:7380322",1,5,4
"WFDC1","s1664_F_GON_01_ASEReadCounter.table","NW_015090842.1:7380491",0,6,6
"WFDC1","s1664_F_GON_01_ASEReadCounter.table","NW_015090842.1:7380567",3,8,5
"WFDC1","s1664_F_GON_01_ASEReadCounter.table","NW_015090842.1:7380672",2,5,3
"WFDC1","s1664_F_GON_01_ASEReadCounter.table","NW_015090842.1:7380721",0,5,5
"WFDC1","s1664_F_GON_01_ASEReadCounter.table","NW_015090842.1:7380743",3,5,2
"WFDC1","s1664_F_GON_01_ASEReadCounter.table","NW_015090842.1:7380852",2,3,1
"WFDC1","s1664_F_GON_01_ASEReadCounter.table","NW_015090842.1:7380878",3,5,2
"WFDC1","s1664_F_GON_01_ASEReadCounter.table","NW_015090842.1:7381081",7,18,11
"WFDC1","s1664_F_GON_01_ASEReadCounter.table","NW_015090842.1:7381127",3,14,11
"WFDC1","s1664_F_GON_01_ASEReadCounter.table","NW_015090842.1:7381195",4,14,10
"WFDC1","s1664_F_GON_01_ASEReadCounter.table","NW_015090842.1:7381253",5,15,10
"WFDC1","s1664_F_GON_01_ASEReadCounter.table","NW_015090842.1:7381378",10,22,12
"WFDC1","s1664_F_GON_01_ASEReadCounter.table","NW_015090842.1:7381433",11,22,11
"WFDC1","s1664_F_GON_01_ASEReadCounter.table","NW_015090842.1:7381434",11,22,11
"WFDC1","s1664_F_GON_01_ASEReadCounter.table","NW_015090842.1:7381442",13,28,15
"WFDC1","s1664_F_GON_01_ASEReadCounter.table","NW_015090842.1:7381517",7,21,14
"WFDC1","s1664_F_GON_01_ASEReadCounter.table","NW_015090842.1:7381520",7,23,16
"WFDC1","s1664_F_GON_01_ASEReadCounter.table","NW_015090842.1:7381677",3,14,11
"WFDC1","s1664_F_GON_01_ASEReadCounter.table","NW_015090842.1:7381709",1,7,6
"ATP2C2","s1664_F_GON_01_ASEReadCounter.table","NW_015090842.1:7395366",0,1,1
"ATP2C2","s1664_F_GON_01_ASEReadCounter.table","NW_015090842.1:7396756",0,3,3
"ATP2C2","s1664_F_GON_01_ASEReadCounter.table","NW_015090842.1:7397049",0,1,1
"ATP2C2","s1664_F_GON_01_ASEReadCounter.table","NW_015090842.1:7398395",1,1,0
"ATP2C2","s1664_F_GON_01_ASEReadCounter.table","NW_015090842.1:7399774",1,1,0
"ATP2C2","s1664_F_GON_01_ASEReadCounter.table","NW_015090842.1:7402554",0,1,1
"ATP2C2","s1664_F_GON_01_ASEReadCounter.table","NW_015090842.1:7402578",0,1,1
"ATP2C2","s1664_F_GON_01_ASEReadCounter.table","NW_015090842.1:7405621",0,1,1
"ATP2C2","s1664_F_GON_01_ASEReadCounter.table","NW_015090842.1:7413855",7,12,5
"ATP2C2","s1664_F_GON_01_ASEReadCounter.table","NW_015090842.1:7413869",1,6,5
"ATP2C2","s1664_F_GON_01_ASEReadCounter.table","NW_015090842.1:7413875",1,6,5
"TLDC1","s1664_F_GON_01_ASEReadCounter.table","NW_015090842.1:7421137",12,19,7
"TLDC1","s1664_F_GON_01_ASEReadCounter.table","NW_015090842.1:7421155",11,17,6
"TLDC1","s1664_F_GON_01_ASEReadCounter.table","NW_015090842.1:7421218",14,27,13
"TLDC1","s1664_F_GON_01_ASEReadCounter.table","NW_015090842.1:7421399",10,21,11
"TLDC1","s1664_F_GON_01_ASEReadCounter.table","NW_015090842.1:7421402",10,21,11
"TLDC1","s1664_F_GON_01_ASEReadCounter.table","NW_015090842.1:7421528",16,26,10
"TLDC1","s1664_F_GON_01_ASEReadCounter.table","NW_015090842.1:7421532",17,27,10
"TLDC1","s1664_F_GON_01_ASEReadCounter.table","NW_015090842.1:7421621",18,32,14
"TLDC1","s1664_F_GON_01_ASEReadCounter.table","NW_015090842.1:7421647",12,24,12
"TLDC1","s1664_F_GON_01_ASEReadCounter.table","NW_015090842.1:7421657",12,25,13
"TLDC1","s1664_F_GON_01_ASEReadCounter.table","NW_015090842.1:7421693",17,31,14
"TLDC1","s1664_F_GON_01_ASEReadCounter.table","NW_015090842.1:7421796",10,24,14
"TLDC1","s1664_F_GON_01_ASEReadCounter.table","NW_015090842.1:7421810",9,23,14
"TLDC1","s1664_F_GON_01_ASEReadCounter.table","NW_015090842.1:7421833",10,29,19
"TLDC1","s1664_F_GON_01_ASEReadCounter.table","NW_015090842.1:7421879",16,32,16
"TLDC1","s1664_F_GON_01_ASEReadCounter.table","NW_015090842.1:7421914",18,39,21
"TLDC1","s1664_F_GON_01_ASEReadCounter.table","NW_015090842.1:7421969",13,24,11
"TLDC1","s1664_F_GON_01_ASEReadCounter.table","NW_015090842.1:7422015",11,22,11
"TLDC1","s1664_F_GON_01_ASEReadCounter.table","NW_015090842.1:7422042",9,20,11
"TLDC1","s1664_F_GON_01_ASEReadCounter.table","NW_015090842.1:7422230",12,27,15
"TLDC1","s1664_F_GON_01_ASEReadCounter.table","NW_015090842.1:7423349",9,17,8
"TLDC1","s1664_F_GON_01_ASEReadCounter.table","NW_015090842.1:7423362",8,15,7
"TLDC1","s1664_F_GON_01_ASEReadCounter.table","NW_015090842.1:7426091",12,24,12
"TLDC1","s1664_F_GON_01_ASEReadCounter.table","NW_015090842.1:7426485",10,20,10
"TLDC1","s1664_F_GON_01_ASEReadCounter.table","NW_015090842.1:7427211",16,29,13
"TLDC1","s1664_F_GON_01_ASEReadCounter.table","NW_015090842.1:7428179",10,20,10
"COTL1","s1664_F_GON_01_ASEReadCounter.table","NW_015090842.1:7490744",12,29,17
"COTL1","s1664_F_GON_01_ASEReadCounter.table","NW_015090842.1:7491051",4,12,8
"COTL1","s1664_F_GON_01_ASEReadCounter.table","NW_015090842.1:7491124",6,21,15
"COTL1","s1664_F_GON_01_ASEReadCounter.table","NW_015090842.1:7491418",5,13,8
"COTL1","s1664_F_GON_01_ASEReadCounter.table","NW_015090842.1:7491539",3,6,3
"COTL1","s1664_F_GON_01_ASEReadCounter.table","NW_015090842.1:7491585",4,9,5
"COTL1","s1664_F_GON_01_ASEReadCounter.table","NW_015090842.1:7491586",4,10,6
"COTL1","s1664_F_GON_01_ASEReadCounter.table","NW_015090842.1:7491646",4,19,15
"COTL1","s1664_F_GON_01_ASEReadCounter.table","NW_015090842.1:7491747",4,14,10
"COTL1","s1664_F_GON_01_ASEReadCounter.table","NW_015090842.1:7491803",7,18,11
"COTL1","s1664_F_GON_01_ASEReadCounter.table","NW_015090842.1:7507551",0,1,1
"COTL1","s1664_F_GON_01_ASEReadCounter.table","NW_015090842.1:7507563",0,1,1
"COTL1","s1664_F_GON_01_ASEReadCounter.table","NW_015090842.1:7510900",0,1,1
"COTL1","s1664_F_GON_01_ASEReadCounter.table","NW_015090842.1:7513196",4,5,1
"COTL1","s1664_F_GON_01_ASEReadCounter.table","NW_015090842.1:7513223",3,4,1
"COTL1","s1664_F_GON_01_ASEReadCounter.table","NW_015090842.1:7513239",1,2,1
"KLHL36","s1664_F_GON_01_ASEReadCounter.table","NW_015090842.1:7514700",3,4,1
"KLHL36","s1664_F_GON_01_ASEReadCounter.table","NW_015090842.1:7519691",0,1,1
"KLHL36","s1664_F_GON_01_ASEReadCounter.table","NW_015090842.1:7519696",0,1,1
"KLHL36","s1664_F_GON_01_ASEReadCounter.table","NW_015090842.1:7526160",2,7,5
"KLHL36","s1664_F_GON_01_ASEReadCounter.table","NW_015090842.1:7526469",0,4,4
"KLHL36","s1664_F_GON_01_ASEReadCounter.table","NW_015090842.1:7526587",4,8,4
"KLHL36","s1664_F_GON_01_ASEReadCounter.table","NW_015090842.1:7526997",1,4,3
"KLHL36","s1664_F_GON_01_ASEReadCounter.table","NW_015090842.1:7527142",4,5,1
"KLHL36","s1664_F_GON_01_ASEReadCounter.table","NW_015090842.1:7535174",1,8,7
"KLHL36","s1664_F_GON_01_ASEReadCounter.table","NW_015090842.1:7535384",2,9,7
"KLHL36","s1664_F_GON_01_ASEReadCounter.table","NW_015090842.1:7535420",3,9,6
"KLHL36","s1664_F_GON_01_ASEReadCounter.table","NW_015090842.1:7535545",1,3,2
"KLHL36","s1664_F_GON_01_ASEReadCounter.table","NW_015090842.1:7535829",2,7,5
"KLHL36","s1664_F_GON_01_ASEReadCounter.table","NW_015090842.1:7535977",1,2,1
"KLHL36","s1664_F_GON_01_ASEReadCounter.table","NW_015090842.1:7536010",1,3,2
"KLHL36","s1664_F_GON_01_ASEReadCounter.table","NW_015090842.1:7536051",1,5,4
"KLHL36","s1664_F_GON_01_ASEReadCounter.table","NW_015090842.1:7536096",1,7,6
"KLHL36","s1664_F_GON_01_ASEReadCounter.table","NW_015090842.1:7536135",2,8,6
"KLHL36","s1664_F_GON_01_ASEReadCounter.table","NW_015090842.1:7536136",2,7,5
"KLHL36","s1664_F_GON_01_ASEReadCounter.table","NW_015090842.1:7536160",2,7,5
"KLHL36","s1664_F_GON_01_ASEReadCounter.table","NW_015090842.1:7536336",2,3,1
"KLHL36","s1664_F_GON_01_ASEReadCounter.table","NW_015090842.1:7536352",2,3,1
"KLHL36","s1664_F_GON_01_ASEReadCounter.table","NW_015090842.1:7536412",1,3,2
"KLHL36","s1664_F_GON_01_ASEReadCounter.table","NW_015090842.1:7536418",1,3,2
"KLHL36","s1664_F_GON_01_ASEReadCounter.table","NW_015090842.1:7536465",1,5,4
"KLHL36","s1664_F_GON_01_ASEReadCounter.table","NW_015090842.1:7536466",1,5,4
"KLHL36","s1664_F_GON_01_ASEReadCounter.table","NW_015090842.1:7536553",4,5,1
"KLHL36","s1664_F_GON_01_ASEReadCounter.table","NW_015090842.1:7536698",3,4,1
"KLHL36","s1664_F_GON_01_ASEReadCounter.table","NW_015090842.1:7536713",2,3,1
"KLHL36","s1664_F_GON_01_ASEReadCounter.table","NW_015090842.1:7536720",4,4,0
"KLHL36","s1664_F_GON_01_ASEReadCounter.table","NW_015090842.1:7536791",2,3,1
"KLHL36","s1664_F_GON_01_ASEReadCounter.table","NW_015090842.1:7536849",2,5,3
"KLHL36","s1664_F_GON_01_ASEReadCounter.table","NW_015090842.1:7536872",2,4,2
"KLHL36","s1664_F_GON_01_ASEReadCounter.table","NW_015090842.1:7536878",2,5,3
"KLHL36","s1664_F_GON_01_ASEReadCounter.table","NW_015090842.1:7536916",4,7,3
"KLHL36","s1664_F_GON_01_ASEReadCounter.table","NW_015090842.1:7536927",4,7,3
"KLHL36","s1664_F_GON_01_ASEReadCounter.table","NW_015090842.1:7537315",6,12,6
"KLHL36","s1664_F_GON_01_ASEReadCounter.table","NW_015090842.1:7537352",5,8,3
"KLHL36","s1664_F_GON_01_ASEReadCounter.table","NW_015090842.1:7537631",6,9,3
"KLHL36","s1664_F_GON_01_ASEReadCounter.table","NW_015090842.1:7537830",13,19,6
"KLHL36","s1664_F_GON_01_ASEReadCounter.table","NW_015090842.1:7537838",12,19,7
"KLHL36","s1664_F_GON_01_ASEReadCounter.table","NW_015090842.1:7538153",9,29,20
"KLHL36","s1664_F_GON_01_ASEReadCounter.table","NW_015090842.1:7538256",12,34,22
"KLHL36","s1664_F_GON_01_ASEReadCounter.table","NW_015090842.1:7538265",13,33,20
"KLHL36","s1664_F_GON_01_ASEReadCounter.table","NW_015090842.1:7538300",11,30,19
"USP10","s1664_F_GON_01_ASEReadCounter.table","NW_015090842.1:7563972",0,3,3
"USP10","s1664_F_GON_01_ASEReadCounter.table","NW_015090842.1:7571816",7,15,8
"USP10","s1664_F_GON_01_ASEReadCounter.table","NW_015090842.1:7571993",5,12,7
"USP10","s1664_F_GON_01_ASEReadCounter.table","NW_015090842.1:7572580",8,14,6
"USP10","s1664_F_GON_01_ASEReadCounter.table","NW_015090842.1:7587372",14,36,22
"CRISPLD2","s1664_F_GON_01_ASEReadCounter.table","NW_015090842.1:7604605",3,3,0
"CRISPLD2","s1664_F_GON_01_ASEReadCounter.table","NW_015090842.1:7609844",5,5,0
"CRISPLD2","s1664_F_GON_01_ASEReadCounter.table","NW_015090842.1:7609845",5,5,0
"CRISPLD2","s1664_F_GON_01_ASEReadCounter.table","NW_015090842.1:7609883",3,3,0
"CRISPLD2","s1664_F_GON_01_ASEReadCounter.table","NW_015090842.1:7610084",3,3,0
"CRISPLD2","s1664_F_GON_01_ASEReadCounter.table","NW_015090842.1:7617757",1,1,0
"CRISPLD2","s1664_F_GON_01_ASEReadCounter.table","NW_015090842.1:7617781",3,3,0
"CRISPLD2","s1664_F_GON_01_ASEReadCounter.table","NW_015090842.1:7617790",3,3,0
"CRISPLD2","s1664_F_GON_01_ASEReadCounter.table","NW_015090842.1:7621452",3,3,0
"CRISPLD2","s1664_F_GON_01_ASEReadCounter.table","NW_015090842.1:7625451",4,4,0
"CRISPLD2","s1664_F_GON_01_ASEReadCounter.table","NW_015090842.1:7626214",2,2,0
"CRISPLD2","s1664_F_GON_01_ASEReadCounter.table","NW_015090842.1:7630784",2,2,0
"CRISPLD2","s1664_F_GON_01_ASEReadCounter.table","NW_015090842.1:7630823",2,2,0
"CRISPLD2","s1664_F_GON_01_ASEReadCounter.table","NW_015090842.1:7633172",5,5,0
"CRISPLD2","s1664_F_GON_01_ASEReadCounter.table","NW_015090842.1:7633326",5,5,0
"CRISPLD2","s1664_F_GON_01_ASEReadCounter.table","NW_015090842.1:7633336",5,5,0
"CRISPLD2","s1664_F_GON_01_ASEReadCounter.table","NW_015090842.1:7633381",7,7,0
"CRISPLD2","s1664_F_GON_01_ASEReadCounter.table","NW_015090842.1:7633388",6,6,0
"CRISPLD2","s1664_F_GON_01_ASEReadCounter.table","NW_015090842.1:7633400",6,7,1
"CRISPLD2","s1664_F_GON_01_ASEReadCounter.table","NW_015090842.1:7633486",2,3,1
"CRISPLD2","s1664_F_GON_01_ASEReadCounter.table","NW_015090842.1:7633503",3,4,1
"CRISPLD2","s1664_F_GON_01_ASEReadCounter.table","NW_015090842.1:7633504",3,4,1
"CRISPLD2","s1664_F_GON_01_ASEReadCounter.table","NW_015090842.1:7633557",5,5,0
"CRISPLD2","s1664_F_GON_01_ASEReadCounter.table","NW_015090842.1:7633571",5,6,1
"CRISPLD2","s1664_F_GON_01_ASEReadCounter.table","NW_015090842.1:7633588",6,7,1
"CRISPLD2","s1664_F_GON_01_ASEReadCounter.table","NW_015090842.1:7633617",8,10,2
"CRISPLD2","s1664_F_GON_01_ASEReadCounter.table","NW_015090842.1:7633695",5,8,3
"CRISPLD2","s1664_F_GON_01_ASEReadCounter.table","NW_015090842.1:7633721",4,6,2
"CRISPLD2","s1664_F_GON_01_ASEReadCounter.table","NW_015090842.1:7633888",4,4,0
"CRISPLD2","s1664_F_GON_01_ASEReadCounter.table","NW_015090842.1:7633910",5,5,0
"CRISPLD2","s1664_F_GON_01_ASEReadCounter.table","NW_015090842.1:7634142",7,7,0
"CRISPLD2","s1664_F_GON_01_ASEReadCounter.table","NW_015090842.1:7634417",0,1,1
"CRISPLD2","s1664_F_GON_01_ASEReadCounter.table","NW_015090842.1:7634825",2,3,1
"CRISPLD2","s1664_F_GON_01_ASEReadCounter.table","NW_015090842.1:7634852",5,6,1
"CRISPLD2","s1664_F_GON_01_ASEReadCounter.table","NW_015090842.1:7635009",7,8,1
"CRISPLD2","s1664_F_GON_01_ASEReadCounter.table","NW_015090842.1:7635208",7,8,1
"CRISPLD2","s1664_F_GON_01_ASEReadCounter.table","NW_015090842.1:7635373",7,7,0
"CRISPLD2","s1664_F_GON_01_ASEReadCounter.table","NW_015090842.1:7635525",4,5,1
"CRISPLD2","s1664_F_GON_01_ASEReadCounter.table","NW_015090842.1:7635583",7,8,1
"CRISPLD2","s1664_F_GON_01_ASEReadCounter.table","NW_015090842.1:7635924",7,7,0
"LOC106888312","s1664_F_GON_01_ASEReadCounter.table","NW_015090842.1:7713031",1,1,0
"LOC106888312","s1664_F_GON_01_ASEReadCounter.table","NW_015090842.1:7727001",0,1,1
"LOC106888312","s1664_F_GON_01_ASEReadCounter.table","NW_015090842.1:7727036",0,1,1
"LOC106888312","s1664_F_GON_01_ASEReadCounter.table","NW_015090842.1:7727072",1,4,3
"LOC106888312","s1664_F_GON_01_ASEReadCounter.table","NW_015090842.1:7727961",3,4,1
"LOC106888312","s1664_F_GON_01_ASEReadCounter.table","NW_015090842.1:7732244",1,2,1
"LOC106888312","s1664_F_GON_01_ASEReadCounter.table","NW_015090842.1:7732443",2,4,2
"LOC106888312","s1664_F_GON_01_ASEReadCounter.table","NW_015090842.1:7732444",2,4,2
"LOC106888312","s1664_F_GON_01_ASEReadCounter.table","NW_015090842.1:7732538",0,1,1
"LOC106888312","s1664_F_GON_01_ASEReadCounter.table","NW_015090842.1:7732548",0,1,1
"LOC106888312","s1664_F_GON_01_ASEReadCounter.table","NW_015090842.1:7732860",1,1,0
"LOC106888312","s1664_F_GON_01_ASEReadCounter.table","NW_015090842.1:7732861",1,1,0
"LOC106888312","s1664_F_GON_01_ASEReadCounter.table","NW_015090842.1:7732918",1,1,0
"LOC106888312","s1664_F_GON_01_ASEReadCounter.table","NW_015090842.1:7732997",2,3,1
"LOC106888312","s1664_F_GON_01_ASEReadCounter.table","NW_015090842.1:7733011",1,2,1
"LOC106888312","s1664_F_GON_01_ASEReadCounter.table","NW_015090842.1:7733046",0,2,2
"LOC106888312","s1664_F_GON_01_ASEReadCounter.table","NW_015090842.1:7733068",2,4,2
"LOC106888312","s1664_F_GON_01_ASEReadCounter.table","NW_015090842.1:7733077",2,4,2
"LOC106888312","s1664_F_GON_01_ASEReadCounter.table","NW_015090842.1:7733096",2,6,4
"LOC106888312","s1664_F_GON_01_ASEReadCounter.table","NW_015090842.1:7733142",2,5,3
"LOC106888312","s1664_F_GON_01_ASEReadCounter.table","NW_015090842.1:7733196",0,3,3
"LOC106888312","s1664_F_GON_01_ASEReadCounter.table","NW_015090842.1:7733299",0,2,2
"LOC106888312","s1664_F_GON_01_ASEReadCounter.table","NW_015090842.1:7733470",2,3,1
"LOC106888312","s1664_F_GON_01_ASEReadCounter.table","NW_015090842.1:7733471",2,3,1
"LOC106888312","s1664_F_GON_01_ASEReadCounter.table","NW_015090842.1:7733472",1,2,1
"LOC106888312","s1664_F_GON_01_ASEReadCounter.table","NW_015090842.1:7733507",2,3,1
"LOC106888312","s1664_F_GON_01_ASEReadCounter.table","NW_015090842.1:7733508",2,3,1
"LOC106888312","s1664_F_GON_01_ASEReadCounter.table","NW_015090842.1:7733518",2,3,1
"LOC106888312","s1664_F_GON_01_ASEReadCounter.table","NW_015090842.1:7733609",1,1,0
"LOC106888312","s1664_F_GON_01_ASEReadCounter.table","NW_015090842.1:7733631",1,1,0
"LOC106888312","s1664_F_GON_01_ASEReadCounter.table","NW_015090842.1:7733674",1,1,0
"LOC106888312","s1664_F_GON_01_ASEReadCounter.table","NW_015090842.1:7733979",0,1,1
"LOC106888312","s1664_F_GON_01_ASEReadCounter.table","NW_015090842.1:7733981",0,1,1
"ZDHHC7","s1664_F_GON_01_ASEReadCounter.table","NW_015090842.1:7737199",8,24,16
"ZDHHC7","s1664_F_GON_01_ASEReadCounter.table","NW_015090842.1:7737332",7,17,10
"ZDHHC7","s1664_F_GON_01_ASEReadCounter.table","NW_015090842.1:7737553",10,22,12
"ZDHHC7","s1664_F_GON_01_ASEReadCounter.table","NW_015090842.1:7737920",10,17,7
"ZDHHC7","s1664_F_GON_01_ASEReadCounter.table","NW_015090842.1:7737953",8,13,5
"ZDHHC7","s1664_F_GON_01_ASEReadCounter.table","NW_015090842.1:7737987",6,8,2
"ZDHHC7","s1664_F_GON_01_ASEReadCounter.table","NW_015090842.1:7738068",6,7,1
"ZDHHC7","s1664_F_GON_01_ASEReadCounter.table","NW_015090842.1:7738204",9,14,5
"LOC106888097","s1664_F_GON_01_ASEReadCounter.table","NW_015090842.1:7767178",3,10,7
"LOC106888097","s1664_F_GON_01_ASEReadCounter.table","NW_015090842.1:7767187",3,12,9
"LOC106888097","s1664_F_GON_01_ASEReadCounter.table","NW_015090842.1:7768144",4,13,9
"LOC106888097","s1664_F_GON_01_ASEReadCounter.table","NW_015090842.1:7768196",7,16,9
"LOC106888097","s1664_F_GON_01_ASEReadCounter.table","NW_015090842.1:7769884",5,13,8
"LOC106888097","s1664_F_GON_01_ASEReadCounter.table","NW_015090842.1:7769893",4,10,6
"LOC106888097","s1664_F_GON_01_ASEReadCounter.table","NW_015090842.1:7770245",8,14,6
"LOC106888097","s1664_F_GON_01_ASEReadCounter.table","NW_015090842.1:7772402",6,17,11
"LOC106888097","s1664_F_GON_01_ASEReadCounter.table","NW_015090842.1:7772483",10,18,8
"LOC106888097","s1664_F_GON_01_ASEReadCounter.table","NW_015090842.1:7772490",11,19,8
"LOC106888097","s1664_F_GON_01_ASEReadCounter.table","NW_015090842.1:7774281",13,19,6
"LOC106888097","s1664_F_GON_01_ASEReadCounter.table","NW_015090842.1:7774552",12,25,13
"LOC106888097","s1664_F_GON_01_ASEReadCounter.table","NW_015090842.1:7774564",11,24,13
"LOC106888097","s1664_F_GON_01_ASEReadCounter.table","NW_015090842.1:7774611",12,28,16
"LOC106888097","s1664_F_GON_01_ASEReadCounter.table","NW_015090842.1:7774681",12,26,14
"LOC106888097","s1664_F_GON_01_ASEReadCounter.table","NW_015090842.1:7774698",7,21,14
"LOC106888097","s1664_F_GON_01_ASEReadCounter.table","NW_015090842.1:7774730",5,12,7
"FOXL1","s1664_F_GON_01_ASEReadCounter.table","NW_015090842.1:8113043",0,1,1
"FOXC2","s1664_F_GON_01_ASEReadCounter.table","NW_015090842.1:8130244",1,1,0
"MTHFSD","s1664_F_GON_01_ASEReadCounter.table","NW_015090842.1:8140051",51,111,60
"MTHFSD","s1664_F_GON_01_ASEReadCounter.table","NW_015090842.1:8142923",78,178,100
"MTHFSD","s1664_F_GON_01_ASEReadCounter.table","NW_015090842.1:8143029",85,192,107
"MTHFSD","s1664_F_GON_01_ASEReadCounter.table","NW_015090842.1:8152035",58,129,71
"MTHFSD","s1664_F_GON_01_ASEReadCounter.table","NW_015090842.1:8152315",38,77,39
"MTHFSD","s1664_F_GON_01_ASEReadCounter.table","NW_015090842.1:8152511",38,83,45
"MTHFSD","s1664_F_GON_01_ASEReadCounter.table","NW_015090842.1:8152518",36,77,41
"MTHFSD","s1664_F_GON_01_ASEReadCounter.table","NW_015090842.1:8152553",30,62,32
"MTHFSD","s1664_F_GON_01_ASEReadCounter.table","NW_015090842.1:8152773",58,121,63
"MTHFSD","s1664_F_GON_01_ASEReadCounter.table","NW_015090842.1:8152805",54,125,71
"IRF8","s1664_F_GON_01_ASEReadCounter.table","NW_015090842.1:8406652",4,9,5
"IRF8","s1664_F_GON_01_ASEReadCounter.table","NW_015090842.1:8406703",6,9,3
"IRF8","s1664_F_GON_01_ASEReadCounter.table","NW_015090842.1:8406704",6,9,3
"IRF8","s1664_F_GON_01_ASEReadCounter.table","NW_015090842.1:8406757",2,2,0
"IRF8","s1664_F_GON_01_ASEReadCounter.table","NW_015090842.1:8406778",2,3,1
"IRF8","s1664_F_GON_01_ASEReadCounter.table","NW_015090842.1:8406819",3,5,2
"IRF8","s1664_F_GON_01_ASEReadCounter.table","NW_015090842.1:8406941",2,3,1
"IRF8","s1664_F_GON_01_ASEReadCounter.table","NW_015090842.1:8407008",1,1,0
"IRF8","s1664_F_GON_01_ASEReadCounter.table","NW_015090842.1:8407057",0,1,1
"IRF8","s1664_F_GON_01_ASEReadCounter.table","NW_015090842.1:8407064",0,1,1
"IRF8","s1664_F_GON_01_ASEReadCounter.table","NW_015090842.1:8407069",0,3,3
"IRF8","s1664_F_GON_01_ASEReadCounter.table","NW_015090842.1:8407120",1,5,4
"IRF8","s1664_F_GON_01_ASEReadCounter.table","NW_015090842.1:8407157",2,5,3
"IRF8","s1664_F_GON_01_ASEReadCounter.table","NW_015090842.1:8407203",3,5,2
"IRF8","s1664_F_GON_01_ASEReadCounter.table","NW_015090842.1:8407272",2,5,3
"IRF8","s1664_F_GON_01_ASEReadCounter.table","NW_015090842.1:8407276",2,5,3
"IRF8","s1664_F_GON_01_ASEReadCounter.table","NW_015090842.1:8407303",2,6,4
"IRF8","s1664_F_GON_01_ASEReadCounter.table","NW_015090842.1:8407451",1,4,3
"IRF8","s1664_F_GON_01_ASEReadCounter.table","NW_015090842.1:8407456",2,5,3
"IRF8","s1664_F_GON_01_ASEReadCounter.table","NW_015090842.1:8408564",3,5,2
"IRF8","s1664_F_GON_01_ASEReadCounter.table","NW_015090842.1:8408585",4,4,0
"IRF8","s1664_F_GON_01_ASEReadCounter.table","NW_015090842.1:8408973",0,2,2
"IRF8","s1664_F_GON_01_ASEReadCounter.table","NW_015090842.1:8409254",0,2,2
"IRF8","s1664_F_GON_01_ASEReadCounter.table","NW_015090842.1:8409255",0,2,2
"IRF8","s1664_F_GON_01_ASEReadCounter.table","NW_015090842.1:8409258",0,2,2
"IRF8","s1664_F_GON_01_ASEReadCounter.table","NW_015090842.1:8409312",2,3,1
"IRF8","s1664_F_GON_01_ASEReadCounter.table","NW_015090842.1:8410216",2,2,0
"IRF8","s1664_F_GON_01_ASEReadCounter.table","NW_015090842.1:8410237",2,3,1
"IRF8","s1664_F_GON_01_ASEReadCounter.table","NW_015090842.1:8410276",3,3,0
"IRF8","s1664_F_GON_01_ASEReadCounter.table","NW_015090842.1:8410813",1,3,2
"IRF8","s1664_F_GON_01_ASEReadCounter.table","NW_015090842.1:8410861",0,2,2
"IRF8","s1664_F_GON_01_ASEReadCounter.table","NW_015090842.1:8411940",2,3,1
"IRF8","s1664_F_GON_01_ASEReadCounter.table","NW_015090842.1:8412006",0,1,1
"COX4I1","s1664_F_GON_01_ASEReadCounter.table","NW_015090842.1:8442258",1213,2428,1215
"COX4I1","s1664_F_GON_01_ASEReadCounter.table","NW_015090842.1:8442333",1012,2039,1027
"EMC8","s1664_F_GON_01_ASEReadCounter.table","NW_015090842.1:8444046",157,323,166
"EMC8","s1664_F_GON_01_ASEReadCounter.table","NW_015090842.1:8444064",134,273,139
"EMC8","s1664_F_GON_01_ASEReadCounter.table","NW_015090842.1:8452029",24,60,36
"EMC8","s1664_F_GON_01_ASEReadCounter.table","NW_015090842.1:8452116",29,66,37
"EMC8","s1664_F_GON_01_ASEReadCounter.table","NW_015090842.1:8452121",28,68,40
"EMC8","s1664_F_GON_01_ASEReadCounter.table","NW_015090842.1:8452222",29,67,38
"EMC8","s1664_F_GON_01_ASEReadCounter.table","NW_015090842.1:8452244",37,81,44
"EMC8","s1664_F_GON_01_ASEReadCounter.table","NW_015090842.1:8452477",14,22,8
"EMC8","s1664_F_GON_01_ASEReadCounter.table","NW_015090842.1:8452498",17,24,7
"EMC8","s1664_F_GON_01_ASEReadCounter.table","NW_015090842.1:8452535",11,14,3
"EMC8","s1664_F_GON_01_ASEReadCounter.table","NW_015090842.1:8452575",6,8,2
"EMC8","s1664_F_GON_01_ASEReadCounter.table","NW_015090842.1:8452600",9,16,7
"EMC8","s1664_F_GON_01_ASEReadCounter.table","NW_015090842.1:8452616",10,17,7
"EMC8","s1664_F_GON_01_ASEReadCounter.table","NW_015090842.1:8452630",8,12,4
"EMC8","s1664_F_GON_01_ASEReadCounter.table","NW_015090842.1:8452650",7,14,7
"EMC8","s1664_F_GON_01_ASEReadCounter.table","NW_015090842.1:8452678",10,16,6
"EMC8","s1664_F_GON_01_ASEReadCounter.table","NW_015090842.1:8452724",10,14,4
"EMC8","s1664_F_GON_01_ASEReadCounter.table","NW_015090842.1:8452731",10,15,5
"EMC8","s1664_F_GON_01_ASEReadCounter.table","NW_015090842.1:8452743",10,20,10
"EMC8","s1664_F_GON_01_ASEReadCounter.table","NW_015090842.1:8452750",8,19,11
"EMC8","s1664_F_GON_01_ASEReadCounter.table","NW_015090842.1:8452778",8,23,15
"EMC8","s1664_F_GON_01_ASEReadCounter.table","NW_015090842.1:8452783",7,22,15
"EMC8","s1664_F_GON_01_ASEReadCounter.table","NW_015090842.1:8452800",9,24,15
"EMC8","s1664_F_GON_01_ASEReadCounter.table","NW_015090842.1:8452804",9,24,15
"EMC8","s1664_F_GON_01_ASEReadCounter.table","NW_015090842.1:8452812",9,24,15
"EMC8","s1664_F_GON_01_ASEReadCounter.table","NW_015090842.1:8452858",9,21,12
"EMC8","s1664_F_GON_01_ASEReadCounter.table","NW_015090842.1:8452906",24,40,16
"EMC8","s1664_F_GON_01_ASEReadCounter.table","NW_015090842.1:8452913",24,41,17
"EMC8","s1664_F_GON_01_ASEReadCounter.table","NW_015090842.1:8453000",18,44,26
"EMC8","s1664_F_GON_01_ASEReadCounter.table","NW_015090842.1:8453007",21,50,29
"EMC8","s1664_F_GON_01_ASEReadCounter.table","NW_015090842.1:8453058",24,48,24
"EMC8","s1664_F_GON_01_ASEReadCounter.table","NW_015090842.1:8453106",21,43,22
"GINS2","s1664_F_GON_01_ASEReadCounter.table","NW_015090842.1:8466420",74,104,30
"GINS2","s1664_F_GON_01_ASEReadCounter.table","NW_015090842.1:8466424",86,119,33
"GINS2","s1664_F_GON_01_ASEReadCounter.table","NW_015090842.1:8466518",94,142,48
"GINS2","s1664_F_GON_01_ASEReadCounter.table","NW_015090842.1:8468482",193,288,95
"GINS2","s1664_F_GON_01_ASEReadCounter.table","NW_015090842.1:8470290",202,284,82
"GINS2","s1664_F_GON_01_ASEReadCounter.table","NW_015090842.1:8470305",199,260,61
"GINS2","s1664_F_GON_01_ASEReadCounter.table","NW_015090842.1:8470381",210,278,68
"GINS2","s1664_F_GON_01_ASEReadCounter.table","NW_015090842.1:8470418",175,245,70
"GINS2","s1664_F_GON_01_ASEReadCounter.table","NW_015090842.1:8470421",159,232,73
"GINS2","s1664_F_GON_01_ASEReadCounter.table","NW_015090842.1:8470430",141,211,70
"GINS2","s1664_F_GON_01_ASEReadCounter.table","NW_015090842.1:8470433",143,211,68
"GINS2","s1664_F_GON_01_ASEReadCounter.table","NW_015090842.1:8470457",79,143,64
"GINS2","s1664_F_GON_01_ASEReadCounter.table","NW_015090842.1:8470491",110,172,62
"GINS2","s1664_F_GON_01_ASEReadCounter.table","NW_015090842.1:8470548",166,227,61
"GINS2","s1664_F_GON_01_ASEReadCounter.table","NW_015090842.1:8470649",141,199,58
"GSE1","s1664_F_GON_01_ASEReadCounter.table","NW_015090842.1:8475362",2,2,0
"GSE1","s1664_F_GON_01_ASEReadCounter.table","NW_015090842.1:8475961",1,2,1
"GSE1","s1664_F_GON_01_ASEReadCounter.table","NW_015090842.1:8476027",0,1,1
"GSE1","s1664_F_GON_01_ASEReadCounter.table","NW_015090842.1:8477442",0,1,1
"GSE1","s1664_F_GON_01_ASEReadCounter.table","NW_015090842.1:8477448",0,1,1
"GSE1","s1664_F_GON_01_ASEReadCounter.table","NW_015090842.1:8477662",0,1,1
"GSE1","s1664_F_GON_01_ASEReadCounter.table","NW_015090842.1:8477933",0,1,1
"GSE1","s1664_F_GON_01_ASEReadCounter.table","NW_015090842.1:8477945",0,1,1
"GSE1","s1664_F_GON_01_ASEReadCounter.table","NW_015090842.1:8483272",0,1,1
"GSE1","s1664_F_GON_01_ASEReadCounter.table","NW_015090842.1:8483411",0,1,1
"GSE1","s1664_F_GON_01_ASEReadCounter.table","NW_015090842.1:8483756",0,1,1
"GSE1","s1664_F_GON_01_ASEReadCounter.table","NW_015090842.1:8486867",2,4,2
"GSE1","s1664_F_GON_01_ASEReadCounter.table","NW_015090842.1:8486939",2,3,1
"GSE1","s1664_F_GON_01_ASEReadCounter.table","NW_015090842.1:8486945",2,3,1
"GSE1","s1664_F_GON_01_ASEReadCounter.table","NW_015090842.1:8486993",1,3,2
"GSE1","s1664_F_GON_01_ASEReadCounter.table","NW_015090842.1:8487062",0,2,2
"GSE1","s1664_F_GON_01_ASEReadCounter.table","NW_015090842.1:8488065",0,2,2
"GSE1","s1664_F_GON_01_ASEReadCounter.table","NW_015090842.1:8488457",1,1,0
"GSE1","s1664_F_GON_01_ASEReadCounter.table","NW_015090842.1:8488463",1,1,0
"GSE1","s1664_F_GON_01_ASEReadCounter.table","NW_015090842.1:8488490",1,1,0
"GSE1","s1664_F_GON_01_ASEReadCounter.table","NW_015090842.1:8488505",1,1,0
"GSE1","s1664_F_GON_01_ASEReadCounter.table","NW_015090842.1:8490180",1,1,0
"KIAA0513","s1664_F_GON_01_ASEReadCounter.table","NW_015090842.1:8668363",8,26,18
"KIAA0513","s1664_F_GON_01_ASEReadCounter.table","NW_015090842.1:8668387",9,25,16
"KIAA0513","s1664_F_GON_01_ASEReadCounter.table","NW_015090842.1:8668390",9,25,16
"KIAA0513","s1664_F_GON_01_ASEReadCounter.table","NW_015090842.1:8673107",14,30,16
"KIAA0513","s1664_F_GON_01_ASEReadCounter.table","NW_015090842.1:8673147",17,41,24
"KIAA0513","s1664_F_GON_01_ASEReadCounter.table","NW_015090842.1:8674661",10,18,8
"KIAA0513","s1664_F_GON_01_ASEReadCounter.table","NW_015090842.1:8674685",12,19,7
"KIAA0513","s1664_F_GON_01_ASEReadCounter.table","NW_015090842.1:8674730",7,18,11
"KIAA0513","s1664_F_GON_01_ASEReadCounter.table","NW_015090842.1:8675525",7,15,8
"KIAA0513","s1664_F_GON_01_ASEReadCounter.table","NW_015090842.1:8675561",8,18,10
"KIAA0513","s1664_F_GON_01_ASEReadCounter.table","NW_015090842.1:8686455",0,1,1
"KIAA0513","s1664_F_GON_01_ASEReadCounter.table","NW_015090842.1:8686508",0,1,1
"KIAA0513","s1664_F_GON_01_ASEReadCounter.table","NW_015090842.1:8693642",1,2,1
"KIAA0513","s1664_F_GON_01_ASEReadCounter.table","NW_015090842.1:8693712",2,3,1
"FBXO31","s1664_F_GON_01_ASEReadCounter.table","NW_015090842.1:8710240",274,627,353
"FBXO31","s1664_F_GON_01_ASEReadCounter.table","NW_015090842.1:8710372",235,496,261
"FBXO31","s1664_F_GON_01_ASEReadCounter.table","NW_015090842.1:8711239",250,555,305
"FBXO31","s1664_F_GON_01_ASEReadCounter.table","NW_015090842.1:8714565",231,503,272
"FBXO31","s1664_F_GON_01_ASEReadCounter.table","NW_015090842.1:8716001",143,315,172
"FBXO31","s1664_F_GON_01_ASEReadCounter.table","NW_015090842.1:8725050",4,5,1
"FBXO31","s1664_F_GON_01_ASEReadCounter.table","NW_015090842.1:8725057",4,5,1
"FBXO31","s1664_F_GON_01_ASEReadCounter.table","NW_015090842.1:8725162",4,6,2
"FBXO31","s1664_F_GON_01_ASEReadCounter.table","NW_015090842.1:8725163",4,6,2
"FBXO31","s1664_F_GON_01_ASEReadCounter.table","NW_015090842.1:8725170",3,5,2
"FBXO31","s1664_F_GON_01_ASEReadCounter.table","NW_015090842.1:8725187",3,4,1
"FBXO31","s1664_F_GON_01_ASEReadCounter.table","NW_015090842.1:8725188",3,4,1
"FBXO31","s1664_F_GON_01_ASEReadCounter.table","NW_015090842.1:8725190",3,4,1
"FBXO31","s1664_F_GON_01_ASEReadCounter.table","NW_015090842.1:8725370",4,4,0
"ZCCHC14","s1664_F_GON_01_ASEReadCounter.table","NW_015090842.1:8750174",19,31,12
"ZCCHC14","s1664_F_GON_01_ASEReadCounter.table","NW_015090842.1:8750189",19,31,12
"ZCCHC14","s1664_F_GON_01_ASEReadCounter.table","NW_015090842.1:8750365",18,33,15
"ZCCHC14","s1664_F_GON_01_ASEReadCounter.table","NW_015090842.1:8750433",23,40,17
"ZCCHC14","s1664_F_GON_01_ASEReadCounter.table","NW_015090842.1:8750449",26,41,15
"ZCCHC14","s1664_F_GON_01_ASEReadCounter.table","NW_015090842.1:8750456",25,42,17
"ZCCHC14","s1664_F_GON_01_ASEReadCounter.table","NW_015090842.1:8750497",24,42,18
"ZCCHC14","s1664_F_GON_01_ASEReadCounter.table","NW_015090842.1:8750547",25,42,17
"ZCCHC14","s1664_F_GON_01_ASEReadCounter.table","NW_015090842.1:8751100",4,11,7
"ZCCHC14","s1664_F_GON_01_ASEReadCounter.table","NW_015090842.1:8751374",11,23,12
"ZCCHC14","s1664_F_GON_01_ASEReadCounter.table","NW_015090842.1:8751403",10,22,12
"ZCCHC14","s1664_F_GON_01_ASEReadCounter.table","NW_015090842.1:8751517",12,27,15
"ZCCHC14","s1664_F_GON_01_ASEReadCounter.table","NW_015090842.1:8752060",9,13,4
"ZCCHC14","s1664_F_GON_01_ASEReadCounter.table","NW_015090842.1:8752172",12,23,11
"ZCCHC14","s1664_F_GON_01_ASEReadCounter.table","NW_015090842.1:8752183",11,23,12
"ZCCHC14","s1664_F_GON_01_ASEReadCounter.table","NW_015090842.1:8752198",14,26,12
"ZCCHC14","s1664_F_GON_01_ASEReadCounter.table","NW_015090842.1:8752248",14,27,13
"ZCCHC14","s1664_F_GON_01_ASEReadCounter.table","NW_015090842.1:8752326",13,25,12
"ZCCHC14","s1664_F_GON_01_ASEReadCounter.table","NW_015090842.1:8752393",12,21,9
"ZCCHC14","s1664_F_GON_01_ASEReadCounter.table","NW_015090842.1:8752914",22,34,12
"ZCCHC14","s1664_F_GON_01_ASEReadCounter.table","NW_015090842.1:8753528",4,9,5
"ZCCHC14","s1664_F_GON_01_ASEReadCounter.table","NW_015090842.1:8753892",6,13,7
"ZCCHC14","s1664_F_GON_01_ASEReadCounter.table","NW_015090842.1:8753910",4,11,7
"ZCCHC14","s1664_F_GON_01_ASEReadCounter.table","NW_015090842.1:8755096",3,4,1
"ZCCHC14","s1664_F_GON_01_ASEReadCounter.table","NW_015090842.1:8755327",3,8,5
"ZCCHC14","s1664_F_GON_01_ASEReadCounter.table","NW_015090842.1:8755723",4,8,4
"ZCCHC14","s1664_F_GON_01_ASEReadCounter.table","NW_015090842.1:8755739",3,8,5
"ZCCHC14","s1664_F_GON_01_ASEReadCounter.table","NW_015090842.1:8756149",3,5,2
"ZCCHC14","s1664_F_GON_01_ASEReadCounter.table","NW_015090842.1:8756347",4,8,4
"ZCCHC14","s1664_F_GON_01_ASEReadCounter.table","NW_015090842.1:8756361",5,9,4
"ZCCHC14","s1664_F_GON_01_ASEReadCounter.table","NW_015090842.1:8756388",5,8,3
"ZCCHC14","s1664_F_GON_01_ASEReadCounter.table","NW_015090842.1:8756389",5,8,3
"ZCCHC14","s1664_F_GON_01_ASEReadCounter.table","NW_015090842.1:8757160",1,4,3
"ZCCHC14","s1664_F_GON_01_ASEReadCounter.table","NW_015090842.1:8804511",0,1,1
"ZCCHC14","s1664_F_GON_01_ASEReadCounter.table","NW_015090842.1:8804979",1,2,1
"JPH3","s1664_F_GON_01_ASEReadCounter.table","NW_015090842.1:8872283",2,2,0
"JPH3","s1664_F_GON_01_ASEReadCounter.table","NW_015090842.1:8872294",1,1,0
"JPH3","s1664_F_GON_01_ASEReadCounter.table","NW_015090842.1:8885525",1,1,0
"KLHDC4","s1664_F_GON_01_ASEReadCounter.table","NW_015090842.1:8890729",135,196,61
"KLHDC4","s1664_F_GON_01_ASEReadCounter.table","NW_015090842.1:8890749",143,199,56
"KLHDC4","s1664_F_GON_01_ASEReadCounter.table","NW_015090842.1:8890761",147,208,61
"KLHDC4","s1664_F_GON_01_ASEReadCounter.table","NW_015090842.1:8891123",144,194,50
"KLHDC4","s1664_F_GON_01_ASEReadCounter.table","NW_015090842.1:8893124",57,93,36
"KLHDC4","s1664_F_GON_01_ASEReadCounter.table","NW_015090842.1:8894542",41,69,28
"KLHDC4","s1664_F_GON_01_ASEReadCounter.table","NW_015090842.1:8896726",39,65,26
"KLHDC4","s1664_F_GON_01_ASEReadCounter.table","NW_015090842.1:8896767",35,55,20
"KLHDC4","s1664_F_GON_01_ASEReadCounter.table","NW_015090842.1:8904174",32,47,15
"KLHDC4","s1664_F_GON_01_ASEReadCounter.table","NW_015090842.1:8904231",39,46,7
"KLHDC4","s1664_F_GON_01_ASEReadCounter.table","NW_015090842.1:8905251",31,40,9
"KLHDC4","s1664_F_GON_01_ASEReadCounter.table","NW_015090842.1:8905263",31,47,16
"KLHDC4","s1664_F_GON_01_ASEReadCounter.table","NW_015090842.1:8919626",2,6,4
"SLC7A5","s1664_F_GON_01_ASEReadCounter.table","NW_015090842.1:8938782",112,193,81
"SLC7A5","s1664_F_GON_01_ASEReadCounter.table","NW_015090842.1:8938943",74,126,52
"SLC7A5","s1664_F_GON_01_ASEReadCounter.table","NW_015090842.1:8939611",23,37,14
"SLC7A5","s1664_F_GON_01_ASEReadCounter.table","NW_015090842.1:8939738",23,46,23
"SLC7A5","s1664_F_GON_01_ASEReadCounter.table","NW_015090842.1:8939739",22,44,22
"SLC7A5","s1664_F_GON_01_ASEReadCounter.table","NW_015090842.1:8939740",19,41,22
"SLC7A5","s1664_F_GON_01_ASEReadCounter.table","NW_015090842.1:8939795",28,41,13
"SLC7A5","s1664_F_GON_01_ASEReadCounter.table","NW_015090842.1:8939815",23,38,15
"SLC7A5","s1664_F_GON_01_ASEReadCounter.table","NW_015090842.1:8939816",22,37,15
"SLC7A5","s1664_F_GON_01_ASEReadCounter.table","NW_015090842.1:8939817",22,39,17
"SLC7A5","s1664_F_GON_01_ASEReadCounter.table","NW_015090842.1:8939845",24,46,22
"SLC7A5","s1664_F_GON_01_ASEReadCounter.table","NW_015090842.1:8939894",16,39,23
"SLC7A5","s1664_F_GON_01_ASEReadCounter.table","NW_015090842.1:8939895",16,39,23
"SLC7A5","s1664_F_GON_01_ASEReadCounter.table","NW_015090842.1:8939997",82,82,0
"SLC7A5","s1664_F_GON_01_ASEReadCounter.table","NW_015090842.1:8940172",27,51,24
"SLC7A5","s1664_F_GON_01_ASEReadCounter.table","NW_015090842.1:8940331",17,34,17
"SLC7A5","s1664_F_GON_01_ASEReadCounter.table","NW_015090842.1:8940696",18,26,8
"SLC7A5","s1664_F_GON_01_ASEReadCounter.table","NW_015090842.1:8940719",10,18,8
"SLC7A5","s1664_F_GON_01_ASEReadCounter.table","NW_015090842.1:8940737",9,19,10
"SLC7A5","s1664_F_GON_01_ASEReadCounter.table","NW_015090842.1:8940743",9,18,9
"SLC7A5","s1664_F_GON_01_ASEReadCounter.table","NW_015090842.1:8940766",12,23,11
"SLC7A5","s1664_F_GON_01_ASEReadCounter.table","NW_015090842.1:8940769",12,24,12
"SLC7A5","s1664_F_GON_01_ASEReadCounter.table","NW_015090842.1:8940861",21,30,9
"SLC7A5","s1664_F_GON_01_ASEReadCounter.table","NW_015090842.1:8941068",17,32,15
"SLC7A5","s1664_F_GON_01_ASEReadCounter.table","NW_015090842.1:8941467",12,26,14
"SLC7A5","s1664_F_GON_01_ASEReadCounter.table","NW_015090842.1:8941531",20,32,12
"SLC7A5","s1664_F_GON_01_ASEReadCounter.table","NW_015090842.1:8941588",22,39,17
"SLC7A5","s1664_F_GON_01_ASEReadCounter.table","NW_015090842.1:8941698",15,21,6
"SLC7A5","s1664_F_GON_01_ASEReadCounter.table","NW_015090842.1:8941717",12,19,7
"SLC7A5","s1664_F_GON_01_ASEReadCounter.table","NW_015090842.1:8941745",15,30,15
"SLC7A5","s1664_F_GON_01_ASEReadCounter.table","NW_015090842.1:8941781",14,31,17
"SLC7A5","s1664_F_GON_01_ASEReadCounter.table","NW_015090842.1:8941887",6,16,10
"SLC7A5","s1664_F_GON_01_ASEReadCounter.table","NW_015090842.1:8941968",9,19,10
"SLC7A5","s1664_F_GON_01_ASEReadCounter.table","NW_015090842.1:8942025",12,23,11
"SLC7A5","s1664_F_GON_01_ASEReadCounter.table","NW_015090842.1:8942069",23,35,12
"SLC7A5","s1664_F_GON_01_ASEReadCounter.table","NW_015090842.1:8942170",23,36,13
"SLC7A5","s1664_F_GON_01_ASEReadCounter.table","NW_015090842.1:8942241",19,34,15
"SLC7A5","s1664_F_GON_01_ASEReadCounter.table","NW_015090842.1:8942283",18,35,17
"SLC7A5","s1664_F_GON_01_ASEReadCounter.table","NW_015090842.1:8942717",26,36,10
"SLC7A5","s1664_F_GON_01_ASEReadCounter.table","NW_015090842.1:8942756",31,41,10
"SLC7A5","s1664_F_GON_01_ASEReadCounter.table","NW_015090842.1:8942766",31,40,9
"SLC7A5","s1664_F_GON_01_ASEReadCounter.table","NW_015090842.1:8943271",18,29,11
"SLC7A5","s1664_F_GON_01_ASEReadCounter.table","NW_015090842.1:8943524",13,26,13
"SLC7A5","s1664_F_GON_01_ASEReadCounter.table","NW_015090842.1:8943530",14,31,17
"SLC7A5","s1664_F_GON_01_ASEReadCounter.table","NW_015090842.1:8943602",12,26,14
"SLC7A5","s1664_F_GON_01_ASEReadCounter.table","NW_015090842.1:8943622",10,21,11
"SLC7A5","s1664_F_GON_01_ASEReadCounter.table","NW_015090842.1:8943661",13,24,11
"SLC7A5","s1664_F_GON_01_ASEReadCounter.table","NW_015090842.1:8943686",14,23,9
"SLC7A5","s1664_F_GON_01_ASEReadCounter.table","NW_015090842.1:8943788",18,28,10
"SLC7A5","s1664_F_GON_01_ASEReadCounter.table","NW_015090842.1:8943814",11,20,9
"SLC7A5","s1664_F_GON_01_ASEReadCounter.table","NW_015090842.1:8943876",13,22,9
"SLC7A5","s1664_F_GON_01_ASEReadCounter.table","NW_015090842.1:8943892",11,21,10
"SLC7A5","s1664_F_GON_01_ASEReadCounter.table","NW_015090842.1:8944097",11,24,13
"SLC7A5","s1664_F_GON_01_ASEReadCounter.table","NW_015090842.1:8944104",12,22,10
"SLC7A5","s1664_F_GON_01_ASEReadCounter.table","NW_015090842.1:8944293",9,14,5
"SLC7A5","s1664_F_GON_01_ASEReadCounter.table","NW_015090842.1:8944297",7,12,5
"SLC7A5","s1664_F_GON_01_ASEReadCounter.table","NW_015090842.1:8944397",8,12,4
"SLC7A5","s1664_F_GON_01_ASEReadCounter.table","NW_015090842.1:8944552",15,22,7
"SLC7A5","s1664_F_GON_01_ASEReadCounter.table","NW_015090842.1:8944629",9,18,9
"CA5A","s1664_F_GON_01_ASEReadCounter.table","NW_015090842.1:8989479",15,35,20
"CA5A","s1664_F_GON_01_ASEReadCounter.table","NW_015090842.1:8989562",21,48,27
"CA5A","s1664_F_GON_01_ASEReadCounter.table","NW_015090842.1:8989609",25,55,30
"CA5A","s1664_F_GON_01_ASEReadCounter.table","NW_015090842.1:8989693",30,72,42
"CA5A","s1664_F_GON_01_ASEReadCounter.table","NW_015090842.1:8989702",34,75,41
"CA5A","s1664_F_GON_01_ASEReadCounter.table","NW_015090842.1:8989746",37,79,42
"CA5A","s1664_F_GON_01_ASEReadCounter.table","NW_015090842.1:8989880",22,50,28
"CA5A","s1664_F_GON_01_ASEReadCounter.table","NW_015090842.1:8989885",19,47,28
"CA5A","s1664_F_GON_01_ASEReadCounter.table","NW_015090842.1:8989929",26,54,28
"CA5A","s1664_F_GON_01_ASEReadCounter.table","NW_015090842.1:8990002",20,52,32
"CA5A","s1664_F_GON_01_ASEReadCounter.table","NW_015090842.1:8990004",20,51,31
"CA5A","s1664_F_GON_01_ASEReadCounter.table","NW_015090842.1:8990005",20,52,32
"CA5A","s1664_F_GON_01_ASEReadCounter.table","NW_015090842.1:8990017",19,47,28
"CA5A","s1664_F_GON_01_ASEReadCounter.table","NW_015090842.1:8990043",13,39,26
"CA5A","s1664_F_GON_01_ASEReadCounter.table","NW_015090842.1:8990060",35,35,0
"CA5A","s1664_F_GON_01_ASEReadCounter.table","NW_015090842.1:8990080",6,29,23
"CA5A","s1664_F_GON_01_ASEReadCounter.table","NW_015090842.1:8990084",5,29,24
"CA5A","s1664_F_GON_01_ASEReadCounter.table","NW_015090842.1:8990090",5,30,25
"CA5A","s1664_F_GON_01_ASEReadCounter.table","NW_015090842.1:8990095",5,29,24
"CA5A","s1664_F_GON_01_ASEReadCounter.table","NW_015090842.1:8990111",4,25,21
"CA5A","s1664_F_GON_01_ASEReadCounter.table","NW_015090842.1:8990112",4,24,20
"CA5A","s1664_F_GON_01_ASEReadCounter.table","NW_015090842.1:8990115",9,29,20
"CA5A","s1664_F_GON_01_ASEReadCounter.table","NW_015090842.1:8990166",14,36,22
"CA5A","s1664_F_GON_01_ASEReadCounter.table","NW_015090842.1:8990169",14,33,19
"CA5A","s1664_F_GON_01_ASEReadCounter.table","NW_015090842.1:8990193",31,31,0
"CA5A","s1664_F_GON_01_ASEReadCounter.table","NW_015090842.1:8990222",8,24,16
"CA5A","s1664_F_GON_01_ASEReadCounter.table","NW_015090842.1:8990289",12,32,20
"CA5A","s1664_F_GON_01_ASEReadCounter.table","NW_015090842.1:8990314",12,33,21
"CA5A","s1664_F_GON_01_ASEReadCounter.table","NW_015090842.1:8990361",15,33,18
"CA5A","s1664_F_GON_01_ASEReadCounter.table","NW_015090842.1:8990368",15,33,18
"CA5A","s1664_F_GON_01_ASEReadCounter.table","NW_015090842.1:8990429",12,29,17
"CA5A","s1664_F_GON_01_ASEReadCounter.table","NW_015090842.1:8990466",7,21,14
"CA5A","s1664_F_GON_01_ASEReadCounter.table","NW_015090842.1:8990663",14,31,17
"CA5A","s1664_F_GON_01_ASEReadCounter.table","NW_015090842.1:8990797",5,13,8
"CA5A","s1664_F_GON_01_ASEReadCounter.table","NW_015090842.1:8990836",7,17,10
"CA5A","s1664_F_GON_01_ASEReadCounter.table","NW_015090842.1:8990842",9,19,10
"CA5A","s1664_F_GON_01_ASEReadCounter.table","NW_015090842.1:8990851",10,21,11
"CA5A","s1664_F_GON_01_ASEReadCounter.table","NW_015090842.1:8990918",14,25,11
"CA5A","s1664_F_GON_01_ASEReadCounter.table","NW_015090842.1:8990921",14,25,11
"CA5A","s1664_F_GON_01_ASEReadCounter.table","NW_015090842.1:8990942",16,27,11
"CA5A","s1664_F_GON_01_ASEReadCounter.table","NW_015090842.1:8991001",10,27,17
"CA5A","s1664_F_GON_01_ASEReadCounter.table","NW_015090842.1:8991038",7,23,16
"CA5A","s1664_F_GON_01_ASEReadCounter.table","NW_015090842.1:8991149",5,20,15
"CA5A","s1664_F_GON_01_ASEReadCounter.table","NW_015090842.1:8991176",7,25,18
"CA5A","s1664_F_GON_01_ASEReadCounter.table","NW_015090842.1:8991241",8,31,23
"CA5A","s1664_F_GON_01_ASEReadCounter.table","NW_015090842.1:8991262",8,25,17
"CA5A","s1664_F_GON_01_ASEReadCounter.table","NW_015090842.1:8991316",5,5,0
"CA5A","s1664_F_GON_01_ASEReadCounter.table","NW_015090842.1:8991319",6,6,0
"CA5A","s1664_F_GON_01_ASEReadCounter.table","NW_015090842.1:8991330",4,4,0
"CA5A","s1664_F_GON_01_ASEReadCounter.table","NW_015090842.1:8991334",5,5,0
"CA5A","s1664_F_GON_01_ASEReadCounter.table","NW_015090842.1:8991362",7,17,10
"CA5A","s1664_F_GON_01_ASEReadCounter.table","NW_015090842.1:8991368",7,17,10
"CA5A","s1664_F_GON_01_ASEReadCounter.table","NW_015090842.1:8991390",9,20,11
"CA5A","s1664_F_GON_01_ASEReadCounter.table","NW_015090842.1:8991395",9,21,12
"CA5A","s1664_F_GON_01_ASEReadCounter.table","NW_015090842.1:8991422",6,19,13
"CA5A","s1664_F_GON_01_ASEReadCounter.table","NW_015090842.1:8991467",0,8,8
"CA5A","s1664_F_GON_01_ASEReadCounter.table","NW_015090842.1:8991576",7,22,15
"CA5A","s1664_F_GON_01_ASEReadCounter.table","NW_015090842.1:8991587",7,19,12
"CA5A","s1664_F_GON_01_ASEReadCounter.table","NW_015090842.1:8991655",4,15,11
"CA5A","s1664_F_GON_01_ASEReadCounter.table","NW_015090842.1:8991717",4,11,7
"CA5A","s1664_F_GON_01_ASEReadCounter.table","NW_015090842.1:8991726",5,13,8
"CA5A","s1664_F_GON_01_ASEReadCounter.table","NW_015090842.1:8991799",7,18,11
"CA5A","s1664_F_GON_01_ASEReadCounter.table","NW_015090842.1:8991809",7,18,11
"CA5A","s1664_F_GON_01_ASEReadCounter.table","NW_015090842.1:8991848",2,12,10
"CA5A","s1664_F_GON_01_ASEReadCounter.table","NW_015090842.1:8991849",2,12,10
"CA5A","s1664_F_GON_01_ASEReadCounter.table","NW_015090842.1:8991927",3,11,8
"CA5A","s1664_F_GON_01_ASEReadCounter.table","NW_015090842.1:8991941",2,9,7
"CA5A","s1664_F_GON_01_ASEReadCounter.table","NW_015090842.1:8992121",2,6,4
"CA5A","s1664_F_GON_01_ASEReadCounter.table","NW_015090842.1:8992224",17,23,6
"CA5A","s1664_F_GON_01_ASEReadCounter.table","NW_015090842.1:9002570",10,36,26
"CA5A","s1664_F_GON_01_ASEReadCounter.table","NW_015090842.1:9002600",5,27,22
"CA5A","s1664_F_GON_01_ASEReadCounter.table","NW_015090842.1:9004312",19,36,17
"CA5A","s1664_F_GON_01_ASEReadCounter.table","NW_015090842.1:9004506",10,16,6
"CA5A","s1664_F_GON_01_ASEReadCounter.table","NW_015090842.1:9004523",9,13,4
"CA5A","s1664_F_GON_01_ASEReadCounter.table","NW_015090842.1:9004530",9,17,8
"CA5A","s1664_F_GON_01_ASEReadCounter.table","NW_015090842.1:9004556",32,42,10
"CA5A","s1664_F_GON_01_ASEReadCounter.table","NW_015090842.1:9005116",46,69,23
"CA5A","s1664_F_GON_01_ASEReadCounter.table","NW_015090842.1:9005120",49,72,23
"CA5A","s1664_F_GON_01_ASEReadCounter.table","NW_015090842.1:9005140",52,82,30
"CA5A","s1664_F_GON_01_ASEReadCounter.table","NW_015090842.1:9005152",55,85,30
"CA5A","s1664_F_GON_01_ASEReadCounter.table","NW_015090842.1:9011011",0,1,1
"CA5A","s1664_F_GON_01_ASEReadCounter.table","NW_015090842.1:9011189",0,1,1
"CA5A","s1664_F_GON_01_ASEReadCounter.table","NW_015090842.1:9011194",0,1,1
"BANP","s1664_F_GON_01_ASEReadCounter.table","NW_015090842.1:9033407",5,6,1
"BANP","s1664_F_GON_01_ASEReadCounter.table","NW_015090842.1:9033409",5,6,1
"BANP","s1664_F_GON_01_ASEReadCounter.table","NW_015090842.1:9033420",4,5,1
"BANP","s1664_F_GON_01_ASEReadCounter.table","NW_015090842.1:9067974",0,9,9
"BANP","s1664_F_GON_01_ASEReadCounter.table","NW_015090842.1:9102510",15,27,12
"BANP","s1664_F_GON_01_ASEReadCounter.table","NW_015090842.1:9168534",26,58,32
"BANP","s1664_F_GON_01_ASEReadCounter.table","NW_015090842.1:9168818",16,28,12
"ZNF469","s1664_F_GON_01_ASEReadCounter.table","NW_015090842.1:9425089",1,1,0
"ZNF469","s1664_F_GON_01_ASEReadCounter.table","NW_015090842.1:9425108",1,1,0
"ZNF469","s1664_F_GON_01_ASEReadCounter.table","NW_015090842.1:9426585",1,1,0
"ZNF469","s1664_F_GON_01_ASEReadCounter.table","NW_015090842.1:9427614",0,1,1
"ZNF469","s1664_F_GON_01_ASEReadCounter.table","NW_015090842.1:9428122",0,1,1
"ZNF469","s1664_F_GON_01_ASEReadCounter.table","NW_015090842.1:9428178",0,1,1
"ZNF469","s1664_F_GON_01_ASEReadCounter.table","NW_015090842.1:9429633",1,3,2
"ZNF469","s1664_F_GON_01_ASEReadCounter.table","NW_015090842.1:9429758",0,2,2
"ZNF469","s1664_F_GON_01_ASEReadCounter.table","NW_015090842.1:9429759",0,3,3
"ZNF469","s1664_F_GON_01_ASEReadCounter.table","NW_015090842.1:9429794",1,4,3
"ZNF469","s1664_F_GON_01_ASEReadCounter.table","NW_015090842.1:9430560",2,2,0
"ZNF469","s1664_F_GON_01_ASEReadCounter.table","NW_015090842.1:9430668",1,1,0
"ZNF469","s1664_F_GON_01_ASEReadCounter.table","NW_015090842.1:9430700",1,1,0
"ZNF469","s1664_F_GON_01_ASEReadCounter.table","NW_015090842.1:9431031",0,2,2
"ZNF469","s1664_F_GON_01_ASEReadCounter.table","NW_015090842.1:9431073",0,3,3
"ZNF469","s1664_F_GON_01_ASEReadCounter.table","NW_015090842.1:9431091",0,2,2
"ZNF469","s1664_F_GON_01_ASEReadCounter.table","NW_015090842.1:9431214",0,1,1
"ZNF469","s1664_F_GON_01_ASEReadCounter.table","NW_015090842.1:9431317",0,2,2
"ZNF469","s1664_F_GON_01_ASEReadCounter.table","NW_015090842.1:9431325",0,1,1
"ZNF469","s1664_F_GON_01_ASEReadCounter.table","NW_015090842.1:9431901",1,2,1
"ZNF469","s1664_F_GON_01_ASEReadCounter.table","NW_015090842.1:9432110",3,7,4
"ZNF469","s1664_F_GON_01_ASEReadCounter.table","NW_015090842.1:9432302",2,7,5
"ZNF469","s1664_F_GON_01_ASEReadCounter.table","NW_015090842.1:9432361",3,6,3
"ZNF469","s1664_F_GON_01_ASEReadCounter.table","NW_015090842.1:9432374",4,7,3
"ZNF469","s1664_F_GON_01_ASEReadCounter.table","NW_015090842.1:9432382",4,7,3
"ZNF469","s1664_F_GON_01_ASEReadCounter.table","NW_015090842.1:9432481",2,3,1
"ZNF469","s1664_F_GON_01_ASEReadCounter.table","NW_015090842.1:9432498",2,3,1
"ZNF469","s1664_F_GON_01_ASEReadCounter.table","NW_015090842.1:9433268",2,4,2
"ZNF469","s1664_F_GON_01_ASEReadCounter.table","NW_015090842.1:9433678",1,3,2
"ZNF469","s1664_F_GON_01_ASEReadCounter.table","NW_015090842.1:9433902",1,3,2
"ZNF469","s1664_F_GON_01_ASEReadCounter.table","NW_015090842.1:9434259",3,6,3
"ZNF469","s1664_F_GON_01_ASEReadCounter.table","NW_015090842.1:9435221",5,13,8
"ZFPM1","s1664_F_GON_01_ASEReadCounter.table","NW_015090842.1:9458862",7,31,24
"ZFPM1","s1664_F_GON_01_ASEReadCounter.table","NW_015090842.1:9458888",10,34,24
"ZFPM1","s1664_F_GON_01_ASEReadCounter.table","NW_015090842.1:9458904",15,44,29
"ZFPM1","s1664_F_GON_01_ASEReadCounter.table","NW_015090842.1:9458916",20,45,25
"ZFPM1","s1664_F_GON_01_ASEReadCounter.table","NW_015090842.1:9468568",23,48,25
"ZFPM1","s1664_F_GON_01_ASEReadCounter.table","NW_015090842.1:9468593",27,49,22
"ZFPM1","s1664_F_GON_01_ASEReadCounter.table","NW_015090842.1:9471561",18,37,19
"ZFPM1","s1664_F_GON_01_ASEReadCounter.table","NW_015090842.1:9472557",18,37,19
"ZFPM1","s1664_F_GON_01_ASEReadCounter.table","NW_015090842.1:9472565",19,37,18
"ZFPM1","s1664_F_GON_01_ASEReadCounter.table","NW_015090842.1:9472608",15,35,20
"ZFPM1","s1664_F_GON_01_ASEReadCounter.table","NW_015090842.1:9472627",18,33,15
"ZFPM1","s1664_F_GON_01_ASEReadCounter.table","NW_015090842.1:9472668",16,34,18
"ZFPM1","s1664_F_GON_01_ASEReadCounter.table","NW_015090842.1:9473655",20,41,21
"ZFPM1","s1664_F_GON_01_ASEReadCounter.table","NW_015090842.1:9475827",12,41,29
"ZFPM1","s1664_F_GON_01_ASEReadCounter.table","NW_015090842.1:9475842",15,52,37
"ZFPM1","s1664_F_GON_01_ASEReadCounter.table","NW_015090842.1:9476119",7,25,18
"ZFPM1","s1664_F_GON_01_ASEReadCounter.table","NW_015090842.1:9476161",5,23,18
"ZFPM1","s1664_F_GON_01_ASEReadCounter.table","NW_015090842.1:9476219",4,17,13
"ZFPM1","s1664_F_GON_01_ASEReadCounter.table","NW_015090842.1:9476233",5,26,21
"ZFPM1","s1664_F_GON_01_ASEReadCounter.table","NW_015090842.1:9476305",11,38,27
"ZFPM1","s1664_F_GON_01_ASEReadCounter.table","NW_015090842.1:9476395",12,29,17
"ZFPM1","s1664_F_GON_01_ASEReadCounter.table","NW_015090842.1:9476421",15,40,25
"ZFPM1","s1664_F_GON_01_ASEReadCounter.table","NW_015090842.1:9476539",10,37,27
"ZFPM1","s1664_F_GON_01_ASEReadCounter.table","NW_015090842.1:9476576",9,32,23
"ZFPM1","s1664_F_GON_01_ASEReadCounter.table","NW_015090842.1:9476599",31,31,0
"ZFPM1","s1664_F_GON_01_ASEReadCounter.table","NW_015090842.1:9476792",14,36,22
"ZFPM1","s1664_F_GON_01_ASEReadCounter.table","NW_015090842.1:9476803",15,38,23
"ZFPM1","s1664_F_GON_01_ASEReadCounter.table","NW_015090842.1:9477115",14,36,22
"ZFPM1","s1664_F_GON_01_ASEReadCounter.table","NW_015090842.1:9477299",3,25,22
"ZFPM1","s1664_F_GON_01_ASEReadCounter.table","NW_015090842.1:9477398",31,31,0
"ZFPM1","s1664_F_GON_01_ASEReadCounter.table","NW_015090842.1:9477422",5,23,18
"ZFPM1","s1664_F_GON_01_ASEReadCounter.table","NW_015090842.1:9477554",15,44,29
"ZFPM1","s1664_F_GON_01_ASEReadCounter.table","NW_015090842.1:9477575",32,32,0
"ZFPM1","s1664_F_GON_01_ASEReadCounter.table","NW_015090842.1:9477595",13,39,26
"ZFPM1","s1664_F_GON_01_ASEReadCounter.table","NW_015090842.1:9477611",14,43,29
"ZFPM1","s1664_F_GON_01_ASEReadCounter.table","NW_015090842.1:9477659",16,49,33
"ZFPM1","s1664_F_GON_01_ASEReadCounter.table","NW_015090842.1:9477737",10,37,27
"ZFPM1","s1664_F_GON_01_ASEReadCounter.table","NW_015090842.1:9477791",9,41,32
"ZFPM1","s1664_F_GON_01_ASEReadCounter.table","NW_015090842.1:9477844",13,36,23
"ZFPM1","s1664_F_GON_01_ASEReadCounter.table","NW_015090842.1:9477917",12,27,15
"ZFPM1","s1664_F_GON_01_ASEReadCounter.table","NW_015090842.1:9478295",20,40,20
"ZFPM1","s1664_F_GON_01_ASEReadCounter.table","NW_015090842.1:9478349",22,45,23
"ZFPM1","s1664_F_GON_01_ASEReadCounter.table","NW_015090842.1:9478524",17,45,28
"ZFPM1","s1664_F_GON_01_ASEReadCounter.table","NW_015090842.1:9478546",18,54,36
"ZFPM1","s1664_F_GON_01_ASEReadCounter.table","NW_015090842.1:9478573",19,52,33
"ZFPM1","s1664_F_GON_01_ASEReadCounter.table","NW_015090842.1:9478582",14,40,26
"ZFPM1","s1664_F_GON_01_ASEReadCounter.table","NW_015090842.1:9478684",3,20,17
"ZFPM1","s1664_F_GON_01_ASEReadCounter.table","NW_015090842.1:9478711",1,14,13
"ZFPM1","s1664_F_GON_01_ASEReadCounter.table","NW_015090842.1:9478761",5,16,11
"ZFPM1","s1664_F_GON_01_ASEReadCounter.table","NW_015090842.1:9478829",9,9,0
"CIDEC","s1664_F_GON_01_ASEReadCounter.table","NW_015090842.1:9480170",2,3,1
"CIDEC","s1664_F_GON_01_ASEReadCounter.table","NW_015090842.1:9480171",2,3,1
"CIDEC","s1664_F_GON_01_ASEReadCounter.table","NW_015090842.1:9480212",4,5,1
"CIDEC","s1664_F_GON_01_ASEReadCounter.table","NW_015090842.1:9480252",3,6,3
"CIDEC","s1664_F_GON_01_ASEReadCounter.table","NW_015090842.1:9480391",7,11,4
"CIDEC","s1664_F_GON_01_ASEReadCounter.table","NW_015090842.1:9480394",7,12,5
"CIDEC","s1664_F_GON_01_ASEReadCounter.table","NW_015090842.1:9480630",6,11,5
"CIDEC","s1664_F_GON_01_ASEReadCounter.table","NW_015090842.1:9480675",2,7,5
"CIDEC","s1664_F_GON_01_ASEReadCounter.table","NW_015090842.1:9480686",2,5,3
"CIDEC","s1664_F_GON_01_ASEReadCounter.table","NW_015090842.1:9480693",2,6,4
"CIDEC","s1664_F_GON_01_ASEReadCounter.table","NW_015090842.1:9480756",4,7,3
"CIDEC","s1664_F_GON_01_ASEReadCounter.table","NW_015090842.1:9481199",2,6,4
"ZC3H18","s1664_F_GON_01_ASEReadCounter.table","NW_015090842.1:9494271",8,24,16
"ZC3H18","s1664_F_GON_01_ASEReadCounter.table","NW_015090842.1:9501427",17,53,36
"ZC3H18","s1664_F_GON_01_ASEReadCounter.table","NW_015090842.1:9501442",19,56,37
"ZC3H18","s1664_F_GON_01_ASEReadCounter.table","NW_015090842.1:9505538",10,45,35
"ZC3H18","s1664_F_GON_01_ASEReadCounter.table","NW_015090842.1:9506778",27,68,41
"ZC3H18","s1664_F_GON_01_ASEReadCounter.table","NW_015090842.1:9522538",28,46,18
"ZC3H18","s1664_F_GON_01_ASEReadCounter.table","NW_015090842.1:9524350",30,56,26
"ZC3H18","s1664_F_GON_01_ASEReadCounter.table","NW_015090842.1:9524366",33,62,29
"ZC3H18","s1664_F_GON_01_ASEReadCounter.table","NW_015090842.1:9524424",24,44,20
"ZC3H18","s1664_F_GON_01_ASEReadCounter.table","NW_015090842.1:9529649",19,64,45
"ZC3H18","s1664_F_GON_01_ASEReadCounter.table","NW_015090842.1:9529688",14,57,43
"ZC3H18","s1664_F_GON_01_ASEReadCounter.table","NW_015090842.1:9529691",14,53,39
"ZC3H18","s1664_F_GON_01_ASEReadCounter.table","NW_015090842.1:9530977",30,74,44
"ZC3H18","s1664_F_GON_01_ASEReadCounter.table","NW_015090842.1:9536699",0,26,26
"CYBA","s1664_F_GON_01_ASEReadCounter.table","NW_015090842.1:9547281",22,37,15
"CYBA","s1664_F_GON_01_ASEReadCounter.table","NW_015090842.1:9547402",80,129,49
"CYBA","s1664_F_GON_01_ASEReadCounter.table","NW_015090842.1:9547553",45,83,38
"CYBA","s1664_F_GON_01_ASEReadCounter.table","NW_015090842.1:9548052",35,60,25
"CYBA","s1664_F_GON_01_ASEReadCounter.table","NW_015090842.1:9548436",48,88,40
"CYBA","s1664_F_GON_01_ASEReadCounter.table","NW_015090842.1:9548442",45,84,39
"CYBA","s1664_F_GON_01_ASEReadCounter.table","NW_015090842.1:9548478",69,107,38
"CYBA","s1664_F_GON_01_ASEReadCounter.table","NW_015090842.1:9548487",63,95,32
"CYBA","s1664_F_GON_01_ASEReadCounter.table","NW_015090842.1:9548490",64,94,30
"CYBA","s1664_F_GON_01_ASEReadCounter.table","NW_015090842.1:9548717",64,88,24
"CYBA","s1664_F_GON_01_ASEReadCounter.table","NW_015090842.1:9548750",54,80,26
"CYBA","s1664_F_GON_01_ASEReadCounter.table","NW_015090842.1:9548766",41,64,23
"MVD","s1664_F_GON_01_ASEReadCounter.table","NW_015090842.1:9550678",23,34,11
"MVD","s1664_F_GON_01_ASEReadCounter.table","NW_015090842.1:9550690",25,42,17
"MVD","s1664_F_GON_01_ASEReadCounter.table","NW_015090842.1:9550691",25,42,17
"MVD","s1664_F_GON_01_ASEReadCounter.table","NW_015090842.1:9550699",26,48,22
"MVD","s1664_F_GON_01_ASEReadCounter.table","NW_015090842.1:9550719",25,49,24
"MVD","s1664_F_GON_01_ASEReadCounter.table","NW_015090842.1:9551596",23,55,32
"MVD","s1664_F_GON_01_ASEReadCounter.table","NW_015090842.1:9551638",24,68,44
"MVD","s1664_F_GON_01_ASEReadCounter.table","NW_015090842.1:9551899",0,2,2
"MVD","s1664_F_GON_01_ASEReadCounter.table","NW_015090842.1:9552193",18,46,28
"MVD","s1664_F_GON_01_ASEReadCounter.table","NW_015090842.1:9552202",20,49,29
"MVD","s1664_F_GON_01_ASEReadCounter.table","NW_015090842.1:9552208",21,51,30
"MVD","s1664_F_GON_01_ASEReadCounter.table","NW_015090842.1:9552625",16,31,15
"MVD","s1664_F_GON_01_ASEReadCounter.table","NW_015090842.1:9552629",30,30,0
"MVD","s1664_F_GON_01_ASEReadCounter.table","NW_015090842.1:9552644",18,36,18
"MVD","s1664_F_GON_01_ASEReadCounter.table","NW_015090842.1:9553093",19,29,10
"MVD","s1664_F_GON_01_ASEReadCounter.table","NW_015090842.1:9553114",20,34,14
"RNF166","s1664_F_GON_01_ASEReadCounter.table","NW_015090842.1:9557900",13,27,14
"RNF166","s1664_F_GON_01_ASEReadCounter.table","NW_015090842.1:9558048",11,27,16
"RNF166","s1664_F_GON_01_ASEReadCounter.table","NW_015090842.1:9558116",13,27,14
"RNF166","s1664_F_GON_01_ASEReadCounter.table","NW_015090842.1:9558308",9,21,12
"RNF166","s1664_F_GON_01_ASEReadCounter.table","NW_015090842.1:9558405",17,32,15
"RNF166","s1664_F_GON_01_ASEReadCounter.table","NW_015090842.1:9558549",39,67,28
"RNF166","s1664_F_GON_01_ASEReadCounter.table","NW_015090842.1:9558556",41,71,30
"RNF166","s1664_F_GON_01_ASEReadCounter.table","NW_015090842.1:9558579",47,76,29
"RNF166","s1664_F_GON_01_ASEReadCounter.table","NW_015090842.1:9558599",41,61,20
"RNF166","s1664_F_GON_01_ASEReadCounter.table","NW_015090842.1:9558688",39,61,22
"RNF166","s1664_F_GON_01_ASEReadCounter.table","NW_015090842.1:9558711",43,65,22
"RNF166","s1664_F_GON_01_ASEReadCounter.table","NW_015090842.1:9558733",42,64,22
"RNF166","s1664_F_GON_01_ASEReadCounter.table","NW_015090842.1:9558847",34,50,16
"RNF166","s1664_F_GON_01_ASEReadCounter.table","NW_015090842.1:9559798",47,72,25
"RNF166","s1664_F_GON_01_ASEReadCounter.table","NW_015090842.1:9560575",51,81,30
"RNF166","s1664_F_GON_01_ASEReadCounter.table","NW_015090842.1:9561055",45,67,22
"RNF166","s1664_F_GON_01_ASEReadCounter.table","NW_015090842.1:9562458",30,59,29
"RNF166","s1664_F_GON_01_ASEReadCounter.table","NW_015090842.1:9562497",30,51,21
"RNF166","s1664_F_GON_01_ASEReadCounter.table","NW_015090842.1:9562539",28,48,20
"RNF166","s1664_F_GON_01_ASEReadCounter.table","NW_015090842.1:9564056",21,39,18
"CTU2","s1664_F_GON_01_ASEReadCounter.table","NW_015090842.1:9565149",4,7,3
"CTU2","s1664_F_GON_01_ASEReadCounter.table","NW_015090842.1:9565193",4,9,5
"CTU2","s1664_F_GON_01_ASEReadCounter.table","NW_015090842.1:9565300",4,13,9
"CTU2","s1664_F_GON_01_ASEReadCounter.table","NW_015090842.1:9565321",3,11,8
"CTU2","s1664_F_GON_01_ASEReadCounter.table","NW_015090842.1:9565721",4,12,8
"CTU2","s1664_F_GON_01_ASEReadCounter.table","NW_015090842.1:9565739",3,12,9
"CTU2","s1664_F_GON_01_ASEReadCounter.table","NW_015090842.1:9565905",8,19,11
"CTU2","s1664_F_GON_01_ASEReadCounter.table","NW_015090842.1:9566013",11,11,0
"CTU2","s1664_F_GON_01_ASEReadCounter.table","NW_015090842.1:9566055",4,21,17
"CTU2","s1664_F_GON_01_ASEReadCounter.table","NW_015090842.1:9566056",4,21,17
"CTU2","s1664_F_GON_01_ASEReadCounter.table","NW_015090842.1:9566151",3,10,7
"CTU2","s1664_F_GON_01_ASEReadCounter.table","NW_015090842.1:9566300",3,18,15
"CTU2","s1664_F_GON_01_ASEReadCounter.table","NW_015090842.1:9566342",5,19,14
"CTU2","s1664_F_GON_01_ASEReadCounter.table","NW_015090842.1:9566548",6,22,16
"CTU2","s1664_F_GON_01_ASEReadCounter.table","NW_015090842.1:9566625",10,24,14
"CTU2","s1664_F_GON_01_ASEReadCounter.table","NW_015090842.1:9566633",8,23,15
"CTU2","s1664_F_GON_01_ASEReadCounter.table","NW_015090842.1:9566807",6,22,16
"CTU2","s1664_F_GON_01_ASEReadCounter.table","NW_015090842.1:9567139",9,22,13
"CTU2","s1664_F_GON_01_ASEReadCounter.table","NW_015090842.1:9567156",10,19,9
"CTU2","s1664_F_GON_01_ASEReadCounter.table","NW_015090842.1:9567614",16,24,8
"CTU2","s1664_F_GON_01_ASEReadCounter.table","NW_015090842.1:9567677",11,21,10
"CTU2","s1664_F_GON_01_ASEReadCounter.table","NW_015090842.1:9567747",17,22,5
"CTU2","s1664_F_GON_01_ASEReadCounter.table","NW_015090842.1:9567828",9,16,7
"CTU2","s1664_F_GON_01_ASEReadCounter.table","NW_015090842.1:9567829",9,16,7
"CTU2","s1664_F_GON_01_ASEReadCounter.table","NW_015090842.1:9567885",10,17,7
"PIEZO1","s1664_F_GON_01_ASEReadCounter.table","NW_015090842.1:9568093",34,59,25
"PIEZO1","s1664_F_GON_01_ASEReadCounter.table","NW_015090842.1:9568672",21,36,15
"PIEZO1","s1664_F_GON_01_ASEReadCounter.table","NW_015090842.1:9568948",19,34,15
"PIEZO1","s1664_F_GON_01_ASEReadCounter.table","NW_015090842.1:9568987",26,26,0
"PIEZO1","s1664_F_GON_01_ASEReadCounter.table","NW_015090842.1:9569040",18,25,7
"PIEZO1","s1664_F_GON_01_ASEReadCounter.table","NW_015090842.1:9569180",20,25,5
"PIEZO1","s1664_F_GON_01_ASEReadCounter.table","NW_015090842.1:9569192",22,27,5
"PIEZO1","s1664_F_GON_01_ASEReadCounter.table","NW_015090842.1:9570088",13,21,8
"PIEZO1","s1664_F_GON_01_ASEReadCounter.table","NW_015090842.1:9570480",5,10,5
"PIEZO1","s1664_F_GON_01_ASEReadCounter.table","NW_015090842.1:9570639",10,15,5
"PIEZO1","s1664_F_GON_01_ASEReadCounter.table","NW_015090842.1:9571847",9,11,2
"PIEZO1","s1664_F_GON_01_ASEReadCounter.table","NW_015090842.1:9572371",9,12,3
"PIEZO1","s1664_F_GON_01_ASEReadCounter.table","NW_015090842.1:9572638",3,4,1
"PIEZO1","s1664_F_GON_01_ASEReadCounter.table","NW_015090842.1:9573156",7,9,2
"PIEZO1","s1664_F_GON_01_ASEReadCounter.table","NW_015090842.1:9573280",5,7,2
"PIEZO1","s1664_F_GON_01_ASEReadCounter.table","NW_015090842.1:9573566",4,8,4
"PIEZO1","s1664_F_GON_01_ASEReadCounter.table","NW_015090842.1:9575341",3,5,2
"PIEZO1","s1664_F_GON_01_ASEReadCounter.table","NW_015090842.1:9575367",2,4,2
"PIEZO1","s1664_F_GON_01_ASEReadCounter.table","NW_015090842.1:9575645",3,4,1
"PIEZO1","s1664_F_GON_01_ASEReadCounter.table","NW_015090842.1:9575696",2,4,2
"PIEZO1","s1664_F_GON_01_ASEReadCounter.table","NW_015090842.1:9575897",1,4,3
"PIEZO1","s1664_F_GON_01_ASEReadCounter.table","NW_015090842.1:9576060",0,2,2
"PIEZO1","s1664_F_GON_01_ASEReadCounter.table","NW_015090842.1:9576087",0,2,2
"PIEZO1","s1664_F_GON_01_ASEReadCounter.table","NW_015090842.1:9576093",0,2,2
"PIEZO1","s1664_F_GON_01_ASEReadCounter.table","NW_015090842.1:9576120",2,5,3
"PIEZO1","s1664_F_GON_01_ASEReadCounter.table","NW_015090842.1:9576687",4,5,1
"PIEZO1","s1664_F_GON_01_ASEReadCounter.table","NW_015090842.1:9576710",4,4,0
"PIEZO1","s1664_F_GON_01_ASEReadCounter.table","NW_015090842.1:9576723",2,5,3
"PIEZO1","s1664_F_GON_01_ASEReadCounter.table","NW_015090842.1:9578268",7,10,3
"PIEZO1","s1664_F_GON_01_ASEReadCounter.table","NW_015090842.1:9578770",6,8,2
"PIEZO1","s1664_F_GON_01_ASEReadCounter.table","NW_015090842.1:9578806",3,5,2
"PIEZO1","s1664_F_GON_01_ASEReadCounter.table","NW_015090842.1:9579064",1,2,1
"PIEZO1","s1664_F_GON_01_ASEReadCounter.table","NW_015090842.1:9579065",1,2,1
"PIEZO1","s1664_F_GON_01_ASEReadCounter.table","NW_015090842.1:9579347",5,5,0
"PIEZO1","s1664_F_GON_01_ASEReadCounter.table","NW_015090842.1:9580996",1,3,2
"PIEZO1","s1664_F_GON_01_ASEReadCounter.table","NW_015090842.1:9581299",2,2,0
"PIEZO1","s1664_F_GON_01_ASEReadCounter.table","NW_015090842.1:9581875",4,5,1
"PIEZO1","s1664_F_GON_01_ASEReadCounter.table","NW_015090842.1:9582046",2,2,0
"PIEZO1","s1664_F_GON_01_ASEReadCounter.table","NW_015090842.1:9582961",2,2,0
"PIEZO1","s1664_F_GON_01_ASEReadCounter.table","NW_015090842.1:9584337",3,3,0
"PIEZO1","s1664_F_GON_01_ASEReadCounter.table","NW_015090842.1:9584425",5,5,0
"PIEZO1","s1664_F_GON_01_ASEReadCounter.table","NW_015090842.1:9584435",5,5,0
"PIEZO1","s1664_F_GON_01_ASEReadCounter.table","NW_015090842.1:9584438",5,5,0
"PIEZO1","s1664_F_GON_01_ASEReadCounter.table","NW_015090842.1:9584441",5,5,0
"CDT1","s1664_F_GON_01_ASEReadCounter.table","NW_015090842.1:9596596",2,5,3
"CDT1","s1664_F_GON_01_ASEReadCounter.table","NW_015090842.1:9596766",2,6,4
"CDT1","s1664_F_GON_01_ASEReadCounter.table","NW_015090842.1:9597054",8,17,9
"CDT1","s1664_F_GON_01_ASEReadCounter.table","NW_015090842.1:9597074",7,14,7
"CDT1","s1664_F_GON_01_ASEReadCounter.table","NW_015090842.1:9597137",9,21,12
"CDT1","s1664_F_GON_01_ASEReadCounter.table","NW_015090842.1:9597756",7,14,7
"CDT1","s1664_F_GON_01_ASEReadCounter.table","NW_015090842.1:9597766",11,19,8
"CDT1","s1664_F_GON_01_ASEReadCounter.table","NW_015090842.1:9598496",15,29,14
"CDT1","s1664_F_GON_01_ASEReadCounter.table","NW_015090842.1:9598498",15,29,14
"CDT1","s1664_F_GON_01_ASEReadCounter.table","NW_015090842.1:9598816",14,26,12
"CDT1","s1664_F_GON_01_ASEReadCounter.table","NW_015090842.1:9598879",17,29,12
"CDT1","s1664_F_GON_01_ASEReadCounter.table","NW_015090842.1:9598912",21,34,13
"CDT1","s1664_F_GON_01_ASEReadCounter.table","NW_015090842.1:9598959",13,27,14
"CDT1","s1664_F_GON_01_ASEReadCounter.table","NW_015090842.1:9599807",61,72,11
"CDT1","s1664_F_GON_01_ASEReadCounter.table","NW_015090842.1:9599819",55,67,12
"CDT1","s1664_F_GON_01_ASEReadCounter.table","NW_015090842.1:9599845",51,65,14
"CDT1","s1664_F_GON_01_ASEReadCounter.table","NW_015090842.1:9600148",64,86,22
"CDT1","s1664_F_GON_01_ASEReadCounter.table","NW_015090842.1:9600151",66,90,24
"CDT1","s1664_F_GON_01_ASEReadCounter.table","NW_015090842.1:9600217",66,92,26
"CDT1","s1664_F_GON_01_ASEReadCounter.table","NW_015090842.1:9600226",66,93,27
"CDT1","s1664_F_GON_01_ASEReadCounter.table","NW_015090842.1:9600260",59,80,21
"CDT1","s1664_F_GON_01_ASEReadCounter.table","NW_015090842.1:9600268",59,79,20
"CDT1","s1664_F_GON_01_ASEReadCounter.table","NW_015090842.1:9600305",60,79,19
"CDT1","s1664_F_GON_01_ASEReadCounter.table","NW_015090842.1:9600397",35,52,17
"CDT1","s1664_F_GON_01_ASEReadCounter.table","NW_015090842.1:9600447",26,45,19
"CDT1","s1664_F_GON_01_ASEReadCounter.table","NW_015090842.1:9600450",25,43,18
"CDT1","s1664_F_GON_01_ASEReadCounter.table","NW_015090842.1:9600485",35,57,22
"CDT1","s1664_F_GON_01_ASEReadCounter.table","NW_015090842.1:9600579",26,50,24
"APRT","s1664_F_GON_01_ASEReadCounter.table","NW_015090842.1:9602308",25,36,11
"APRT","s1664_F_GON_01_ASEReadCounter.table","NW_015090842.1:9602440",37,64,27
"APRT","s1664_F_GON_01_ASEReadCounter.table","NW_015090842.1:9602449",42,69,27
"APRT","s1664_F_GON_01_ASEReadCounter.table","NW_015090842.1:9602451",42,69,27
"APRT","s1664_F_GON_01_ASEReadCounter.table","NW_015090842.1:9602455",45,72,27
"APRT","s1664_F_GON_01_ASEReadCounter.table","NW_015090842.1:9602462",44,70,26
"APRT","s1664_F_GON_01_ASEReadCounter.table","NW_015090842.1:9602507",36,54,18
"APRT","s1664_F_GON_01_ASEReadCounter.table","NW_015090842.1:9602514",35,55,20
"APRT","s1664_F_GON_01_ASEReadCounter.table","NW_015090842.1:9602530",33,50,17
"APRT","s1664_F_GON_01_ASEReadCounter.table","NW_015090842.1:9602582",27,56,29
"APRT","s1664_F_GON_01_ASEReadCounter.table","NW_015090842.1:9602583",28,57,29
"APRT","s1664_F_GON_01_ASEReadCounter.table","NW_015090842.1:9602650",31,67,36
"APRT","s1664_F_GON_01_ASEReadCounter.table","NW_015090842.1:9602655",31,65,34
"APRT","s1664_F_GON_01_ASEReadCounter.table","NW_015090842.1:9602712",27,67,40
"APRT","s1664_F_GON_01_ASEReadCounter.table","NW_015090842.1:9602764",25,62,37
"APRT","s1664_F_GON_01_ASEReadCounter.table","NW_015090842.1:9602821",36,64,28
"APRT","s1664_F_GON_01_ASEReadCounter.table","NW_015090842.1:9602867",32,56,24
"APRT","s1664_F_GON_01_ASEReadCounter.table","NW_015090842.1:9602883",30,55,25
"APRT","s1664_F_GON_01_ASEReadCounter.table","NW_015090842.1:9602886",34,60,26
"APRT","s1664_F_GON_01_ASEReadCounter.table","NW_015090842.1:9602948",36,58,22
"APRT","s1664_F_GON_01_ASEReadCounter.table","NW_015090842.1:9602958",38,61,23
"APRT","s1664_F_GON_01_ASEReadCounter.table","NW_015090842.1:9603020",43,74,31
"APRT","s1664_F_GON_01_ASEReadCounter.table","NW_015090842.1:9603025",43,74,31
"APRT","s1664_F_GON_01_ASEReadCounter.table","NW_015090842.1:9603154",25,38,13
"APRT","s1664_F_GON_01_ASEReadCounter.table","NW_015090842.1:9603166",28,44,16
"APRT","s1664_F_GON_01_ASEReadCounter.table","NW_015090842.1:9603326",32,53,21
"APRT","s1664_F_GON_01_ASEReadCounter.table","NW_015090842.1:9603419",38,65,27
"APRT","s1664_F_GON_01_ASEReadCounter.table","NW_015090842.1:9603420",39,66,27
"APRT","s1664_F_GON_01_ASEReadCounter.table","NW_015090842.1:9603464",34,79,45
"APRT","s1664_F_GON_01_ASEReadCounter.table","NW_015090842.1:9603528",58,156,98
"APRT","s1664_F_GON_01_ASEReadCounter.table","NW_015090842.1:9603607",75,224,149
"APRT","s1664_F_GON_01_ASEReadCounter.table","NW_015090842.1:9603622",76,224,148
"APRT","s1664_F_GON_01_ASEReadCounter.table","NW_015090842.1:9604361",84,240,156
"APRT","s1664_F_GON_01_ASEReadCounter.table","NW_015090842.1:9605317",75,199,124
"APRT","s1664_F_GON_01_ASEReadCounter.table","NW_015090842.1:9605336",78,216,138
"GALNS","s1664_F_GON_01_ASEReadCounter.table","NW_015090842.1:9612872",18,34,16
"GALNS","s1664_F_GON_01_ASEReadCounter.table","NW_015090842.1:9612873",18,34,16
"GALNS","s1664_F_GON_01_ASEReadCounter.table","NW_015090842.1:9612877",21,36,15
"GALNS","s1664_F_GON_01_ASEReadCounter.table","NW_015090842.1:9612942",75,136,61
"GALNS","s1664_F_GON_01_ASEReadCounter.table","NW_015090842.1:9612987",119,119,0
"GALNS","s1664_F_GON_01_ASEReadCounter.table","NW_015090842.1:9613064",54,126,72
"GALNS","s1664_F_GON_01_ASEReadCounter.table","NW_015090842.1:9613096",99,177,78
"GALNS","s1664_F_GON_01_ASEReadCounter.table","NW_015090842.1:9613123",89,161,72
"GALNS","s1664_F_GON_01_ASEReadCounter.table","NW_015090842.1:9613125",88,157,69
"GALNS","s1664_F_GON_01_ASEReadCounter.table","NW_015090842.1:9613193",89,160,71
"GALNS","s1664_F_GON_01_ASEReadCounter.table","NW_015090842.1:9613226",78,151,73
"GALNS","s1664_F_GON_01_ASEReadCounter.table","NW_015090842.1:9613249",84,162,78
"GALNS","s1664_F_GON_01_ASEReadCounter.table","NW_015090842.1:9613256",91,173,82
"GALNS","s1664_F_GON_01_ASEReadCounter.table","NW_015090842.1:9613317",103,186,83
"GALNS","s1664_F_GON_01_ASEReadCounter.table","NW_015090842.1:9613343",98,176,78
"GALNS","s1664_F_GON_01_ASEReadCounter.table","NW_015090842.1:9613344",97,175,78
"GALNS","s1664_F_GON_01_ASEReadCounter.table","NW_015090842.1:9613371",94,173,79
"GALNS","s1664_F_GON_01_ASEReadCounter.table","NW_015090842.1:9613378",90,175,85
"GALNS","s1664_F_GON_01_ASEReadCounter.table","NW_015090842.1:9613379",88,172,84
"GALNS","s1664_F_GON_01_ASEReadCounter.table","NW_015090842.1:9613516",98,179,81
"GALNS","s1664_F_GON_01_ASEReadCounter.table","NW_015090842.1:9613572",96,190,94
"GALNS","s1664_F_GON_01_ASEReadCounter.table","NW_015090842.1:9613597",84,188,104
"GALNS","s1664_F_GON_01_ASEReadCounter.table","NW_015090842.1:9613627",54,138,84
"GALNS","s1664_F_GON_01_ASEReadCounter.table","NW_015090842.1:9613640",51,130,79
"GALNS","s1664_F_GON_01_ASEReadCounter.table","NW_015090842.1:9614025",72,131,59
"GALNS","s1664_F_GON_01_ASEReadCounter.table","NW_015090842.1:9614169",47,108,61
"GALNS","s1664_F_GON_01_ASEReadCounter.table","NW_015090842.1:9614232",111,111,0
"GALNS","s1664_F_GON_01_ASEReadCounter.table","NW_015090842.1:9614667",79,131,52
"GALNS","s1664_F_GON_01_ASEReadCounter.table","NW_015090842.1:9614709",63,114,51
"GALNS","s1664_F_GON_01_ASEReadCounter.table","NW_015090842.1:9614880",67,112,45
"GALNS","s1664_F_GON_01_ASEReadCounter.table","NW_015090842.1:9614902",64,112,48
"GALNS","s1664_F_GON_01_ASEReadCounter.table","NW_015090842.1:9614960",47,91,44
"GALNS","s1664_F_GON_01_ASEReadCounter.table","NW_015090842.1:9615114",84,179,95
"GALNS","s1664_F_GON_01_ASEReadCounter.table","NW_015090842.1:9615199",67,193,126
"GALNS","s1664_F_GON_01_ASEReadCounter.table","NW_015090842.1:9615217",66,192,126
"GALNS","s1664_F_GON_01_ASEReadCounter.table","NW_015090842.1:9615277",63,258,195
"GALNS","s1664_F_GON_01_ASEReadCounter.table","NW_015090842.1:9615377",99,469,370
"GALNS","s1664_F_GON_01_ASEReadCounter.table","NW_015090842.1:9647858",69,436,367
"GALNS","s1664_F_GON_01_ASEReadCounter.table","NW_015090842.1:9649186",64,399,335
"GALNS","s1664_F_GON_01_ASEReadCounter.table","NW_015090842.1:9649237",71,409,338
"GALNS","s1664_F_GON_01_ASEReadCounter.table","NW_015090842.1:9661193",27,146,119
"TRAPPC2L","s1664_F_GON_01_ASEReadCounter.table","NW_015090842.1:9662951",500,850,350
"TRAPPC2L","s1664_F_GON_01_ASEReadCounter.table","NW_015090842.1:9663014",525,839,314
"TRAPPC2L","s1664_F_GON_01_ASEReadCounter.table","NW_015090842.1:9664305",696,699,3
"TRAPPC2L","s1664_F_GON_01_ASEReadCounter.table","NW_015090842.1:9665155",414,679,265
"TRAPPC2L","s1664_F_GON_01_ASEReadCounter.table","NW_015090842.1:9665211",127,240,113
"PABPN1L","s1664_F_GON_01_ASEReadCounter.table","NW_015090842.1:9669959",3,5,2
"CBFA2T3","s1664_F_GON_01_ASEReadCounter.table","NW_015090842.1:9709469",0,2,2
"CBFA2T3","s1664_F_GON_01_ASEReadCounter.table","NW_015090842.1:9709475",0,2,2
"CBFA2T3","s1664_F_GON_01_ASEReadCounter.table","NW_015090842.1:9712673",1,1,0
"CBFA2T3","s1664_F_GON_01_ASEReadCounter.table","NW_015090842.1:9712787",1,2,1
"CBFA2T3","s1664_F_GON_01_ASEReadCounter.table","NW_015090842.1:9712791",1,2,1
"CBFA2T3","s1664_F_GON_01_ASEReadCounter.table","NW_015090842.1:9713121",0,1,1
"CBFA2T3","s1664_F_GON_01_ASEReadCounter.table","NW_015090842.1:9717058",1,2,1
"ACSF3","s1664_F_GON_01_ASEReadCounter.table","NW_015090842.1:9773379",3,9,6
"ACSF3","s1664_F_GON_01_ASEReadCounter.table","NW_015090842.1:9773382",4,10,6
"ACSF3","s1664_F_GON_01_ASEReadCounter.table","NW_015090842.1:9773384",4,10,6
"ACSF3","s1664_F_GON_01_ASEReadCounter.table","NW_015090842.1:9773388",3,10,7
"ACSF3","s1664_F_GON_01_ASEReadCounter.table","NW_015090842.1:9776753",11,40,29
"ACSF3","s1664_F_GON_01_ASEReadCounter.table","NW_015090842.1:9776783",14,45,31
"ACSF3","s1664_F_GON_01_ASEReadCounter.table","NW_015090842.1:9776879",15,37,22
"ACSF3","s1664_F_GON_01_ASEReadCounter.table","NW_015090842.1:9776965",14,38,24
"ACSF3","s1664_F_GON_01_ASEReadCounter.table","NW_015090842.1:9777091",13,31,18
"ACSF3","s1664_F_GON_01_ASEReadCounter.table","NW_015090842.1:9777206",15,34,19
"ACSF3","s1664_F_GON_01_ASEReadCounter.table","NW_015090842.1:9777283",19,54,35
"ACSF3","s1664_F_GON_01_ASEReadCounter.table","NW_015090842.1:9778955",28,74,46
"ACSF3","s1664_F_GON_01_ASEReadCounter.table","NW_015090842.1:9778997",30,94,64
"ACSF3","s1664_F_GON_01_ASEReadCounter.table","NW_015090842.1:9789311",14,21,7
"ACSF3","s1664_F_GON_01_ASEReadCounter.table","NW_015090842.1:9789906",1,7,6
"ACSF3","s1664_F_GON_01_ASEReadCounter.table","NW_015090842.1:9834743",15,29,14
"ACSF3","s1664_F_GON_01_ASEReadCounter.table","NW_015090842.1:9834852",23,42,19
"ACSF3","s1664_F_GON_01_ASEReadCounter.table","NW_015090842.1:9834861",18,35,17
"ACSF3","s1664_F_GON_01_ASEReadCounter.table","NW_015090842.1:9839359",14,29,15
"ACSF3","s1664_F_GON_01_ASEReadCounter.table","NW_015090842.1:9839378",16,32,16
"ACSF3","s1664_F_GON_01_ASEReadCounter.table","NW_015090842.1:9839455",15,25,10
"ACSF3","s1664_F_GON_01_ASEReadCounter.table","NW_015090842.1:9839457",15,24,9
"ACSF3","s1664_F_GON_01_ASEReadCounter.table","NW_015090842.1:9839489",14,22,8
"ACSF3","s1664_F_GON_01_ASEReadCounter.table","NW_015090842.1:9839500",13,17,4
"ACSF3","s1664_F_GON_01_ASEReadCounter.table","NW_015090842.1:9839501",13,17,4
"ACSF3","s1664_F_GON_01_ASEReadCounter.table","NW_015090842.1:9839504",15,19,4
"ACSF3","s1664_F_GON_01_ASEReadCounter.table","NW_015090842.1:9839512",10,12,2
"ACSF3","s1664_F_GON_01_ASEReadCounter.table","NW_015090842.1:9839527",9,10,1
"ACSF3","s1664_F_GON_01_ASEReadCounter.table","NW_015090842.1:9839533",5,5,0
"ACSF3","s1664_F_GON_01_ASEReadCounter.table","NW_015090842.1:9839535",5,5,0
"ACSF3","s1664_F_GON_01_ASEReadCounter.table","NW_015090842.1:9839545",4,4,0
"ACSF3","s1664_F_GON_01_ASEReadCounter.table","NW_015090842.1:9839550",2,2,0
"ACSF3","s1664_F_GON_01_ASEReadCounter.table","NW_015090842.1:9839551",2,2,0
"CDH15","s1664_F_GON_01_ASEReadCounter.table","NW_015090842.1:9847163",0,1,1
"CDH15","s1664_F_GON_01_ASEReadCounter.table","NW_015090842.1:9847174",0,1,1
"CDH15","s1664_F_GON_01_ASEReadCounter.table","NW_015090842.1:9848220",1,3,2
"CDH15","s1664_F_GON_01_ASEReadCounter.table","NW_015090842.1:9848265",0,1,1
"CDH15","s1664_F_GON_01_ASEReadCounter.table","NW_015090842.1:9848531",2,2,0
"CDH15","s1664_F_GON_01_ASEReadCounter.table","NW_015090842.1:9848552",1,3,2
"CDH15","s1664_F_GON_01_ASEReadCounter.table","NW_015090842.1:9848936",1,2,1
"CDH15","s1664_F_GON_01_ASEReadCounter.table","NW_015090842.1:9849086",1,1,0
"CDH15","s1664_F_GON_01_ASEReadCounter.table","NW_015090842.1:9849119",1,1,0
"CDH15","s1664_F_GON_01_ASEReadCounter.table","NW_015090842.1:9849140",1,1,0
"CDH15","s1664_F_GON_01_ASEReadCounter.table","NW_015090842.1:9849473",0,1,1
"CDH15","s1664_F_GON_01_ASEReadCounter.table","NW_015090842.1:9850609",1,1,0
"SLC22A31","s1664_F_GON_01_ASEReadCounter.table","NW_015090842.1:9850818",0,1,1
"SLC22A31","s1664_F_GON_01_ASEReadCounter.table","NW_015090842.1:9850929",1,2,1
"SLC22A31","s1664_F_GON_01_ASEReadCounter.table","NW_015090842.1:9850936",1,2,1
"SLC22A31","s1664_F_GON_01_ASEReadCounter.table","NW_015090842.1:9850940",1,2,1
"SLC22A31","s1664_F_GON_01_ASEReadCounter.table","NW_015090842.1:9850948",1,2,1
"SLC22A31","s1664_F_GON_01_ASEReadCounter.table","NW_015090842.1:9850961",1,2,1
"SLC22A31","s1664_F_GON_01_ASEReadCounter.table","NW_015090842.1:9850970",1,2,1
"SLC22A31","s1664_F_GON_01_ASEReadCounter.table","NW_015090842.1:9850978",1,2,1
"SLC22A31","s1664_F_GON_01_ASEReadCounter.table","NW_015090842.1:9850981",1,2,1
"SLC22A31","s1664_F_GON_01_ASEReadCounter.table","NW_015090842.1:9851117",21,30,9
"SLC22A31","s1664_F_GON_01_ASEReadCounter.table","NW_015090842.1:9851130",25,35,10
"SLC22A31","s1664_F_GON_01_ASEReadCounter.table","NW_015090842.1:9851139",29,39,10
"SLC22A31","s1664_F_GON_01_ASEReadCounter.table","NW_015090842.1:9851265",51,85,34
"SLC22A31","s1664_F_GON_01_ASEReadCounter.table","NW_015090842.1:9851302",47,73,26
"SLC22A31","s1664_F_GON_01_ASEReadCounter.table","NW_015090842.1:9851303",48,74,26
"SLC22A31","s1664_F_GON_01_ASEReadCounter.table","NW_015090842.1:9851305",49,75,26
"SLC22A31","s1664_F_GON_01_ASEReadCounter.table","NW_015090842.1:9851343",58,78,20
"SLC22A31","s1664_F_GON_01_ASEReadCounter.table","NW_015090842.1:9851344",66,85,19
"SLC22A31","s1664_F_GON_01_ASEReadCounter.table","NW_015090842.1:9851361",86,86,0
"SLC22A31","s1664_F_GON_01_ASEReadCounter.table","NW_015090842.1:9851381",77,108,31
"SLC22A31","s1664_F_GON_01_ASEReadCounter.table","NW_015090842.1:9851421",82,117,35
"SLC22A31","s1664_F_GON_01_ASEReadCounter.table","NW_015090842.1:9851501",51,66,15
"SLC22A31","s1664_F_GON_01_ASEReadCounter.table","NW_015090842.1:9851526",67,94,27
"SLC22A31","s1664_F_GON_01_ASEReadCounter.table","NW_015090842.1:9851589",89,124,35
"SLC22A31","s1664_F_GON_01_ASEReadCounter.table","NW_015090842.1:9851712",89,132,43
"SLC22A31","s1664_F_GON_01_ASEReadCounter.table","NW_015090842.1:9851899",80,123,43
"SLC22A31","s1664_F_GON_01_ASEReadCounter.table","NW_015090842.1:9852139",94,126,32
"SLC22A31","s1664_F_GON_01_ASEReadCounter.table","NW_015090842.1:9852380",76,125,49
"SLC22A31","s1664_F_GON_01_ASEReadCounter.table","NW_015090842.1:9852431",68,97,29
"SLC22A31","s1664_F_GON_01_ASEReadCounter.table","NW_015090842.1:9852630",69,94,25
"SLC22A31","s1664_F_GON_01_ASEReadCounter.table","NW_015090842.1:9852711",48,75,27
"SLC22A31","s1664_F_GON_01_ASEReadCounter.table","NW_015090842.1:9853099",55,70,15
"SLC22A31","s1664_F_GON_01_ASEReadCounter.table","NW_015090842.1:9853102",55,70,15
"SLC22A31","s1664_F_GON_01_ASEReadCounter.table","NW_015090842.1:9853421",50,51,1
"SLC22A31","s1664_F_GON_01_ASEReadCounter.table","NW_015090842.1:9853457",55,56,1
"SLC22A31","s1664_F_GON_01_ASEReadCounter.table","NW_015090842.1:9853502",44,45,1
"ANKRD11","s1664_F_GON_01_ASEReadCounter.table","NW_015090842.1:9858863",2,3,1
"ANKRD11","s1664_F_GON_01_ASEReadCounter.table","NW_015090842.1:9859101",21,33,12
"ANKRD11","s1664_F_GON_01_ASEReadCounter.table","NW_015090842.1:9859352",11,31,20
"ANKRD11","s1664_F_GON_01_ASEReadCounter.table","NW_015090842.1:9859381",7,21,14
"ANKRD11","s1664_F_GON_01_ASEReadCounter.table","NW_015090842.1:9859679",15,39,24
"ANKRD11","s1664_F_GON_01_ASEReadCounter.table","NW_015090842.1:9861097",16,33,17
"ANKRD11","s1664_F_GON_01_ASEReadCounter.table","NW_015090842.1:9862571",5,15,10
"ANKRD11","s1664_F_GON_01_ASEReadCounter.table","NW_015090842.1:9862652",9,14,5
"ANKRD11","s1664_F_GON_01_ASEReadCounter.table","NW_015090842.1:9866071",0,11,11
"ANKRD11","s1664_F_GON_01_ASEReadCounter.table","NW_015090842.1:9866200",0,9,9
"ANKRD11","s1664_F_GON_01_ASEReadCounter.table","NW_015090842.1:9867391",5,10,5
"ANKRD11","s1664_F_GON_01_ASEReadCounter.table","NW_015090842.1:9867472",4,10,6
"ANKRD11","s1664_F_GON_01_ASEReadCounter.table","NW_015090842.1:9867559",5,12,7
"ANKRD11","s1664_F_GON_01_ASEReadCounter.table","NW_015090842.1:9867667",2,5,3
"ANKRD11","s1664_F_GON_01_ASEReadCounter.table","NW_015090842.1:9867934",5,16,11
"ANKRD11","s1664_F_GON_01_ASEReadCounter.table","NW_015090842.1:9868064",6,12,6
"ANKRD11","s1664_F_GON_01_ASEReadCounter.table","NW_015090842.1:9868093",7,16,9
"ANKRD11","s1664_F_GON_01_ASEReadCounter.table","NW_015090842.1:9868222",4,8,4
"ANKRD11","s1664_F_GON_01_ASEReadCounter.table","NW_015090842.1:9868327",4,14,10
"ANKRD11","s1664_F_GON_01_ASEReadCounter.table","NW_015090842.1:9868414",7,15,8
"ANKRD11","s1664_F_GON_01_ASEReadCounter.table","NW_015090842.1:9868441",5,14,9
"ANKRD11","s1664_F_GON_01_ASEReadCounter.table","NW_015090842.1:9868444",5,15,10
"ANKRD11","s1664_F_GON_01_ASEReadCounter.table","NW_015090842.1:9868519",8,20,12
"ANKRD11","s1664_F_GON_01_ASEReadCounter.table","NW_015090842.1:9868609",10,16,6
"ANKRD11","s1664_F_GON_01_ASEReadCounter.table","NW_015090842.1:9868666",6,12,6
"ANKRD11","s1664_F_GON_01_ASEReadCounter.table","NW_015090842.1:9868738",21,21,0
"ANKRD11","s1664_F_GON_01_ASEReadCounter.table","NW_015090842.1:9869431",9,14,5
"ANKRD11","s1664_F_GON_01_ASEReadCounter.table","NW_015090842.1:9869578",8,21,13
"ANKRD11","s1664_F_GON_01_ASEReadCounter.table","NW_015090842.1:9869734",12,21,9
"ANKRD11","s1664_F_GON_01_ASEReadCounter.table","NW_015090842.1:9870070",7,13,6
"ANKRD11","s1664_F_GON_01_ASEReadCounter.table","NW_015090842.1:9870349",16,23,7
"ANKRD11","s1664_F_GON_01_ASEReadCounter.table","NW_015090842.1:9870604",7,23,16
"ANKRD11","s1664_F_GON_01_ASEReadCounter.table","NW_015090842.1:9870613",6,22,16
"ANKRD11","s1664_F_GON_01_ASEReadCounter.table","NW_015090842.1:9870685",10,25,15
"ANKRD11","s1664_F_GON_01_ASEReadCounter.table","NW_015090842.1:9870760",11,25,14
"ANKRD11","s1664_F_GON_01_ASEReadCounter.table","NW_015090842.1:9870847",5,16,11
"ANKRD11","s1664_F_GON_01_ASEReadCounter.table","NW_015090842.1:9871103",13,26,13
"ANKRD11","s1664_F_GON_01_ASEReadCounter.table","NW_015090842.1:9871165",8,17,9
"ANKRD11","s1664_F_GON_01_ASEReadCounter.table","NW_015090842.1:9871508",9,9,0
"ANKRD11","s1664_F_GON_01_ASEReadCounter.table","NW_015090842.1:9871820",5,9,4
"ANKRD11","s1664_F_GON_01_ASEReadCounter.table","NW_015090842.1:9872118",2,4,2
"ANKRD11","s1664_F_GON_01_ASEReadCounter.table","NW_015090842.1:9877406",5,6,1
"SPG7","s1664_F_GON_01_ASEReadCounter.table","NW_015090842.1:10051190",68,142,74
"SPG7","s1664_F_GON_01_ASEReadCounter.table","NW_015090842.1:10051218",74,162,88
"SPG7","s1664_F_GON_01_ASEReadCounter.table","NW_015090842.1:10052348",102,179,77
"SPG7","s1664_F_GON_01_ASEReadCounter.table","NW_015090842.1:10052366",94,166,72
"SPG7","s1664_F_GON_01_ASEReadCounter.table","NW_015090842.1:10065173",113,252,139
"SPG7","s1664_F_GON_01_ASEReadCounter.table","NW_015090842.1:10065215",82,207,125
"SPG7","s1664_F_GON_01_ASEReadCounter.table","NW_015090842.1:10066365",94,207,113
"SPG7","s1664_F_GON_01_ASEReadCounter.table","NW_015090842.1:10069752",134,294,160
"SPG7","s1664_F_GON_01_ASEReadCounter.table","NW_015090842.1:10069800",127,313,186
"SPG7","s1664_F_GON_01_ASEReadCounter.table","NW_015090842.1:10071192",139,362,223
"SPG7","s1664_F_GON_01_ASEReadCounter.table","NW_015090842.1:10071219",126,322,196
"SPG7","s1664_F_GON_01_ASEReadCounter.table","NW_015090842.1:10071967",105,294,189
"SPG7","s1664_F_GON_01_ASEReadCounter.table","NW_015090842.1:10075109",201,422,221
"SPG7","s1664_F_GON_01_ASEReadCounter.table","NW_015090842.1:10075114",208,429,221
"SPG7","s1664_F_GON_01_ASEReadCounter.table","NW_015090842.1:10075198",171,342,171
"SPG7","s1664_F_GON_01_ASEReadCounter.table","NW_015090842.1:10075487",104,297,193
"SPG7","s1664_F_GON_01_ASEReadCounter.table","NW_015090842.1:10075488",104,301,197
"SPG7","s1664_F_GON_01_ASEReadCounter.table","NW_015090842.1:10075548",100,243,143
"RPL13","s1664_F_GON_01_ASEReadCounter.table","NW_015090842.1:10077387",709,1479,770
"RPL13","s1664_F_GON_01_ASEReadCounter.table","NW_015090842.1:10077978",982,2145,1163
"RPL13","s1664_F_GON_01_ASEReadCounter.table","NW_015090842.1:10077992",991,2070,1079
"CPNE7","s1664_F_GON_01_ASEReadCounter.table","NW_015090842.1:10084001",1,3,2
"CPNE7","s1664_F_GON_01_ASEReadCounter.table","NW_015090842.1:10084856",1,3,2
"CPNE7","s1664_F_GON_01_ASEReadCounter.table","NW_015090842.1:10084872",1,1,0
"CPNE7","s1664_F_GON_01_ASEReadCounter.table","NW_015090842.1:10084892",1,1,0
"CPNE7","s1664_F_GON_01_ASEReadCounter.table","NW_015090842.1:10084921",1,1,0
"CPNE7","s1664_F_GON_01_ASEReadCounter.table","NW_015090842.1:10084935",1,1,0
"CPNE7","s1664_F_GON_01_ASEReadCounter.table","NW_015090842.1:10085000",1,1,0
"CPNE7","s1664_F_GON_01_ASEReadCounter.table","NW_015090842.1:10085089",1,1,0
"CPNE7","s1664_F_GON_01_ASEReadCounter.table","NW_015090842.1:10085096",1,1,0
"CPNE7","s1664_F_GON_01_ASEReadCounter.table","NW_015090842.1:10085126",1,1,0
"CPNE7","s1664_F_GON_01_ASEReadCounter.table","NW_015090842.1:10085167",1,1,0
"CPNE7","s1664_F_GON_01_ASEReadCounter.table","NW_015090842.1:10085180",0,1,1
"CPNE7","s1664_F_GON_01_ASEReadCounter.table","NW_015090842.1:10085201",0,1,1
"CPNE7","s1664_F_GON_01_ASEReadCounter.table","NW_015090842.1:10088134",1,3,2
"CPNE7","s1664_F_GON_01_ASEReadCounter.table","NW_015090842.1:10088146",1,3,2
"CPNE7","s1664_F_GON_01_ASEReadCounter.table","NW_015090842.1:10088806",4,5,1
"CPNE7","s1664_F_GON_01_ASEReadCounter.table","NW_015090842.1:10088940",4,6,2
"CPNE7","s1664_F_GON_01_ASEReadCounter.table","NW_015090842.1:10088965",2,5,3
"CPNE7","s1664_F_GON_01_ASEReadCounter.table","NW_015090842.1:10088967",2,5,3
"CPNE7","s1664_F_GON_01_ASEReadCounter.table","NW_015090842.1:10088973",2,5,3
"CPNE7","s1664_F_GON_01_ASEReadCounter.table","NW_015090842.1:10090924",4,8,4
"CPNE7","s1664_F_GON_01_ASEReadCounter.table","NW_015090842.1:10090930",3,7,4
"CPNE7","s1664_F_GON_01_ASEReadCounter.table","NW_015090842.1:10091075",4,8,4
"CPNE7","s1664_F_GON_01_ASEReadCounter.table","NW_015090842.1:10091389",1,4,3
"CPNE7","s1664_F_GON_01_ASEReadCounter.table","NW_015090842.1:10091407",1,5,4
"CPNE7","s1664_F_GON_01_ASEReadCounter.table","NW_015090842.1:10091488",11,11,0
"CPNE7","s1664_F_GON_01_ASEReadCounter.table","NW_015090842.1:10091491",11,11,0
"CPNE7","s1664_F_GON_01_ASEReadCounter.table","NW_015090842.1:10091530",4,7,3
"CPNE7","s1664_F_GON_01_ASEReadCounter.table","NW_015090842.1:10091875",4,7,3
"CPNE7","s1664_F_GON_01_ASEReadCounter.table","NW_015090842.1:10091983",1,4,3
"CPNE7","s1664_F_GON_01_ASEReadCounter.table","NW_015090842.1:10091997",1,4,3
"CPNE7","s1664_F_GON_01_ASEReadCounter.table","NW_015090842.1:10092038",0,2,2
"CPNE7","s1664_F_GON_01_ASEReadCounter.table","NW_015090842.1:10092140",2,3,1
"CPNE7","s1664_F_GON_01_ASEReadCounter.table","NW_015090842.1:10092183",1,3,2
"CPNE7","s1664_F_GON_01_ASEReadCounter.table","NW_015090842.1:10092201",1,2,1
"CPNE7","s1664_F_GON_01_ASEReadCounter.table","NW_015090842.1:10092230",0,1,1
"CPNE7","s1664_F_GON_01_ASEReadCounter.table","NW_015090842.1:10092246",0,1,1
"LOC106888185","s1664_F_GON_01_ASEReadCounter.table","NW_015090842.1:10094965",3,8,5
"LOC106888185","s1664_F_GON_01_ASEReadCounter.table","NW_015090842.1:10094966",3,8,5
"LOC106888185","s1664_F_GON_01_ASEReadCounter.table","NW_015090842.1:10094985",3,10,7
"LOC106888185","s1664_F_GON_01_ASEReadCounter.table","NW_015090842.1:10095055",0,4,4
"LOC106888185","s1664_F_GON_01_ASEReadCounter.table","NW_015090842.1:10095062",0,2,2
"LOC106888185","s1664_F_GON_01_ASEReadCounter.table","NW_015090842.1:10095130",2,9,7
"LOC106888185","s1664_F_GON_01_ASEReadCounter.table","NW_015090842.1:10095265",23,41,18
"LOC106888185","s1664_F_GON_01_ASEReadCounter.table","NW_015090842.1:10095586",19,46,27
"LOC106888185","s1664_F_GON_01_ASEReadCounter.table","NW_015090842.1:10095593",18,43,25
"LOC106888185","s1664_F_GON_01_ASEReadCounter.table","NW_015090842.1:10095616",19,49,30
"LOC106888185","s1664_F_GON_01_ASEReadCounter.table","NW_015090842.1:10095662",16,46,30
"LOC106888185","s1664_F_GON_01_ASEReadCounter.table","NW_015090842.1:10095674",13,42,29
"LOC106888185","s1664_F_GON_01_ASEReadCounter.table","NW_015090842.1:10095786",12,31,19
"LOC106888185","s1664_F_GON_01_ASEReadCounter.table","NW_015090842.1:10095831",9,25,16
"LOC106888185","s1664_F_GON_01_ASEReadCounter.table","NW_015090842.1:10096230",16,30,14
"LOC106888185","s1664_F_GON_01_ASEReadCounter.table","NW_015090842.1:10096249",12,28,16
"LOC106888185","s1664_F_GON_01_ASEReadCounter.table","NW_015090842.1:10096272",11,34,23
"LOC106888185","s1664_F_GON_01_ASEReadCounter.table","NW_015090842.1:10096288",10,32,22
"LOC106888185","s1664_F_GON_01_ASEReadCounter.table","NW_015090842.1:10097248",6,26,20
"LOC106888185","s1664_F_GON_01_ASEReadCounter.table","NW_015090842.1:10097265",7,33,26
"LOC106888185","s1664_F_GON_01_ASEReadCounter.table","NW_015090842.1:10097446",0,2,2
"DPEP1","s1664_F_GON_01_ASEReadCounter.table","NW_015090842.1:10098017",0,7,7
"DPEP1","s1664_F_GON_01_ASEReadCounter.table","NW_015090842.1:10098518",1,10,9
"DPEP1","s1664_F_GON_01_ASEReadCounter.table","NW_015090842.1:10098595",1,8,7
"DPEP1","s1664_F_GON_01_ASEReadCounter.table","NW_015090842.1:10098597",1,7,6
"DPEP1","s1664_F_GON_01_ASEReadCounter.table","NW_015090842.1:10098601",1,7,6
"DPEP1","s1664_F_GON_01_ASEReadCounter.table","NW_015090842.1:10098608",1,7,6
"DPEP1","s1664_F_GON_01_ASEReadCounter.table","NW_015090842.1:10098630",2,9,7
"DPEP1","s1664_F_GON_01_ASEReadCounter.table","NW_015090842.1:10098659",2,10,8
"DPEP1","s1664_F_GON_01_ASEReadCounter.table","NW_015090842.1:10099765",5,20,15
"DPEP1","s1664_F_GON_01_ASEReadCounter.table","NW_015090842.1:10099985",1,15,14
"DPEP1","s1664_F_GON_01_ASEReadCounter.table","NW_015090842.1:10099986",1,14,13
"DPEP1","s1664_F_GON_01_ASEReadCounter.table","NW_015090842.1:10099991",1,16,15
"DPEP1","s1664_F_GON_01_ASEReadCounter.table","NW_015090842.1:10100044",0,15,15
"DPEP1","s1664_F_GON_01_ASEReadCounter.table","NW_015090842.1:10100045",0,15,15
"DPEP1","s1664_F_GON_01_ASEReadCounter.table","NW_015090842.1:10100084",2,18,16
"DPEP1","s1664_F_GON_01_ASEReadCounter.table","NW_015090842.1:10100295",0,11,11
"DPEP1","s1664_F_GON_01_ASEReadCounter.table","NW_015090842.1:10100529",2,10,8
"DPEP1","s1664_F_GON_01_ASEReadCounter.table","NW_015090842.1:10100893",6,18,12
"DPEP1","s1664_F_GON_01_ASEReadCounter.table","NW_015090842.1:10100902",7,21,14
"DPEP1","s1664_F_GON_01_ASEReadCounter.table","NW_015090842.1:10101072",6,19,13
"DPEP1","s1664_F_GON_01_ASEReadCounter.table","NW_015090842.1:10101199",6,17,11
"DPEP1","s1664_F_GON_01_ASEReadCounter.table","NW_015090842.1:10101483",2,22,20
"DPEP1","s1664_F_GON_01_ASEReadCounter.table","NW_015090842.1:10101497",2,24,22
"DPEP1","s1664_F_GON_01_ASEReadCounter.table","NW_015090842.1:10101525",2,27,25
"DPEP1","s1664_F_GON_01_ASEReadCounter.table","NW_015090842.1:10101875",2,23,21
"DPEP1","s1664_F_GON_01_ASEReadCounter.table","NW_015090842.1:10101913",3,21,18
"DPEP1","s1664_F_GON_01_ASEReadCounter.table","NW_015090842.1:10101996",3,23,20
"DPEP1","s1664_F_GON_01_ASEReadCounter.table","NW_015090842.1:10102014",3,16,13
"DPEP1","s1664_F_GON_01_ASEReadCounter.table","NW_015090842.1:10102035",3,12,9
"CHMP1A","s1664_F_GON_01_ASEReadCounter.table","NW_015090842.1:10102901",81,181,100
"CHMP1A","s1664_F_GON_01_ASEReadCounter.table","NW_015090842.1:10102961",55,177,122
"CHMP1A","s1664_F_GON_01_ASEReadCounter.table","NW_015090842.1:10102996",50,172,122
"CHMP1A","s1664_F_GON_01_ASEReadCounter.table","NW_015090842.1:10103004",55,176,121
"CHMP1A","s1664_F_GON_01_ASEReadCounter.table","NW_015090842.1:10103006",55,180,125
"CHMP1A","s1664_F_GON_01_ASEReadCounter.table","NW_015090842.1:10103052",107,246,139
"CHMP1A","s1664_F_GON_01_ASEReadCounter.table","NW_015090842.1:10103095",116,243,127
"CHMP1A","s1664_F_GON_01_ASEReadCounter.table","NW_015090842.1:10103096",117,243,126
"CHMP1A","s1664_F_GON_01_ASEReadCounter.table","NW_015090842.1:10103152",91,176,85
"CHMP1A","s1664_F_GON_01_ASEReadCounter.table","NW_015090842.1:10103173",82,172,90
"CHMP1A","s1664_F_GON_01_ASEReadCounter.table","NW_015090842.1:10103334",54,112,58
"CHMP1A","s1664_F_GON_01_ASEReadCounter.table","NW_015090842.1:10103373",27,95,68
"CHMP1A","s1664_F_GON_01_ASEReadCounter.table","NW_015090842.1:10103408",55,140,85
"CHMP1A","s1664_F_GON_01_ASEReadCounter.table","NW_015090842.1:10103412",57,140,83
"CHMP1A","s1664_F_GON_01_ASEReadCounter.table","NW_015090842.1:10103512",78,168,90
"CHMP1A","s1664_F_GON_01_ASEReadCounter.table","NW_015090842.1:10103513",79,168,89
"CHMP1A","s1664_F_GON_01_ASEReadCounter.table","NW_015090842.1:10103583",56,123,67
"CHMP1A","s1664_F_GON_01_ASEReadCounter.table","NW_015090842.1:10103614",53,115,62
"CHMP1A","s1664_F_GON_01_ASEReadCounter.table","NW_015090842.1:10103657",50,111,61
"CHMP1A","s1664_F_GON_01_ASEReadCounter.table","NW_015090842.1:10103669",45,102,57
"CHMP1A","s1664_F_GON_01_ASEReadCounter.table","NW_015090842.1:10103674",41,91,50
"CHMP1A","s1664_F_GON_01_ASEReadCounter.table","NW_015090842.1:10103677",42,94,52
"CHMP1A","s1664_F_GON_01_ASEReadCounter.table","NW_015090842.1:10103729",60,121,61
"CHMP1A","s1664_F_GON_01_ASEReadCounter.table","NW_015090842.1:10103758",74,132,58
"CHMP1A","s1664_F_GON_01_ASEReadCounter.table","NW_015090842.1:10103761",76,135,59
"CHMP1A","s1664_F_GON_01_ASEReadCounter.table","NW_015090842.1:10103788",80,174,94
"CHMP1A","s1664_F_GON_01_ASEReadCounter.table","NW_015090842.1:10103789",80,175,95
"CHMP1A","s1664_F_GON_01_ASEReadCounter.table","NW_015090842.1:10103790",80,176,96
"CHMP1A","s1664_F_GON_01_ASEReadCounter.table","NW_015090842.1:10103950",68,144,76
"CHMP1A","s1664_F_GON_01_ASEReadCounter.table","NW_015090842.1:10104335",54,94,40
"CHMP1A","s1664_F_GON_01_ASEReadCounter.table","NW_015090842.1:10104429",61,145,84
"CHMP1A","s1664_F_GON_01_ASEReadCounter.table","NW_015090842.1:10104532",58,131,73
"CHMP1A","s1664_F_GON_01_ASEReadCounter.table","NW_015090842.1:10104633",50,107,57
"CHMP1A","s1664_F_GON_01_ASEReadCounter.table","NW_015090842.1:10104759",57,133,76
"CHMP1A","s1664_F_GON_01_ASEReadCounter.table","NW_015090842.1:10104794",72,137,65
"CHMP1A","s1664_F_GON_01_ASEReadCounter.table","NW_015090842.1:10104841",84,84,0
"CHMP1A","s1664_F_GON_01_ASEReadCounter.table","NW_015090842.1:10104844",45,84,39
"CHMP1A","s1664_F_GON_01_ASEReadCounter.table","NW_015090842.1:10106242",50,106,56
"CHMP1A","s1664_F_GON_01_ASEReadCounter.table","NW_015090842.1:10106290",44,96,52
"CHMP1A","s1664_F_GON_01_ASEReadCounter.table","NW_015090842.1:10106335",58,118,60
"CHMP1A","s1664_F_GON_01_ASEReadCounter.table","NW_015090842.1:10106383",63,134,71
"CHMP1A","s1664_F_GON_01_ASEReadCounter.table","NW_015090842.1:10106747",54,123,69
"CHMP1A","s1664_F_GON_01_ASEReadCounter.table","NW_015090842.1:10107404",71,144,73
"CHMP1A","s1664_F_GON_01_ASEReadCounter.table","NW_015090842.1:10107876",61,110,49
"CDK10","s1664_F_GON_01_ASEReadCounter.table","NW_015090842.1:10109030",8,9,1
"CDK10","s1664_F_GON_01_ASEReadCounter.table","NW_015090842.1:10109963",49,123,74
"CDK10","s1664_F_GON_01_ASEReadCounter.table","NW_015090842.1:10110887",72,140,68
"CDK10","s1664_F_GON_01_ASEReadCounter.table","NW_015090842.1:10111254",48,112,64
"CDK10","s1664_F_GON_01_ASEReadCounter.table","NW_015090842.1:10111380",50,134,84
"CDK10","s1664_F_GON_01_ASEReadCounter.table","NW_015090842.1:10111395",52,124,72
"CDK10","s1664_F_GON_01_ASEReadCounter.table","NW_015090842.1:10111437",30,108,78
"CDK10","s1664_F_GON_01_ASEReadCounter.table","NW_015090842.1:10111798",67,144,77
"CDK10","s1664_F_GON_01_ASEReadCounter.table","NW_015090842.1:10111840",73,166,93
"CDK10","s1664_F_GON_01_ASEReadCounter.table","NW_015090842.1:10112031",93,192,99
"CDK10","s1664_F_GON_01_ASEReadCounter.table","NW_015090842.1:10112285",93,210,117
"CDK10","s1664_F_GON_01_ASEReadCounter.table","NW_015090842.1:10112398",91,205,114
"CDK10","s1664_F_GON_01_ASEReadCounter.table","NW_015090842.1:10112455",72,169,97
"CDK10","s1664_F_GON_01_ASEReadCounter.table","NW_015090842.1:10112461",66,151,85
"CDK10","s1664_F_GON_01_ASEReadCounter.table","NW_015090842.1:10112497",62,136,74
"CDK10","s1664_F_GON_01_ASEReadCounter.table","NW_015090842.1:10112508",53,133,80
"CDK10","s1664_F_GON_01_ASEReadCounter.table","NW_015090842.1:10112518",37,114,77
"CDK10","s1664_F_GON_01_ASEReadCounter.table","NW_015090842.1:10112540",23,110,87
"CDK10","s1664_F_GON_01_ASEReadCounter.table","NW_015090842.1:10112556",54,138,84
"CDK10","s1664_F_GON_01_ASEReadCounter.table","NW_015090842.1:10112561",55,157,102
"CDK10","s1664_F_GON_01_ASEReadCounter.table","NW_015090842.1:10112596",69,169,100
"CDK10","s1664_F_GON_01_ASEReadCounter.table","NW_015090842.1:10112630",50,134,84
"CDK10","s1664_F_GON_01_ASEReadCounter.table","NW_015090842.1:10112656",45,120,75
"CDK10","s1664_F_GON_01_ASEReadCounter.table","NW_015090842.1:10112665",41,95,54
"CDK10","s1664_F_GON_01_ASEReadCounter.table","NW_015090842.1:10112668",39,91,52
"CDK10","s1664_F_GON_01_ASEReadCounter.table","NW_015090842.1:10112781",20,51,31
"CDK10","s1664_F_GON_01_ASEReadCounter.table","NW_015090842.1:10112782",20,51,31
"CDK10","s1664_F_GON_01_ASEReadCounter.table","NW_015090842.1:10112795",18,46,28
"CDK10","s1664_F_GON_01_ASEReadCounter.table","NW_015090842.1:10112841",6,15,9
"CDK10","s1664_F_GON_01_ASEReadCounter.table","NW_015090842.1:10112861",3,9,6
"SPATA2L","s1664_F_GON_01_ASEReadCounter.table","NW_015090842.1:10113212",3,8,5
"SPATA2L","s1664_F_GON_01_ASEReadCounter.table","NW_015090842.1:10113280",5,14,9
"SPATA2L","s1664_F_GON_01_ASEReadCounter.table","NW_015090842.1:10113296",5,14,9
"SPATA2L","s1664_F_GON_01_ASEReadCounter.table","NW_015090842.1:10113321",6,16,10
"SPATA2L","s1664_F_GON_01_ASEReadCounter.table","NW_015090842.1:10113332",5,17,12
"SPATA2L","s1664_F_GON_01_ASEReadCounter.table","NW_015090842.1:10113380",9,21,12
"SPATA2L","s1664_F_GON_01_ASEReadCounter.table","NW_015090842.1:10113381",9,24,15
"SPATA2L","s1664_F_GON_01_ASEReadCounter.table","NW_015090842.1:10113412",11,26,15
"SPATA2L","s1664_F_GON_01_ASEReadCounter.table","NW_015090842.1:10113421",12,25,13
"SPATA2L","s1664_F_GON_01_ASEReadCounter.table","NW_015090842.1:10113465",9,23,14
"SPATA2L","s1664_F_GON_01_ASEReadCounter.table","NW_015090842.1:10113535",11,26,15
"SPATA2L","s1664_F_GON_01_ASEReadCounter.table","NW_015090842.1:10113645",11,28,17
"SPATA2L","s1664_F_GON_01_ASEReadCounter.table","NW_015090842.1:10113682",16,40,24
"SPATA2L","s1664_F_GON_01_ASEReadCounter.table","NW_015090842.1:10113696",14,37,23
"SPATA2L","s1664_F_GON_01_ASEReadCounter.table","NW_015090842.1:10113727",16,39,23
"SPATA2L","s1664_F_GON_01_ASEReadCounter.table","NW_015090842.1:10113799",18,41,23
"SPATA2L","s1664_F_GON_01_ASEReadCounter.table","NW_015090842.1:10113809",20,45,25
"SPATA2L","s1664_F_GON_01_ASEReadCounter.table","NW_015090842.1:10113827",19,46,27
"SPATA2L","s1664_F_GON_01_ASEReadCounter.table","NW_015090842.1:10113831",21,46,25
"SPATA2L","s1664_F_GON_01_ASEReadCounter.table","NW_015090842.1:10113894",10,29,19
"SPATA2L","s1664_F_GON_01_ASEReadCounter.table","NW_015090842.1:10113905",7,28,21
"SPATA2L","s1664_F_GON_01_ASEReadCounter.table","NW_015090842.1:10113914",6,27,21
"SPATA2L","s1664_F_GON_01_ASEReadCounter.table","NW_015090842.1:10113920",7,29,22
"SPATA2L","s1664_F_GON_01_ASEReadCounter.table","NW_015090842.1:10113937",11,36,25
"SPATA2L","s1664_F_GON_01_ASEReadCounter.table","NW_015090842.1:10113971",10,34,24
"SPATA2L","s1664_F_GON_01_ASEReadCounter.table","NW_015090842.1:10113976",10,35,25
"SPATA2L","s1664_F_GON_01_ASEReadCounter.table","NW_015090842.1:10113985",10,34,24
"SPATA2L","s1664_F_GON_01_ASEReadCounter.table","NW_015090842.1:10113994",13,38,25
"SPATA2L","s1664_F_GON_01_ASEReadCounter.table","NW_015090842.1:10114063",13,37,24
"SPATA2L","s1664_F_GON_01_ASEReadCounter.table","NW_015090842.1:10114066",13,35,22
"SPATA2L","s1664_F_GON_01_ASEReadCounter.table","NW_015090842.1:10114069",13,35,22
"SPATA2L","s1664_F_GON_01_ASEReadCounter.table","NW_015090842.1:10114121",7,22,15
"SPATA2L","s1664_F_GON_01_ASEReadCounter.table","NW_015090842.1:10114159",5,22,17
"SPATA2L","s1664_F_GON_01_ASEReadCounter.table","NW_015090842.1:10114282",27,27,0
"SPATA2L","s1664_F_GON_01_ASEReadCounter.table","NW_015090842.1:10114470",6,17,11
"SPATA2L","s1664_F_GON_01_ASEReadCounter.table","NW_015090842.1:10114524",6,16,10
"VPS9D1","s1664_F_GON_01_ASEReadCounter.table","NW_015090842.1:10116377",14,19,5
"VPS9D1","s1664_F_GON_01_ASEReadCounter.table","NW_015090842.1:10116415",14,18,4
"VPS9D1","s1664_F_GON_01_ASEReadCounter.table","NW_015090842.1:10116607",13,17,4
"VPS9D1","s1664_F_GON_01_ASEReadCounter.table","NW_015090842.1:10116816",9,9,0
"VPS9D1","s1664_F_GON_01_ASEReadCounter.table","NW_015090842.1:10116821",5,9,4
"VPS9D1","s1664_F_GON_01_ASEReadCounter.table","NW_015090842.1:10116825",3,6,3
"VPS9D1","s1664_F_GON_01_ASEReadCounter.table","NW_015090842.1:10116882",3,9,6
"VPS9D1","s1664_F_GON_01_ASEReadCounter.table","NW_015090842.1:10116885",3,9,6
"VPS9D1","s1664_F_GON_01_ASEReadCounter.table","NW_015090842.1:10116933",4,9,5
"VPS9D1","s1664_F_GON_01_ASEReadCounter.table","NW_015090842.1:10116942",3,7,4
"VPS9D1","s1664_F_GON_01_ASEReadCounter.table","NW_015090842.1:10117152",1,5,4
"VPS9D1","s1664_F_GON_01_ASEReadCounter.table","NW_015090842.1:10117396",7,7,0
"VPS9D1","s1664_F_GON_01_ASEReadCounter.table","NW_015090842.1:10117405",7,7,0
"VPS9D1","s1664_F_GON_01_ASEReadCounter.table","NW_015090842.1:10117480",4,9,5
"VPS9D1","s1664_F_GON_01_ASEReadCounter.table","NW_015090842.1:10117497",3,7,4
"VPS9D1","s1664_F_GON_01_ASEReadCounter.table","NW_015090842.1:10117499",3,7,4
"VPS9D1","s1664_F_GON_01_ASEReadCounter.table","NW_015090842.1:10117516",4,6,2
"VPS9D1","s1664_F_GON_01_ASEReadCounter.table","NW_015090842.1:10117525",3,5,2
"VPS9D1","s1664_F_GON_01_ASEReadCounter.table","NW_015090842.1:10117579",1,2,1
"VPS9D1","s1664_F_GON_01_ASEReadCounter.table","NW_015090842.1:10117627",2,4,2
"VPS9D1","s1664_F_GON_01_ASEReadCounter.table","NW_015090842.1:10117678",4,5,1
"VPS9D1","s1664_F_GON_01_ASEReadCounter.table","NW_015090842.1:10117773",5,5,0
"VPS9D1","s1664_F_GON_01_ASEReadCounter.table","NW_015090842.1:10117937",9,11,2
"VPS9D1","s1664_F_GON_01_ASEReadCounter.table","NW_015090842.1:10117961",9,11,2
"VPS9D1","s1664_F_GON_01_ASEReadCounter.table","NW_015090842.1:10118236",6,9,3
"VPS9D1","s1664_F_GON_01_ASEReadCounter.table","NW_015090842.1:10118414",8,11,3
"VPS9D1","s1664_F_GON_01_ASEReadCounter.table","NW_015090842.1:10118973",2,9,7
"VPS9D1","s1664_F_GON_01_ASEReadCounter.table","NW_015090842.1:10119500",3,7,4
"ZNF276","s1664_F_GON_01_ASEReadCounter.table","NW_015090842.1:10121760",8,10,2
"ZNF276","s1664_F_GON_01_ASEReadCounter.table","NW_015090842.1:10121769",8,10,2
"ZNF276","s1664_F_GON_01_ASEReadCounter.table","NW_015090842.1:10121802",8,12,4
"ZNF276","s1664_F_GON_01_ASEReadCounter.table","NW_015090842.1:10121971",9,11,2
"ZNF276","s1664_F_GON_01_ASEReadCounter.table","NW_015090842.1:10122883",5,8,3
"ZNF276","s1664_F_GON_01_ASEReadCounter.table","NW_015090842.1:10123069",6,9,3
"ZNF276","s1664_F_GON_01_ASEReadCounter.table","NW_015090842.1:10123207",6,14,8
"ZNF276","s1664_F_GON_01_ASEReadCounter.table","NW_015090842.1:10125787",7,23,16
"ZNF276","s1664_F_GON_01_ASEReadCounter.table","NW_015090842.1:10126309",6,20,14
"ZNF276","s1664_F_GON_01_ASEReadCounter.table","NW_015090842.1:10126348",6,25,19
"ZNF276","s1664_F_GON_01_ASEReadCounter.table","NW_015090842.1:10126978",15,31,16
"ZNF276","s1664_F_GON_01_ASEReadCounter.table","NW_015090842.1:10126991",10,24,14
"ZNF276","s1664_F_GON_01_ASEReadCounter.table","NW_015090842.1:10127023",14,29,15
"ZNF276","s1664_F_GON_01_ASEReadCounter.table","NW_015090842.1:10127063",16,34,18
"ZNF276","s1664_F_GON_01_ASEReadCounter.table","NW_015090842.1:10127373",16,31,15
"ZNF276","s1664_F_GON_01_ASEReadCounter.table","NW_015090842.1:10127931",16,31,15
"ZNF276","s1664_F_GON_01_ASEReadCounter.table","NW_015090842.1:10128070",15,38,23
"ZNF276","s1664_F_GON_01_ASEReadCounter.table","NW_015090842.1:10128102",21,47,26
"ZNF276","s1664_F_GON_01_ASEReadCounter.table","NW_015090842.1:10128356",27,48,21
"ZNF276","s1664_F_GON_01_ASEReadCounter.table","NW_015090842.1:10128497",14,32,18
"FANCA","s1664_F_GON_01_ASEReadCounter.table","NW_015090842.1:10128743",13,36,23
"FANCA","s1664_F_GON_01_ASEReadCounter.table","NW_015090842.1:10128822",21,51,30
"FANCA","s1664_F_GON_01_ASEReadCounter.table","NW_015090842.1:10129383",31,58,27
"FANCA","s1664_F_GON_01_ASEReadCounter.table","NW_015090842.1:10129390",33,56,23
"FANCA","s1664_F_GON_01_ASEReadCounter.table","NW_015090842.1:10129422",31,51,20
"FANCA","s1664_F_GON_01_ASEReadCounter.table","NW_015090842.1:10129969",23,39,16
"FANCA","s1664_F_GON_01_ASEReadCounter.table","NW_015090842.1:10130399",25,38,13
"FANCA","s1664_F_GON_01_ASEReadCounter.table","NW_015090842.1:10130857",24,35,11
"FANCA","s1664_F_GON_01_ASEReadCounter.table","NW_015090842.1:10130878",18,32,14
"FANCA","s1664_F_GON_01_ASEReadCounter.table","NW_015090842.1:10133530",20,33,13
"FANCA","s1664_F_GON_01_ASEReadCounter.table","NW_015090842.1:10133533",19,32,13
"FANCA","s1664_F_GON_01_ASEReadCounter.table","NW_015090842.1:10133536",20,31,11
"FANCA","s1664_F_GON_01_ASEReadCounter.table","NW_015090842.1:10133601",21,34,13
"FANCA","s1664_F_GON_01_ASEReadCounter.table","NW_015090842.1:10134492",12,20,8
"FANCA","s1664_F_GON_01_ASEReadCounter.table","NW_015090842.1:10134531",17,24,7
"FANCA","s1664_F_GON_01_ASEReadCounter.table","NW_015090842.1:10136957",9,15,6
"FANCA","s1664_F_GON_01_ASEReadCounter.table","NW_015090842.1:10136982",9,13,4
"FANCA","s1664_F_GON_01_ASEReadCounter.table","NW_015090842.1:10136999",8,12,4
"FANCA","s1664_F_GON_01_ASEReadCounter.table","NW_015090842.1:10137019",7,15,8
"FANCA","s1664_F_GON_01_ASEReadCounter.table","NW_015090842.1:10137673",11,19,8
"FANCA","s1664_F_GON_01_ASEReadCounter.table","NW_015090842.1:10138618",8,15,7
"FANCA","s1664_F_GON_01_ASEReadCounter.table","NW_015090842.1:10139140",9,14,5
"FANCA","s1664_F_GON_01_ASEReadCounter.table","NW_015090842.1:10140699",8,11,3
"FANCA","s1664_F_GON_01_ASEReadCounter.table","NW_015090842.1:10141234",5,7,2
"FANCA","s1664_F_GON_01_ASEReadCounter.table","NW_015090842.1:10145030",6,7,1
"FANCA","s1664_F_GON_01_ASEReadCounter.table","NW_015090842.1:10150518",2,6,4
"FANCA","s1664_F_GON_01_ASEReadCounter.table","NW_015090842.1:10152863",1,3,2
"FANCA","s1664_F_GON_01_ASEReadCounter.table","NW_015090842.1:10154490",3,4,1
"FANCA","s1664_F_GON_01_ASEReadCounter.table","NW_015090842.1:10158162",2,3,1
"FANCA","s1664_F_GON_01_ASEReadCounter.table","NW_015090842.1:10158957",3,5,2
"FANCA","s1664_F_GON_01_ASEReadCounter.table","NW_015090842.1:10160177",1,5,4
"FANCA","s1664_F_GON_01_ASEReadCounter.table","NW_015090842.1:10162980",4,6,2
"FANCA","s1664_F_GON_01_ASEReadCounter.table","NW_015090842.1:10163667",3,3,0
"FANCA","s1664_F_GON_01_ASEReadCounter.table","NW_015090842.1:10164257",1,3,2
"FANCA","s1664_F_GON_01_ASEReadCounter.table","NW_015090842.1:10165331",1,2,1
"SPIRE2","s1664_F_GON_01_ASEReadCounter.table","NW_015090842.1:10175262",3,3,0
"SPIRE2","s1664_F_GON_01_ASEReadCounter.table","NW_015090842.1:10175352",2,2,0
"SPIRE2","s1664_F_GON_01_ASEReadCounter.table","NW_015090842.1:10175400",7,8,1
"SPIRE2","s1664_F_GON_01_ASEReadCounter.table","NW_015090842.1:10175418",8,9,1
"SPIRE2","s1664_F_GON_01_ASEReadCounter.table","NW_015090842.1:10175704",6,7,1
"SPIRE2","s1664_F_GON_01_ASEReadCounter.table","NW_015090842.1:10176115",9,9,0
"SPIRE2","s1664_F_GON_01_ASEReadCounter.table","NW_015090842.1:10176561",10,10,0
"SPIRE2","s1664_F_GON_01_ASEReadCounter.table","NW_015090842.1:10176817",11,11,0
"SPIRE2","s1664_F_GON_01_ASEReadCounter.table","NW_015090842.1:10177084",10,10,0
"SPIRE2","s1664_F_GON_01_ASEReadCounter.table","NW_015090842.1:10177110",7,7,0
"SPIRE2","s1664_F_GON_01_ASEReadCounter.table","NW_015090842.1:10177838",8,11,3
"SPIRE2","s1664_F_GON_01_ASEReadCounter.table","NW_015090842.1:10178000",10,12,2
"SPIRE2","s1664_F_GON_01_ASEReadCounter.table","NW_015090842.1:10178164",8,9,1
"SPIRE2","s1664_F_GON_01_ASEReadCounter.table","NW_015090842.1:10178216",7,9,2
"SPIRE2","s1664_F_GON_01_ASEReadCounter.table","NW_015090842.1:10178403",4,6,2
"SPIRE2","s1664_F_GON_01_ASEReadCounter.table","NW_015090842.1:10178409",4,6,2
"SPIRE2","s1664_F_GON_01_ASEReadCounter.table","NW_015090842.1:10178524",5,10,5
"SPIRE2","s1664_F_GON_01_ASEReadCounter.table","NW_015090842.1:10178526",6,11,5
"SPIRE2","s1664_F_GON_01_ASEReadCounter.table","NW_015090842.1:10178531",6,10,4
"SPIRE2","s1664_F_GON_01_ASEReadCounter.table","NW_015090842.1:10178565",5,10,5
"SPIRE2","s1664_F_GON_01_ASEReadCounter.table","NW_015090842.1:10178587",4,7,3
"SPIRE2","s1664_F_GON_01_ASEReadCounter.table","NW_015090842.1:10178640",1,4,3
"SPIRE2","s1664_F_GON_01_ASEReadCounter.table","NW_015090842.1:10178651",2,6,4
"SPIRE2","s1664_F_GON_01_ASEReadCounter.table","NW_015090842.1:10178682",1,5,4
"TCF25","s1664_F_GON_01_ASEReadCounter.table","NW_015090842.1:10180912",27,73,46
"TCF25","s1664_F_GON_01_ASEReadCounter.table","NW_015090842.1:10180924",28,75,47
"TCF25","s1664_F_GON_01_ASEReadCounter.table","NW_015090842.1:10180931",31,80,49
"TCF25","s1664_F_GON_01_ASEReadCounter.table","NW_015090842.1:10185332",82,198,116
"TCF25","s1664_F_GON_01_ASEReadCounter.table","NW_015090842.1:10188816",58,128,70
"MC1R","s1664_F_GON_01_ASEReadCounter.table","NW_015090842.1:10202460",1,1,0
"MC1R","s1664_F_GON_01_ASEReadCounter.table","NW_015090842.1:10202465",1,1,0
"DBNDD1","s1664_F_GON_01_ASEReadCounter.table","NW_015090842.1:10223105",117,293,176
"GAS8","s1664_F_GON_01_ASEReadCounter.table","NW_015090842.1:10228982",473,975,502
"GAS8","s1664_F_GON_01_ASEReadCounter.table","NW_015090842.1:10229832",439,956,517
"GAS8","s1664_F_GON_01_ASEReadCounter.table","NW_015090842.1:10232375",449,966,517
"GAS8","s1664_F_GON_01_ASEReadCounter.table","NW_015090842.1:10232901",348,763,415
"GAS8","s1664_F_GON_01_ASEReadCounter.table","NW_015090842.1:10232928",299,613,314
"GAS8","s1664_F_GON_01_ASEReadCounter.table","NW_015090842.1:10232967",241,491,250
"GAS8","s1664_F_GON_01_ASEReadCounter.table","NW_015090842.1:10233032",143,313,170
"GAS8","s1664_F_GON_01_ASEReadCounter.table","NW_015090842.1:10233057",114,250,136
"GAS8","s1664_F_GON_01_ASEReadCounter.table","NW_015090842.1:10233058",113,252,139
"GAS8","s1664_F_GON_01_ASEReadCounter.table","NW_015090842.1:10233176",131,234,103
"GAS8","s1664_F_GON_01_ASEReadCounter.table","NW_015090842.1:10233196",113,214,101
"GAS8","s1664_F_GON_01_ASEReadCounter.table","NW_015090842.1:10233252",81,141,60
"GAS8","s1664_F_GON_01_ASEReadCounter.table","NW_015090842.1:10233303",36,62,26
"LOC106888094","s1664_F_GON_01_ASEReadCounter.table","NW_015090842.1:10233334",1,9,8
"LOC106888094","s1664_F_GON_01_ASEReadCounter.table","NW_015090842.1:10233362",6,18,12
"LOC106888094","s1664_F_GON_01_ASEReadCounter.table","NW_015090842.1:10233373",6,18,12
"LOC106888094","s1664_F_GON_01_ASEReadCounter.table","NW_015090842.1:10233388",7,20,13
"LOC106888094","s1664_F_GON_01_ASEReadCounter.table","NW_015090842.1:10233402",9,22,13
"LOC106888094","s1664_F_GON_01_ASEReadCounter.table","NW_015090842.1:10233465",14,29,15
"LOC106888094","s1664_F_GON_01_ASEReadCounter.table","NW_015090842.1:10233803",20,53,33
"LOC106888094","s1664_F_GON_01_ASEReadCounter.table","NW_015090842.1:10233815",16,44,28
"LOC106888094","s1664_F_GON_01_ASEReadCounter.table","NW_015090842.1:10235484",9,11,2
"LOC106888094","s1664_F_GON_01_ASEReadCounter.table","NW_015090842.1:10235611",9,14,5
"LOC106888094","s1664_F_GON_01_ASEReadCounter.table","NW_015090842.1:10236098",5,9,4
"LOC106888094","s1664_F_GON_01_ASEReadCounter.table","NW_015090842.1:10236161",4,5,1
"LOC106888094","s1664_F_GON_01_ASEReadCounter.table","NW_015090842.1:10236380",7,9,2
"LOC106888094","s1664_F_GON_01_ASEReadCounter.table","NW_015090842.1:10236388",6,8,2
"LOC106888094","s1664_F_GON_01_ASEReadCounter.table","NW_015090842.1:10236425",4,8,4
"LOC106888094","s1664_F_GON_01_ASEReadCounter.table","NW_015090842.1:10236426",4,8,4
"LOC106888094","s1664_F_GON_01_ASEReadCounter.table","NW_015090842.1:10236603",4,7,3
"LOC106888173","s1664_F_GON_01_ASEReadCounter.table","NW_015090842.1:10239596",1,6,5
"LOC106888173","s1664_F_GON_01_ASEReadCounter.table","NW_015090842.1:10240036",4,10,6
"LOC106888173","s1664_F_GON_01_ASEReadCounter.table","NW_015090842.1:10240095",6,15,9
"LOC106888173","s1664_F_GON_01_ASEReadCounter.table","NW_015090842.1:10240280",3,9,6
"LOC106888173","s1664_F_GON_01_ASEReadCounter.table","NW_015090842.1:10240557",9,21,12
"LOC106888173","s1664_F_GON_01_ASEReadCounter.table","NW_015090842.1:10240603",6,17,11
"LOC106888173","s1664_F_GON_01_ASEReadCounter.table","NW_015090842.1:10240609",6,16,10
"LOC106888173","s1664_F_GON_01_ASEReadCounter.table","NW_015090842.1:10240690",4,16,12
"LOC106888173","s1664_F_GON_01_ASEReadCounter.table","NW_015090842.1:10240924",8,12,4
"LOC106888173","s1664_F_GON_01_ASEReadCounter.table","NW_015090842.1:10241037",2,6,4
"LOC106888173","s1664_F_GON_01_ASEReadCounter.table","NW_015090842.1:10241046",5,11,6
"LOC106888173","s1664_F_GON_01_ASEReadCounter.table","NW_015090842.1:10241058",5,11,6
"LOC106888173","s1664_F_GON_01_ASEReadCounter.table","NW_015090842.1:10241064",7,16,9
"LOC106888173","s1664_F_GON_01_ASEReadCounter.table","NW_015090842.1:10241103",21,21,0
"LOC106888173","s1664_F_GON_01_ASEReadCounter.table","NW_015090842.1:10241163",7,17,10
"LOC106888173","s1664_F_GON_01_ASEReadCounter.table","NW_015090842.1:10241803",6,20,14
"LOC106888173","s1664_F_GON_01_ASEReadCounter.table","NW_015090842.1:10241827",6,20,14
"LOC106888173","s1664_F_GON_01_ASEReadCounter.table","NW_015090842.1:10241869",7,16,9
"LOC106888173","s1664_F_GON_01_ASEReadCounter.table","NW_015090842.1:10242079",9,19,10
"LOC106888173","s1664_F_GON_01_ASEReadCounter.table","NW_015090842.1:10242103",8,17,9
"LOC106888173","s1664_F_GON_01_ASEReadCounter.table","NW_015090842.1:10242157",6,16,10
"LOC106888173","s1664_F_GON_01_ASEReadCounter.table","NW_015090842.1:10242455",12,22,10
"LOC106888173","s1664_F_GON_01_ASEReadCounter.table","NW_015090842.1:10242481",13,25,12
"LOC106888173","s1664_F_GON_01_ASEReadCounter.table","NW_015090842.1:10242590",9,24,15
"LOC106888173","s1664_F_GON_01_ASEReadCounter.table","NW_015090842.1:10242794",9,24,15
"LOC106888173","s1664_F_GON_01_ASEReadCounter.table","NW_015090842.1:10242909",15,29,14
"LOC106888173","s1664_F_GON_01_ASEReadCounter.table","NW_015090842.1:10243094",15,30,15
"LOC106888173","s1664_F_GON_01_ASEReadCounter.table","NW_015090842.1:10243133",12,30,18
"LOC106888173","s1664_F_GON_01_ASEReadCounter.table","NW_015090842.1:10243273",22,50,28
"LOC106888173","s1664_F_GON_01_ASEReadCounter.table","NW_015090842.1:10243278",23,51,28
"LOC106888173","s1664_F_GON_01_ASEReadCounter.table","NW_015090842.1:10243281",22,49,27
"LOC106888173","s1664_F_GON_01_ASEReadCounter.table","NW_015090842.1:10243347",22,23,1
"LOC106888173","s1664_F_GON_01_ASEReadCounter.table","NW_015090842.1:10243353",12,19,7
"LOC106888173","s1664_F_GON_01_ASEReadCounter.table","NW_015090842.1:10243363",11,15,4
"LOC106888173","s1664_F_GON_01_ASEReadCounter.table","NW_015090842.1:10243365",10,14,4
"LOC106888173","s1664_F_GON_01_ASEReadCounter.table","NW_015090842.1:10243566",15,44,29
"LOC106888173","s1664_F_GON_01_ASEReadCounter.table","NW_015090842.1:10243605",12,42,30
"LOC106888173","s1664_F_GON_01_ASEReadCounter.table","NW_015090842.1:10243614",11,39,28
"LOC106888173","s1664_F_GON_01_ASEReadCounter.table","NW_015090842.1:10243615",11,39,28
"LOC106888173","s1664_F_GON_01_ASEReadCounter.table","NW_015090842.1:10243640",10,31,21
"LOC106888173","s1664_F_GON_01_ASEReadCounter.table","NW_015090842.1:10243680",9,26,17
"LOC106888173","s1664_F_GON_01_ASEReadCounter.table","NW_015090842.1:10243742",14,38,24
"LOC106888173","s1664_F_GON_01_ASEReadCounter.table","NW_015090842.1:10243804",13,32,19
"LOC106888173","s1664_F_GON_01_ASEReadCounter.table","NW_015090842.1:10243913",6,13,7
"LOC106888173","s1664_F_GON_01_ASEReadCounter.table","NW_015090842.1:10243921",6,12,6
"LOC106888384","s1664_F_GON_01_ASEReadCounter.table","NW_015090842.1:10244714",2,4,2
"LOC106888384","s1664_F_GON_01_ASEReadCounter.table","NW_015090842.1:10244942",1,3,2
"LOC106888384","s1664_F_GON_01_ASEReadCounter.table","NW_015090842.1:10244998",1,2,1
"LOC106888384","s1664_F_GON_01_ASEReadCounter.table","NW_015090842.1:10250743",1,2,1
"LOC106888384","s1664_F_GON_01_ASEReadCounter.table","NW_015090842.1:10250771",1,2,1
"LOC106888384","s1664_F_GON_01_ASEReadCounter.table","NW_015090842.1:10251339",1,1,0
"LOC106888384","s1664_F_GON_01_ASEReadCounter.table","NW_015090842.1:10251354",0,2,2
"LOC106888384","s1664_F_GON_01_ASEReadCounter.table","NW_015090842.1:10251358",0,2,2
"LOC106888384","s1664_F_GON_01_ASEReadCounter.table","NW_015090842.1:10251369",0,2,2
"LOC106888384","s1664_F_GON_01_ASEReadCounter.table","NW_015090842.1:10251370",0,2,2
"LOC106888384","s1664_F_GON_01_ASEReadCounter.table","NW_015090842.1:10251375",0,2,2
"LOC106888384","s1664_F_GON_01_ASEReadCounter.table","NW_015090842.1:10251388",0,2,2
"LOC106888384","s1664_F_GON_01_ASEReadCounter.table","NW_015090842.1:10251390",0,2,2
"LOC106888384","s1664_F_GON_01_ASEReadCounter.table","NW_015090842.1:10251393",0,2,2
"LOC106888384","s1664_F_GON_01_ASEReadCounter.table","NW_015090842.1:10251399",0,2,2
"LOC106888384","s1664_F_GON_01_ASEReadCounter.table","NW_015090842.1:10251492",1,1,0
"LOC106888384","s1664_F_GON_01_ASEReadCounter.table","NW_015090842.1:10253165",2,2,0
"LOC106888384","s1664_F_GON_01_ASEReadCounter.table","NW_015090842.1:10253284",0,2,2
"LOC106888384","s1664_F_GON_01_ASEReadCounter.table","NW_015090842.1:10254028",2,5,3
"LOC106888384","s1664_F_GON_01_ASEReadCounter.table","NW_015090842.1:10254227",1,4,3
"LOC106888384","s1664_F_GON_01_ASEReadCounter.table","NW_015090842.1:10254233",1,3,2
"LOC106888384","s1664_F_GON_01_ASEReadCounter.table","NW_015090842.1:10254263",3,5,2
"LOC106888384","s1664_F_GON_01_ASEReadCounter.table","NW_015090842.1:10254293",4,6,2
"LOC106888384","s1664_F_GON_01_ASEReadCounter.table","NW_015090842.1:10254570",3,7,4
"LOC106888384","s1664_F_GON_01_ASEReadCounter.table","NW_015090842.1:10254605",8,8,0
"LOC106888384","s1664_F_GON_01_ASEReadCounter.table","NW_015090842.1:10254608",8,8,0
"LOC106888384","s1664_F_GON_01_ASEReadCounter.table","NW_015090842.1:10254618",4,4,0
"LOC106888384","s1664_F_GON_01_ASEReadCounter.table","NW_015090842.1:10254620",4,4,0
"LOC106888384","s1664_F_GON_01_ASEReadCounter.table","NW_015090842.1:10254623",4,4,0
"LOC106888384","s1664_F_GON_01_ASEReadCounter.table","NW_015090842.1:10254624",4,4,0
"LOC106888384","s1664_F_GON_01_ASEReadCounter.table","NW_015090842.1:10254627",4,4,0
"LOC106888384","s1664_F_GON_01_ASEReadCounter.table","NW_015090842.1:10254629",4,4,0
"LOC106888384","s1664_F_GON_01_ASEReadCounter.table","NW_015090842.1:10254647",0,3,3
"LOC106888384","s1664_F_GON_01_ASEReadCounter.table","NW_015090842.1:10254663",0,3,3
"LOC106888384","s1664_F_GON_01_ASEReadCounter.table","NW_015090842.1:10254840",1,1,0
"LOC106888384","s1664_F_GON_01_ASEReadCounter.table","NW_015090842.1:10254891",4,4,0
"LOC106888384","s1664_F_GON_01_ASEReadCounter.table","NW_015090842.1:10254900",0,4,4
"LOC106888384","s1664_F_GON_01_ASEReadCounter.table","NW_015090842.1:10254915",0,4,4
"LOC106888384","s1664_F_GON_01_ASEReadCounter.table","NW_015090842.1:10254965",2,2,0
"LOC106888384","s1664_F_GON_01_ASEReadCounter.table","NW_015090842.1:10254975",0,1,1
"LOC106888384","s1664_F_GON_01_ASEReadCounter.table","NW_015090842.1:10255077",2,5,3
"LOC106888384","s1664_F_GON_01_ASEReadCounter.table","NW_015090842.1:10255117",2,5,3
"LOC106888384","s1664_F_GON_01_ASEReadCounter.table","NW_015090842.1:10255138",3,5,2
"LOC106888384","s1664_F_GON_01_ASEReadCounter.table","NW_015090842.1:10255139",3,6,3
"LOC106888384","s1664_F_GON_01_ASEReadCounter.table","NW_015090842.1:10255209",2,4,2
"LOC106888384","s1664_F_GON_01_ASEReadCounter.table","NW_015090842.1:10255211",2,3,1
"LOC106888384","s1664_F_GON_01_ASEReadCounter.table","NW_015090842.1:10255236",3,5,2
"LOC106888384","s1664_F_GON_01_ASEReadCounter.table","NW_015090842.1:10255262",4,5,1
"LOC106888384","s1664_F_GON_01_ASEReadCounter.table","NW_015090842.1:10255264",4,6,2
"LOC106888384","s1664_F_GON_01_ASEReadCounter.table","NW_015090842.1:10255306",2,3,1
"LOC106888384","s1664_F_GON_01_ASEReadCounter.table","NW_015090842.1:10255340",2,4,2
"LOC106888384","s1664_F_GON_01_ASEReadCounter.table","NW_015090842.1:10255410",3,6,3
"LOC106888384","s1664_F_GON_01_ASEReadCounter.table","NW_015090842.1:10255449",1,3,2
"LOC106888384","s1664_F_GON_01_ASEReadCounter.table","NW_015090842.1:10255496",1,1,0
"LOC106888384","s1664_F_GON_01_ASEReadCounter.table","NW_015090842.1:10255505",1,1,0
"LOC106888384","s1664_F_GON_01_ASEReadCounter.table","NW_015090842.1:10255531",3,5,2
"LOC106888384","s1664_F_GON_01_ASEReadCounter.table","NW_015090842.1:10255608",4,8,4
"LOC106888384","s1664_F_GON_01_ASEReadCounter.table","NW_015090842.1:10255704",97,108,11
"LOC106888384","s1664_F_GON_01_ASEReadCounter.table","NW_015090842.1:10255731",111,122,11
"LOC106888384","s1664_F_GON_01_ASEReadCounter.table","NW_015090842.1:10255771",89,104,15
"TANGO6","s1664_F_GON_01_ASEReadCounter.table","NW_015090842.1:10257782",41,60,19
"TANGO6","s1664_F_GON_01_ASEReadCounter.table","NW_015090842.1:10258162",11,22,11
"TANGO6","s1664_F_GON_01_ASEReadCounter.table","NW_015090842.1:10258185",13,27,14
"TANGO6","s1664_F_GON_01_ASEReadCounter.table","NW_015090842.1:10259267",14,34,20
"TANGO6","s1664_F_GON_01_ASEReadCounter.table","NW_015090842.1:10260250",46,90,44
"TANGO6","s1664_F_GON_01_ASEReadCounter.table","NW_015090842.1:10260289",51,97,46
"TANGO6","s1664_F_GON_01_ASEReadCounter.table","NW_015090842.1:10260309",42,83,41
"TANGO6","s1664_F_GON_01_ASEReadCounter.table","NW_015090842.1:10260979",26,60,34
"TANGO6","s1664_F_GON_01_ASEReadCounter.table","NW_015090842.1:10261599",29,58,29
"TANGO6","s1664_F_GON_01_ASEReadCounter.table","NW_015090842.1:10268425",61,126,65
"TANGO6","s1664_F_GON_01_ASEReadCounter.table","NW_015090842.1:10269831",45,107,62
"TANGO6","s1664_F_GON_01_ASEReadCounter.table","NW_015090842.1:10270813",49,109,60
"TANGO6","s1664_F_GON_01_ASEReadCounter.table","NW_015090842.1:10274018",13,26,13
"TANGO6","s1664_F_GON_01_ASEReadCounter.table","NW_015090842.1:10275974",17,27,10
"TANGO6","s1664_F_GON_01_ASEReadCounter.table","NW_015090842.1:10275976",17,27,10
"TANGO6","s1664_F_GON_01_ASEReadCounter.table","NW_015090842.1:10276123",16,26,10
"TANGO6","s1664_F_GON_01_ASEReadCounter.table","NW_015090842.1:10276271",13,21,8
"TANGO6","s1664_F_GON_01_ASEReadCounter.table","NW_015090842.1:10276272",12,20,8
"TANGO6","s1664_F_GON_01_ASEReadCounter.table","NW_015090842.1:10276275",13,21,8
"TANGO6","s1664_F_GON_01_ASEReadCounter.table","NW_015090842.1:10276278",14,21,7
"TANGO6","s1664_F_GON_01_ASEReadCounter.table","NW_015090842.1:10276368",11,14,3
"TANGO6","s1664_F_GON_01_ASEReadCounter.table","NW_015090842.1:10276373",12,17,5
"TANGO6","s1664_F_GON_01_ASEReadCounter.table","NW_015090842.1:10276630",17,25,8
"TANGO6","s1664_F_GON_01_ASEReadCounter.table","NW_015090842.1:10281498",28,35,7
"TANGO6","s1664_F_GON_01_ASEReadCounter.table","NW_015090842.1:10281516",27,36,9
"TANGO6","s1664_F_GON_01_ASEReadCounter.table","NW_015090842.1:10282842",29,41,12
"TANGO6","s1664_F_GON_01_ASEReadCounter.table","NW_015090842.1:10282863",23,31,8
"TANGO6","s1664_F_GON_01_ASEReadCounter.table","NW_015090842.1:10282869",24,34,10
"TANGO6","s1664_F_GON_01_ASEReadCounter.table","NW_015090842.1:10282903",21,39,18
"TANGO6","s1664_F_GON_01_ASEReadCounter.table","NW_015090842.1:10283757",23,46,23
"TANGO6","s1664_F_GON_01_ASEReadCounter.table","NW_015090842.1:10283785",19,43,24
"HAS3","s1664_F_GON_01_ASEReadCounter.table","NW_015090842.1:10288266",1,2,1
"HAS3","s1664_F_GON_01_ASEReadCounter.table","NW_015090842.1:10288274",1,3,2
"HAS3","s1664_F_GON_01_ASEReadCounter.table","NW_015090842.1:10288364",1,2,1
"HAS3","s1664_F_GON_01_ASEReadCounter.table","NW_015090842.1:10289269",0,2,2
"HAS3","s1664_F_GON_01_ASEReadCounter.table","NW_015090842.1:10289272",0,1,1
"HAS3","s1664_F_GON_01_ASEReadCounter.table","NW_015090842.1:10289469",1,1,0
"HAS3","s1664_F_GON_01_ASEReadCounter.table","NW_015090842.1:10290375",3,4,1
"HAS3","s1664_F_GON_01_ASEReadCounter.table","NW_015090842.1:10290395",2,4,2
"HAS3","s1664_F_GON_01_ASEReadCounter.table","NW_015090842.1:10290439",4,4,0
"HAS3","s1664_F_GON_01_ASEReadCounter.table","NW_015090842.1:10290561",2,4,2
"HAS3","s1664_F_GON_01_ASEReadCounter.table","NW_015090842.1:10290609",1,2,1
"HAS3","s1664_F_GON_01_ASEReadCounter.table","NW_015090842.1:10290666",2,3,1
"HAS3","s1664_F_GON_01_ASEReadCounter.table","NW_015090842.1:10290723",0,1,1
"HAS3","s1664_F_GON_01_ASEReadCounter.table","NW_015090842.1:10290927",4,5,1
"HAS3","s1664_F_GON_01_ASEReadCounter.table","NW_015090842.1:10291004",3,4,1
"CHTF8","s1664_F_GON_01_ASEReadCounter.table","NW_015090842.1:10291319",16,27,11
"CHTF8","s1664_F_GON_01_ASEReadCounter.table","NW_015090842.1:10291491",50,73,23
"CHTF8","s1664_F_GON_01_ASEReadCounter.table","NW_015090842.1:10291520",61,98,37
"CHTF8","s1664_F_GON_01_ASEReadCounter.table","NW_015090842.1:10291593",72,122,50
"CHTF8","s1664_F_GON_01_ASEReadCounter.table","NW_015090842.1:10291600",70,118,48
"CHTF8","s1664_F_GON_01_ASEReadCounter.table","NW_015090842.1:10291609",68,112,44
"CHTF8","s1664_F_GON_01_ASEReadCounter.table","NW_015090842.1:10291639",69,113,44
"CHTF8","s1664_F_GON_01_ASEReadCounter.table","NW_015090842.1:10291641",69,112,43
"CHTF8","s1664_F_GON_01_ASEReadCounter.table","NW_015090842.1:10291648",71,116,45
"CHTF8","s1664_F_GON_01_ASEReadCounter.table","NW_015090842.1:10291656",70,115,45
"CHTF8","s1664_F_GON_01_ASEReadCounter.table","NW_015090842.1:10291675",73,122,49
"CHTF8","s1664_F_GON_01_ASEReadCounter.table","NW_015090842.1:10291696",70,114,44
"CHTF8","s1664_F_GON_01_ASEReadCounter.table","NW_015090842.1:10291714",67,115,48
"CHTF8","s1664_F_GON_01_ASEReadCounter.table","NW_015090842.1:10291732",65,111,46
"CHTF8","s1664_F_GON_01_ASEReadCounter.table","NW_015090842.1:10291755",51,98,47
"CHTF8","s1664_F_GON_01_ASEReadCounter.table","NW_015090842.1:10291756",49,95,46
"CHTF8","s1664_F_GON_01_ASEReadCounter.table","NW_015090842.1:10291758",49,98,49
"CHTF8","s1664_F_GON_01_ASEReadCounter.table","NW_015090842.1:10291792",60,112,52
"CHTF8","s1664_F_GON_01_ASEReadCounter.table","NW_015090842.1:10291895",65,111,46
"CHTF8","s1664_F_GON_01_ASEReadCounter.table","NW_015090842.1:10292132",55,97,42
"CHTF8","s1664_F_GON_01_ASEReadCounter.table","NW_015090842.1:10292314",60,103,43
"CHTF8","s1664_F_GON_01_ASEReadCounter.table","NW_015090842.1:10292317",59,102,43
"CHTF8","s1664_F_GON_01_ASEReadCounter.table","NW_015090842.1:10292928",18,35,17
"UTP4","s1664_F_GON_01_ASEReadCounter.table","NW_015090842.1:10293146",12,32,20
"UTP4","s1664_F_GON_01_ASEReadCounter.table","NW_015090842.1:10293151",12,31,19
"UTP4","s1664_F_GON_01_ASEReadCounter.table","NW_015090842.1:10293191",10,23,13
"UTP4","s1664_F_GON_01_ASEReadCounter.table","NW_015090842.1:10293362",4,15,11
"UTP4","s1664_F_GON_01_ASEReadCounter.table","NW_015090842.1:10293430",5,13,8
"UTP4","s1664_F_GON_01_ASEReadCounter.table","NW_015090842.1:10293625",4,11,7
"UTP4","s1664_F_GON_01_ASEReadCounter.table","NW_015090842.1:10293684",8,22,14
"UTP4","s1664_F_GON_01_ASEReadCounter.table","NW_015090842.1:10294093",7,26,19
"UTP4","s1664_F_GON_01_ASEReadCounter.table","NW_015090842.1:10294622",4,13,9
"UTP4","s1664_F_GON_01_ASEReadCounter.table","NW_015090842.1:10294632",4,11,7
"UTP4","s1664_F_GON_01_ASEReadCounter.table","NW_015090842.1:10295238",9,24,15
"UTP4","s1664_F_GON_01_ASEReadCounter.table","NW_015090842.1:10295880",7,22,15
"UTP4","s1664_F_GON_01_ASEReadCounter.table","NW_015090842.1:10295884",5,20,15
"UTP4","s1664_F_GON_01_ASEReadCounter.table","NW_015090842.1:10295903",7,16,9
"UTP4","s1664_F_GON_01_ASEReadCounter.table","NW_015090842.1:10295906",7,17,10
"UTP4","s1664_F_GON_01_ASEReadCounter.table","NW_015090842.1:10295915",7,17,10
"UTP4","s1664_F_GON_01_ASEReadCounter.table","NW_015090842.1:10295938",8,18,10
"UTP4","s1664_F_GON_01_ASEReadCounter.table","NW_015090842.1:10296175",8,24,16
"UTP4","s1664_F_GON_01_ASEReadCounter.table","NW_015090842.1:10296660",11,30,19
"UTP4","s1664_F_GON_01_ASEReadCounter.table","NW_015090842.1:10296679",10,27,17
"UTP4","s1664_F_GON_01_ASEReadCounter.table","NW_015090842.1:10297193",14,39,25
"UTP4","s1664_F_GON_01_ASEReadCounter.table","NW_015090842.1:10297220",16,40,24
"UTP4","s1664_F_GON_01_ASEReadCounter.table","NW_015090842.1:10297307",18,40,22
"UTP4","s1664_F_GON_01_ASEReadCounter.table","NW_015090842.1:10297558",27,48,21
"UTP4","s1664_F_GON_01_ASEReadCounter.table","NW_015090842.1:10297943",13,35,22
"UTP4","s1664_F_GON_01_ASEReadCounter.table","NW_015090842.1:10297979",10,29,19
"UTP4","s1664_F_GON_01_ASEReadCounter.table","NW_015090842.1:10298022",14,27,13
"UTP4","s1664_F_GON_01_ASEReadCounter.table","NW_015090842.1:10298079",1,6,5
"UTP4","s1664_F_GON_01_ASEReadCounter.table","NW_015090842.1:10298081",0,5,5
"UTP4","s1664_F_GON_01_ASEReadCounter.table","NW_015090842.1:10298082",0,5,5
"SNTB2","s1664_F_GON_01_ASEReadCounter.table","NW_015090842.1:10298905",2,2,0
"SNTB2","s1664_F_GON_01_ASEReadCounter.table","NW_015090842.1:10298928",2,2,0
"SNTB2","s1664_F_GON_01_ASEReadCounter.table","NW_015090842.1:10303506",8,13,5
"SNTB2","s1664_F_GON_01_ASEReadCounter.table","NW_015090842.1:10303524",11,14,3
"SNTB2","s1664_F_GON_01_ASEReadCounter.table","NW_015090842.1:10304059",4,10,6
"SNTB2","s1664_F_GON_01_ASEReadCounter.table","NW_015090842.1:10304089",6,12,6
"SNTB2","s1664_F_GON_01_ASEReadCounter.table","NW_015090842.1:10304167",7,10,3
"SNTB2","s1664_F_GON_01_ASEReadCounter.table","NW_015090842.1:10304176",5,8,3
"SNTB2","s1664_F_GON_01_ASEReadCounter.table","NW_015090842.1:10305069",4,11,7
"SNTB2","s1664_F_GON_01_ASEReadCounter.table","NW_015090842.1:10305099",5,13,8
"SNTB2","s1664_F_GON_01_ASEReadCounter.table","NW_015090842.1:10305171",9,17,8
"SNTB2","s1664_F_GON_01_ASEReadCounter.table","NW_015090842.1:10305177",8,16,8
"SNTB2","s1664_F_GON_01_ASEReadCounter.table","NW_015090842.1:10305451",6,15,9
"SNTB2","s1664_F_GON_01_ASEReadCounter.table","NW_015090842.1:10305547",4,15,11
"SNTB2","s1664_F_GON_01_ASEReadCounter.table","NW_015090842.1:10305847",4,12,8
"SNTB2","s1664_F_GON_01_ASEReadCounter.table","NW_015090842.1:10306173",3,11,8
"SNTB2","s1664_F_GON_01_ASEReadCounter.table","NW_015090842.1:10306275",8,16,8
"SNTB2","s1664_F_GON_01_ASEReadCounter.table","NW_015090842.1:10306457",5,13,8
"SNTB2","s1664_F_GON_01_ASEReadCounter.table","NW_015090842.1:10306496",6,12,6
"SNTB2","s1664_F_GON_01_ASEReadCounter.table","NW_015090842.1:10306499",6,12,6
"VPS4A","s1664_F_GON_01_ASEReadCounter.table","NW_015090842.1:10308566",57,169,112
"VPS4A","s1664_F_GON_01_ASEReadCounter.table","NW_015090842.1:10308573",56,173,117
"VPS4A","s1664_F_GON_01_ASEReadCounter.table","NW_015090842.1:10308856",73,251,178
"VPS4A","s1664_F_GON_01_ASEReadCounter.table","NW_015090842.1:10309056",91,313,222
"VPS4A","s1664_F_GON_01_ASEReadCounter.table","NW_015090842.1:10309089",107,312,205
"VPS4A","s1664_F_GON_01_ASEReadCounter.table","NW_015090842.1:10309392",122,302,180
"VPS4A","s1664_F_GON_01_ASEReadCounter.table","NW_015090842.1:10309413",132,347,215
"VPS4A","s1664_F_GON_01_ASEReadCounter.table","NW_015090842.1:10309467",122,392,270
"VPS4A","s1664_F_GON_01_ASEReadCounter.table","NW_015090842.1:10310230",143,386,243
"VPS4A","s1664_F_GON_01_ASEReadCounter.table","NW_015090842.1:10310425",141,342,201
"VPS4A","s1664_F_GON_01_ASEReadCounter.table","NW_015090842.1:10310639",165,462,297
"VPS4A","s1664_F_GON_01_ASEReadCounter.table","NW_015090842.1:10310734",141,364,223
"VPS4A","s1664_F_GON_01_ASEReadCounter.table","NW_015090842.1:10310737",142,371,229
"VPS4A","s1664_F_GON_01_ASEReadCounter.table","NW_015090842.1:10310746",140,369,229
"VPS4A","s1664_F_GON_01_ASEReadCounter.table","NW_015090842.1:10310767",137,376,239
"VPS4A","s1664_F_GON_01_ASEReadCounter.table","NW_015090842.1:10310995",174,424,250
"VPS4A","s1664_F_GON_01_ASEReadCounter.table","NW_015090842.1:10311004",185,432,247
"VPS4A","s1664_F_GON_01_ASEReadCounter.table","NW_015090842.1:10311007",189,442,253
"VPS4A","s1664_F_GON_01_ASEReadCounter.table","NW_015090842.1:10311013",189,439,250
"VPS4A","s1664_F_GON_01_ASEReadCounter.table","NW_015090842.1:10311022",175,416,241
"VPS4A","s1664_F_GON_01_ASEReadCounter.table","NW_015090842.1:10311023",174,412,238
"VPS4A","s1664_F_GON_01_ASEReadCounter.table","NW_015090842.1:10311426",181,467,286
"VPS4A","s1664_F_GON_01_ASEReadCounter.table","NW_015090842.1:10311489",1,12,11
"VPS4A","s1664_F_GON_01_ASEReadCounter.table","NW_015090842.1:10311490",1,8,7
"VPS4A","s1664_F_GON_01_ASEReadCounter.table","NW_015090842.1:10311525",9,24,15
"VPS4A","s1664_F_GON_01_ASEReadCounter.table","NW_015090842.1:10311529",10,39,29
"VPS4A","s1664_F_GON_01_ASEReadCounter.table","NW_015090842.1:10311530",10,41,31
"VPS4A","s1664_F_GON_01_ASEReadCounter.table","NW_015090842.1:10311552",38,86,48
"VPS4A","s1664_F_GON_01_ASEReadCounter.table","NW_015090842.1:10311689",28,72,44
"VPS4A","s1664_F_GON_01_ASEReadCounter.table","NW_015090842.1:10311700",34,77,43
"VPS4A","s1664_F_GON_01_ASEReadCounter.table","NW_015090842.1:10311701",34,75,41
"VPS4A","s1664_F_GON_01_ASEReadCounter.table","NW_015090842.1:10311703",34,76,42
"COG8","s1664_F_GON_01_ASEReadCounter.table","NW_015090842.1:10313487",13,34,21
"COG8","s1664_F_GON_01_ASEReadCounter.table","NW_015090842.1:10313559",19,51,32
"COG8","s1664_F_GON_01_ASEReadCounter.table","NW_015090842.1:10313579",17,45,28
"COG8","s1664_F_GON_01_ASEReadCounter.table","NW_015090842.1:10313665",14,29,15
"COG8","s1664_F_GON_01_ASEReadCounter.table","NW_015090842.1:10313681",15,33,18
"COG8","s1664_F_GON_01_ASEReadCounter.table","NW_015090842.1:10313768",16,44,28
"COG8","s1664_F_GON_01_ASEReadCounter.table","NW_015090842.1:10313775",19,44,25
"COG8","s1664_F_GON_01_ASEReadCounter.table","NW_015090842.1:10313811",16,36,20
"COG8","s1664_F_GON_01_ASEReadCounter.table","NW_015090842.1:10313858",13,32,19
"COG8","s1664_F_GON_01_ASEReadCounter.table","NW_015090842.1:10314100",22,51,29
"COG8","s1664_F_GON_01_ASEReadCounter.table","NW_015090842.1:10314213",9,38,29
"COG8","s1664_F_GON_01_ASEReadCounter.table","NW_015090842.1:10315093",11,32,21
"COG8","s1664_F_GON_01_ASEReadCounter.table","NW_015090842.1:10315162",21,37,16
"COG8","s1664_F_GON_01_ASEReadCounter.table","NW_015090842.1:10315285",22,46,24
"COG8","s1664_F_GON_01_ASEReadCounter.table","NW_015090842.1:10315360",16,37,21
"COG8","s1664_F_GON_01_ASEReadCounter.table","NW_015090842.1:10315369",15,37,22
"COG8","s1664_F_GON_01_ASEReadCounter.table","NW_015090842.1:10315504",10,24,14
"COG8","s1664_F_GON_01_ASEReadCounter.table","NW_015090842.1:10315508",10,24,14
"COG8","s1664_F_GON_01_ASEReadCounter.table","NW_015090842.1:10315624",16,36,20
"COG8","s1664_F_GON_01_ASEReadCounter.table","NW_015090842.1:10315693",14,24,10
"COG8","s1664_F_GON_01_ASEReadCounter.table","NW_015090842.1:10315698",13,24,11
"COG8","s1664_F_GON_01_ASEReadCounter.table","NW_015090842.1:10315768",12,35,23
"COG8","s1664_F_GON_01_ASEReadCounter.table","NW_015090842.1:10315769",12,35,23
"COG8","s1664_F_GON_01_ASEReadCounter.table","NW_015090842.1:10315784",10,34,24
"COG8","s1664_F_GON_01_ASEReadCounter.table","NW_015090842.1:10316093",4,22,18
"COG8","s1664_F_GON_01_ASEReadCounter.table","NW_015090842.1:10316133",3,20,17
"NIP7","s1664_F_GON_01_ASEReadCounter.table","NW_015090842.1:10316759",33,57,24
"NIP7","s1664_F_GON_01_ASEReadCounter.table","NW_015090842.1:10316967",206,321,115
"NIP7","s1664_F_GON_01_ASEReadCounter.table","NW_015090842.1:10316995",247,367,120
"NIP7","s1664_F_GON_01_ASEReadCounter.table","NW_015090842.1:10317240",292,469,177
"NIP7","s1664_F_GON_01_ASEReadCounter.table","NW_015090842.1:10317247",286,457,171
"NIP7","s1664_F_GON_01_ASEReadCounter.table","NW_015090842.1:10317264",267,432,165
"NIP7","s1664_F_GON_01_ASEReadCounter.table","NW_015090842.1:10317433",320,530,210
"NIP7","s1664_F_GON_01_ASEReadCounter.table","NW_015090842.1:10317738",260,447,187
"NIP7","s1664_F_GON_01_ASEReadCounter.table","NW_015090842.1:10317769",271,441,170
"NIP7","s1664_F_GON_01_ASEReadCounter.table","NW_015090842.1:10317808",185,304,119
"NIP7","s1664_F_GON_01_ASEReadCounter.table","NW_015090842.1:10317870",123,219,96
"NIP7","s1664_F_GON_01_ASEReadCounter.table","NW_015090842.1:10317871",123,216,93
"NIP7","s1664_F_GON_01_ASEReadCounter.table","NW_015090842.1:10317898",86,152,66
"NIP7","s1664_F_GON_01_ASEReadCounter.table","NW_015090842.1:10317911",76,132,56
"TMED6","s1664_F_GON_01_ASEReadCounter.table","NW_015090842.1:10318731",2,2,0
"TERF2","s1664_F_GON_01_ASEReadCounter.table","NW_015090842.1:10321665",13,13,0
"TERF2","s1664_F_GON_01_ASEReadCounter.table","NW_015090842.1:10321768",56,127,71
"TERF2","s1664_F_GON_01_ASEReadCounter.table","NW_015090842.1:10321777",52,122,70
"TERF2","s1664_F_GON_01_ASEReadCounter.table","NW_015090842.1:10321805",54,136,82
"TERF2","s1664_F_GON_01_ASEReadCounter.table","NW_015090842.1:10321878",72,174,102
"TERF2","s1664_F_GON_01_ASEReadCounter.table","NW_015090842.1:10321893",69,165,96
"TERF2","s1664_F_GON_01_ASEReadCounter.table","NW_015090842.1:10321897",65,152,87
"TERF2","s1664_F_GON_01_ASEReadCounter.table","NW_015090842.1:10321908",59,143,84
"TERF2","s1664_F_GON_01_ASEReadCounter.table","NW_015090842.1:10322001",89,220,131
"TERF2","s1664_F_GON_01_ASEReadCounter.table","NW_015090842.1:10322035",68,177,109
"TERF2","s1664_F_GON_01_ASEReadCounter.table","NW_015090842.1:10322051",61,182,121
"TERF2","s1664_F_GON_01_ASEReadCounter.table","NW_015090842.1:10322137",40,141,101
"TERF2","s1664_F_GON_01_ASEReadCounter.table","NW_015090842.1:10322144",43,138,95
"TERF2","s1664_F_GON_01_ASEReadCounter.table","NW_015090842.1:10322388",32,122,90
"TERF2","s1664_F_GON_01_ASEReadCounter.table","NW_015090842.1:10322396",33,118,85
"TERF2","s1664_F_GON_01_ASEReadCounter.table","NW_015090842.1:10322502",51,129,78
"TERF2","s1664_F_GON_01_ASEReadCounter.table","NW_015090842.1:10322504",49,130,81
"TERF2","s1664_F_GON_01_ASEReadCounter.table","NW_015090842.1:10322510",50,132,82
"TERF2","s1664_F_GON_01_ASEReadCounter.table","NW_015090842.1:10323580",48,129,81
"TERF2","s1664_F_GON_01_ASEReadCounter.table","NW_015090842.1:10324314",36,107,71
"TERF2","s1664_F_GON_01_ASEReadCounter.table","NW_015090842.1:10326832",26,90,64
"TERF2","s1664_F_GON_01_ASEReadCounter.table","NW_015090842.1:10327787",10,38,28
"TERF2","s1664_F_GON_01_ASEReadCounter.table","NW_015090842.1:10328588",24,63,39
"TERF2","s1664_F_GON_01_ASEReadCounter.table","NW_015090842.1:10328644",17,52,35
"TERF2","s1664_F_GON_01_ASEReadCounter.table","NW_015090842.1:10329813",13,46,33
"TERF2","s1664_F_GON_01_ASEReadCounter.table","NW_015090842.1:10330749",12,30,18
"TERF2","s1664_F_GON_01_ASEReadCounter.table","NW_015090842.1:10330789",18,38,20
"CYB5B","s1664_F_GON_01_ASEReadCounter.table","NW_015090842.1:10336595",18,48,30
"CYB5B","s1664_F_GON_01_ASEReadCounter.table","NW_015090842.1:10336667",86,176,90
"CYB5B","s1664_F_GON_01_ASEReadCounter.table","NW_015090842.1:10336689",131,244,113
"CYB5B","s1664_F_GON_01_ASEReadCounter.table","NW_015090842.1:10336728",178,356,178
"CYB5B","s1664_F_GON_01_ASEReadCounter.table","NW_015090842.1:10345068",164,349,185
"CYB5B","s1664_F_GON_01_ASEReadCounter.table","NW_015090842.1:10348800",209,471,262
"CYB5B","s1664_F_GON_01_ASEReadCounter.table","NW_015090842.1:10348888",166,395,229
"CYB5B","s1664_F_GON_01_ASEReadCounter.table","NW_015090842.1:10349046",192,425,233
"CYB5B","s1664_F_GON_01_ASEReadCounter.table","NW_015090842.1:10349119",112,318,206
"CYB5B","s1664_F_GON_01_ASEReadCounter.table","NW_015090842.1:10349146",62,274,212
"CYB5B","s1664_F_GON_01_ASEReadCounter.table","NW_015090842.1:10349157",117,336,219
