"gene","id","snp","ref_count","total_count","alt_count"
"CENPN","s954_F_PIT_01_ASEReadCounter.table","NW_015090842.1:5801612",0,1,1
"CENPN","s954_F_PIT_01_ASEReadCounter.table","NW_015090842.1:5801618",0,1,1
"CENPN","s954_F_PIT_01_ASEReadCounter.table","NW_015090842.1:5801623",1,2,1
"CENPN","s954_F_PIT_01_ASEReadCounter.table","NW_015090842.1:5801631",1,2,1
"CENPN","s954_F_PIT_01_ASEReadCounter.table","NW_015090842.1:5801632",1,2,1
"CENPN","s954_F_PIT_01_ASEReadCounter.table","NW_015090842.1:5801655",0,4,4
"CENPN","s954_F_PIT_01_ASEReadCounter.table","NW_015090842.1:5801662",1,5,4
"CENPN","s954_F_PIT_01_ASEReadCounter.table","NW_015090842.1:5801670",1,4,3
"CENPN","s954_F_PIT_01_ASEReadCounter.table","NW_015090842.1:5801674",1,5,4
"CENPN","s954_F_PIT_01_ASEReadCounter.table","NW_015090842.1:5801692",1,5,4
"CENPN","s954_F_PIT_01_ASEReadCounter.table","NW_015090842.1:5801697",1,5,4
"CENPN","s954_F_PIT_01_ASEReadCounter.table","NW_015090842.1:5802008",0,2,2
"CENPN","s954_F_PIT_01_ASEReadCounter.table","NW_015090842.1:5802012",0,2,2
"CENPN","s954_F_PIT_01_ASEReadCounter.table","NW_015090842.1:5802087",2,5,3
"CENPN","s954_F_PIT_01_ASEReadCounter.table","NW_015090842.1:5810113",4,4,0
"CENPN","s954_F_PIT_01_ASEReadCounter.table","NW_015090842.1:5810147",8,8,0
"CENPN","s954_F_PIT_01_ASEReadCounter.table","NW_015090842.1:5810148",8,8,0
"ATMIN","s954_F_PIT_01_ASEReadCounter.table","NW_015090842.1:5818789",10,23,13
"ATMIN","s954_F_PIT_01_ASEReadCounter.table","NW_015090842.1:5819958",12,20,8
"ATMIN","s954_F_PIT_01_ASEReadCounter.table","NW_015090842.1:5820004",15,24,9
"ATMIN","s954_F_PIT_01_ASEReadCounter.table","NW_015090842.1:5820217",7,13,6
"ATMIN","s954_F_PIT_01_ASEReadCounter.table","NW_015090842.1:5820250",4,10,6
"ATMIN","s954_F_PIT_01_ASEReadCounter.table","NW_015090842.1:5820298",5,11,6
"ATMIN","s954_F_PIT_01_ASEReadCounter.table","NW_015090842.1:5820417",7,14,7
"ATMIN","s954_F_PIT_01_ASEReadCounter.table","NW_015090842.1:5820421",9,16,7
"ATMIN","s954_F_PIT_01_ASEReadCounter.table","NW_015090842.1:5820448",6,11,5
"ATMIN","s954_F_PIT_01_ASEReadCounter.table","NW_015090842.1:5820457",3,10,7
"ATMIN","s954_F_PIT_01_ASEReadCounter.table","NW_015090842.1:5820510",7,16,9
"ATMIN","s954_F_PIT_01_ASEReadCounter.table","NW_015090842.1:5820673",2,11,9
"ATMIN","s954_F_PIT_01_ASEReadCounter.table","NW_015090842.1:5820754",4,15,11
"ATMIN","s954_F_PIT_01_ASEReadCounter.table","NW_015090842.1:5820820",7,16,9
"ATMIN","s954_F_PIT_01_ASEReadCounter.table","NW_015090842.1:5820865",7,16,9
"ATMIN","s954_F_PIT_01_ASEReadCounter.table","NW_015090842.1:5820889",5,18,13
"ATMIN","s954_F_PIT_01_ASEReadCounter.table","NW_015090842.1:5820891",5,17,12
"ATMIN","s954_F_PIT_01_ASEReadCounter.table","NW_015090842.1:5820997",18,35,17
"ATMIN","s954_F_PIT_01_ASEReadCounter.table","NW_015090842.1:5821063",18,30,12
"ATMIN","s954_F_PIT_01_ASEReadCounter.table","NW_015090842.1:5821132",11,29,18
"ATMIN","s954_F_PIT_01_ASEReadCounter.table","NW_015090842.1:5821645",18,26,8
"ATMIN","s954_F_PIT_01_ASEReadCounter.table","NW_015090842.1:5825066",16,26,10
"ATMIN","s954_F_PIT_01_ASEReadCounter.table","NW_015090842.1:5825106",15,26,11
"ATMIN","s954_F_PIT_01_ASEReadCounter.table","NW_015090842.1:5825122",10,21,11
"ATMIN","s954_F_PIT_01_ASEReadCounter.table","NW_015090842.1:5825178",15,28,13
"ATMIN","s954_F_PIT_01_ASEReadCounter.table","NW_015090842.1:5825194",16,28,12
"ATMIN","s954_F_PIT_01_ASEReadCounter.table","NW_015090842.1:5825195",16,28,12
"ATMIN","s954_F_PIT_01_ASEReadCounter.table","NW_015090842.1:5825220",14,24,10
"ATMIN","s954_F_PIT_01_ASEReadCounter.table","NW_015090842.1:5825240",18,28,10
"ATMIN","s954_F_PIT_01_ASEReadCounter.table","NW_015090842.1:5825303",22,34,12
"ATMIN","s954_F_PIT_01_ASEReadCounter.table","NW_015090842.1:5825304",23,35,12
"ATMIN","s954_F_PIT_01_ASEReadCounter.table","NW_015090842.1:5825310",24,35,11
"ATMIN","s954_F_PIT_01_ASEReadCounter.table","NW_015090842.1:5825406",14,25,11
"ATMIN","s954_F_PIT_01_ASEReadCounter.table","NW_015090842.1:5825415",18,29,11
"ATMIN","s954_F_PIT_01_ASEReadCounter.table","NW_015090842.1:5825438",19,30,11
"ATMIN","s954_F_PIT_01_ASEReadCounter.table","NW_015090842.1:5825485",19,31,12
"ATMIN","s954_F_PIT_01_ASEReadCounter.table","NW_015090842.1:5825524",18,33,15
"ATMIN","s954_F_PIT_01_ASEReadCounter.table","NW_015090842.1:5825557",20,35,15
"ATMIN","s954_F_PIT_01_ASEReadCounter.table","NW_015090842.1:5825571",22,39,17
"ATMIN","s954_F_PIT_01_ASEReadCounter.table","NW_015090842.1:5825579",21,39,18
"ATMIN","s954_F_PIT_01_ASEReadCounter.table","NW_015090842.1:5825590",17,33,16
"ATMIN","s954_F_PIT_01_ASEReadCounter.table","NW_015090842.1:5825689",20,38,18
"ATMIN","s954_F_PIT_01_ASEReadCounter.table","NW_015090842.1:5825703",24,44,20
"ATMIN","s954_F_PIT_01_ASEReadCounter.table","NW_015090842.1:5825787",17,37,20
"ATMIN","s954_F_PIT_01_ASEReadCounter.table","NW_015090842.1:5825833",25,47,22
"ATMIN","s954_F_PIT_01_ASEReadCounter.table","NW_015090842.1:5825841",22,42,20
"ATMIN","s954_F_PIT_01_ASEReadCounter.table","NW_015090842.1:5825895",23,43,20
"ATMIN","s954_F_PIT_01_ASEReadCounter.table","NW_015090842.1:5825984",15,37,22
"ATMIN","s954_F_PIT_01_ASEReadCounter.table","NW_015090842.1:5826162",23,46,23
"ATMIN","s954_F_PIT_01_ASEReadCounter.table","NW_015090842.1:5826194",31,56,25
"ATMIN","s954_F_PIT_01_ASEReadCounter.table","NW_015090842.1:5826235",29,54,25
"ATMIN","s954_F_PIT_01_ASEReadCounter.table","NW_015090842.1:5826245",34,60,26
"ATMIN","s954_F_PIT_01_ASEReadCounter.table","NW_015090842.1:5826335",14,27,13
"ATMIN","s954_F_PIT_01_ASEReadCounter.table","NW_015090842.1:5826417",15,33,18
"ATMIN","s954_F_PIT_01_ASEReadCounter.table","NW_015090842.1:5826431",12,36,24
"ATMIN","s954_F_PIT_01_ASEReadCounter.table","NW_015090842.1:5826438",14,33,19
"ATMIN","s954_F_PIT_01_ASEReadCounter.table","NW_015090842.1:5826463",23,43,20
"ATMIN","s954_F_PIT_01_ASEReadCounter.table","NW_015090842.1:5826502",24,41,17
"ATMIN","s954_F_PIT_01_ASEReadCounter.table","NW_015090842.1:5826511",25,42,17
"ATMIN","s954_F_PIT_01_ASEReadCounter.table","NW_015090842.1:5826659",17,38,21
"ATMIN","s954_F_PIT_01_ASEReadCounter.table","NW_015090842.1:5826701",19,44,25
"ATMIN","s954_F_PIT_01_ASEReadCounter.table","NW_015090842.1:5826702",17,42,25
"ATMIN","s954_F_PIT_01_ASEReadCounter.table","NW_015090842.1:5826732",18,43,25
"ATMIN","s954_F_PIT_01_ASEReadCounter.table","NW_015090842.1:5826745",18,44,26
"ATMIN","s954_F_PIT_01_ASEReadCounter.table","NW_015090842.1:5826835",26,54,28
"ATMIN","s954_F_PIT_01_ASEReadCounter.table","NW_015090842.1:5826942",9,34,25
"ATMIN","s954_F_PIT_01_ASEReadCounter.table","NW_015090842.1:5827193",22,41,19
"ATMIN","s954_F_PIT_01_ASEReadCounter.table","NW_015090842.1:5827196",23,43,20
"ATMIN","s954_F_PIT_01_ASEReadCounter.table","NW_015090842.1:5827269",21,38,17
"ATMIN","s954_F_PIT_01_ASEReadCounter.table","NW_015090842.1:5827315",20,34,14
"ATMIN","s954_F_PIT_01_ASEReadCounter.table","NW_015090842.1:5827316",20,35,15
"ATMIN","s954_F_PIT_01_ASEReadCounter.table","NW_015090842.1:5827333",17,33,16
"PPP1R3E","s954_F_PIT_01_ASEReadCounter.table","NW_015090842.1:5837733",7,17,10
"PPP1R3E","s954_F_PIT_01_ASEReadCounter.table","NW_015090842.1:5837947",5,8,3
"PKD1L2","s954_F_PIT_01_ASEReadCounter.table","NW_015090842.1:5867597",1,2,1
"PKD1L2","s954_F_PIT_01_ASEReadCounter.table","NW_015090842.1:5867600",1,2,1
"PKD1L2","s954_F_PIT_01_ASEReadCounter.table","NW_015090842.1:5867660",1,1,0
"PKD1L2","s954_F_PIT_01_ASEReadCounter.table","NW_015090842.1:5867675",1,1,0
"PKD1L2","s954_F_PIT_01_ASEReadCounter.table","NW_015090842.1:5867788",1,1,0
"PKD1L2","s954_F_PIT_01_ASEReadCounter.table","NW_015090842.1:5872825",0,1,1
"PKD1L2","s954_F_PIT_01_ASEReadCounter.table","NW_015090842.1:5872876",0,1,1
"BCO1","s954_F_PIT_01_ASEReadCounter.table","NW_015090842.1:5915610",1,1,0
"BCO1","s954_F_PIT_01_ASEReadCounter.table","NW_015090842.1:5915646",1,2,1
"BCO1","s954_F_PIT_01_ASEReadCounter.table","NW_015090842.1:5917836",2,3,1
"BCO1","s954_F_PIT_01_ASEReadCounter.table","NW_015090842.1:5917912",7,11,4
"BCO1","s954_F_PIT_01_ASEReadCounter.table","NW_015090842.1:5917941",14,20,6
"BCO1","s954_F_PIT_01_ASEReadCounter.table","NW_015090842.1:5917971",14,21,7
"BCO1","s954_F_PIT_01_ASEReadCounter.table","NW_015090842.1:5921679",17,23,6
"BCO1","s954_F_PIT_01_ASEReadCounter.table","NW_015090842.1:5921726",13,17,4
"BCO1","s954_F_PIT_01_ASEReadCounter.table","NW_015090842.1:5925669",9,12,3
"BCO1","s954_F_PIT_01_ASEReadCounter.table","NW_015090842.1:5926937",14,19,5
"BCO1","s954_F_PIT_01_ASEReadCounter.table","NW_015090842.1:5927921",13,18,5
"BCO1","s954_F_PIT_01_ASEReadCounter.table","NW_015090842.1:5927948",11,16,5
"BCO1","s954_F_PIT_01_ASEReadCounter.table","NW_015090842.1:5927968",10,14,4
"BCO1","s954_F_PIT_01_ASEReadCounter.table","NW_015090842.1:5928052",9,11,2
"BCO1","s954_F_PIT_01_ASEReadCounter.table","NW_015090842.1:5932726",21,32,11
"BCO1","s954_F_PIT_01_ASEReadCounter.table","NW_015090842.1:5932801",22,26,4
"BCO1","s954_F_PIT_01_ASEReadCounter.table","NW_015090842.1:5934558",17,22,5
"BCO1","s954_F_PIT_01_ASEReadCounter.table","NW_015090842.1:5934575",17,24,7
"BCO1","s954_F_PIT_01_ASEReadCounter.table","NW_015090842.1:5934608",15,22,7
"BCO1","s954_F_PIT_01_ASEReadCounter.table","NW_015090842.1:5934647",14,23,9
"BCO1","s954_F_PIT_01_ASEReadCounter.table","NW_015090842.1:5934725",14,19,5
"BCO1","s954_F_PIT_01_ASEReadCounter.table","NW_015090842.1:5934726",14,19,5
"BCO1","s954_F_PIT_01_ASEReadCounter.table","NW_015090842.1:5934733",11,13,2
"BCO1","s954_F_PIT_01_ASEReadCounter.table","NW_015090842.1:5934821",10,16,6
"BCO1","s954_F_PIT_01_ASEReadCounter.table","NW_015090842.1:5934826",10,16,6
"BCO1","s954_F_PIT_01_ASEReadCounter.table","NW_015090842.1:5934844",7,10,3
"BCO1","s954_F_PIT_01_ASEReadCounter.table","NW_015090842.1:5934958",12,14,2
"BCO1","s954_F_PIT_01_ASEReadCounter.table","NW_015090842.1:5934976",12,14,2
"GAN","s954_F_PIT_01_ASEReadCounter.table","NW_015090842.1:5939249",0,2,2
"GAN","s954_F_PIT_01_ASEReadCounter.table","NW_015090842.1:5953759",5,9,4
"GAN","s954_F_PIT_01_ASEReadCounter.table","NW_015090842.1:5957502",6,9,3
"GAN","s954_F_PIT_01_ASEReadCounter.table","NW_015090842.1:5957578",4,9,5
"GAN","s954_F_PIT_01_ASEReadCounter.table","NW_015090842.1:5966047",2,10,8
"GAN","s954_F_PIT_01_ASEReadCounter.table","NW_015090842.1:5966126",3,10,7
"GAN","s954_F_PIT_01_ASEReadCounter.table","NW_015090842.1:5966127",3,10,7
"GAN","s954_F_PIT_01_ASEReadCounter.table","NW_015090842.1:5966162",7,13,6
"GAN","s954_F_PIT_01_ASEReadCounter.table","NW_015090842.1:5966483",7,14,7
"CMIP","s954_F_PIT_01_ASEReadCounter.table","NW_015090842.1:6109159",16,35,19
"CMIP","s954_F_PIT_01_ASEReadCounter.table","NW_015090842.1:6109166",15,31,16
"CMIP","s954_F_PIT_01_ASEReadCounter.table","NW_015090842.1:6114641",19,45,26
"CMIP","s954_F_PIT_01_ASEReadCounter.table","NW_015090842.1:6114751",11,38,27
"CMIP","s954_F_PIT_01_ASEReadCounter.table","NW_015090842.1:6114824",8,30,22
"CMIP","s954_F_PIT_01_ASEReadCounter.table","NW_015090842.1:6126295",33,33,0
"CMIP","s954_F_PIT_01_ASEReadCounter.table","NW_015090842.1:6128998",19,47,28
"CMIP","s954_F_PIT_01_ASEReadCounter.table","NW_015090842.1:6130562",28,75,47
"CMIP","s954_F_PIT_01_ASEReadCounter.table","NW_015090842.1:6132522",21,48,27
"CMIP","s954_F_PIT_01_ASEReadCounter.table","NW_015090842.1:6138265",24,84,60
"CMIP","s954_F_PIT_01_ASEReadCounter.table","NW_015090842.1:6138300",25,88,63
"CMIP","s954_F_PIT_01_ASEReadCounter.table","NW_015090842.1:6138342",22,71,49
"CMIP","s954_F_PIT_01_ASEReadCounter.table","NW_015090842.1:6138343",22,75,53
"CMIP","s954_F_PIT_01_ASEReadCounter.table","NW_015090842.1:6138345",22,78,56
"CMIP","s954_F_PIT_01_ASEReadCounter.table","NW_015090842.1:6138647",28,69,41
"CMIP","s954_F_PIT_01_ASEReadCounter.table","NW_015090842.1:6138745",14,69,55
"CMIP","s954_F_PIT_01_ASEReadCounter.table","NW_015090842.1:6138832",5,39,34
"CMIP","s954_F_PIT_01_ASEReadCounter.table","NW_015090842.1:6138967",28,64,36
"CMIP","s954_F_PIT_01_ASEReadCounter.table","NW_015090842.1:6139131",6,30,24
"CMIP","s954_F_PIT_01_ASEReadCounter.table","NW_015090842.1:6139163",1,32,31
"CMIP","s954_F_PIT_01_ASEReadCounter.table","NW_015090842.1:6139212",58,60,2
"CMIP","s954_F_PIT_01_ASEReadCounter.table","NW_015090842.1:6139360",6,26,20
"CMIP","s954_F_PIT_01_ASEReadCounter.table","NW_015090842.1:6139572",4,15,11
"PLCG2","s954_F_PIT_01_ASEReadCounter.table","NW_015090842.1:6179613",4,7,3
"PLCG2","s954_F_PIT_01_ASEReadCounter.table","NW_015090842.1:6179658",6,7,1
"PLCG2","s954_F_PIT_01_ASEReadCounter.table","NW_015090842.1:6203766",9,10,1
"PLCG2","s954_F_PIT_01_ASEReadCounter.table","NW_015090842.1:6203775",7,8,1
"PLCG2","s954_F_PIT_01_ASEReadCounter.table","NW_015090842.1:6203787",7,11,4
"PLCG2","s954_F_PIT_01_ASEReadCounter.table","NW_015090842.1:6209741",9,16,7
"PLCG2","s954_F_PIT_01_ASEReadCounter.table","NW_015090842.1:6209798",1,5,4
"PLCG2","s954_F_PIT_01_ASEReadCounter.table","NW_015090842.1:6209816",2,7,5
"PLCG2","s954_F_PIT_01_ASEReadCounter.table","NW_015090842.1:6217547",14,47,33
"PLCG2","s954_F_PIT_01_ASEReadCounter.table","NW_015090842.1:6218641",12,28,16
"PLCG2","s954_F_PIT_01_ASEReadCounter.table","NW_015090842.1:6220552",11,28,17
"PLCG2","s954_F_PIT_01_ASEReadCounter.table","NW_015090842.1:6221969",11,20,9
"PLCG2","s954_F_PIT_01_ASEReadCounter.table","NW_015090842.1:6228672",14,25,11
"PLCG2","s954_F_PIT_01_ASEReadCounter.table","NW_015090842.1:6228694",10,20,10
"PLCG2","s954_F_PIT_01_ASEReadCounter.table","NW_015090842.1:6228722",12,25,13
"PLCG2","s954_F_PIT_01_ASEReadCounter.table","NW_015090842.1:6228747",8,26,18
"PLCG2","s954_F_PIT_01_ASEReadCounter.table","NW_015090842.1:6228835",10,20,10
"PLCG2","s954_F_PIT_01_ASEReadCounter.table","NW_015090842.1:6228841",9,20,11
"PLCG2","s954_F_PIT_01_ASEReadCounter.table","NW_015090842.1:6228865",14,28,14
"PLCG2","s954_F_PIT_01_ASEReadCounter.table","NW_015090842.1:6228917",16,28,12
"PLCG2","s954_F_PIT_01_ASEReadCounter.table","NW_015090842.1:6228926",17,28,11
"PLCG2","s954_F_PIT_01_ASEReadCounter.table","NW_015090842.1:6228954",12,19,7
"PLCG2","s954_F_PIT_01_ASEReadCounter.table","NW_015090842.1:6229002",16,27,11
"PLCG2","s954_F_PIT_01_ASEReadCounter.table","NW_015090842.1:6229006",18,29,11
"PLCG2","s954_F_PIT_01_ASEReadCounter.table","NW_015090842.1:6229081",10,16,6
"PLCG2","s954_F_PIT_01_ASEReadCounter.table","NW_015090842.1:6229097",9,11,2
"PLCG2","s954_F_PIT_01_ASEReadCounter.table","NW_015090842.1:6229160",5,9,4
"PLCG2","s954_F_PIT_01_ASEReadCounter.table","NW_015090842.1:6229213",7,17,10
"PLCG2","s954_F_PIT_01_ASEReadCounter.table","NW_015090842.1:6229231",11,26,15
"PLCG2","s954_F_PIT_01_ASEReadCounter.table","NW_015090842.1:6229663",11,12,1
"PLCG2","s954_F_PIT_01_ASEReadCounter.table","NW_015090842.1:6229748",22,23,1
"PLCG2","s954_F_PIT_01_ASEReadCounter.table","NW_015090842.1:6229892",18,21,3
"PLCG2","s954_F_PIT_01_ASEReadCounter.table","NW_015090842.1:6230248",18,19,1
"PLCG2","s954_F_PIT_01_ASEReadCounter.table","NW_015090842.1:6230255",16,19,3
"PLCG2","s954_F_PIT_01_ASEReadCounter.table","NW_015090842.1:6230276",15,17,2
"PLCG2","s954_F_PIT_01_ASEReadCounter.table","NW_015090842.1:6230296",8,11,3
"PLCG2","s954_F_PIT_01_ASEReadCounter.table","NW_015090842.1:6230349",11,18,7
"PLCG2","s954_F_PIT_01_ASEReadCounter.table","NW_015090842.1:6230408",16,25,9
"PLCG2","s954_F_PIT_01_ASEReadCounter.table","NW_015090842.1:6230439",15,20,5
"PLCG2","s954_F_PIT_01_ASEReadCounter.table","NW_015090842.1:6230757",4,7,3
"PLCG2","s954_F_PIT_01_ASEReadCounter.table","NW_015090842.1:6230758",5,7,2
"PLCG2","s954_F_PIT_01_ASEReadCounter.table","NW_015090842.1:6230898",17,20,3
"PLCG2","s954_F_PIT_01_ASEReadCounter.table","NW_015090842.1:6230976",20,23,3
"PLCG2","s954_F_PIT_01_ASEReadCounter.table","NW_015090842.1:6231078",13,14,1
"PLCG2","s954_F_PIT_01_ASEReadCounter.table","NW_015090842.1:6231138",24,27,3
"PLCG2","s954_F_PIT_01_ASEReadCounter.table","NW_015090842.1:6231177",24,27,3
"PLCG2","s954_F_PIT_01_ASEReadCounter.table","NW_015090842.1:6231263",17,19,2
"SDR42E1","s954_F_PIT_01_ASEReadCounter.table","NW_015090842.1:6235292",1,5,4
"SDR42E1","s954_F_PIT_01_ASEReadCounter.table","NW_015090842.1:6235315",1,9,8
"SDR42E1","s954_F_PIT_01_ASEReadCounter.table","NW_015090842.1:6235348",5,17,12
"SDR42E1","s954_F_PIT_01_ASEReadCounter.table","NW_015090842.1:6235355",5,16,11
"SDR42E1","s954_F_PIT_01_ASEReadCounter.table","NW_015090842.1:6235417",8,21,13
"SDR42E1","s954_F_PIT_01_ASEReadCounter.table","NW_015090842.1:6235558",6,18,12
"SDR42E1","s954_F_PIT_01_ASEReadCounter.table","NW_015090842.1:6235741",18,36,18
"SDR42E1","s954_F_PIT_01_ASEReadCounter.table","NW_015090842.1:6235777",19,36,17
"SDR42E1","s954_F_PIT_01_ASEReadCounter.table","NW_015090842.1:6235806",23,51,28
"SDR42E1","s954_F_PIT_01_ASEReadCounter.table","NW_015090842.1:6235809",22,50,28
"SDR42E1","s954_F_PIT_01_ASEReadCounter.table","NW_015090842.1:6235816",22,48,26
"SDR42E1","s954_F_PIT_01_ASEReadCounter.table","NW_015090842.1:6235914",14,36,22
"SDR42E1","s954_F_PIT_01_ASEReadCounter.table","NW_015090842.1:6235935",13,40,27
"SDR42E1","s954_F_PIT_01_ASEReadCounter.table","NW_015090842.1:6235957",11,39,28
"SDR42E1","s954_F_PIT_01_ASEReadCounter.table","NW_015090842.1:6236040",9,25,16
"SDR42E1","s954_F_PIT_01_ASEReadCounter.table","NW_015090842.1:6236260",10,20,10
"SDR42E1","s954_F_PIT_01_ASEReadCounter.table","NW_015090842.1:6236281",9,23,14
"SDR42E1","s954_F_PIT_01_ASEReadCounter.table","NW_015090842.1:6236305",6,22,16
"SDR42E1","s954_F_PIT_01_ASEReadCounter.table","NW_015090842.1:6236458",10,35,25
"SDR42E1","s954_F_PIT_01_ASEReadCounter.table","NW_015090842.1:6236476",11,37,26
"SDR42E1","s954_F_PIT_01_ASEReadCounter.table","NW_015090842.1:6236608",10,32,22
"SDR42E1","s954_F_PIT_01_ASEReadCounter.table","NW_015090842.1:6238244",6,15,9
"SDR42E1","s954_F_PIT_01_ASEReadCounter.table","NW_015090842.1:6238829",3,7,4
"HSD17B2","s954_F_PIT_01_ASEReadCounter.table","NW_015090842.1:6262951",0,1,1
"HSD17B2","s954_F_PIT_01_ASEReadCounter.table","NW_015090842.1:6266125",0,1,1
"HSD17B2","s954_F_PIT_01_ASEReadCounter.table","NW_015090842.1:6266135",0,1,1
"HSD17B2","s954_F_PIT_01_ASEReadCounter.table","NW_015090842.1:6266944",0,1,1
"HSD17B2","s954_F_PIT_01_ASEReadCounter.table","NW_015090842.1:6267053",0,1,1
"HSD17B2","s954_F_PIT_01_ASEReadCounter.table","NW_015090842.1:6267674",0,1,1
"HSD17B2","s954_F_PIT_01_ASEReadCounter.table","NW_015090842.1:6267913",0,1,1
"HSD17B2","s954_F_PIT_01_ASEReadCounter.table","NW_015090842.1:6268098",0,3,3
"HSD17B2","s954_F_PIT_01_ASEReadCounter.table","NW_015090842.1:6268203",0,4,4
"ARY2","s954_F_PIT_01_ASEReadCounter.table","NW_015090842.1:6303922",0,2,2
"ARY2","s954_F_PIT_01_ASEReadCounter.table","NW_015090842.1:6303954",0,3,3
"ARY2","s954_F_PIT_01_ASEReadCounter.table","NW_015090842.1:6303979",0,3,3
"ARY2","s954_F_PIT_01_ASEReadCounter.table","NW_015090842.1:6305848",2,6,4
"ARY2","s954_F_PIT_01_ASEReadCounter.table","NW_015090842.1:6305856",2,6,4
"ARY2","s954_F_PIT_01_ASEReadCounter.table","NW_015090842.1:6305857",2,6,4
"ARY2","s954_F_PIT_01_ASEReadCounter.table","NW_015090842.1:6306017",0,3,3
"ARY2","s954_F_PIT_01_ASEReadCounter.table","NW_015090842.1:6306052",1,6,5
"ARY2","s954_F_PIT_01_ASEReadCounter.table","NW_015090842.1:6306094",1,5,4
"ARY2","s954_F_PIT_01_ASEReadCounter.table","NW_015090842.1:6306100",1,4,3
"ARY2","s954_F_PIT_01_ASEReadCounter.table","NW_015090842.1:6306146",0,1,1
"ARY2","s954_F_PIT_01_ASEReadCounter.table","NW_015090842.1:6306147",0,1,1
"ARY2","s954_F_PIT_01_ASEReadCounter.table","NW_015090842.1:6306390",3,4,1
"ARY2","s954_F_PIT_01_ASEReadCounter.table","NW_015090842.1:6306567",3,8,5
"ARY2","s954_F_PIT_01_ASEReadCounter.table","NW_015090842.1:6306705",1,2,1
"ARY2","s954_F_PIT_01_ASEReadCounter.table","NW_015090842.1:6306773",3,5,2
"ARY2","s954_F_PIT_01_ASEReadCounter.table","NW_015090842.1:6307039",1,3,2
"ARY2","s954_F_PIT_01_ASEReadCounter.table","NW_015090842.1:6307043",1,3,2
"ARY2","s954_F_PIT_01_ASEReadCounter.table","NW_015090842.1:6307093",1,2,1
"ARY2","s954_F_PIT_01_ASEReadCounter.table","NW_015090842.1:6307138",0,1,1
"ARY2","s954_F_PIT_01_ASEReadCounter.table","NW_015090842.1:6307157",1,3,2
"ARY2","s954_F_PIT_01_ASEReadCounter.table","NW_015090842.1:6307187",1,2,1
"ARY2","s954_F_PIT_01_ASEReadCounter.table","NW_015090842.1:6307204",1,3,2
"ARY2","s954_F_PIT_01_ASEReadCounter.table","NW_015090842.1:6307278",2,3,1
"ARY2","s954_F_PIT_01_ASEReadCounter.table","NW_015090842.1:6307305",3,5,2
"ARY2","s954_F_PIT_01_ASEReadCounter.table","NW_015090842.1:6307318",3,5,2
"ARY2","s954_F_PIT_01_ASEReadCounter.table","NW_015090842.1:6307429",0,4,4
"ARY2","s954_F_PIT_01_ASEReadCounter.table","NW_015090842.1:6307487",0,3,3
"ARY2","s954_F_PIT_01_ASEReadCounter.table","NW_015090842.1:6307670",0,2,2
"ARYL","s954_F_PIT_01_ASEReadCounter.table","NW_015090842.1:6313360",1,2,1
"ARYL","s954_F_PIT_01_ASEReadCounter.table","NW_015090842.1:6313377",2,3,1
"ARYL","s954_F_PIT_01_ASEReadCounter.table","NW_015090842.1:6313767",1,3,2
"ARY1","s954_F_PIT_01_ASEReadCounter.table","NW_015090842.1:6314296",0,2,2
"ARY1","s954_F_PIT_01_ASEReadCounter.table","NW_015090842.1:6314541",0,1,1
"ARY1","s954_F_PIT_01_ASEReadCounter.table","NW_015090842.1:6314597",0,2,2
"ARY1","s954_F_PIT_01_ASEReadCounter.table","NW_015090842.1:6314750",0,2,2
"ARY1","s954_F_PIT_01_ASEReadCounter.table","NW_015090842.1:6315022",1,2,1
"ARY1","s954_F_PIT_01_ASEReadCounter.table","NW_015090842.1:6315026",1,2,1
"ARY1","s954_F_PIT_01_ASEReadCounter.table","NW_015090842.1:6315043",1,1,0
"ARY1","s954_F_PIT_01_ASEReadCounter.table","NW_015090842.1:6315065",1,1,0
"ARY1","s954_F_PIT_01_ASEReadCounter.table","NW_015090842.1:6315409",1,4,3
"ARY1","s954_F_PIT_01_ASEReadCounter.table","NW_015090842.1:6315479",0,3,3
"ARY1","s954_F_PIT_01_ASEReadCounter.table","NW_015090842.1:6318342",2,5,3
"ARY1","s954_F_PIT_01_ASEReadCounter.table","NW_015090842.1:6318427",3,5,2
"ARY1","s954_F_PIT_01_ASEReadCounter.table","NW_015090842.1:6318603",1,2,1
"ARY1","s954_F_PIT_01_ASEReadCounter.table","NW_015090842.1:6318708",1,2,1
"ARY1","s954_F_PIT_01_ASEReadCounter.table","NW_015090842.1:6318858",2,4,2
"ARY1","s954_F_PIT_01_ASEReadCounter.table","NW_015090842.1:6318952",1,2,1
"MPHOSPH6","s954_F_PIT_01_ASEReadCounter.table","NW_015090842.1:6324063",23,52,29
"MPHOSPH6","s954_F_PIT_01_ASEReadCounter.table","NW_015090842.1:6324174",35,90,55
"MPHOSPH6","s954_F_PIT_01_ASEReadCounter.table","NW_015090842.1:6324270",53,129,76
"MPHOSPH6","s954_F_PIT_01_ASEReadCounter.table","NW_015090842.1:6324762",54,129,75
"MPHOSPH6","s954_F_PIT_01_ASEReadCounter.table","NW_015090842.1:6324780",56,115,59
"MPHOSPH6","s954_F_PIT_01_ASEReadCounter.table","NW_015090842.1:6324902",56,137,81
"MPHOSPH6","s954_F_PIT_01_ASEReadCounter.table","NW_015090842.1:6325066",72,154,82
"MPHOSPH6","s954_F_PIT_01_ASEReadCounter.table","NW_015090842.1:6325089",86,183,97
"MPHOSPH6","s954_F_PIT_01_ASEReadCounter.table","NW_015090842.1:6325877",79,196,117
"MPHOSPH6","s954_F_PIT_01_ASEReadCounter.table","NW_015090842.1:6326976",57,136,79
"CDH13","s954_F_PIT_01_ASEReadCounter.table","NW_015090842.1:6662283",8,10,2
"CDH13","s954_F_PIT_01_ASEReadCounter.table","NW_015090842.1:6693665",8,12,4
"CDH13","s954_F_PIT_01_ASEReadCounter.table","NW_015090842.1:6693697",11,15,4
"CDH13","s954_F_PIT_01_ASEReadCounter.table","NW_015090842.1:6693712",10,13,3
"CDH13","s954_F_PIT_01_ASEReadCounter.table","NW_015090842.1:6693723",10,13,3
"CDH13","s954_F_PIT_01_ASEReadCounter.table","NW_015090842.1:6693738",6,8,2
"CDH13","s954_F_PIT_01_ASEReadCounter.table","NW_015090842.1:6823730",3,5,2
"CDH13","s954_F_PIT_01_ASEReadCounter.table","NW_015090842.1:6889713",3,6,3
"CDH13","s954_F_PIT_01_ASEReadCounter.table","NW_015090842.1:6955167",12,13,1
"MLYCD","s954_F_PIT_01_ASEReadCounter.table","NW_015090842.1:7150054",24,56,32
"MLYCD","s954_F_PIT_01_ASEReadCounter.table","NW_015090842.1:7150131",34,93,59
"MLYCD","s954_F_PIT_01_ASEReadCounter.table","NW_015090842.1:7150585",42,86,44
"MLYCD","s954_F_PIT_01_ASEReadCounter.table","NW_015090842.1:7150686",37,65,28
"MLYCD","s954_F_PIT_01_ASEReadCounter.table","NW_015090842.1:7150696",39,75,36
"MLYCD","s954_F_PIT_01_ASEReadCounter.table","NW_015090842.1:7150869",29,62,33
"MLYCD","s954_F_PIT_01_ASEReadCounter.table","NW_015090842.1:7151100",33,74,41
"MLYCD","s954_F_PIT_01_ASEReadCounter.table","NW_015090842.1:7151127",36,78,42
"MLYCD","s954_F_PIT_01_ASEReadCounter.table","NW_015090842.1:7157538",37,86,49
"MLYCD","s954_F_PIT_01_ASEReadCounter.table","NW_015090842.1:7167662",23,50,27
"MLYCD","s954_F_PIT_01_ASEReadCounter.table","NW_015090842.1:7167675",25,49,24
"MLYCD","s954_F_PIT_01_ASEReadCounter.table","NW_015090842.1:7167710",25,50,25
"MLYCD","s954_F_PIT_01_ASEReadCounter.table","NW_015090842.1:7167781",19,39,20
"MLYCD","s954_F_PIT_01_ASEReadCounter.table","NW_015090842.1:7167803",14,22,8
"MLYCD","s954_F_PIT_01_ASEReadCounter.table","NW_015090842.1:7167812",10,19,9
"MLYCD","s954_F_PIT_01_ASEReadCounter.table","NW_015090842.1:7167845",18,31,13
"MLYCD","s954_F_PIT_01_ASEReadCounter.table","NW_015090842.1:7167862",19,31,12
"MLYCD","s954_F_PIT_01_ASEReadCounter.table","NW_015090842.1:7167929",17,33,16
"MLYCD","s954_F_PIT_01_ASEReadCounter.table","NW_015090842.1:7167995",16,25,9
"MLYCD","s954_F_PIT_01_ASEReadCounter.table","NW_015090842.1:7168005",16,27,11
"MLYCD","s954_F_PIT_01_ASEReadCounter.table","NW_015090842.1:7168037",13,26,13
"HSBP1","s954_F_PIT_01_ASEReadCounter.table","NW_015090842.1:7245192",205,338,133
"HSBP1","s954_F_PIT_01_ASEReadCounter.table","NW_015090842.1:7245226",238,401,163
"HSBP1","s954_F_PIT_01_ASEReadCounter.table","NW_015090842.1:7245257",222,369,147
"HSBP1","s954_F_PIT_01_ASEReadCounter.table","NW_015090842.1:7245296",189,360,171
"HSBP1","s954_F_PIT_01_ASEReadCounter.table","NW_015090842.1:7245389",234,415,181
"HSBP1","s954_F_PIT_01_ASEReadCounter.table","NW_015090842.1:7245400",241,408,167
"HSBP1","s954_F_PIT_01_ASEReadCounter.table","NW_015090842.1:7245445",237,418,181
"HSBP1","s954_F_PIT_01_ASEReadCounter.table","NW_015090842.1:7245495",225,408,183
"HSBP1","s954_F_PIT_01_ASEReadCounter.table","NW_015090842.1:7245733",144,304,160
"HSBP1","s954_F_PIT_01_ASEReadCounter.table","NW_015090842.1:7245771",178,311,133
"HSBP1","s954_F_PIT_01_ASEReadCounter.table","NW_015090842.1:7245813",189,331,142
"HSBP1","s954_F_PIT_01_ASEReadCounter.table","NW_015090842.1:7245926",248,415,167
"HSBP1","s954_F_PIT_01_ASEReadCounter.table","NW_015090842.1:7245927",247,413,166
"HSBP1","s954_F_PIT_01_ASEReadCounter.table","NW_015090842.1:7245933",239,396,157
"HSBP1","s954_F_PIT_01_ASEReadCounter.table","NW_015090842.1:7246002",198,360,162
"HSBP1","s954_F_PIT_01_ASEReadCounter.table","NW_015090842.1:7246094",204,363,159
"HSBP1","s954_F_PIT_01_ASEReadCounter.table","NW_015090842.1:7246167",207,354,147
"HSBP1","s954_F_PIT_01_ASEReadCounter.table","NW_015090842.1:7246183",194,343,149
"HSBP1","s954_F_PIT_01_ASEReadCounter.table","NW_015090842.1:7247285",41,59,18
"HSBP1","s954_F_PIT_01_ASEReadCounter.table","NW_015090842.1:7247651",431,820,389
"HSBP1","s954_F_PIT_01_ASEReadCounter.table","NW_015090842.1:7247657",425,822,397
"HSBP1","s954_F_PIT_01_ASEReadCounter.table","NW_015090842.1:7248520",294,531,237
"HSBP1","s954_F_PIT_01_ASEReadCounter.table","NW_015090842.1:7248535",240,430,190
"KCNG4","s954_F_PIT_01_ASEReadCounter.table","NW_015090842.1:7283245",0,1,1
"WFDC1","s954_F_PIT_01_ASEReadCounter.table","NW_015090842.1:7366517",5,10,5
"WFDC1","s954_F_PIT_01_ASEReadCounter.table","NW_015090842.1:7373367",2,5,3
"WFDC1","s954_F_PIT_01_ASEReadCounter.table","NW_015090842.1:7375828",6,18,12
"WFDC1","s954_F_PIT_01_ASEReadCounter.table","NW_015090842.1:7378036",5,13,8
"WFDC1","s954_F_PIT_01_ASEReadCounter.table","NW_015090842.1:7379125",8,17,9
"WFDC1","s954_F_PIT_01_ASEReadCounter.table","NW_015090842.1:7379451",3,6,3
"WFDC1","s954_F_PIT_01_ASEReadCounter.table","NW_015090842.1:7379471",3,7,4
"WFDC1","s954_F_PIT_01_ASEReadCounter.table","NW_015090842.1:7379576",3,9,6
"WFDC1","s954_F_PIT_01_ASEReadCounter.table","NW_015090842.1:7379596",3,9,6
"WFDC1","s954_F_PIT_01_ASEReadCounter.table","NW_015090842.1:7379605",3,8,5
"WFDC1","s954_F_PIT_01_ASEReadCounter.table","NW_015090842.1:7379626",2,6,4
"WFDC1","s954_F_PIT_01_ASEReadCounter.table","NW_015090842.1:7379631",1,5,4
"WFDC1","s954_F_PIT_01_ASEReadCounter.table","NW_015090842.1:7379632",1,5,4
"WFDC1","s954_F_PIT_01_ASEReadCounter.table","NW_015090842.1:7379652",2,7,5
"WFDC1","s954_F_PIT_01_ASEReadCounter.table","NW_015090842.1:7379669",2,4,2
"WFDC1","s954_F_PIT_01_ASEReadCounter.table","NW_015090842.1:7379674",2,3,1
"WFDC1","s954_F_PIT_01_ASEReadCounter.table","NW_015090842.1:7379719",3,7,4
"WFDC1","s954_F_PIT_01_ASEReadCounter.table","NW_015090842.1:7379735",3,6,3
"WFDC1","s954_F_PIT_01_ASEReadCounter.table","NW_015090842.1:7379739",2,5,3
"WFDC1","s954_F_PIT_01_ASEReadCounter.table","NW_015090842.1:7379821",1,3,2
"WFDC1","s954_F_PIT_01_ASEReadCounter.table","NW_015090842.1:7379840",4,6,2
"WFDC1","s954_F_PIT_01_ASEReadCounter.table","NW_015090842.1:7379933",6,8,2
"WFDC1","s954_F_PIT_01_ASEReadCounter.table","NW_015090842.1:7379935",6,8,2
"WFDC1","s954_F_PIT_01_ASEReadCounter.table","NW_015090842.1:7379983",4,8,4
"WFDC1","s954_F_PIT_01_ASEReadCounter.table","NW_015090842.1:7380060",5,6,1
"WFDC1","s954_F_PIT_01_ASEReadCounter.table","NW_015090842.1:7380136",6,7,1
"WFDC1","s954_F_PIT_01_ASEReadCounter.table","NW_015090842.1:7380150",6,9,3
"WFDC1","s954_F_PIT_01_ASEReadCounter.table","NW_015090842.1:7380164",7,10,3
"WFDC1","s954_F_PIT_01_ASEReadCounter.table","NW_015090842.1:7380237",6,10,4
"WFDC1","s954_F_PIT_01_ASEReadCounter.table","NW_015090842.1:7380261",6,11,5
"WFDC1","s954_F_PIT_01_ASEReadCounter.table","NW_015090842.1:7380322",6,9,3
"WFDC1","s954_F_PIT_01_ASEReadCounter.table","NW_015090842.1:7380491",8,13,5
"WFDC1","s954_F_PIT_01_ASEReadCounter.table","NW_015090842.1:7380567",8,13,5
"WFDC1","s954_F_PIT_01_ASEReadCounter.table","NW_015090842.1:7380672",4,5,1
"WFDC1","s954_F_PIT_01_ASEReadCounter.table","NW_015090842.1:7380721",5,11,6
"WFDC1","s954_F_PIT_01_ASEReadCounter.table","NW_015090842.1:7380743",6,12,6
"WFDC1","s954_F_PIT_01_ASEReadCounter.table","NW_015090842.1:7380852",4,10,6
"WFDC1","s954_F_PIT_01_ASEReadCounter.table","NW_015090842.1:7380878",3,9,6
"WFDC1","s954_F_PIT_01_ASEReadCounter.table","NW_015090842.1:7381081",4,19,15
"WFDC1","s954_F_PIT_01_ASEReadCounter.table","NW_015090842.1:7381127",5,20,15
"WFDC1","s954_F_PIT_01_ASEReadCounter.table","NW_015090842.1:7381195",12,22,10
"WFDC1","s954_F_PIT_01_ASEReadCounter.table","NW_015090842.1:7381253",8,19,11
"WFDC1","s954_F_PIT_01_ASEReadCounter.table","NW_015090842.1:7381378",6,12,6
"WFDC1","s954_F_PIT_01_ASEReadCounter.table","NW_015090842.1:7381433",5,15,10
"WFDC1","s954_F_PIT_01_ASEReadCounter.table","NW_015090842.1:7381434",5,16,11
"WFDC1","s954_F_PIT_01_ASEReadCounter.table","NW_015090842.1:7381442",7,23,16
"WFDC1","s954_F_PIT_01_ASEReadCounter.table","NW_015090842.1:7381517",4,14,10
"WFDC1","s954_F_PIT_01_ASEReadCounter.table","NW_015090842.1:7381520",5,16,11
"WFDC1","s954_F_PIT_01_ASEReadCounter.table","NW_015090842.1:7381677",5,9,4
"WFDC1","s954_F_PIT_01_ASEReadCounter.table","NW_015090842.1:7381709",3,4,1
"ATP2C2","s954_F_PIT_01_ASEReadCounter.table","NW_015090842.1:7392613",2,6,4
"ATP2C2","s954_F_PIT_01_ASEReadCounter.table","NW_015090842.1:7395230",4,7,3
"ATP2C2","s954_F_PIT_01_ASEReadCounter.table","NW_015090842.1:7395366",3,6,3
"ATP2C2","s954_F_PIT_01_ASEReadCounter.table","NW_015090842.1:7396756",7,7,0
"ATP2C2","s954_F_PIT_01_ASEReadCounter.table","NW_015090842.1:7397049",8,12,4
"ATP2C2","s954_F_PIT_01_ASEReadCounter.table","NW_015090842.1:7398395",4,10,6
"ATP2C2","s954_F_PIT_01_ASEReadCounter.table","NW_015090842.1:7399774",4,8,4
"ATP2C2","s954_F_PIT_01_ASEReadCounter.table","NW_015090842.1:7402554",5,13,8
"ATP2C2","s954_F_PIT_01_ASEReadCounter.table","NW_015090842.1:7402578",9,17,8
"ATP2C2","s954_F_PIT_01_ASEReadCounter.table","NW_015090842.1:7405621",7,19,12
"ATP2C2","s954_F_PIT_01_ASEReadCounter.table","NW_015090842.1:7413855",8,9,1
"ATP2C2","s954_F_PIT_01_ASEReadCounter.table","NW_015090842.1:7413869",1,2,1
"ATP2C2","s954_F_PIT_01_ASEReadCounter.table","NW_015090842.1:7413875",1,2,1
"TLDC1","s954_F_PIT_01_ASEReadCounter.table","NW_015090842.1:7421137",37,58,21
"TLDC1","s954_F_PIT_01_ASEReadCounter.table","NW_015090842.1:7421155",30,52,22
"TLDC1","s954_F_PIT_01_ASEReadCounter.table","NW_015090842.1:7421218",27,49,22
"TLDC1","s954_F_PIT_01_ASEReadCounter.table","NW_015090842.1:7421399",24,52,28
"TLDC1","s954_F_PIT_01_ASEReadCounter.table","NW_015090842.1:7421402",25,54,29
"TLDC1","s954_F_PIT_01_ASEReadCounter.table","NW_015090842.1:7421528",24,56,32
"TLDC1","s954_F_PIT_01_ASEReadCounter.table","NW_015090842.1:7421532",25,58,33
"TLDC1","s954_F_PIT_01_ASEReadCounter.table","NW_015090842.1:7421621",30,69,39
"TLDC1","s954_F_PIT_01_ASEReadCounter.table","NW_015090842.1:7421647",34,71,37
"TLDC1","s954_F_PIT_01_ASEReadCounter.table","NW_015090842.1:7421657",29,64,35
"TLDC1","s954_F_PIT_01_ASEReadCounter.table","NW_015090842.1:7421693",37,76,39
"TLDC1","s954_F_PIT_01_ASEReadCounter.table","NW_015090842.1:7421796",17,37,20
"TLDC1","s954_F_PIT_01_ASEReadCounter.table","NW_015090842.1:7421810",26,54,28
"TLDC1","s954_F_PIT_01_ASEReadCounter.table","NW_015090842.1:7421833",29,61,32
"TLDC1","s954_F_PIT_01_ASEReadCounter.table","NW_015090842.1:7421879",32,63,31
"TLDC1","s954_F_PIT_01_ASEReadCounter.table","NW_015090842.1:7421914",32,61,29
"TLDC1","s954_F_PIT_01_ASEReadCounter.table","NW_015090842.1:7421969",19,47,28
"TLDC1","s954_F_PIT_01_ASEReadCounter.table","NW_015090842.1:7422015",22,52,30
"TLDC1","s954_F_PIT_01_ASEReadCounter.table","NW_015090842.1:7422042",33,65,32
"TLDC1","s954_F_PIT_01_ASEReadCounter.table","NW_015090842.1:7422230",37,71,34
"TLDC1","s954_F_PIT_01_ASEReadCounter.table","NW_015090842.1:7423349",27,56,29
"TLDC1","s954_F_PIT_01_ASEReadCounter.table","NW_015090842.1:7423362",23,51,28
"TLDC1","s954_F_PIT_01_ASEReadCounter.table","NW_015090842.1:7426091",27,50,23
"TLDC1","s954_F_PIT_01_ASEReadCounter.table","NW_015090842.1:7426485",33,65,32
"TLDC1","s954_F_PIT_01_ASEReadCounter.table","NW_015090842.1:7427211",30,66,36
"TLDC1","s954_F_PIT_01_ASEReadCounter.table","NW_015090842.1:7428179",26,60,34
"COTL1","s954_F_PIT_01_ASEReadCounter.table","NW_015090842.1:7490744",97,177,80
"COTL1","s954_F_PIT_01_ASEReadCounter.table","NW_015090842.1:7491051",86,146,60
"COTL1","s954_F_PIT_01_ASEReadCounter.table","NW_015090842.1:7491124",80,138,58
"COTL1","s954_F_PIT_01_ASEReadCounter.table","NW_015090842.1:7491418",69,105,36
"COTL1","s954_F_PIT_01_ASEReadCounter.table","NW_015090842.1:7491539",48,102,54
"COTL1","s954_F_PIT_01_ASEReadCounter.table","NW_015090842.1:7491585",85,166,81
"COTL1","s954_F_PIT_01_ASEReadCounter.table","NW_015090842.1:7491586",87,176,89
"COTL1","s954_F_PIT_01_ASEReadCounter.table","NW_015090842.1:7491646",120,218,98
"COTL1","s954_F_PIT_01_ASEReadCounter.table","NW_015090842.1:7491747",96,175,79
"COTL1","s954_F_PIT_01_ASEReadCounter.table","NW_015090842.1:7491803",91,161,70
"COTL1","s954_F_PIT_01_ASEReadCounter.table","NW_015090842.1:7506078",0,2,2
"COTL1","s954_F_PIT_01_ASEReadCounter.table","NW_015090842.1:7510900",1,1,0
"KLHL36","s954_F_PIT_01_ASEReadCounter.table","NW_015090842.1:7514700",5,11,6
"KLHL36","s954_F_PIT_01_ASEReadCounter.table","NW_015090842.1:7519691",6,12,6
"KLHL36","s954_F_PIT_01_ASEReadCounter.table","NW_015090842.1:7519696",6,12,6
"KLHL36","s954_F_PIT_01_ASEReadCounter.table","NW_015090842.1:7526160",11,39,28
"KLHL36","s954_F_PIT_01_ASEReadCounter.table","NW_015090842.1:7526469",10,25,15
"KLHL36","s954_F_PIT_01_ASEReadCounter.table","NW_015090842.1:7526587",10,24,14
"KLHL36","s954_F_PIT_01_ASEReadCounter.table","NW_015090842.1:7526997",7,18,11
"KLHL36","s954_F_PIT_01_ASEReadCounter.table","NW_015090842.1:7527142",11,19,8
"KLHL36","s954_F_PIT_01_ASEReadCounter.table","NW_015090842.1:7535174",23,61,38
"KLHL36","s954_F_PIT_01_ASEReadCounter.table","NW_015090842.1:7535384",8,32,24
"KLHL36","s954_F_PIT_01_ASEReadCounter.table","NW_015090842.1:7535420",17,44,27
"KLHL36","s954_F_PIT_01_ASEReadCounter.table","NW_015090842.1:7535545",10,19,9
"KLHL36","s954_F_PIT_01_ASEReadCounter.table","NW_015090842.1:7535829",15,32,17
"KLHL36","s954_F_PIT_01_ASEReadCounter.table","NW_015090842.1:7535977",17,37,20
"KLHL36","s954_F_PIT_01_ASEReadCounter.table","NW_015090842.1:7536010",18,39,21
"KLHL36","s954_F_PIT_01_ASEReadCounter.table","NW_015090842.1:7536051",22,42,20
"KLHL36","s954_F_PIT_01_ASEReadCounter.table","NW_015090842.1:7536096",23,40,17
"KLHL36","s954_F_PIT_01_ASEReadCounter.table","NW_015090842.1:7536135",28,47,19
"KLHL36","s954_F_PIT_01_ASEReadCounter.table","NW_015090842.1:7536136",27,46,19
"KLHL36","s954_F_PIT_01_ASEReadCounter.table","NW_015090842.1:7536160",30,50,20
"KLHL36","s954_F_PIT_01_ASEReadCounter.table","NW_015090842.1:7536336",18,47,29
"KLHL36","s954_F_PIT_01_ASEReadCounter.table","NW_015090842.1:7536352",17,50,33
"KLHL36","s954_F_PIT_01_ASEReadCounter.table","NW_015090842.1:7536412",8,32,24
"KLHL36","s954_F_PIT_01_ASEReadCounter.table","NW_015090842.1:7536418",8,32,24
"KLHL36","s954_F_PIT_01_ASEReadCounter.table","NW_015090842.1:7536465",9,26,17
"KLHL36","s954_F_PIT_01_ASEReadCounter.table","NW_015090842.1:7536466",9,26,17
"KLHL36","s954_F_PIT_01_ASEReadCounter.table","NW_015090842.1:7536553",14,31,17
"KLHL36","s954_F_PIT_01_ASEReadCounter.table","NW_015090842.1:7536698",10,27,17
"KLHL36","s954_F_PIT_01_ASEReadCounter.table","NW_015090842.1:7536713",3,22,19
"KLHL36","s954_F_PIT_01_ASEReadCounter.table","NW_015090842.1:7536720",6,18,12
"KLHL36","s954_F_PIT_01_ASEReadCounter.table","NW_015090842.1:7536791",19,37,18
"KLHL36","s954_F_PIT_01_ASEReadCounter.table","NW_015090842.1:7536849",14,25,11
"KLHL36","s954_F_PIT_01_ASEReadCounter.table","NW_015090842.1:7536872",14,31,17
"KLHL36","s954_F_PIT_01_ASEReadCounter.table","NW_015090842.1:7536878",16,31,15
"KLHL36","s954_F_PIT_01_ASEReadCounter.table","NW_015090842.1:7536916",19,32,13
"KLHL36","s954_F_PIT_01_ASEReadCounter.table","NW_015090842.1:7536927",20,38,18
"KLHL36","s954_F_PIT_01_ASEReadCounter.table","NW_015090842.1:7537315",20,47,27
"KLHL36","s954_F_PIT_01_ASEReadCounter.table","NW_015090842.1:7537352",14,35,21
"KLHL36","s954_F_PIT_01_ASEReadCounter.table","NW_015090842.1:7537631",19,40,21
"KLHL36","s954_F_PIT_01_ASEReadCounter.table","NW_015090842.1:7537830",25,54,29
"KLHL36","s954_F_PIT_01_ASEReadCounter.table","NW_015090842.1:7537838",22,52,30
"KLHL36","s954_F_PIT_01_ASEReadCounter.table","NW_015090842.1:7538153",14,39,25
"KLHL36","s954_F_PIT_01_ASEReadCounter.table","NW_015090842.1:7538256",10,25,15
"KLHL36","s954_F_PIT_01_ASEReadCounter.table","NW_015090842.1:7538265",9,23,14
"KLHL36","s954_F_PIT_01_ASEReadCounter.table","NW_015090842.1:7538300",8,27,19
"USP10","s954_F_PIT_01_ASEReadCounter.table","NW_015090842.1:7563972",12,20,8
"USP10","s954_F_PIT_01_ASEReadCounter.table","NW_015090842.1:7571816",35,61,26
"USP10","s954_F_PIT_01_ASEReadCounter.table","NW_015090842.1:7571993",19,46,27
"USP10","s954_F_PIT_01_ASEReadCounter.table","NW_015090842.1:7572580",36,92,56
"USP10","s954_F_PIT_01_ASEReadCounter.table","NW_015090842.1:7587372",47,83,36
"CRISPLD2","s954_F_PIT_01_ASEReadCounter.table","NW_015090842.1:7604605",2,2,0
"CRISPLD2","s954_F_PIT_01_ASEReadCounter.table","NW_015090842.1:7609844",2,2,0
"CRISPLD2","s954_F_PIT_01_ASEReadCounter.table","NW_015090842.1:7609845",2,2,0
"CRISPLD2","s954_F_PIT_01_ASEReadCounter.table","NW_015090842.1:7617781",1,1,0
"CRISPLD2","s954_F_PIT_01_ASEReadCounter.table","NW_015090842.1:7617790",1,1,0
"CRISPLD2","s954_F_PIT_01_ASEReadCounter.table","NW_015090842.1:7621452",2,2,0
"CRISPLD2","s954_F_PIT_01_ASEReadCounter.table","NW_015090842.1:7625451",1,1,0
"CRISPLD2","s954_F_PIT_01_ASEReadCounter.table","NW_015090842.1:7626214",4,4,0
"CRISPLD2","s954_F_PIT_01_ASEReadCounter.table","NW_015090842.1:7630784",8,8,0
"CRISPLD2","s954_F_PIT_01_ASEReadCounter.table","NW_015090842.1:7630823",7,7,0
"CRISPLD2","s954_F_PIT_01_ASEReadCounter.table","NW_015090842.1:7633172",6,6,0
"CRISPLD2","s954_F_PIT_01_ASEReadCounter.table","NW_015090842.1:7633326",6,7,1
"CRISPLD2","s954_F_PIT_01_ASEReadCounter.table","NW_015090842.1:7633336",7,8,1
"CRISPLD2","s954_F_PIT_01_ASEReadCounter.table","NW_015090842.1:7633381",11,11,0
"CRISPLD2","s954_F_PIT_01_ASEReadCounter.table","NW_015090842.1:7633388",11,11,0
"CRISPLD2","s954_F_PIT_01_ASEReadCounter.table","NW_015090842.1:7633400",11,12,1
"CRISPLD2","s954_F_PIT_01_ASEReadCounter.table","NW_015090842.1:7633486",6,10,4
"CRISPLD2","s954_F_PIT_01_ASEReadCounter.table","NW_015090842.1:7633503",5,9,4
"CRISPLD2","s954_F_PIT_01_ASEReadCounter.table","NW_015090842.1:7633504",5,9,4
"CRISPLD2","s954_F_PIT_01_ASEReadCounter.table","NW_015090842.1:7633557",6,9,3
"CRISPLD2","s954_F_PIT_01_ASEReadCounter.table","NW_015090842.1:7633571",3,6,3
"CRISPLD2","s954_F_PIT_01_ASEReadCounter.table","NW_015090842.1:7633588",3,6,3
"CRISPLD2","s954_F_PIT_01_ASEReadCounter.table","NW_015090842.1:7633617",3,5,2
"CRISPLD2","s954_F_PIT_01_ASEReadCounter.table","NW_015090842.1:7633695",4,5,1
"CRISPLD2","s954_F_PIT_01_ASEReadCounter.table","NW_015090842.1:7633721",6,8,2
"CRISPLD2","s954_F_PIT_01_ASEReadCounter.table","NW_015090842.1:7633888",0,1,1
"CRISPLD2","s954_F_PIT_01_ASEReadCounter.table","NW_015090842.1:7633910",1,2,1
"CRISPLD2","s954_F_PIT_01_ASEReadCounter.table","NW_015090842.1:7634142",3,4,1
"CRISPLD2","s954_F_PIT_01_ASEReadCounter.table","NW_015090842.1:7634417",3,4,1
"CRISPLD2","s954_F_PIT_01_ASEReadCounter.table","NW_015090842.1:7634825",2,2,0
"CRISPLD2","s954_F_PIT_01_ASEReadCounter.table","NW_015090842.1:7634852",3,3,0
"CRISPLD2","s954_F_PIT_01_ASEReadCounter.table","NW_015090842.1:7635009",0,1,1
"CRISPLD2","s954_F_PIT_01_ASEReadCounter.table","NW_015090842.1:7635208",7,9,2
"CRISPLD2","s954_F_PIT_01_ASEReadCounter.table","NW_015090842.1:7635373",6,9,3
"CRISPLD2","s954_F_PIT_01_ASEReadCounter.table","NW_015090842.1:7635525",7,8,1
"CRISPLD2","s954_F_PIT_01_ASEReadCounter.table","NW_015090842.1:7635583",8,10,2
"CRISPLD2","s954_F_PIT_01_ASEReadCounter.table","NW_015090842.1:7635924",7,10,3
"LOC106888312","s954_F_PIT_01_ASEReadCounter.table","NW_015090842.1:7727001",0,2,2
"LOC106888312","s954_F_PIT_01_ASEReadCounter.table","NW_015090842.1:7727036",0,2,2
"LOC106888312","s954_F_PIT_01_ASEReadCounter.table","NW_015090842.1:7727072",1,1,0
"LOC106888312","s954_F_PIT_01_ASEReadCounter.table","NW_015090842.1:7727961",0,2,2
"LOC106888312","s954_F_PIT_01_ASEReadCounter.table","NW_015090842.1:7732244",1,1,0
"LOC106888312","s954_F_PIT_01_ASEReadCounter.table","NW_015090842.1:7732538",0,1,1
"LOC106888312","s954_F_PIT_01_ASEReadCounter.table","NW_015090842.1:7732548",0,1,1
"LOC106888312","s954_F_PIT_01_ASEReadCounter.table","NW_015090842.1:7732576",0,1,1
"LOC106888312","s954_F_PIT_01_ASEReadCounter.table","NW_015090842.1:7732580",0,1,1
"LOC106888312","s954_F_PIT_01_ASEReadCounter.table","NW_015090842.1:7732629",1,1,0
"LOC106888312","s954_F_PIT_01_ASEReadCounter.table","NW_015090842.1:7732637",1,1,0
"LOC106888312","s954_F_PIT_01_ASEReadCounter.table","NW_015090842.1:7732682",1,2,1
"LOC106888312","s954_F_PIT_01_ASEReadCounter.table","NW_015090842.1:7732696",1,2,1
"LOC106888312","s954_F_PIT_01_ASEReadCounter.table","NW_015090842.1:7732709",0,1,1
"LOC106888312","s954_F_PIT_01_ASEReadCounter.table","NW_015090842.1:7732718",0,1,1
"LOC106888312","s954_F_PIT_01_ASEReadCounter.table","NW_015090842.1:7732739",0,1,1
"LOC106888312","s954_F_PIT_01_ASEReadCounter.table","NW_015090842.1:7732743",0,1,1
"LOC106888312","s954_F_PIT_01_ASEReadCounter.table","NW_015090842.1:7732744",0,1,1
"LOC106888312","s954_F_PIT_01_ASEReadCounter.table","NW_015090842.1:7732756",0,1,1
"LOC106888312","s954_F_PIT_01_ASEReadCounter.table","NW_015090842.1:7732757",0,1,1
"LOC106888312","s954_F_PIT_01_ASEReadCounter.table","NW_015090842.1:7732782",1,2,1
"LOC106888312","s954_F_PIT_01_ASEReadCounter.table","NW_015090842.1:7732796",1,2,1
"LOC106888312","s954_F_PIT_01_ASEReadCounter.table","NW_015090842.1:7733196",0,1,1
"LOC106888312","s954_F_PIT_01_ASEReadCounter.table","NW_015090842.1:7733470",1,2,1
"LOC106888312","s954_F_PIT_01_ASEReadCounter.table","NW_015090842.1:7733471",1,2,1
"LOC106888312","s954_F_PIT_01_ASEReadCounter.table","NW_015090842.1:7733472",1,2,1
"LOC106888312","s954_F_PIT_01_ASEReadCounter.table","NW_015090842.1:7733507",1,1,0
"LOC106888312","s954_F_PIT_01_ASEReadCounter.table","NW_015090842.1:7733508",1,1,0
"LOC106888312","s954_F_PIT_01_ASEReadCounter.table","NW_015090842.1:7733518",1,1,0
"LOC106888312","s954_F_PIT_01_ASEReadCounter.table","NW_015090842.1:7733609",0,2,2
"LOC106888312","s954_F_PIT_01_ASEReadCounter.table","NW_015090842.1:7733631",0,2,2
"LOC106888312","s954_F_PIT_01_ASEReadCounter.table","NW_015090842.1:7733674",0,2,2
"ZDHHC7","s954_F_PIT_01_ASEReadCounter.table","NW_015090842.1:7737199",26,51,25
"ZDHHC7","s954_F_PIT_01_ASEReadCounter.table","NW_015090842.1:7737332",13,37,24
"ZDHHC7","s954_F_PIT_01_ASEReadCounter.table","NW_015090842.1:7737553",27,74,47
"ZDHHC7","s954_F_PIT_01_ASEReadCounter.table","NW_015090842.1:7737920",22,42,20
"ZDHHC7","s954_F_PIT_01_ASEReadCounter.table","NW_015090842.1:7737953",19,35,16
"ZDHHC7","s954_F_PIT_01_ASEReadCounter.table","NW_015090842.1:7737987",20,37,17
"ZDHHC7","s954_F_PIT_01_ASEReadCounter.table","NW_015090842.1:7738068",11,30,19
"ZDHHC7","s954_F_PIT_01_ASEReadCounter.table","NW_015090842.1:7738204",18,43,25
"LOC106888097","s954_F_PIT_01_ASEReadCounter.table","NW_015090842.1:7767178",22,49,27
"LOC106888097","s954_F_PIT_01_ASEReadCounter.table","NW_015090842.1:7767187",21,50,29
"LOC106888097","s954_F_PIT_01_ASEReadCounter.table","NW_015090842.1:7768144",23,65,42
"LOC106888097","s954_F_PIT_01_ASEReadCounter.table","NW_015090842.1:7768196",31,80,49
"LOC106888097","s954_F_PIT_01_ASEReadCounter.table","NW_015090842.1:7769884",30,69,39
"LOC106888097","s954_F_PIT_01_ASEReadCounter.table","NW_015090842.1:7769893",28,61,33
"LOC106888097","s954_F_PIT_01_ASEReadCounter.table","NW_015090842.1:7770245",35,78,43
"LOC106888097","s954_F_PIT_01_ASEReadCounter.table","NW_015090842.1:7772402",39,98,59
"LOC106888097","s954_F_PIT_01_ASEReadCounter.table","NW_015090842.1:7772483",39,93,54
"LOC106888097","s954_F_PIT_01_ASEReadCounter.table","NW_015090842.1:7772490",41,91,50
"LOC106888097","s954_F_PIT_01_ASEReadCounter.table","NW_015090842.1:7774281",38,107,69
"LOC106888097","s954_F_PIT_01_ASEReadCounter.table","NW_015090842.1:7774552",34,116,82
"LOC106888097","s954_F_PIT_01_ASEReadCounter.table","NW_015090842.1:7774564",34,116,82
"LOC106888097","s954_F_PIT_01_ASEReadCounter.table","NW_015090842.1:7774611",24,106,82
"LOC106888097","s954_F_PIT_01_ASEReadCounter.table","NW_015090842.1:7774681",23,83,60
"LOC106888097","s954_F_PIT_01_ASEReadCounter.table","NW_015090842.1:7774698",22,66,44
"LOC106888097","s954_F_PIT_01_ASEReadCounter.table","NW_015090842.1:7774730",10,31,21
"LOC106888097","s954_F_PIT_01_ASEReadCounter.table","NW_015090842.1:7774778",3,4,1
"LOC106888097","s954_F_PIT_01_ASEReadCounter.table","NW_015090842.1:7774793",3,4,1
"FOXL1","s954_F_PIT_01_ASEReadCounter.table","NW_015090842.1:8113043",1,1,0
"FOXC2","s954_F_PIT_01_ASEReadCounter.table","NW_015090842.1:8129599",5,29,24
"FOXC2","s954_F_PIT_01_ASEReadCounter.table","NW_015090842.1:8129616",12,36,24
"FOXC2","s954_F_PIT_01_ASEReadCounter.table","NW_015090842.1:8129715",10,31,21
"FOXC2","s954_F_PIT_01_ASEReadCounter.table","NW_015090842.1:8129719",9,29,20
"FOXC2","s954_F_PIT_01_ASEReadCounter.table","NW_015090842.1:8130244",9,32,23
"FOXC2","s954_F_PIT_01_ASEReadCounter.table","NW_015090842.1:8130472",7,17,10
"FOXC2","s954_F_PIT_01_ASEReadCounter.table","NW_015090842.1:8130490",7,22,15
"FOXC2","s954_F_PIT_01_ASEReadCounter.table","NW_015090842.1:8130547",12,24,12
"FOXC2","s954_F_PIT_01_ASEReadCounter.table","NW_015090842.1:8130550",12,24,12
"FOXC2","s954_F_PIT_01_ASEReadCounter.table","NW_015090842.1:8130573",11,24,13
"FOXC2","s954_F_PIT_01_ASEReadCounter.table","NW_015090842.1:8130575",12,25,13
"MTHFSD","s954_F_PIT_01_ASEReadCounter.table","NW_015090842.1:8140051",16,30,14
"MTHFSD","s954_F_PIT_01_ASEReadCounter.table","NW_015090842.1:8142923",15,40,25
"MTHFSD","s954_F_PIT_01_ASEReadCounter.table","NW_015090842.1:8143029",22,50,28
"MTHFSD","s954_F_PIT_01_ASEReadCounter.table","NW_015090842.1:8152035",16,32,16
"MTHFSD","s954_F_PIT_01_ASEReadCounter.table","NW_015090842.1:8152315",14,26,12
"MTHFSD","s954_F_PIT_01_ASEReadCounter.table","NW_015090842.1:8152511",14,30,16
"MTHFSD","s954_F_PIT_01_ASEReadCounter.table","NW_015090842.1:8152518",12,27,15
"MTHFSD","s954_F_PIT_01_ASEReadCounter.table","NW_015090842.1:8152553",11,24,13
"MTHFSD","s954_F_PIT_01_ASEReadCounter.table","NW_015090842.1:8152773",19,35,16
"MTHFSD","s954_F_PIT_01_ASEReadCounter.table","NW_015090842.1:8152805",24,40,16
"FOXF1","s954_F_PIT_01_ASEReadCounter.table","NW_015090842.1:8164789",8,13,5
"FOXF1","s954_F_PIT_01_ASEReadCounter.table","NW_015090842.1:8166883",4,4,0
"FOXF1","s954_F_PIT_01_ASEReadCounter.table","NW_015090842.1:8167113",4,9,5
"FOXF1","s954_F_PIT_01_ASEReadCounter.table","NW_015090842.1:8167588",2,7,5
"IRF8","s954_F_PIT_01_ASEReadCounter.table","NW_015090842.1:8406652",1,2,1
"IRF8","s954_F_PIT_01_ASEReadCounter.table","NW_015090842.1:8406703",2,3,1
"IRF8","s954_F_PIT_01_ASEReadCounter.table","NW_015090842.1:8406704",2,3,1
"IRF8","s954_F_PIT_01_ASEReadCounter.table","NW_015090842.1:8406757",5,6,1
"IRF8","s954_F_PIT_01_ASEReadCounter.table","NW_015090842.1:8406778",4,6,2
"IRF8","s954_F_PIT_01_ASEReadCounter.table","NW_015090842.1:8406819",4,6,2
"IRF8","s954_F_PIT_01_ASEReadCounter.table","NW_015090842.1:8406941",4,6,2
"IRF8","s954_F_PIT_01_ASEReadCounter.table","NW_015090842.1:8407008",3,4,1
"IRF8","s954_F_PIT_01_ASEReadCounter.table","NW_015090842.1:8407057",2,2,0
"IRF8","s954_F_PIT_01_ASEReadCounter.table","NW_015090842.1:8407064",2,2,0
"IRF8","s954_F_PIT_01_ASEReadCounter.table","NW_015090842.1:8407069",2,3,1
"IRF8","s954_F_PIT_01_ASEReadCounter.table","NW_015090842.1:8407120",2,3,1
"IRF8","s954_F_PIT_01_ASEReadCounter.table","NW_015090842.1:8407157",2,3,1
"IRF8","s954_F_PIT_01_ASEReadCounter.table","NW_015090842.1:8407203",2,3,1
"IRF8","s954_F_PIT_01_ASEReadCounter.table","NW_015090842.1:8407272",2,4,2
"IRF8","s954_F_PIT_01_ASEReadCounter.table","NW_015090842.1:8407276",1,3,2
"IRF8","s954_F_PIT_01_ASEReadCounter.table","NW_015090842.1:8407303",2,5,3
"IRF8","s954_F_PIT_01_ASEReadCounter.table","NW_015090842.1:8407451",2,8,6
"IRF8","s954_F_PIT_01_ASEReadCounter.table","NW_015090842.1:8407456",4,10,6
"IRF8","s954_F_PIT_01_ASEReadCounter.table","NW_015090842.1:8408564",2,4,2
"IRF8","s954_F_PIT_01_ASEReadCounter.table","NW_015090842.1:8408585",2,2,0
"IRF8","s954_F_PIT_01_ASEReadCounter.table","NW_015090842.1:8408973",3,4,1
"IRF8","s954_F_PIT_01_ASEReadCounter.table","NW_015090842.1:8409060",2,6,4
"IRF8","s954_F_PIT_01_ASEReadCounter.table","NW_015090842.1:8409065",3,7,4
"IRF8","s954_F_PIT_01_ASEReadCounter.table","NW_015090842.1:8409254",3,6,3
"IRF8","s954_F_PIT_01_ASEReadCounter.table","NW_015090842.1:8409255",3,6,3
"IRF8","s954_F_PIT_01_ASEReadCounter.table","NW_015090842.1:8409258",3,6,3
"IRF8","s954_F_PIT_01_ASEReadCounter.table","NW_015090842.1:8409312",4,6,2
"IRF8","s954_F_PIT_01_ASEReadCounter.table","NW_015090842.1:8410216",1,3,2
"IRF8","s954_F_PIT_01_ASEReadCounter.table","NW_015090842.1:8410237",2,4,2
"IRF8","s954_F_PIT_01_ASEReadCounter.table","NW_015090842.1:8410276",4,4,0
"IRF8","s954_F_PIT_01_ASEReadCounter.table","NW_015090842.1:8410813",2,3,1
"IRF8","s954_F_PIT_01_ASEReadCounter.table","NW_015090842.1:8410861",4,5,1
"IRF8","s954_F_PIT_01_ASEReadCounter.table","NW_015090842.1:8411940",5,5,0
"IRF8","s954_F_PIT_01_ASEReadCounter.table","NW_015090842.1:8412006",2,3,1
"IRF8","s954_F_PIT_01_ASEReadCounter.table","NW_015090842.1:8412042",3,4,1
"DUSP15","s954_F_PIT_01_ASEReadCounter.table","NW_015090842.1:8422787",4,6,2
"DUSP15","s954_F_PIT_01_ASEReadCounter.table","NW_015090842.1:8422832",3,3,0
"DUSP15","s954_F_PIT_01_ASEReadCounter.table","NW_015090842.1:8422898",1,2,1
"DUSP15","s954_F_PIT_01_ASEReadCounter.table","NW_015090842.1:8422909",3,4,1
"COX4I1","s954_F_PIT_01_ASEReadCounter.table","NW_015090842.1:8442258",796,1497,701
"COX4I1","s954_F_PIT_01_ASEReadCounter.table","NW_015090842.1:8442333",701,1362,661
"EMC8","s954_F_PIT_01_ASEReadCounter.table","NW_015090842.1:8444046",53,120,67
"EMC8","s954_F_PIT_01_ASEReadCounter.table","NW_015090842.1:8444064",47,107,60
"EMC8","s954_F_PIT_01_ASEReadCounter.table","NW_015090842.1:8452029",10,29,19
"EMC8","s954_F_PIT_01_ASEReadCounter.table","NW_015090842.1:8452116",18,36,18
"EMC8","s954_F_PIT_01_ASEReadCounter.table","NW_015090842.1:8452121",16,36,20
"EMC8","s954_F_PIT_01_ASEReadCounter.table","NW_015090842.1:8452222",16,31,15
"EMC8","s954_F_PIT_01_ASEReadCounter.table","NW_015090842.1:8452244",15,29,14
"EMC8","s954_F_PIT_01_ASEReadCounter.table","NW_015090842.1:8452477",9,14,5
"EMC8","s954_F_PIT_01_ASEReadCounter.table","NW_015090842.1:8452498",6,12,6
"EMC8","s954_F_PIT_01_ASEReadCounter.table","NW_015090842.1:8452535",5,9,4
"EMC8","s954_F_PIT_01_ASEReadCounter.table","NW_015090842.1:8452575",5,8,3
"EMC8","s954_F_PIT_01_ASEReadCounter.table","NW_015090842.1:8452600",5,8,3
"EMC8","s954_F_PIT_01_ASEReadCounter.table","NW_015090842.1:8452616",6,9,3
"EMC8","s954_F_PIT_01_ASEReadCounter.table","NW_015090842.1:8452630",7,8,1
"EMC8","s954_F_PIT_01_ASEReadCounter.table","NW_015090842.1:8452650",7,11,4
"EMC8","s954_F_PIT_01_ASEReadCounter.table","NW_015090842.1:8452678",7,13,6
"EMC8","s954_F_PIT_01_ASEReadCounter.table","NW_015090842.1:8452724",4,9,5
"EMC8","s954_F_PIT_01_ASEReadCounter.table","NW_015090842.1:8452731",4,8,4
"EMC8","s954_F_PIT_01_ASEReadCounter.table","NW_015090842.1:8452743",4,8,4
"EMC8","s954_F_PIT_01_ASEReadCounter.table","NW_015090842.1:8452750",3,6,3
"EMC8","s954_F_PIT_01_ASEReadCounter.table","NW_015090842.1:8452778",2,7,5
"EMC8","s954_F_PIT_01_ASEReadCounter.table","NW_015090842.1:8452783",3,9,6
"EMC8","s954_F_PIT_01_ASEReadCounter.table","NW_015090842.1:8452800",6,9,3
"EMC8","s954_F_PIT_01_ASEReadCounter.table","NW_015090842.1:8452804",7,10,3
"EMC8","s954_F_PIT_01_ASEReadCounter.table","NW_015090842.1:8452812",7,10,3
"EMC8","s954_F_PIT_01_ASEReadCounter.table","NW_015090842.1:8452858",13,17,4
"EMC8","s954_F_PIT_01_ASEReadCounter.table","NW_015090842.1:8452906",13,24,11
"EMC8","s954_F_PIT_01_ASEReadCounter.table","NW_015090842.1:8452913",11,22,11
"EMC8","s954_F_PIT_01_ASEReadCounter.table","NW_015090842.1:8453000",10,20,10
"EMC8","s954_F_PIT_01_ASEReadCounter.table","NW_015090842.1:8453007",11,23,12
"EMC8","s954_F_PIT_01_ASEReadCounter.table","NW_015090842.1:8453058",8,20,12
"EMC8","s954_F_PIT_01_ASEReadCounter.table","NW_015090842.1:8453106",3,15,12
"GINS2","s954_F_PIT_01_ASEReadCounter.table","NW_015090842.1:8466420",15,20,5
"GINS2","s954_F_PIT_01_ASEReadCounter.table","NW_015090842.1:8466424",17,22,5
"GINS2","s954_F_PIT_01_ASEReadCounter.table","NW_015090842.1:8466518",17,25,8
"GINS2","s954_F_PIT_01_ASEReadCounter.table","NW_015090842.1:8468482",33,46,13
"GINS2","s954_F_PIT_01_ASEReadCounter.table","NW_015090842.1:8470290",33,45,12
"GINS2","s954_F_PIT_01_ASEReadCounter.table","NW_015090842.1:8470305",31,45,14
"GINS2","s954_F_PIT_01_ASEReadCounter.table","NW_015090842.1:8470381",25,36,11
"GINS2","s954_F_PIT_01_ASEReadCounter.table","NW_015090842.1:8470418",23,34,11
"GINS2","s954_F_PIT_01_ASEReadCounter.table","NW_015090842.1:8470421",19,30,11
"GINS2","s954_F_PIT_01_ASEReadCounter.table","NW_015090842.1:8470430",15,26,11
"GINS2","s954_F_PIT_01_ASEReadCounter.table","NW_015090842.1:8470433",14,25,11
"GINS2","s954_F_PIT_01_ASEReadCounter.table","NW_015090842.1:8470457",9,19,10
"GINS2","s954_F_PIT_01_ASEReadCounter.table","NW_015090842.1:8470491",15,25,10
"GINS2","s954_F_PIT_01_ASEReadCounter.table","NW_015090842.1:8470548",15,28,13
"GINS2","s954_F_PIT_01_ASEReadCounter.table","NW_015090842.1:8470649",18,25,7
"GSE1","s954_F_PIT_01_ASEReadCounter.table","NW_015090842.1:8475362",39,83,44
"GSE1","s954_F_PIT_01_ASEReadCounter.table","NW_015090842.1:8475961",27,45,18
"GSE1","s954_F_PIT_01_ASEReadCounter.table","NW_015090842.1:8476027",20,36,16
"GSE1","s954_F_PIT_01_ASEReadCounter.table","NW_015090842.1:8476159",16,20,4
"GSE1","s954_F_PIT_01_ASEReadCounter.table","NW_015090842.1:8477442",0,16,16
"GSE1","s954_F_PIT_01_ASEReadCounter.table","NW_015090842.1:8477448",0,15,15
"GSE1","s954_F_PIT_01_ASEReadCounter.table","NW_015090842.1:8477662",0,10,10
"GSE1","s954_F_PIT_01_ASEReadCounter.table","NW_015090842.1:8477933",16,42,26
"GSE1","s954_F_PIT_01_ASEReadCounter.table","NW_015090842.1:8477945",14,39,25
"GSE1","s954_F_PIT_01_ASEReadCounter.table","NW_015090842.1:8483272",2,24,22
"GSE1","s954_F_PIT_01_ASEReadCounter.table","NW_015090842.1:8483367",2,11,9
"GSE1","s954_F_PIT_01_ASEReadCounter.table","NW_015090842.1:8483411",0,9,9
"GSE1","s954_F_PIT_01_ASEReadCounter.table","NW_015090842.1:8483756",4,27,23
"GSE1","s954_F_PIT_01_ASEReadCounter.table","NW_015090842.1:8486867",38,66,28
"GSE1","s954_F_PIT_01_ASEReadCounter.table","NW_015090842.1:8486939",42,85,43
"GSE1","s954_F_PIT_01_ASEReadCounter.table","NW_015090842.1:8486945",40,85,45
"GSE1","s954_F_PIT_01_ASEReadCounter.table","NW_015090842.1:8486993",24,61,37
"GSE1","s954_F_PIT_01_ASEReadCounter.table","NW_015090842.1:8487062",25,55,30
"GSE1","s954_F_PIT_01_ASEReadCounter.table","NW_015090842.1:8488065",27,58,31
"GSE1","s954_F_PIT_01_ASEReadCounter.table","NW_015090842.1:8488457",26,49,23
"GSE1","s954_F_PIT_01_ASEReadCounter.table","NW_015090842.1:8488463",23,45,22
"GSE1","s954_F_PIT_01_ASEReadCounter.table","NW_015090842.1:8488490",40,40,0
"GSE1","s954_F_PIT_01_ASEReadCounter.table","NW_015090842.1:8488505",22,42,20
"GSE1","s954_F_PIT_01_ASEReadCounter.table","NW_015090842.1:8490180",0,31,31
"KIAA0513","s954_F_PIT_01_ASEReadCounter.table","NW_015090842.1:8668363",78,164,86
"KIAA0513","s954_F_PIT_01_ASEReadCounter.table","NW_015090842.1:8668387",79,157,78
"KIAA0513","s954_F_PIT_01_ASEReadCounter.table","NW_015090842.1:8668390",78,154,76
"KIAA0513","s954_F_PIT_01_ASEReadCounter.table","NW_015090842.1:8673107",86,176,90
"KIAA0513","s954_F_PIT_01_ASEReadCounter.table","NW_015090842.1:8673147",80,157,77
"KIAA0513","s954_F_PIT_01_ASEReadCounter.table","NW_015090842.1:8674661",60,133,73
"KIAA0513","s954_F_PIT_01_ASEReadCounter.table","NW_015090842.1:8674685",54,127,73
"KIAA0513","s954_F_PIT_01_ASEReadCounter.table","NW_015090842.1:8674730",59,126,67
"KIAA0513","s954_F_PIT_01_ASEReadCounter.table","NW_015090842.1:8675525",65,142,77
"KIAA0513","s954_F_PIT_01_ASEReadCounter.table","NW_015090842.1:8675561",64,147,83
"KIAA0513","s954_F_PIT_01_ASEReadCounter.table","NW_015090842.1:8678608",2,30,28
"KIAA0513","s954_F_PIT_01_ASEReadCounter.table","NW_015090842.1:8686455",0,26,26
"KIAA0513","s954_F_PIT_01_ASEReadCounter.table","NW_015090842.1:8686508",0,31,31
"KIAA0513","s954_F_PIT_01_ASEReadCounter.table","NW_015090842.1:8686521",0,31,31
"KIAA0513","s954_F_PIT_01_ASEReadCounter.table","NW_015090842.1:8693642",29,51,22
"KIAA0513","s954_F_PIT_01_ASEReadCounter.table","NW_015090842.1:8693712",35,61,26
"KIAA0513","s954_F_PIT_01_ASEReadCounter.table","NW_015090842.1:8695794",2,3,1
"FBXO31","s954_F_PIT_01_ASEReadCounter.table","NW_015090842.1:8710240",20,57,37
"FBXO31","s954_F_PIT_01_ASEReadCounter.table","NW_015090842.1:8710372",41,63,22
"FBXO31","s954_F_PIT_01_ASEReadCounter.table","NW_015090842.1:8711239",33,68,35
"FBXO31","s954_F_PIT_01_ASEReadCounter.table","NW_015090842.1:8714565",30,85,55
"FBXO31","s954_F_PIT_01_ASEReadCounter.table","NW_015090842.1:8716001",27,58,31
"FBXO31","s954_F_PIT_01_ASEReadCounter.table","NW_015090842.1:8725050",3,3,0
"FBXO31","s954_F_PIT_01_ASEReadCounter.table","NW_015090842.1:8725057",3,3,0
"FBXO31","s954_F_PIT_01_ASEReadCounter.table","NW_015090842.1:8725162",2,2,0
"FBXO31","s954_F_PIT_01_ASEReadCounter.table","NW_015090842.1:8725163",2,2,0
"FBXO31","s954_F_PIT_01_ASEReadCounter.table","NW_015090842.1:8725170",2,2,0
"FBXO31","s954_F_PIT_01_ASEReadCounter.table","NW_015090842.1:8725187",3,3,0
"FBXO31","s954_F_PIT_01_ASEReadCounter.table","NW_015090842.1:8725188",3,3,0
"FBXO31","s954_F_PIT_01_ASEReadCounter.table","NW_015090842.1:8725190",3,3,0
"FBXO31","s954_F_PIT_01_ASEReadCounter.table","NW_015090842.1:8725370",3,4,1
"ZCCHC14","s954_F_PIT_01_ASEReadCounter.table","NW_015090842.1:8750174",51,54,3
"ZCCHC14","s954_F_PIT_01_ASEReadCounter.table","NW_015090842.1:8750189",51,54,3
"ZCCHC14","s954_F_PIT_01_ASEReadCounter.table","NW_015090842.1:8750365",21,33,12
"ZCCHC14","s954_F_PIT_01_ASEReadCounter.table","NW_015090842.1:8750433",14,26,12
"ZCCHC14","s954_F_PIT_01_ASEReadCounter.table","NW_015090842.1:8750449",15,30,15
"ZCCHC14","s954_F_PIT_01_ASEReadCounter.table","NW_015090842.1:8750456",12,29,17
"ZCCHC14","s954_F_PIT_01_ASEReadCounter.table","NW_015090842.1:8750497",20,38,18
"ZCCHC14","s954_F_PIT_01_ASEReadCounter.table","NW_015090842.1:8750547",26,46,20
"ZCCHC14","s954_F_PIT_01_ASEReadCounter.table","NW_015090842.1:8751100",14,16,2
"ZCCHC14","s954_F_PIT_01_ASEReadCounter.table","NW_015090842.1:8751374",10,20,10
"ZCCHC14","s954_F_PIT_01_ASEReadCounter.table","NW_015090842.1:8751403",14,31,17
"ZCCHC14","s954_F_PIT_01_ASEReadCounter.table","NW_015090842.1:8751517",6,17,11
"ZCCHC14","s954_F_PIT_01_ASEReadCounter.table","NW_015090842.1:8752060",7,11,4
"ZCCHC14","s954_F_PIT_01_ASEReadCounter.table","NW_015090842.1:8752172",9,16,7
"ZCCHC14","s954_F_PIT_01_ASEReadCounter.table","NW_015090842.1:8752183",10,17,7
"ZCCHC14","s954_F_PIT_01_ASEReadCounter.table","NW_015090842.1:8752198",14,23,9
"ZCCHC14","s954_F_PIT_01_ASEReadCounter.table","NW_015090842.1:8752248",15,28,13
"ZCCHC14","s954_F_PIT_01_ASEReadCounter.table","NW_015090842.1:8752326",11,20,9
"ZCCHC14","s954_F_PIT_01_ASEReadCounter.table","NW_015090842.1:8752393",8,18,10
"ZCCHC14","s954_F_PIT_01_ASEReadCounter.table","NW_015090842.1:8752914",6,19,13
"ZCCHC14","s954_F_PIT_01_ASEReadCounter.table","NW_015090842.1:8753528",10,20,10
"ZCCHC14","s954_F_PIT_01_ASEReadCounter.table","NW_015090842.1:8753892",3,8,5
"ZCCHC14","s954_F_PIT_01_ASEReadCounter.table","NW_015090842.1:8753910",5,10,5
"ZCCHC14","s954_F_PIT_01_ASEReadCounter.table","NW_015090842.1:8755096",5,15,10
"ZCCHC14","s954_F_PIT_01_ASEReadCounter.table","NW_015090842.1:8755327",9,15,6
"ZCCHC14","s954_F_PIT_01_ASEReadCounter.table","NW_015090842.1:8755723",8,12,4
"ZCCHC14","s954_F_PIT_01_ASEReadCounter.table","NW_015090842.1:8755739",6,11,5
"ZCCHC14","s954_F_PIT_01_ASEReadCounter.table","NW_015090842.1:8756149",9,11,2
"ZCCHC14","s954_F_PIT_01_ASEReadCounter.table","NW_015090842.1:8756347",10,20,10
"ZCCHC14","s954_F_PIT_01_ASEReadCounter.table","NW_015090842.1:8756361",11,19,8
"ZCCHC14","s954_F_PIT_01_ASEReadCounter.table","NW_015090842.1:8756388",9,19,10
"ZCCHC14","s954_F_PIT_01_ASEReadCounter.table","NW_015090842.1:8756389",9,19,10
"ZCCHC14","s954_F_PIT_01_ASEReadCounter.table","NW_015090842.1:8757160",13,26,13
"ZCCHC14","s954_F_PIT_01_ASEReadCounter.table","NW_015090842.1:8804511",4,10,6
"ZCCHC14","s954_F_PIT_01_ASEReadCounter.table","NW_015090842.1:8804979",5,6,1
"JPH3","s954_F_PIT_01_ASEReadCounter.table","NW_015090842.1:8845375",7,8,1
"JPH3","s954_F_PIT_01_ASEReadCounter.table","NW_015090842.1:8845640",9,18,9
"JPH3","s954_F_PIT_01_ASEReadCounter.table","NW_015090842.1:8845654",9,17,8
"JPH3","s954_F_PIT_01_ASEReadCounter.table","NW_015090842.1:8872283",16,28,12
"JPH3","s954_F_PIT_01_ASEReadCounter.table","NW_015090842.1:8872294",14,26,12
"JPH3","s954_F_PIT_01_ASEReadCounter.table","NW_015090842.1:8872730",11,23,12
"JPH3","s954_F_PIT_01_ASEReadCounter.table","NW_015090842.1:8885260",9,18,9
"JPH3","s954_F_PIT_01_ASEReadCounter.table","NW_015090842.1:8885315",9,24,15
"JPH3","s954_F_PIT_01_ASEReadCounter.table","NW_015090842.1:8885328",9,22,13
"JPH3","s954_F_PIT_01_ASEReadCounter.table","NW_015090842.1:8885438",11,26,15
"JPH3","s954_F_PIT_01_ASEReadCounter.table","NW_015090842.1:8885525",2,8,6
"KLHDC4","s954_F_PIT_01_ASEReadCounter.table","NW_015090842.1:8890729",28,55,27
"KLHDC4","s954_F_PIT_01_ASEReadCounter.table","NW_015090842.1:8890749",33,60,27
"KLHDC4","s954_F_PIT_01_ASEReadCounter.table","NW_015090842.1:8890761",34,59,25
"KLHDC4","s954_F_PIT_01_ASEReadCounter.table","NW_015090842.1:8891123",62,114,52
"KLHDC4","s954_F_PIT_01_ASEReadCounter.table","NW_015090842.1:8893124",63,100,37
"KLHDC4","s954_F_PIT_01_ASEReadCounter.table","NW_015090842.1:8894542",51,76,25
"KLHDC4","s954_F_PIT_01_ASEReadCounter.table","NW_015090842.1:8896726",31,60,29
"KLHDC4","s954_F_PIT_01_ASEReadCounter.table","NW_015090842.1:8896767",37,64,27
"KLHDC4","s954_F_PIT_01_ASEReadCounter.table","NW_015090842.1:8904174",35,57,22
"KLHDC4","s954_F_PIT_01_ASEReadCounter.table","NW_015090842.1:8904231",37,63,26
"KLHDC4","s954_F_PIT_01_ASEReadCounter.table","NW_015090842.1:8905251",37,52,15
"KLHDC4","s954_F_PIT_01_ASEReadCounter.table","NW_015090842.1:8905263",36,51,15
"KLHDC4","s954_F_PIT_01_ASEReadCounter.table","NW_015090842.1:8919626",6,9,3
"SLC7A5","s954_F_PIT_01_ASEReadCounter.table","NW_015090842.1:8938782",129,190,61
"SLC7A5","s954_F_PIT_01_ASEReadCounter.table","NW_015090842.1:8938943",98,155,57
"SLC7A5","s954_F_PIT_01_ASEReadCounter.table","NW_015090842.1:8939611",65,93,28
"SLC7A5","s954_F_PIT_01_ASEReadCounter.table","NW_015090842.1:8939738",104,174,70
"SLC7A5","s954_F_PIT_01_ASEReadCounter.table","NW_015090842.1:8939739",104,173,69
"SLC7A5","s954_F_PIT_01_ASEReadCounter.table","NW_015090842.1:8939740",101,172,71
"SLC7A5","s954_F_PIT_01_ASEReadCounter.table","NW_015090842.1:8939795",112,173,61
"SLC7A5","s954_F_PIT_01_ASEReadCounter.table","NW_015090842.1:8939815",90,159,69
"SLC7A5","s954_F_PIT_01_ASEReadCounter.table","NW_015090842.1:8939816",90,158,68
"SLC7A5","s954_F_PIT_01_ASEReadCounter.table","NW_015090842.1:8939817",89,164,75
"SLC7A5","s954_F_PIT_01_ASEReadCounter.table","NW_015090842.1:8939845",98,169,71
"SLC7A5","s954_F_PIT_01_ASEReadCounter.table","NW_015090842.1:8939894",78,142,64
"SLC7A5","s954_F_PIT_01_ASEReadCounter.table","NW_015090842.1:8939895",78,139,61
"SLC7A5","s954_F_PIT_01_ASEReadCounter.table","NW_015090842.1:8939997",247,247,0
"SLC7A5","s954_F_PIT_01_ASEReadCounter.table","NW_015090842.1:8940172",89,166,77
"SLC7A5","s954_F_PIT_01_ASEReadCounter.table","NW_015090842.1:8940331",51,90,39
"SLC7A5","s954_F_PIT_01_ASEReadCounter.table","NW_015090842.1:8940696",53,69,16
"SLC7A5","s954_F_PIT_01_ASEReadCounter.table","NW_015090842.1:8940719",22,58,36
"SLC7A5","s954_F_PIT_01_ASEReadCounter.table","NW_015090842.1:8940737",26,61,35
"SLC7A5","s954_F_PIT_01_ASEReadCounter.table","NW_015090842.1:8940743",28,66,38
"SLC7A5","s954_F_PIT_01_ASEReadCounter.table","NW_015090842.1:8940766",47,95,48
"SLC7A5","s954_F_PIT_01_ASEReadCounter.table","NW_015090842.1:8940769",50,110,60
"SLC7A5","s954_F_PIT_01_ASEReadCounter.table","NW_015090842.1:8940861",70,134,64
"SLC7A5","s954_F_PIT_01_ASEReadCounter.table","NW_015090842.1:8941068",90,158,68
"SLC7A5","s954_F_PIT_01_ASEReadCounter.table","NW_015090842.1:8941467",60,107,47
"SLC7A5","s954_F_PIT_01_ASEReadCounter.table","NW_015090842.1:8941531",74,121,47
"SLC7A5","s954_F_PIT_01_ASEReadCounter.table","NW_015090842.1:8941588",88,140,52
"SLC7A5","s954_F_PIT_01_ASEReadCounter.table","NW_015090842.1:8941698",54,77,23
"SLC7A5","s954_F_PIT_01_ASEReadCounter.table","NW_015090842.1:8941717",59,88,29
"SLC7A5","s954_F_PIT_01_ASEReadCounter.table","NW_015090842.1:8941745",60,94,34
"SLC7A5","s954_F_PIT_01_ASEReadCounter.table","NW_015090842.1:8941781",67,115,48
"SLC7A5","s954_F_PIT_01_ASEReadCounter.table","NW_015090842.1:8941887",44,87,43
"SLC7A5","s954_F_PIT_01_ASEReadCounter.table","NW_015090842.1:8941968",21,56,35
"SLC7A5","s954_F_PIT_01_ASEReadCounter.table","NW_015090842.1:8942025",31,61,30
"SLC7A5","s954_F_PIT_01_ASEReadCounter.table","NW_015090842.1:8942069",47,85,38
"SLC7A5","s954_F_PIT_01_ASEReadCounter.table","NW_015090842.1:8942170",61,110,49
"SLC7A5","s954_F_PIT_01_ASEReadCounter.table","NW_015090842.1:8942241",87,135,48
"SLC7A5","s954_F_PIT_01_ASEReadCounter.table","NW_015090842.1:8942283",86,129,43
"SLC7A5","s954_F_PIT_01_ASEReadCounter.table","NW_015090842.1:8942717",64,102,38
"SLC7A5","s954_F_PIT_01_ASEReadCounter.table","NW_015090842.1:8942756",79,131,52
"SLC7A5","s954_F_PIT_01_ASEReadCounter.table","NW_015090842.1:8942766",81,137,56
"SLC7A5","s954_F_PIT_01_ASEReadCounter.table","NW_015090842.1:8943271",65,105,40
"SLC7A5","s954_F_PIT_01_ASEReadCounter.table","NW_015090842.1:8943524",66,100,34
"SLC7A5","s954_F_PIT_01_ASEReadCounter.table","NW_015090842.1:8943530",71,106,35
"SLC7A5","s954_F_PIT_01_ASEReadCounter.table","NW_015090842.1:8943602",67,95,28
"SLC7A5","s954_F_PIT_01_ASEReadCounter.table","NW_015090842.1:8943622",63,88,25
"SLC7A5","s954_F_PIT_01_ASEReadCounter.table","NW_015090842.1:8943661",74,104,30
"SLC7A5","s954_F_PIT_01_ASEReadCounter.table","NW_015090842.1:8943686",66,97,31
"SLC7A5","s954_F_PIT_01_ASEReadCounter.table","NW_015090842.1:8943788",44,76,32
"SLC7A5","s954_F_PIT_01_ASEReadCounter.table","NW_015090842.1:8943814",47,77,30
"SLC7A5","s954_F_PIT_01_ASEReadCounter.table","NW_015090842.1:8943876",44,81,37
"SLC7A5","s954_F_PIT_01_ASEReadCounter.table","NW_015090842.1:8943892",47,85,38
"SLC7A5","s954_F_PIT_01_ASEReadCounter.table","NW_015090842.1:8944097",45,92,47
"SLC7A5","s954_F_PIT_01_ASEReadCounter.table","NW_015090842.1:8944104",50,89,39
"SLC7A5","s954_F_PIT_01_ASEReadCounter.table","NW_015090842.1:8944293",32,56,24
"SLC7A5","s954_F_PIT_01_ASEReadCounter.table","NW_015090842.1:8944297",30,54,24
"SLC7A5","s954_F_PIT_01_ASEReadCounter.table","NW_015090842.1:8944397",42,63,21
"SLC7A5","s954_F_PIT_01_ASEReadCounter.table","NW_015090842.1:8944552",43,78,35
"SLC7A5","s954_F_PIT_01_ASEReadCounter.table","NW_015090842.1:8944629",43,75,32
"CA5A","s954_F_PIT_01_ASEReadCounter.table","NW_015090842.1:8989479",22,54,32
"CA5A","s954_F_PIT_01_ASEReadCounter.table","NW_015090842.1:8989562",29,73,44
"CA5A","s954_F_PIT_01_ASEReadCounter.table","NW_015090842.1:8989609",31,74,43
"CA5A","s954_F_PIT_01_ASEReadCounter.table","NW_015090842.1:8989693",58,122,64
"CA5A","s954_F_PIT_01_ASEReadCounter.table","NW_015090842.1:8989702",64,122,58
"CA5A","s954_F_PIT_01_ASEReadCounter.table","NW_015090842.1:8989746",58,129,71
"CA5A","s954_F_PIT_01_ASEReadCounter.table","NW_015090842.1:8989880",45,102,57
"CA5A","s954_F_PIT_01_ASEReadCounter.table","NW_015090842.1:8989885",48,103,55
"CA5A","s954_F_PIT_01_ASEReadCounter.table","NW_015090842.1:8989929",51,121,70
"CA5A","s954_F_PIT_01_ASEReadCounter.table","NW_015090842.1:8990002",49,117,68
"CA5A","s954_F_PIT_01_ASEReadCounter.table","NW_015090842.1:8990004",50,120,70
"CA5A","s954_F_PIT_01_ASEReadCounter.table","NW_015090842.1:8990005",50,121,71
"CA5A","s954_F_PIT_01_ASEReadCounter.table","NW_015090842.1:8990017",46,113,67
"CA5A","s954_F_PIT_01_ASEReadCounter.table","NW_015090842.1:8990043",34,72,38
"CA5A","s954_F_PIT_01_ASEReadCounter.table","NW_015090842.1:8990060",80,80,0
"CA5A","s954_F_PIT_01_ASEReadCounter.table","NW_015090842.1:8990080",21,67,46
"CA5A","s954_F_PIT_01_ASEReadCounter.table","NW_015090842.1:8990084",24,68,44
"CA5A","s954_F_PIT_01_ASEReadCounter.table","NW_015090842.1:8990090",31,78,47
"CA5A","s954_F_PIT_01_ASEReadCounter.table","NW_015090842.1:8990095",35,82,47
"CA5A","s954_F_PIT_01_ASEReadCounter.table","NW_015090842.1:8990111",33,76,43
"CA5A","s954_F_PIT_01_ASEReadCounter.table","NW_015090842.1:8990112",32,74,42
"CA5A","s954_F_PIT_01_ASEReadCounter.table","NW_015090842.1:8990115",38,78,40
"CA5A","s954_F_PIT_01_ASEReadCounter.table","NW_015090842.1:8990166",42,83,41
"CA5A","s954_F_PIT_01_ASEReadCounter.table","NW_015090842.1:8990169",50,91,41
"CA5A","s954_F_PIT_01_ASEReadCounter.table","NW_015090842.1:8990193",89,89,0
"CA5A","s954_F_PIT_01_ASEReadCounter.table","NW_015090842.1:8990222",36,80,44
"CA5A","s954_F_PIT_01_ASEReadCounter.table","NW_015090842.1:8990289",51,89,38
"CA5A","s954_F_PIT_01_ASEReadCounter.table","NW_015090842.1:8990314",57,97,40
"CA5A","s954_F_PIT_01_ASEReadCounter.table","NW_015090842.1:8990361",54,96,42
"CA5A","s954_F_PIT_01_ASEReadCounter.table","NW_015090842.1:8990368",52,95,43
"CA5A","s954_F_PIT_01_ASEReadCounter.table","NW_015090842.1:8990429",36,80,44
"CA5A","s954_F_PIT_01_ASEReadCounter.table","NW_015090842.1:8990466",28,66,38
"CA5A","s954_F_PIT_01_ASEReadCounter.table","NW_015090842.1:8990663",33,73,40
"CA5A","s954_F_PIT_01_ASEReadCounter.table","NW_015090842.1:8990797",29,72,43
"CA5A","s954_F_PIT_01_ASEReadCounter.table","NW_015090842.1:8990836",31,67,36
"CA5A","s954_F_PIT_01_ASEReadCounter.table","NW_015090842.1:8990842",34,70,36
"CA5A","s954_F_PIT_01_ASEReadCounter.table","NW_015090842.1:8990851",35,67,32
"CA5A","s954_F_PIT_01_ASEReadCounter.table","NW_015090842.1:8990918",38,68,30
"CA5A","s954_F_PIT_01_ASEReadCounter.table","NW_015090842.1:8990921",31,61,30
"CA5A","s954_F_PIT_01_ASEReadCounter.table","NW_015090842.1:8990942",31,63,32
"CA5A","s954_F_PIT_01_ASEReadCounter.table","NW_015090842.1:8991001",33,79,46
"CA5A","s954_F_PIT_01_ASEReadCounter.table","NW_015090842.1:8991038",37,83,46
"CA5A","s954_F_PIT_01_ASEReadCounter.table","NW_015090842.1:8991149",43,83,40
"CA5A","s954_F_PIT_01_ASEReadCounter.table","NW_015090842.1:8991176",45,87,42
"CA5A","s954_F_PIT_01_ASEReadCounter.table","NW_015090842.1:8991241",45,94,49
"CA5A","s954_F_PIT_01_ASEReadCounter.table","NW_015090842.1:8991262",40,85,45
"CA5A","s954_F_PIT_01_ASEReadCounter.table","NW_015090842.1:8991316",38,41,3
"CA5A","s954_F_PIT_01_ASEReadCounter.table","NW_015090842.1:8991319",38,42,4
"CA5A","s954_F_PIT_01_ASEReadCounter.table","NW_015090842.1:8991330",39,39,0
"CA5A","s954_F_PIT_01_ASEReadCounter.table","NW_015090842.1:8991334",39,41,2
"CA5A","s954_F_PIT_01_ASEReadCounter.table","NW_015090842.1:8991362",47,79,32
"CA5A","s954_F_PIT_01_ASEReadCounter.table","NW_015090842.1:8991368",42,76,34
"CA5A","s954_F_PIT_01_ASEReadCounter.table","NW_015090842.1:8991390",43,81,38
"CA5A","s954_F_PIT_01_ASEReadCounter.table","NW_015090842.1:8991395",46,86,40
"CA5A","s954_F_PIT_01_ASEReadCounter.table","NW_015090842.1:8991422",41,85,44
"CA5A","s954_F_PIT_01_ASEReadCounter.table","NW_015090842.1:8991467",38,66,28
"CA5A","s954_F_PIT_01_ASEReadCounter.table","NW_015090842.1:8991576",29,64,35
"CA5A","s954_F_PIT_01_ASEReadCounter.table","NW_015090842.1:8991587",32,71,39
"CA5A","s954_F_PIT_01_ASEReadCounter.table","NW_015090842.1:8991655",38,75,37
"CA5A","s954_F_PIT_01_ASEReadCounter.table","NW_015090842.1:8991717",36,69,33
"CA5A","s954_F_PIT_01_ASEReadCounter.table","NW_015090842.1:8991726",35,68,33
"CA5A","s954_F_PIT_01_ASEReadCounter.table","NW_015090842.1:8991799",40,85,45
"CA5A","s954_F_PIT_01_ASEReadCounter.table","NW_015090842.1:8991809",38,84,46
"CA5A","s954_F_PIT_01_ASEReadCounter.table","NW_015090842.1:8991848",21,65,44
"CA5A","s954_F_PIT_01_ASEReadCounter.table","NW_015090842.1:8991849",22,69,47
"CA5A","s954_F_PIT_01_ASEReadCounter.table","NW_015090842.1:8991927",21,63,42
"CA5A","s954_F_PIT_01_ASEReadCounter.table","NW_015090842.1:8991941",21,56,35
"CA5A","s954_F_PIT_01_ASEReadCounter.table","NW_015090842.1:8992121",19,43,24
"CA5A","s954_F_PIT_01_ASEReadCounter.table","NW_015090842.1:8992224",30,67,37
"CA5A","s954_F_PIT_01_ASEReadCounter.table","NW_015090842.1:9002570",16,54,38
"CA5A","s954_F_PIT_01_ASEReadCounter.table","NW_015090842.1:9002600",13,51,38
"CA5A","s954_F_PIT_01_ASEReadCounter.table","NW_015090842.1:9004312",11,39,28
"CA5A","s954_F_PIT_01_ASEReadCounter.table","NW_015090842.1:9004506",1,2,1
"CA5A","s954_F_PIT_01_ASEReadCounter.table","NW_015090842.1:9004523",2,3,1
"CA5A","s954_F_PIT_01_ASEReadCounter.table","NW_015090842.1:9004530",3,4,1
"CA5A","s954_F_PIT_01_ASEReadCounter.table","NW_015090842.1:9004556",4,6,2
"CA5A","s954_F_PIT_01_ASEReadCounter.table","NW_015090842.1:9005116",1,1,0
"CA5A","s954_F_PIT_01_ASEReadCounter.table","NW_015090842.1:9005120",1,1,0
"CA5A","s954_F_PIT_01_ASEReadCounter.table","NW_015090842.1:9005140",0,1,1
"CA5A","s954_F_PIT_01_ASEReadCounter.table","NW_015090842.1:9005152",0,1,1
"CA5A","s954_F_PIT_01_ASEReadCounter.table","NW_015090842.1:9011189",1,1,0
"CA5A","s954_F_PIT_01_ASEReadCounter.table","NW_015090842.1:9011194",1,1,0
"BANP","s954_F_PIT_01_ASEReadCounter.table","NW_015090842.1:9033407",7,19,12
"BANP","s954_F_PIT_01_ASEReadCounter.table","NW_015090842.1:9033409",7,19,12
"BANP","s954_F_PIT_01_ASEReadCounter.table","NW_015090842.1:9033420",7,21,14
"BANP","s954_F_PIT_01_ASEReadCounter.table","NW_015090842.1:9067974",0,23,23
"BANP","s954_F_PIT_01_ASEReadCounter.table","NW_015090842.1:9102510",23,41,18
"BANP","s954_F_PIT_01_ASEReadCounter.table","NW_015090842.1:9168534",20,42,22
"BANP","s954_F_PIT_01_ASEReadCounter.table","NW_015090842.1:9168818",19,38,19
"ZNF469","s954_F_PIT_01_ASEReadCounter.table","NW_015090842.1:9425089",0,1,1
"ZNF469","s954_F_PIT_01_ASEReadCounter.table","NW_015090842.1:9425108",1,2,1
"ZNF469","s954_F_PIT_01_ASEReadCounter.table","NW_015090842.1:9425182",1,1,0
"ZNF469","s954_F_PIT_01_ASEReadCounter.table","NW_015090842.1:9426367",1,1,0
"ZNF469","s954_F_PIT_01_ASEReadCounter.table","NW_015090842.1:9427614",2,2,0
"ZNF469","s954_F_PIT_01_ASEReadCounter.table","NW_015090842.1:9428122",1,1,0
"ZNF469","s954_F_PIT_01_ASEReadCounter.table","NW_015090842.1:9428178",1,2,1
"ZNF469","s954_F_PIT_01_ASEReadCounter.table","NW_015090842.1:9428419",0,2,2
"ZNF469","s954_F_PIT_01_ASEReadCounter.table","NW_015090842.1:9429633",1,1,0
"ZNF469","s954_F_PIT_01_ASEReadCounter.table","NW_015090842.1:9429794",1,1,0
"ZNF469","s954_F_PIT_01_ASEReadCounter.table","NW_015090842.1:9430560",1,1,0
"ZNF469","s954_F_PIT_01_ASEReadCounter.table","NW_015090842.1:9430668",0,2,2
"ZNF469","s954_F_PIT_01_ASEReadCounter.table","NW_015090842.1:9430700",1,2,1
"ZNF469","s954_F_PIT_01_ASEReadCounter.table","NW_015090842.1:9431031",2,5,3
"ZNF469","s954_F_PIT_01_ASEReadCounter.table","NW_015090842.1:9431073",1,3,2
"ZNF469","s954_F_PIT_01_ASEReadCounter.table","NW_015090842.1:9431091",0,2,2
"ZNF469","s954_F_PIT_01_ASEReadCounter.table","NW_015090842.1:9431150",1,2,1
"ZNF469","s954_F_PIT_01_ASEReadCounter.table","NW_015090842.1:9431162",1,3,2
"ZNF469","s954_F_PIT_01_ASEReadCounter.table","NW_015090842.1:9431214",1,3,2
"ZNF469","s954_F_PIT_01_ASEReadCounter.table","NW_015090842.1:9432110",0,1,1
"ZNF469","s954_F_PIT_01_ASEReadCounter.table","NW_015090842.1:9432361",0,1,1
"ZNF469","s954_F_PIT_01_ASEReadCounter.table","NW_015090842.1:9432374",0,1,1
"ZNF469","s954_F_PIT_01_ASEReadCounter.table","NW_015090842.1:9432382",0,1,1
"ZNF469","s954_F_PIT_01_ASEReadCounter.table","NW_015090842.1:9432498",0,1,1
"ZNF469","s954_F_PIT_01_ASEReadCounter.table","NW_015090842.1:9433678",5,5,0
"ZNF469","s954_F_PIT_01_ASEReadCounter.table","NW_015090842.1:9433902",1,2,1
"ZNF469","s954_F_PIT_01_ASEReadCounter.table","NW_015090842.1:9433980",2,3,1
"ZNF469","s954_F_PIT_01_ASEReadCounter.table","NW_015090842.1:9434259",0,1,1
"ZNF469","s954_F_PIT_01_ASEReadCounter.table","NW_015090842.1:9435221",6,6,0
"ZFPM1","s954_F_PIT_01_ASEReadCounter.table","NW_015090842.1:9458862",4,7,3
"ZFPM1","s954_F_PIT_01_ASEReadCounter.table","NW_015090842.1:9458888",8,12,4
"ZFPM1","s954_F_PIT_01_ASEReadCounter.table","NW_015090842.1:9458904",14,20,6
"ZFPM1","s954_F_PIT_01_ASEReadCounter.table","NW_015090842.1:9458916",14,21,7
"ZFPM1","s954_F_PIT_01_ASEReadCounter.table","NW_015090842.1:9468568",14,23,9
"ZFPM1","s954_F_PIT_01_ASEReadCounter.table","NW_015090842.1:9468593",12,23,11
"ZFPM1","s954_F_PIT_01_ASEReadCounter.table","NW_015090842.1:9471561",10,17,7
"ZFPM1","s954_F_PIT_01_ASEReadCounter.table","NW_015090842.1:9472557",13,18,5
"ZFPM1","s954_F_PIT_01_ASEReadCounter.table","NW_015090842.1:9472565",12,18,6
"ZFPM1","s954_F_PIT_01_ASEReadCounter.table","NW_015090842.1:9472608",10,17,7
"ZFPM1","s954_F_PIT_01_ASEReadCounter.table","NW_015090842.1:9472627",7,17,10
"ZFPM1","s954_F_PIT_01_ASEReadCounter.table","NW_015090842.1:9472668",6,18,12
"ZFPM1","s954_F_PIT_01_ASEReadCounter.table","NW_015090842.1:9473655",8,20,12
"ZFPM1","s954_F_PIT_01_ASEReadCounter.table","NW_015090842.1:9475827",9,19,10
"ZFPM1","s954_F_PIT_01_ASEReadCounter.table","NW_015090842.1:9475842",8,21,13
"ZFPM1","s954_F_PIT_01_ASEReadCounter.table","NW_015090842.1:9476119",5,13,8
"ZFPM1","s954_F_PIT_01_ASEReadCounter.table","NW_015090842.1:9476161",5,13,8
"ZFPM1","s954_F_PIT_01_ASEReadCounter.table","NW_015090842.1:9476219",6,16,10
"ZFPM1","s954_F_PIT_01_ASEReadCounter.table","NW_015090842.1:9476233",5,17,12
"ZFPM1","s954_F_PIT_01_ASEReadCounter.table","NW_015090842.1:9476305",7,19,12
"ZFPM1","s954_F_PIT_01_ASEReadCounter.table","NW_015090842.1:9476395",8,19,11
"ZFPM1","s954_F_PIT_01_ASEReadCounter.table","NW_015090842.1:9476421",9,21,12
"ZFPM1","s954_F_PIT_01_ASEReadCounter.table","NW_015090842.1:9476539",12,20,8
"ZFPM1","s954_F_PIT_01_ASEReadCounter.table","NW_015090842.1:9476576",11,16,5
"ZFPM1","s954_F_PIT_01_ASEReadCounter.table","NW_015090842.1:9476599",18,18,0
"ZFPM1","s954_F_PIT_01_ASEReadCounter.table","NW_015090842.1:9476792",16,37,21
"ZFPM1","s954_F_PIT_01_ASEReadCounter.table","NW_015090842.1:9476803",14,33,19
"ZFPM1","s954_F_PIT_01_ASEReadCounter.table","NW_015090842.1:9477115",7,19,12
"ZFPM1","s954_F_PIT_01_ASEReadCounter.table","NW_015090842.1:9477299",3,13,10
"ZFPM1","s954_F_PIT_01_ASEReadCounter.table","NW_015090842.1:9477398",22,22,0
"ZFPM1","s954_F_PIT_01_ASEReadCounter.table","NW_015090842.1:9477422",11,25,14
"ZFPM1","s954_F_PIT_01_ASEReadCounter.table","NW_015090842.1:9477554",6,23,17
"ZFPM1","s954_F_PIT_01_ASEReadCounter.table","NW_015090842.1:9477575",18,18,0
"ZFPM1","s954_F_PIT_01_ASEReadCounter.table","NW_015090842.1:9477595",7,25,18
"ZFPM1","s954_F_PIT_01_ASEReadCounter.table","NW_015090842.1:9477611",6,22,16
"ZFPM1","s954_F_PIT_01_ASEReadCounter.table","NW_015090842.1:9477659",8,25,17
"ZFPM1","s954_F_PIT_01_ASEReadCounter.table","NW_015090842.1:9477737",7,29,22
"ZFPM1","s954_F_PIT_01_ASEReadCounter.table","NW_015090842.1:9477791",4,18,14
"ZFPM1","s954_F_PIT_01_ASEReadCounter.table","NW_015090842.1:9477844",8,16,8
"ZFPM1","s954_F_PIT_01_ASEReadCounter.table","NW_015090842.1:9477917",4,19,15
"ZFPM1","s954_F_PIT_01_ASEReadCounter.table","NW_015090842.1:9478295",19,34,15
"ZFPM1","s954_F_PIT_01_ASEReadCounter.table","NW_015090842.1:9478349",16,30,14
"ZFPM1","s954_F_PIT_01_ASEReadCounter.table","NW_015090842.1:9478524",8,19,11
"ZFPM1","s954_F_PIT_01_ASEReadCounter.table","NW_015090842.1:9478546",10,28,18
"ZFPM1","s954_F_PIT_01_ASEReadCounter.table","NW_015090842.1:9478573",9,27,18
"ZFPM1","s954_F_PIT_01_ASEReadCounter.table","NW_015090842.1:9478582",8,26,18
"ZFPM1","s954_F_PIT_01_ASEReadCounter.table","NW_015090842.1:9478684",5,12,7
"ZFPM1","s954_F_PIT_01_ASEReadCounter.table","NW_015090842.1:9478711",5,11,6
"ZFPM1","s954_F_PIT_01_ASEReadCounter.table","NW_015090842.1:9478761",3,11,8
"ZFPM1","s954_F_PIT_01_ASEReadCounter.table","NW_015090842.1:9478829",4,4,0
"CIDEC","s954_F_PIT_01_ASEReadCounter.table","NW_015090842.1:9480252",1,1,0
"CIDEC","s954_F_PIT_01_ASEReadCounter.table","NW_015090842.1:9480391",1,1,0
"CIDEC","s954_F_PIT_01_ASEReadCounter.table","NW_015090842.1:9480394",1,1,0
"CIDEC","s954_F_PIT_01_ASEReadCounter.table","NW_015090842.1:9480675",1,1,0
"CIDEC","s954_F_PIT_01_ASEReadCounter.table","NW_015090842.1:9480686",1,1,0
"CIDEC","s954_F_PIT_01_ASEReadCounter.table","NW_015090842.1:9480693",1,1,0
"CIDEC","s954_F_PIT_01_ASEReadCounter.table","NW_015090842.1:9480756",2,2,0
"CIDEC","s954_F_PIT_01_ASEReadCounter.table","NW_015090842.1:9481199",2,2,0
"CIDEC","s954_F_PIT_01_ASEReadCounter.table","NW_015090842.1:9481604",1,1,0
"ZC3H18","s954_F_PIT_01_ASEReadCounter.table","NW_015090842.1:9494271",5,15,10
"ZC3H18","s954_F_PIT_01_ASEReadCounter.table","NW_015090842.1:9501427",26,48,22
"ZC3H18","s954_F_PIT_01_ASEReadCounter.table","NW_015090842.1:9501442",21,42,21
"ZC3H18","s954_F_PIT_01_ASEReadCounter.table","NW_015090842.1:9505538",10,29,19
"ZC3H18","s954_F_PIT_01_ASEReadCounter.table","NW_015090842.1:9506778",27,49,22
"ZC3H18","s954_F_PIT_01_ASEReadCounter.table","NW_015090842.1:9522538",12,39,27
"ZC3H18","s954_F_PIT_01_ASEReadCounter.table","NW_015090842.1:9524350",24,51,27
"ZC3H18","s954_F_PIT_01_ASEReadCounter.table","NW_015090842.1:9524366",24,47,23
"ZC3H18","s954_F_PIT_01_ASEReadCounter.table","NW_015090842.1:9524424",21,49,28
"ZC3H18","s954_F_PIT_01_ASEReadCounter.table","NW_015090842.1:9529649",23,51,28
"ZC3H18","s954_F_PIT_01_ASEReadCounter.table","NW_015090842.1:9529688",21,47,26
"ZC3H18","s954_F_PIT_01_ASEReadCounter.table","NW_015090842.1:9529691",21,46,25
"ZC3H18","s954_F_PIT_01_ASEReadCounter.table","NW_015090842.1:9530977",27,60,33
"ZC3H18","s954_F_PIT_01_ASEReadCounter.table","NW_015090842.1:9536699",0,16,16
"CYBA","s954_F_PIT_01_ASEReadCounter.table","NW_015090842.1:9547281",65,87,22
"CYBA","s954_F_PIT_01_ASEReadCounter.table","NW_015090842.1:9547402",185,236,51
"CYBA","s954_F_PIT_01_ASEReadCounter.table","NW_015090842.1:9547553",106,166,60
"CYBA","s954_F_PIT_01_ASEReadCounter.table","NW_015090842.1:9548052",111,146,35
"CYBA","s954_F_PIT_01_ASEReadCounter.table","NW_015090842.1:9548436",173,220,47
"CYBA","s954_F_PIT_01_ASEReadCounter.table","NW_015090842.1:9548442",179,223,44
"CYBA","s954_F_PIT_01_ASEReadCounter.table","NW_015090842.1:9548478",213,271,58
"CYBA","s954_F_PIT_01_ASEReadCounter.table","NW_015090842.1:9548487",203,256,53
"CYBA","s954_F_PIT_01_ASEReadCounter.table","NW_015090842.1:9548490",205,260,55
"CYBA","s954_F_PIT_01_ASEReadCounter.table","NW_015090842.1:9548717",189,236,47
"CYBA","s954_F_PIT_01_ASEReadCounter.table","NW_015090842.1:9548750",121,163,42
"CYBA","s954_F_PIT_01_ASEReadCounter.table","NW_015090842.1:9548766",95,124,29
"MVD","s954_F_PIT_01_ASEReadCounter.table","NW_015090842.1:9550678",10,19,9
"MVD","s954_F_PIT_01_ASEReadCounter.table","NW_015090842.1:9550690",9,18,9
"MVD","s954_F_PIT_01_ASEReadCounter.table","NW_015090842.1:9550691",9,19,10
"MVD","s954_F_PIT_01_ASEReadCounter.table","NW_015090842.1:9550699",11,24,13
"MVD","s954_F_PIT_01_ASEReadCounter.table","NW_015090842.1:9550719",12,25,13
"MVD","s954_F_PIT_01_ASEReadCounter.table","NW_015090842.1:9551596",33,67,34
"MVD","s954_F_PIT_01_ASEReadCounter.table","NW_015090842.1:9551638",31,72,41
"MVD","s954_F_PIT_01_ASEReadCounter.table","NW_015090842.1:9551899",0,5,5
"MVD","s954_F_PIT_01_ASEReadCounter.table","NW_015090842.1:9552193",34,59,25
"MVD","s954_F_PIT_01_ASEReadCounter.table","NW_015090842.1:9552202",32,57,25
"MVD","s954_F_PIT_01_ASEReadCounter.table","NW_015090842.1:9552208",30,54,24
"MVD","s954_F_PIT_01_ASEReadCounter.table","NW_015090842.1:9552625",22,42,20
"MVD","s954_F_PIT_01_ASEReadCounter.table","NW_015090842.1:9552629",41,41,0
"MVD","s954_F_PIT_01_ASEReadCounter.table","NW_015090842.1:9552644",24,44,20
"MVD","s954_F_PIT_01_ASEReadCounter.table","NW_015090842.1:9553093",21,44,23
"MVD","s954_F_PIT_01_ASEReadCounter.table","NW_015090842.1:9553114",22,47,25
"RNF166","s954_F_PIT_01_ASEReadCounter.table","NW_015090842.1:9557900",40,80,40
"RNF166","s954_F_PIT_01_ASEReadCounter.table","NW_015090842.1:9558048",28,73,45
"RNF166","s954_F_PIT_01_ASEReadCounter.table","NW_015090842.1:9558116",33,85,52
"RNF166","s954_F_PIT_01_ASEReadCounter.table","NW_015090842.1:9558308",38,73,35
"RNF166","s954_F_PIT_01_ASEReadCounter.table","NW_015090842.1:9558405",25,56,31
"RNF166","s954_F_PIT_01_ASEReadCounter.table","NW_015090842.1:9558549",39,85,46
"RNF166","s954_F_PIT_01_ASEReadCounter.table","NW_015090842.1:9558556",39,84,45
"RNF166","s954_F_PIT_01_ASEReadCounter.table","NW_015090842.1:9558579",36,79,43
"RNF166","s954_F_PIT_01_ASEReadCounter.table","NW_015090842.1:9558599",34,73,39
"RNF166","s954_F_PIT_01_ASEReadCounter.table","NW_015090842.1:9558688",38,76,38
"RNF166","s954_F_PIT_01_ASEReadCounter.table","NW_015090842.1:9558711",36,73,37
"RNF166","s954_F_PIT_01_ASEReadCounter.table","NW_015090842.1:9558733",37,76,39
"RNF166","s954_F_PIT_01_ASEReadCounter.table","NW_015090842.1:9558847",24,57,33
"RNF166","s954_F_PIT_01_ASEReadCounter.table","NW_015090842.1:9559798",37,79,42
"RNF166","s954_F_PIT_01_ASEReadCounter.table","NW_015090842.1:9560575",54,98,44
"RNF166","s954_F_PIT_01_ASEReadCounter.table","NW_015090842.1:9561055",48,94,46
"RNF166","s954_F_PIT_01_ASEReadCounter.table","NW_015090842.1:9562458",44,88,44
"RNF166","s954_F_PIT_01_ASEReadCounter.table","NW_015090842.1:9562497",28,61,33
"RNF166","s954_F_PIT_01_ASEReadCounter.table","NW_015090842.1:9562539",17,51,34
"RNF166","s954_F_PIT_01_ASEReadCounter.table","NW_015090842.1:9564056",22,51,29
"CTU2","s954_F_PIT_01_ASEReadCounter.table","NW_015090842.1:9565149",28,41,13
"CTU2","s954_F_PIT_01_ASEReadCounter.table","NW_015090842.1:9565193",27,44,17
"CTU2","s954_F_PIT_01_ASEReadCounter.table","NW_015090842.1:9565300",33,56,23
"CTU2","s954_F_PIT_01_ASEReadCounter.table","NW_015090842.1:9565321",35,55,20
"CTU2","s954_F_PIT_01_ASEReadCounter.table","NW_015090842.1:9565721",29,55,26
"CTU2","s954_F_PIT_01_ASEReadCounter.table","NW_015090842.1:9565739",29,53,24
"CTU2","s954_F_PIT_01_ASEReadCounter.table","NW_015090842.1:9565905",30,47,17
"CTU2","s954_F_PIT_01_ASEReadCounter.table","NW_015090842.1:9566013",37,37,0
"CTU2","s954_F_PIT_01_ASEReadCounter.table","NW_015090842.1:9566055",27,51,24
"CTU2","s954_F_PIT_01_ASEReadCounter.table","NW_015090842.1:9566056",28,51,23
"CTU2","s954_F_PIT_01_ASEReadCounter.table","NW_015090842.1:9566151",22,38,16
"CTU2","s954_F_PIT_01_ASEReadCounter.table","NW_015090842.1:9566300",25,45,20
"CTU2","s954_F_PIT_01_ASEReadCounter.table","NW_015090842.1:9566342",20,46,26
"CTU2","s954_F_PIT_01_ASEReadCounter.table","NW_015090842.1:9566548",32,62,30
"CTU2","s954_F_PIT_01_ASEReadCounter.table","NW_015090842.1:9566625",34,66,32
"CTU2","s954_F_PIT_01_ASEReadCounter.table","NW_015090842.1:9566633",40,73,33
"CTU2","s954_F_PIT_01_ASEReadCounter.table","NW_015090842.1:9566807",35,68,33
"CTU2","s954_F_PIT_01_ASEReadCounter.table","NW_015090842.1:9567139",25,54,29
"CTU2","s954_F_PIT_01_ASEReadCounter.table","NW_015090842.1:9567156",26,55,29
"CTU2","s954_F_PIT_01_ASEReadCounter.table","NW_015090842.1:9567614",25,54,29
"CTU2","s954_F_PIT_01_ASEReadCounter.table","NW_015090842.1:9567677",21,45,24
"CTU2","s954_F_PIT_01_ASEReadCounter.table","NW_015090842.1:9567747",29,46,17
"CTU2","s954_F_PIT_01_ASEReadCounter.table","NW_015090842.1:9567828",17,32,15
"CTU2","s954_F_PIT_01_ASEReadCounter.table","NW_015090842.1:9567829",17,34,17
"CTU2","s954_F_PIT_01_ASEReadCounter.table","NW_015090842.1:9567885",7,20,13
"PIEZO1","s954_F_PIT_01_ASEReadCounter.table","NW_015090842.1:9568093",9,23,14
"PIEZO1","s954_F_PIT_01_ASEReadCounter.table","NW_015090842.1:9568672",16,37,21
"PIEZO1","s954_F_PIT_01_ASEReadCounter.table","NW_015090842.1:9568948",15,36,21
"PIEZO1","s954_F_PIT_01_ASEReadCounter.table","NW_015090842.1:9568987",29,29,0
"PIEZO1","s954_F_PIT_01_ASEReadCounter.table","NW_015090842.1:9569040",13,27,14
"PIEZO1","s954_F_PIT_01_ASEReadCounter.table","NW_015090842.1:9569180",15,31,16
"PIEZO1","s954_F_PIT_01_ASEReadCounter.table","NW_015090842.1:9569192",13,28,15
"PIEZO1","s954_F_PIT_01_ASEReadCounter.table","NW_015090842.1:9570088",10,27,17
"PIEZO1","s954_F_PIT_01_ASEReadCounter.table","NW_015090842.1:9570480",10,16,6
"PIEZO1","s954_F_PIT_01_ASEReadCounter.table","NW_015090842.1:9570639",7,19,12
"PIEZO1","s954_F_PIT_01_ASEReadCounter.table","NW_015090842.1:9571847",11,20,9
"PIEZO1","s954_F_PIT_01_ASEReadCounter.table","NW_015090842.1:9572371",11,21,10
"PIEZO1","s954_F_PIT_01_ASEReadCounter.table","NW_015090842.1:9572638",3,8,5
"PIEZO1","s954_F_PIT_01_ASEReadCounter.table","NW_015090842.1:9573156",14,31,17
"PIEZO1","s954_F_PIT_01_ASEReadCounter.table","NW_015090842.1:9573280",12,26,14
"PIEZO1","s954_F_PIT_01_ASEReadCounter.table","NW_015090842.1:9573566",9,21,12
"PIEZO1","s954_F_PIT_01_ASEReadCounter.table","NW_015090842.1:9575341",4,12,8
"PIEZO1","s954_F_PIT_01_ASEReadCounter.table","NW_015090842.1:9575367",5,12,7
"PIEZO1","s954_F_PIT_01_ASEReadCounter.table","NW_015090842.1:9575645",5,13,8
"PIEZO1","s954_F_PIT_01_ASEReadCounter.table","NW_015090842.1:9575696",6,18,12
"PIEZO1","s954_F_PIT_01_ASEReadCounter.table","NW_015090842.1:9575897",4,9,5
"PIEZO1","s954_F_PIT_01_ASEReadCounter.table","NW_015090842.1:9576060",4,9,5
"PIEZO1","s954_F_PIT_01_ASEReadCounter.table","NW_015090842.1:9576087",4,9,5
"PIEZO1","s954_F_PIT_01_ASEReadCounter.table","NW_015090842.1:9576093",6,12,6
"PIEZO1","s954_F_PIT_01_ASEReadCounter.table","NW_015090842.1:9576120",8,16,8
"PIEZO1","s954_F_PIT_01_ASEReadCounter.table","NW_015090842.1:9576687",6,14,8
"PIEZO1","s954_F_PIT_01_ASEReadCounter.table","NW_015090842.1:9576710",15,15,0
"PIEZO1","s954_F_PIT_01_ASEReadCounter.table","NW_015090842.1:9576723",7,14,7
"PIEZO1","s954_F_PIT_01_ASEReadCounter.table","NW_015090842.1:9578268",8,18,10
"PIEZO1","s954_F_PIT_01_ASEReadCounter.table","NW_015090842.1:9578770",7,14,7
"PIEZO1","s954_F_PIT_01_ASEReadCounter.table","NW_015090842.1:9578806",7,17,10
"PIEZO1","s954_F_PIT_01_ASEReadCounter.table","NW_015090842.1:9579064",8,11,3
"PIEZO1","s954_F_PIT_01_ASEReadCounter.table","NW_015090842.1:9579065",9,14,5
"PIEZO1","s954_F_PIT_01_ASEReadCounter.table","NW_015090842.1:9579347",5,10,5
"PIEZO1","s954_F_PIT_01_ASEReadCounter.table","NW_015090842.1:9580765",6,11,5
"PIEZO1","s954_F_PIT_01_ASEReadCounter.table","NW_015090842.1:9580996",9,14,5
"PIEZO1","s954_F_PIT_01_ASEReadCounter.table","NW_015090842.1:9581101",5,8,3
"PIEZO1","s954_F_PIT_01_ASEReadCounter.table","NW_015090842.1:9581299",1,5,4
"PIEZO1","s954_F_PIT_01_ASEReadCounter.table","NW_015090842.1:9581875",2,10,8
"PIEZO1","s954_F_PIT_01_ASEReadCounter.table","NW_015090842.1:9582046",4,10,6
"PIEZO1","s954_F_PIT_01_ASEReadCounter.table","NW_015090842.1:9582961",2,4,2
"PIEZO1","s954_F_PIT_01_ASEReadCounter.table","NW_015090842.1:9583298",3,6,3
"PIEZO1","s954_F_PIT_01_ASEReadCounter.table","NW_015090842.1:9584337",4,6,2
"PIEZO1","s954_F_PIT_01_ASEReadCounter.table","NW_015090842.1:9584425",4,6,2
"PIEZO1","s954_F_PIT_01_ASEReadCounter.table","NW_015090842.1:9584435",5,8,3
"PIEZO1","s954_F_PIT_01_ASEReadCounter.table","NW_015090842.1:9584438",4,7,3
"PIEZO1","s954_F_PIT_01_ASEReadCounter.table","NW_015090842.1:9584441",5,7,2
"CDT1","s954_F_PIT_01_ASEReadCounter.table","NW_015090842.1:9596596",3,3,0
"CDT1","s954_F_PIT_01_ASEReadCounter.table","NW_015090842.1:9596766",3,6,3
"CDT1","s954_F_PIT_01_ASEReadCounter.table","NW_015090842.1:9597054",7,13,6
"CDT1","s954_F_PIT_01_ASEReadCounter.table","NW_015090842.1:9597074",6,12,6
"CDT1","s954_F_PIT_01_ASEReadCounter.table","NW_015090842.1:9597137",10,16,6
"CDT1","s954_F_PIT_01_ASEReadCounter.table","NW_015090842.1:9597756",7,21,14
"CDT1","s954_F_PIT_01_ASEReadCounter.table","NW_015090842.1:9597766",8,22,14
"CDT1","s954_F_PIT_01_ASEReadCounter.table","NW_015090842.1:9598496",11,21,10
"CDT1","s954_F_PIT_01_ASEReadCounter.table","NW_015090842.1:9598498",11,22,11
"CDT1","s954_F_PIT_01_ASEReadCounter.table","NW_015090842.1:9598816",7,13,6
"CDT1","s954_F_PIT_01_ASEReadCounter.table","NW_015090842.1:9598879",7,16,9
"CDT1","s954_F_PIT_01_ASEReadCounter.table","NW_015090842.1:9598912",11,20,9
"CDT1","s954_F_PIT_01_ASEReadCounter.table","NW_015090842.1:9598959",15,21,6
"CDT1","s954_F_PIT_01_ASEReadCounter.table","NW_015090842.1:9599807",12,14,2
"CDT1","s954_F_PIT_01_ASEReadCounter.table","NW_015090842.1:9599819",11,14,3
"CDT1","s954_F_PIT_01_ASEReadCounter.table","NW_015090842.1:9599845",14,18,4
"CDT1","s954_F_PIT_01_ASEReadCounter.table","NW_015090842.1:9600148",16,27,11
"CDT1","s954_F_PIT_01_ASEReadCounter.table","NW_015090842.1:9600151",17,29,12
"CDT1","s954_F_PIT_01_ASEReadCounter.table","NW_015090842.1:9600217",15,32,17
"CDT1","s954_F_PIT_01_ASEReadCounter.table","NW_015090842.1:9600226",11,28,17
"CDT1","s954_F_PIT_01_ASEReadCounter.table","NW_015090842.1:9600260",11,24,13
"CDT1","s954_F_PIT_01_ASEReadCounter.table","NW_015090842.1:9600268",10,23,13
"CDT1","s954_F_PIT_01_ASEReadCounter.table","NW_015090842.1:9600305",10,22,12
"CDT1","s954_F_PIT_01_ASEReadCounter.table","NW_015090842.1:9600397",9,12,3
"CDT1","s954_F_PIT_01_ASEReadCounter.table","NW_015090842.1:9600447",4,10,6
"CDT1","s954_F_PIT_01_ASEReadCounter.table","NW_015090842.1:9600450",3,9,6
"CDT1","s954_F_PIT_01_ASEReadCounter.table","NW_015090842.1:9600485",7,15,8
"CDT1","s954_F_PIT_01_ASEReadCounter.table","NW_015090842.1:9600579",8,12,4
"APRT","s954_F_PIT_01_ASEReadCounter.table","NW_015090842.1:9602308",13,51,38
"APRT","s954_F_PIT_01_ASEReadCounter.table","NW_015090842.1:9602440",36,115,79
"APRT","s954_F_PIT_01_ASEReadCounter.table","NW_015090842.1:9602449",37,117,80
"APRT","s954_F_PIT_01_ASEReadCounter.table","NW_015090842.1:9602451",39,122,83
"APRT","s954_F_PIT_01_ASEReadCounter.table","NW_015090842.1:9602455",38,121,83
"APRT","s954_F_PIT_01_ASEReadCounter.table","NW_015090842.1:9602462",37,117,80
"APRT","s954_F_PIT_01_ASEReadCounter.table","NW_015090842.1:9602507",36,106,70
"APRT","s954_F_PIT_01_ASEReadCounter.table","NW_015090842.1:9602514",34,106,72
"APRT","s954_F_PIT_01_ASEReadCounter.table","NW_015090842.1:9602530",33,97,64
"APRT","s954_F_PIT_01_ASEReadCounter.table","NW_015090842.1:9602582",34,112,78
"APRT","s954_F_PIT_01_ASEReadCounter.table","NW_015090842.1:9602583",35,113,78
"APRT","s954_F_PIT_01_ASEReadCounter.table","NW_015090842.1:9602650",38,131,93
"APRT","s954_F_PIT_01_ASEReadCounter.table","NW_015090842.1:9602655",36,127,91
"APRT","s954_F_PIT_01_ASEReadCounter.table","NW_015090842.1:9602712",42,144,102
"APRT","s954_F_PIT_01_ASEReadCounter.table","NW_015090842.1:9602764",51,159,108
"APRT","s954_F_PIT_01_ASEReadCounter.table","NW_015090842.1:9602821",45,131,86
"APRT","s954_F_PIT_01_ASEReadCounter.table","NW_015090842.1:9602867",49,131,82
"APRT","s954_F_PIT_01_ASEReadCounter.table","NW_015090842.1:9602883",48,135,87
"APRT","s954_F_PIT_01_ASEReadCounter.table","NW_015090842.1:9602886",51,139,88
"APRT","s954_F_PIT_01_ASEReadCounter.table","NW_015090842.1:9602948",50,134,84
"APRT","s954_F_PIT_01_ASEReadCounter.table","NW_015090842.1:9602958",51,137,86
"APRT","s954_F_PIT_01_ASEReadCounter.table","NW_015090842.1:9603020",55,179,124
"APRT","s954_F_PIT_01_ASEReadCounter.table","NW_015090842.1:9603025",56,177,121
"APRT","s954_F_PIT_01_ASEReadCounter.table","NW_015090842.1:9603154",40,126,86
"APRT","s954_F_PIT_01_ASEReadCounter.table","NW_015090842.1:9603166",48,150,102
"APRT","s954_F_PIT_01_ASEReadCounter.table","NW_015090842.1:9603326",51,144,93
"APRT","s954_F_PIT_01_ASEReadCounter.table","NW_015090842.1:9603419",49,142,93
"APRT","s954_F_PIT_01_ASEReadCounter.table","NW_015090842.1:9603420",48,139,91
"APRT","s954_F_PIT_01_ASEReadCounter.table","NW_015090842.1:9603464",44,120,76
"APRT","s954_F_PIT_01_ASEReadCounter.table","NW_015090842.1:9603528",55,147,92
"APRT","s954_F_PIT_01_ASEReadCounter.table","NW_015090842.1:9603607",49,131,82
"APRT","s954_F_PIT_01_ASEReadCounter.table","NW_015090842.1:9603622",55,126,71
"APRT","s954_F_PIT_01_ASEReadCounter.table","NW_015090842.1:9604361",36,111,75
"APRT","s954_F_PIT_01_ASEReadCounter.table","NW_015090842.1:9605317",24,94,70
"APRT","s954_F_PIT_01_ASEReadCounter.table","NW_015090842.1:9605336",33,112,79
"GALNS","s954_F_PIT_01_ASEReadCounter.table","NW_015090842.1:9612872",4,8,4
"GALNS","s954_F_PIT_01_ASEReadCounter.table","NW_015090842.1:9612873",4,8,4
"GALNS","s954_F_PIT_01_ASEReadCounter.table","NW_015090842.1:9612877",4,8,4
"GALNS","s954_F_PIT_01_ASEReadCounter.table","NW_015090842.1:9612942",5,16,11
"GALNS","s954_F_PIT_01_ASEReadCounter.table","NW_015090842.1:9612987",12,12,0
"GALNS","s954_F_PIT_01_ASEReadCounter.table","NW_015090842.1:9613064",14,30,16
"GALNS","s954_F_PIT_01_ASEReadCounter.table","NW_015090842.1:9613096",28,44,16
"GALNS","s954_F_PIT_01_ASEReadCounter.table","NW_015090842.1:9613123",26,36,10
"GALNS","s954_F_PIT_01_ASEReadCounter.table","NW_015090842.1:9613125",26,36,10
"GALNS","s954_F_PIT_01_ASEReadCounter.table","NW_015090842.1:9613193",23,35,12
"GALNS","s954_F_PIT_01_ASEReadCounter.table","NW_015090842.1:9613226",20,35,15
"GALNS","s954_F_PIT_01_ASEReadCounter.table","NW_015090842.1:9613249",24,43,19
"GALNS","s954_F_PIT_01_ASEReadCounter.table","NW_015090842.1:9613256",29,52,23
"GALNS","s954_F_PIT_01_ASEReadCounter.table","NW_015090842.1:9613317",24,43,19
"GALNS","s954_F_PIT_01_ASEReadCounter.table","NW_015090842.1:9613343",23,39,16
"GALNS","s954_F_PIT_01_ASEReadCounter.table","NW_015090842.1:9613344",23,39,16
"GALNS","s954_F_PIT_01_ASEReadCounter.table","NW_015090842.1:9613371",19,39,20
"GALNS","s954_F_PIT_01_ASEReadCounter.table","NW_015090842.1:9613378",21,44,23
"GALNS","s954_F_PIT_01_ASEReadCounter.table","NW_015090842.1:9613379",23,45,22
"GALNS","s954_F_PIT_01_ASEReadCounter.table","NW_015090842.1:9613516",16,46,30
"GALNS","s954_F_PIT_01_ASEReadCounter.table","NW_015090842.1:9613572",17,42,25
"GALNS","s954_F_PIT_01_ASEReadCounter.table","NW_015090842.1:9613597",13,43,30
"GALNS","s954_F_PIT_01_ASEReadCounter.table","NW_015090842.1:9613627",10,42,32
"GALNS","s954_F_PIT_01_ASEReadCounter.table","NW_015090842.1:9613640",13,43,30
"GALNS","s954_F_PIT_01_ASEReadCounter.table","NW_015090842.1:9614025",14,33,19
"GALNS","s954_F_PIT_01_ASEReadCounter.table","NW_015090842.1:9614169",18,42,24
"GALNS","s954_F_PIT_01_ASEReadCounter.table","NW_015090842.1:9614232",57,57,0
"GALNS","s954_F_PIT_01_ASEReadCounter.table","NW_015090842.1:9614667",15,30,15
"GALNS","s954_F_PIT_01_ASEReadCounter.table","NW_015090842.1:9614709",17,33,16
"GALNS","s954_F_PIT_01_ASEReadCounter.table","NW_015090842.1:9614880",18,27,9
"GALNS","s954_F_PIT_01_ASEReadCounter.table","NW_015090842.1:9614902",14,23,9
"GALNS","s954_F_PIT_01_ASEReadCounter.table","NW_015090842.1:9614960",8,18,10
"GALNS","s954_F_PIT_01_ASEReadCounter.table","NW_015090842.1:9615114",19,42,23
"GALNS","s954_F_PIT_01_ASEReadCounter.table","NW_015090842.1:9615199",22,38,16
"GALNS","s954_F_PIT_01_ASEReadCounter.table","NW_015090842.1:9615217",18,37,19
"GALNS","s954_F_PIT_01_ASEReadCounter.table","NW_015090842.1:9615277",16,33,17
"GALNS","s954_F_PIT_01_ASEReadCounter.table","NW_015090842.1:9615377",26,52,26
"GALNS","s954_F_PIT_01_ASEReadCounter.table","NW_015090842.1:9647858",11,19,8
"GALNS","s954_F_PIT_01_ASEReadCounter.table","NW_015090842.1:9649186",7,20,13
"GALNS","s954_F_PIT_01_ASEReadCounter.table","NW_015090842.1:9649237",9,22,13
"GALNS","s954_F_PIT_01_ASEReadCounter.table","NW_015090842.1:9661193",9,19,10
"TRAPPC2L","s954_F_PIT_01_ASEReadCounter.table","NW_015090842.1:9662951",82,166,84
"TRAPPC2L","s954_F_PIT_01_ASEReadCounter.table","NW_015090842.1:9663014",84,153,69
"TRAPPC2L","s954_F_PIT_01_ASEReadCounter.table","NW_015090842.1:9664305",129,129,0
"TRAPPC2L","s954_F_PIT_01_ASEReadCounter.table","NW_015090842.1:9665155",51,111,60
"TRAPPC2L","s954_F_PIT_01_ASEReadCounter.table","NW_015090842.1:9665211",8,26,18
"PABPN1L","s954_F_PIT_01_ASEReadCounter.table","NW_015090842.1:9669959",0,1,1
"CBFA2T3","s954_F_PIT_01_ASEReadCounter.table","NW_015090842.1:9709469",0,10,10
"CBFA2T3","s954_F_PIT_01_ASEReadCounter.table","NW_015090842.1:9709475",0,10,10
"CBFA2T3","s954_F_PIT_01_ASEReadCounter.table","NW_015090842.1:9711845",0,5,5
"CBFA2T3","s954_F_PIT_01_ASEReadCounter.table","NW_015090842.1:9712157",0,7,7
"CBFA2T3","s954_F_PIT_01_ASEReadCounter.table","NW_015090842.1:9712160",0,7,7
"CBFA2T3","s954_F_PIT_01_ASEReadCounter.table","NW_015090842.1:9712166",0,7,7
"CBFA2T3","s954_F_PIT_01_ASEReadCounter.table","NW_015090842.1:9712536",3,8,5
"CBFA2T3","s954_F_PIT_01_ASEReadCounter.table","NW_015090842.1:9712673",5,14,9
"CBFA2T3","s954_F_PIT_01_ASEReadCounter.table","NW_015090842.1:9712787",4,13,9
"CBFA2T3","s954_F_PIT_01_ASEReadCounter.table","NW_015090842.1:9712791",6,14,8
"CBFA2T3","s954_F_PIT_01_ASEReadCounter.table","NW_015090842.1:9712805",6,14,8
"CBFA2T3","s954_F_PIT_01_ASEReadCounter.table","NW_015090842.1:9712811",7,16,9
"CBFA2T3","s954_F_PIT_01_ASEReadCounter.table","NW_015090842.1:9712848",7,21,14
"CBFA2T3","s954_F_PIT_01_ASEReadCounter.table","NW_015090842.1:9713088",6,12,6
"CBFA2T3","s954_F_PIT_01_ASEReadCounter.table","NW_015090842.1:9713121",5,13,8
"CBFA2T3","s954_F_PIT_01_ASEReadCounter.table","NW_015090842.1:9717058",7,14,7
"CBFA2T3","s954_F_PIT_01_ASEReadCounter.table","NW_015090842.1:9717093",8,17,9
"CBFA2T3","s954_F_PIT_01_ASEReadCounter.table","NW_015090842.1:9717114",9,17,8
"CBFA2T3","s954_F_PIT_01_ASEReadCounter.table","NW_015090842.1:9717139",8,18,10
"CBFA2T3","s954_F_PIT_01_ASEReadCounter.table","NW_015090842.1:9719788",5,11,6
"CBFA2T3","s954_F_PIT_01_ASEReadCounter.table","NW_015090842.1:9728475",1,2,1
"CBFA2T3","s954_F_PIT_01_ASEReadCounter.table","NW_015090842.1:9728654",1,1,0
"ACSF3","s954_F_PIT_01_ASEReadCounter.table","NW_015090842.1:9773379",0,1,1
"ACSF3","s954_F_PIT_01_ASEReadCounter.table","NW_015090842.1:9773382",0,1,1
"ACSF3","s954_F_PIT_01_ASEReadCounter.table","NW_015090842.1:9773384",0,1,1
"ACSF3","s954_F_PIT_01_ASEReadCounter.table","NW_015090842.1:9773388",0,2,2
"ACSF3","s954_F_PIT_01_ASEReadCounter.table","NW_015090842.1:9776753",10,21,11
"ACSF3","s954_F_PIT_01_ASEReadCounter.table","NW_015090842.1:9776783",11,22,11
"ACSF3","s954_F_PIT_01_ASEReadCounter.table","NW_015090842.1:9776879",13,20,7
"ACSF3","s954_F_PIT_01_ASEReadCounter.table","NW_015090842.1:9776965",11,22,11
"ACSF3","s954_F_PIT_01_ASEReadCounter.table","NW_015090842.1:9777091",13,25,12
"ACSF3","s954_F_PIT_01_ASEReadCounter.table","NW_015090842.1:9777206",18,31,13
"ACSF3","s954_F_PIT_01_ASEReadCounter.table","NW_015090842.1:9777283",17,31,14
"ACSF3","s954_F_PIT_01_ASEReadCounter.table","NW_015090842.1:9778955",10,33,23
"ACSF3","s954_F_PIT_01_ASEReadCounter.table","NW_015090842.1:9778997",9,35,26
"ACSF3","s954_F_PIT_01_ASEReadCounter.table","NW_015090842.1:9789311",21,46,25
"ACSF3","s954_F_PIT_01_ASEReadCounter.table","NW_015090842.1:9789906",5,25,20
"ACSF3","s954_F_PIT_01_ASEReadCounter.table","NW_015090842.1:9834743",41,91,50
"ACSF3","s954_F_PIT_01_ASEReadCounter.table","NW_015090842.1:9834852",41,91,50
"ACSF3","s954_F_PIT_01_ASEReadCounter.table","NW_015090842.1:9834861",32,79,47
"ACSF3","s954_F_PIT_01_ASEReadCounter.table","NW_015090842.1:9839359",24,49,25
"ACSF3","s954_F_PIT_01_ASEReadCounter.table","NW_015090842.1:9839378",25,54,29
"ACSF3","s954_F_PIT_01_ASEReadCounter.table","NW_015090842.1:9839455",22,54,32
"ACSF3","s954_F_PIT_01_ASEReadCounter.table","NW_015090842.1:9839457",23,49,26
"ACSF3","s954_F_PIT_01_ASEReadCounter.table","NW_015090842.1:9839489",17,37,20
"ACSF3","s954_F_PIT_01_ASEReadCounter.table","NW_015090842.1:9839500",11,26,15
"ACSF3","s954_F_PIT_01_ASEReadCounter.table","NW_015090842.1:9839501",11,27,16
"ACSF3","s954_F_PIT_01_ASEReadCounter.table","NW_015090842.1:9839504",12,28,16
"ACSF3","s954_F_PIT_01_ASEReadCounter.table","NW_015090842.1:9839512",13,22,9
"ACSF3","s954_F_PIT_01_ASEReadCounter.table","NW_015090842.1:9839527",9,18,9
"ACSF3","s954_F_PIT_01_ASEReadCounter.table","NW_015090842.1:9839533",7,16,9
"ACSF3","s954_F_PIT_01_ASEReadCounter.table","NW_015090842.1:9839535",7,16,9
"ACSF3","s954_F_PIT_01_ASEReadCounter.table","NW_015090842.1:9839545",5,12,7
"ACSF3","s954_F_PIT_01_ASEReadCounter.table","NW_015090842.1:9839550",3,10,7
"ACSF3","s954_F_PIT_01_ASEReadCounter.table","NW_015090842.1:9839551",5,12,7
"SLC22A31","s954_F_PIT_01_ASEReadCounter.table","NW_015090842.1:9850978",0,1,1
"SLC22A31","s954_F_PIT_01_ASEReadCounter.table","NW_015090842.1:9850981",0,1,1
"SLC22A31","s954_F_PIT_01_ASEReadCounter.table","NW_015090842.1:9851117",0,1,1
"SLC22A31","s954_F_PIT_01_ASEReadCounter.table","NW_015090842.1:9851130",0,1,1
"SLC22A31","s954_F_PIT_01_ASEReadCounter.table","NW_015090842.1:9851139",0,1,1
"SLC22A31","s954_F_PIT_01_ASEReadCounter.table","NW_015090842.1:9851265",2,8,6
"SLC22A31","s954_F_PIT_01_ASEReadCounter.table","NW_015090842.1:9851302",1,7,6
"SLC22A31","s954_F_PIT_01_ASEReadCounter.table","NW_015090842.1:9851303",1,7,6
"SLC22A31","s954_F_PIT_01_ASEReadCounter.table","NW_015090842.1:9851305",1,6,5
"SLC22A31","s954_F_PIT_01_ASEReadCounter.table","NW_015090842.1:9851343",1,4,3
"SLC22A31","s954_F_PIT_01_ASEReadCounter.table","NW_015090842.1:9851344",2,5,3
"SLC22A31","s954_F_PIT_01_ASEReadCounter.table","NW_015090842.1:9851361",7,7,0
"SLC22A31","s954_F_PIT_01_ASEReadCounter.table","NW_015090842.1:9851381",4,11,7
"SLC22A31","s954_F_PIT_01_ASEReadCounter.table","NW_015090842.1:9851421",5,14,9
"SLC22A31","s954_F_PIT_01_ASEReadCounter.table","NW_015090842.1:9851501",3,12,9
"SLC22A31","s954_F_PIT_01_ASEReadCounter.table","NW_015090842.1:9851526",8,14,6
"SLC22A31","s954_F_PIT_01_ASEReadCounter.table","NW_015090842.1:9851589",12,18,6
"SLC22A31","s954_F_PIT_01_ASEReadCounter.table","NW_015090842.1:9851712",9,21,12
"SLC22A31","s954_F_PIT_01_ASEReadCounter.table","NW_015090842.1:9851899",1,9,8
"SLC22A31","s954_F_PIT_01_ASEReadCounter.table","NW_015090842.1:9852139",4,9,5
"SLC22A31","s954_F_PIT_01_ASEReadCounter.table","NW_015090842.1:9852380",9,21,12
"SLC22A31","s954_F_PIT_01_ASEReadCounter.table","NW_015090842.1:9852431",4,10,6
"SLC22A31","s954_F_PIT_01_ASEReadCounter.table","NW_015090842.1:9852630",7,19,12
"SLC22A31","s954_F_PIT_01_ASEReadCounter.table","NW_015090842.1:9852711",5,11,6
"SLC22A31","s954_F_PIT_01_ASEReadCounter.table","NW_015090842.1:9853099",2,6,4
"SLC22A31","s954_F_PIT_01_ASEReadCounter.table","NW_015090842.1:9853102",2,6,4
"SLC22A31","s954_F_PIT_01_ASEReadCounter.table","NW_015090842.1:9853421",4,4,0
"SLC22A31","s954_F_PIT_01_ASEReadCounter.table","NW_015090842.1:9853457",2,3,1
"SLC22A31","s954_F_PIT_01_ASEReadCounter.table","NW_015090842.1:9853502",2,3,1
"ANKRD11","s954_F_PIT_01_ASEReadCounter.table","NW_015090842.1:9858863",4,5,1
"ANKRD11","s954_F_PIT_01_ASEReadCounter.table","NW_015090842.1:9859101",46,115,69
"ANKRD11","s954_F_PIT_01_ASEReadCounter.table","NW_015090842.1:9859352",65,163,98
"ANKRD11","s954_F_PIT_01_ASEReadCounter.table","NW_015090842.1:9859381",33,107,74
"ANKRD11","s954_F_PIT_01_ASEReadCounter.table","NW_015090842.1:9859679",59,132,73
"ANKRD11","s954_F_PIT_01_ASEReadCounter.table","NW_015090842.1:9861097",72,158,86
"ANKRD11","s954_F_PIT_01_ASEReadCounter.table","NW_015090842.1:9862571",57,114,57
"ANKRD11","s954_F_PIT_01_ASEReadCounter.table","NW_015090842.1:9862652",43,73,30
"ANKRD11","s954_F_PIT_01_ASEReadCounter.table","NW_015090842.1:9866071",0,58,58
"ANKRD11","s954_F_PIT_01_ASEReadCounter.table","NW_015090842.1:9866200",0,56,56
"ANKRD11","s954_F_PIT_01_ASEReadCounter.table","NW_015090842.1:9867391",26,54,28
"ANKRD11","s954_F_PIT_01_ASEReadCounter.table","NW_015090842.1:9867472",40,79,39
"ANKRD11","s954_F_PIT_01_ASEReadCounter.table","NW_015090842.1:9867559",37,75,38
"ANKRD11","s954_F_PIT_01_ASEReadCounter.table","NW_015090842.1:9867667",47,90,43
"ANKRD11","s954_F_PIT_01_ASEReadCounter.table","NW_015090842.1:9867934",40,85,45
"ANKRD11","s954_F_PIT_01_ASEReadCounter.table","NW_015090842.1:9868064",53,87,34
"ANKRD11","s954_F_PIT_01_ASEReadCounter.table","NW_015090842.1:9868093",48,78,30
"ANKRD11","s954_F_PIT_01_ASEReadCounter.table","NW_015090842.1:9868222",42,83,41
"ANKRD11","s954_F_PIT_01_ASEReadCounter.table","NW_015090842.1:9868327",39,76,37
"ANKRD11","s954_F_PIT_01_ASEReadCounter.table","NW_015090842.1:9868414",42,91,49
"ANKRD11","s954_F_PIT_01_ASEReadCounter.table","NW_015090842.1:9868441",42,89,47
"ANKRD11","s954_F_PIT_01_ASEReadCounter.table","NW_015090842.1:9868444",44,96,52
"ANKRD11","s954_F_PIT_01_ASEReadCounter.table","NW_015090842.1:9868519",55,102,47
"ANKRD11","s954_F_PIT_01_ASEReadCounter.table","NW_015090842.1:9868609",67,134,67
"ANKRD11","s954_F_PIT_01_ASEReadCounter.table","NW_015090842.1:9868666",58,107,49
"ANKRD11","s954_F_PIT_01_ASEReadCounter.table","NW_015090842.1:9868738",100,100,0
"ANKRD11","s954_F_PIT_01_ASEReadCounter.table","NW_015090842.1:9869431",45,78,33
"ANKRD11","s954_F_PIT_01_ASEReadCounter.table","NW_015090842.1:9869578",68,124,56
"ANKRD11","s954_F_PIT_01_ASEReadCounter.table","NW_015090842.1:9869734",66,135,69
"ANKRD11","s954_F_PIT_01_ASEReadCounter.table","NW_015090842.1:9870070",47,88,41
"ANKRD11","s954_F_PIT_01_ASEReadCounter.table","NW_015090842.1:9870349",49,88,39
"ANKRD11","s954_F_PIT_01_ASEReadCounter.table","NW_015090842.1:9870604",69,122,53
"ANKRD11","s954_F_PIT_01_ASEReadCounter.table","NW_015090842.1:9870613",71,129,58
"ANKRD11","s954_F_PIT_01_ASEReadCounter.table","NW_015090842.1:9870685",61,132,71
"ANKRD11","s954_F_PIT_01_ASEReadCounter.table","NW_015090842.1:9870760",55,111,56
"ANKRD11","s954_F_PIT_01_ASEReadCounter.table","NW_015090842.1:9870847",42,102,60
"ANKRD11","s954_F_PIT_01_ASEReadCounter.table","NW_015090842.1:9871103",37,80,43
"ANKRD11","s954_F_PIT_01_ASEReadCounter.table","NW_015090842.1:9871165",40,74,34
"ANKRD11","s954_F_PIT_01_ASEReadCounter.table","NW_015090842.1:9871508",72,72,0
"ANKRD11","s954_F_PIT_01_ASEReadCounter.table","NW_015090842.1:9871820",24,44,20
"ANKRD11","s954_F_PIT_01_ASEReadCounter.table","NW_015090842.1:9872118",31,57,26
"ANKRD11","s954_F_PIT_01_ASEReadCounter.table","NW_015090842.1:9877406",22,42,20
"SPG7","s954_F_PIT_01_ASEReadCounter.table","NW_015090842.1:10051190",62,138,76
"SPG7","s954_F_PIT_01_ASEReadCounter.table","NW_015090842.1:10051218",73,158,85
"SPG7","s954_F_PIT_01_ASEReadCounter.table","NW_015090842.1:10052348",90,182,92
"SPG7","s954_F_PIT_01_ASEReadCounter.table","NW_015090842.1:10052366",96,187,91
"SPG7","s954_F_PIT_01_ASEReadCounter.table","NW_015090842.1:10065173",89,181,92
"SPG7","s954_F_PIT_01_ASEReadCounter.table","NW_015090842.1:10065215",89,175,86
"SPG7","s954_F_PIT_01_ASEReadCounter.table","NW_015090842.1:10066365",66,144,78
"SPG7","s954_F_PIT_01_ASEReadCounter.table","NW_015090842.1:10069752",85,181,96
"SPG7","s954_F_PIT_01_ASEReadCounter.table","NW_015090842.1:10069800",94,205,111
"SPG7","s954_F_PIT_01_ASEReadCounter.table","NW_015090842.1:10071192",97,215,118
"SPG7","s954_F_PIT_01_ASEReadCounter.table","NW_015090842.1:10071219",82,192,110
"SPG7","s954_F_PIT_01_ASEReadCounter.table","NW_015090842.1:10071967",72,154,82
"SPG7","s954_F_PIT_01_ASEReadCounter.table","NW_015090842.1:10075109",122,233,111
"SPG7","s954_F_PIT_01_ASEReadCounter.table","NW_015090842.1:10075114",122,238,116
"SPG7","s954_F_PIT_01_ASEReadCounter.table","NW_015090842.1:10075198",84,167,83
"SPG7","s954_F_PIT_01_ASEReadCounter.table","NW_015090842.1:10075487",59,116,57
"SPG7","s954_F_PIT_01_ASEReadCounter.table","NW_015090842.1:10075488",59,119,60
"SPG7","s954_F_PIT_01_ASEReadCounter.table","NW_015090842.1:10075548",43,94,51
"RPL13","s954_F_PIT_01_ASEReadCounter.table","NW_015090842.1:10077387",680,1437,757
"RPL13","s954_F_PIT_01_ASEReadCounter.table","NW_015090842.1:10077978",1007,2169,1162
"RPL13","s954_F_PIT_01_ASEReadCounter.table","NW_015090842.1:10077992",971,2060,1089
"CPNE7","s954_F_PIT_01_ASEReadCounter.table","NW_015090842.1:10084001",3,3,0
"CPNE7","s954_F_PIT_01_ASEReadCounter.table","NW_015090842.1:10084856",3,3,0
"CPNE7","s954_F_PIT_01_ASEReadCounter.table","NW_015090842.1:10084872",2,2,0
"CPNE7","s954_F_PIT_01_ASEReadCounter.table","NW_015090842.1:10084892",3,3,0
"CPNE7","s954_F_PIT_01_ASEReadCounter.table","NW_015090842.1:10084921",3,3,0
"CPNE7","s954_F_PIT_01_ASEReadCounter.table","NW_015090842.1:10084935",4,4,0
"CPNE7","s954_F_PIT_01_ASEReadCounter.table","NW_015090842.1:10085000",4,4,0
"CPNE7","s954_F_PIT_01_ASEReadCounter.table","NW_015090842.1:10085089",5,5,0
"CPNE7","s954_F_PIT_01_ASEReadCounter.table","NW_015090842.1:10085096",6,6,0
"CPNE7","s954_F_PIT_01_ASEReadCounter.table","NW_015090842.1:10085126",3,3,0
"CPNE7","s954_F_PIT_01_ASEReadCounter.table","NW_015090842.1:10085167",3,3,0
"CPNE7","s954_F_PIT_01_ASEReadCounter.table","NW_015090842.1:10085180",2,2,0
"CPNE7","s954_F_PIT_01_ASEReadCounter.table","NW_015090842.1:10085201",3,3,0
"CPNE7","s954_F_PIT_01_ASEReadCounter.table","NW_015090842.1:10088134",7,7,0
"CPNE7","s954_F_PIT_01_ASEReadCounter.table","NW_015090842.1:10088146",5,5,0
"CPNE7","s954_F_PIT_01_ASEReadCounter.table","NW_015090842.1:10088806",4,4,0
"CPNE7","s954_F_PIT_01_ASEReadCounter.table","NW_015090842.1:10088940",6,6,0
"CPNE7","s954_F_PIT_01_ASEReadCounter.table","NW_015090842.1:10088965",4,4,0
"CPNE7","s954_F_PIT_01_ASEReadCounter.table","NW_015090842.1:10088967",4,4,0
"CPNE7","s954_F_PIT_01_ASEReadCounter.table","NW_015090842.1:10088973",4,4,0
"CPNE7","s954_F_PIT_01_ASEReadCounter.table","NW_015090842.1:10090924",9,9,0
"CPNE7","s954_F_PIT_01_ASEReadCounter.table","NW_015090842.1:10090930",9,9,0
"CPNE7","s954_F_PIT_01_ASEReadCounter.table","NW_015090842.1:10091075",7,7,0
"CPNE7","s954_F_PIT_01_ASEReadCounter.table","NW_015090842.1:10091389",5,5,0
"CPNE7","s954_F_PIT_01_ASEReadCounter.table","NW_015090842.1:10091407",6,6,0
"CPNE7","s954_F_PIT_01_ASEReadCounter.table","NW_015090842.1:10091488",7,7,0
"CPNE7","s954_F_PIT_01_ASEReadCounter.table","NW_015090842.1:10091491",7,7,0
"CPNE7","s954_F_PIT_01_ASEReadCounter.table","NW_015090842.1:10091530",8,8,0
"CPNE7","s954_F_PIT_01_ASEReadCounter.table","NW_015090842.1:10091875",6,6,0
"CPNE7","s954_F_PIT_01_ASEReadCounter.table","NW_015090842.1:10091983",7,7,0
"CPNE7","s954_F_PIT_01_ASEReadCounter.table","NW_015090842.1:10091997",5,5,0
"CPNE7","s954_F_PIT_01_ASEReadCounter.table","NW_015090842.1:10092038",1,1,0
"CPNE7","s954_F_PIT_01_ASEReadCounter.table","NW_015090842.1:10092140",5,5,0
"CPNE7","s954_F_PIT_01_ASEReadCounter.table","NW_015090842.1:10092183",4,4,0
"CPNE7","s954_F_PIT_01_ASEReadCounter.table","NW_015090842.1:10092201",2,2,0
"CPNE7","s954_F_PIT_01_ASEReadCounter.table","NW_015090842.1:10092230",1,1,0
"LOC106888185","s954_F_PIT_01_ASEReadCounter.table","NW_015090842.1:10094965",2,13,11
"LOC106888185","s954_F_PIT_01_ASEReadCounter.table","NW_015090842.1:10094966",2,13,11
"LOC106888185","s954_F_PIT_01_ASEReadCounter.table","NW_015090842.1:10094985",2,15,13
"LOC106888185","s954_F_PIT_01_ASEReadCounter.table","NW_015090842.1:10095055",1,13,12
"LOC106888185","s954_F_PIT_01_ASEReadCounter.table","NW_015090842.1:10095062",1,12,11
"LOC106888185","s954_F_PIT_01_ASEReadCounter.table","NW_015090842.1:10095130",1,20,19
"LOC106888185","s954_F_PIT_01_ASEReadCounter.table","NW_015090842.1:10095265",22,64,42
"LOC106888185","s954_F_PIT_01_ASEReadCounter.table","NW_015090842.1:10095586",19,74,55
"LOC106888185","s954_F_PIT_01_ASEReadCounter.table","NW_015090842.1:10095593",19,76,57
"LOC106888185","s954_F_PIT_01_ASEReadCounter.table","NW_015090842.1:10095616",18,67,49
"LOC106888185","s954_F_PIT_01_ASEReadCounter.table","NW_015090842.1:10095662",17,55,38
"LOC106888185","s954_F_PIT_01_ASEReadCounter.table","NW_015090842.1:10095674",17,54,37
"LOC106888185","s954_F_PIT_01_ASEReadCounter.table","NW_015090842.1:10095786",23,57,34
"LOC106888185","s954_F_PIT_01_ASEReadCounter.table","NW_015090842.1:10095831",21,53,32
"LOC106888185","s954_F_PIT_01_ASEReadCounter.table","NW_015090842.1:10096230",24,72,48
"LOC106888185","s954_F_PIT_01_ASEReadCounter.table","NW_015090842.1:10096249",28,82,54
"LOC106888185","s954_F_PIT_01_ASEReadCounter.table","NW_015090842.1:10096272",31,86,55
"LOC106888185","s954_F_PIT_01_ASEReadCounter.table","NW_015090842.1:10096288",29,83,54
"LOC106888185","s954_F_PIT_01_ASEReadCounter.table","NW_015090842.1:10097248",31,84,53
"LOC106888185","s954_F_PIT_01_ASEReadCounter.table","NW_015090842.1:10097265",38,93,55
"LOC106888185","s954_F_PIT_01_ASEReadCounter.table","NW_015090842.1:10097446",9,20,11
"DPEP1","s954_F_PIT_01_ASEReadCounter.table","NW_015090842.1:10098518",0,4,4
"DPEP1","s954_F_PIT_01_ASEReadCounter.table","NW_015090842.1:10098595",0,4,4
"DPEP1","s954_F_PIT_01_ASEReadCounter.table","NW_015090842.1:10098597",0,4,4
"DPEP1","s954_F_PIT_01_ASEReadCounter.table","NW_015090842.1:10098601",0,5,5
"DPEP1","s954_F_PIT_01_ASEReadCounter.table","NW_015090842.1:10098608",0,5,5
"DPEP1","s954_F_PIT_01_ASEReadCounter.table","NW_015090842.1:10098630",0,5,5
"DPEP1","s954_F_PIT_01_ASEReadCounter.table","NW_015090842.1:10098659",0,5,5
"DPEP1","s954_F_PIT_01_ASEReadCounter.table","NW_015090842.1:10099765",0,2,2
"DPEP1","s954_F_PIT_01_ASEReadCounter.table","NW_015090842.1:10099985",0,2,2
"DPEP1","s954_F_PIT_01_ASEReadCounter.table","NW_015090842.1:10099986",0,3,3
"DPEP1","s954_F_PIT_01_ASEReadCounter.table","NW_015090842.1:10099991",0,5,5
"DPEP1","s954_F_PIT_01_ASEReadCounter.table","NW_015090842.1:10100044",0,9,9
"DPEP1","s954_F_PIT_01_ASEReadCounter.table","NW_015090842.1:10100045",0,9,9
"DPEP1","s954_F_PIT_01_ASEReadCounter.table","NW_015090842.1:10100084",0,8,8
"DPEP1","s954_F_PIT_01_ASEReadCounter.table","NW_015090842.1:10100295",0,8,8
"DPEP1","s954_F_PIT_01_ASEReadCounter.table","NW_015090842.1:10100529",0,5,5
"DPEP1","s954_F_PIT_01_ASEReadCounter.table","NW_015090842.1:10100893",0,5,5
"DPEP1","s954_F_PIT_01_ASEReadCounter.table","NW_015090842.1:10100902",0,4,4
"DPEP1","s954_F_PIT_01_ASEReadCounter.table","NW_015090842.1:10101072",0,4,4
"DPEP1","s954_F_PIT_01_ASEReadCounter.table","NW_015090842.1:10101199",0,10,10
"DPEP1","s954_F_PIT_01_ASEReadCounter.table","NW_015090842.1:10101483",0,11,11
"DPEP1","s954_F_PIT_01_ASEReadCounter.table","NW_015090842.1:10101497",0,12,12
"DPEP1","s954_F_PIT_01_ASEReadCounter.table","NW_015090842.1:10101525",0,10,10
"DPEP1","s954_F_PIT_01_ASEReadCounter.table","NW_015090842.1:10101875",1,10,9
"DPEP1","s954_F_PIT_01_ASEReadCounter.table","NW_015090842.1:10101913",1,8,7
"DPEP1","s954_F_PIT_01_ASEReadCounter.table","NW_015090842.1:10101996",2,3,1
"DPEP1","s954_F_PIT_01_ASEReadCounter.table","NW_015090842.1:10102014",2,4,2
"DPEP1","s954_F_PIT_01_ASEReadCounter.table","NW_015090842.1:10102035",2,3,1
"CHMP1A","s954_F_PIT_01_ASEReadCounter.table","NW_015090842.1:10102901",51,128,77
"CHMP1A","s954_F_PIT_01_ASEReadCounter.table","NW_015090842.1:10102961",45,136,91
"CHMP1A","s954_F_PIT_01_ASEReadCounter.table","NW_015090842.1:10102996",40,133,93
"CHMP1A","s954_F_PIT_01_ASEReadCounter.table","NW_015090842.1:10103004",43,136,93
"CHMP1A","s954_F_PIT_01_ASEReadCounter.table","NW_015090842.1:10103006",43,136,93
"CHMP1A","s954_F_PIT_01_ASEReadCounter.table","NW_015090842.1:10103052",72,184,112
"CHMP1A","s954_F_PIT_01_ASEReadCounter.table","NW_015090842.1:10103095",83,192,109
"CHMP1A","s954_F_PIT_01_ASEReadCounter.table","NW_015090842.1:10103096",83,194,111
"CHMP1A","s954_F_PIT_01_ASEReadCounter.table","NW_015090842.1:10103152",75,153,78
"CHMP1A","s954_F_PIT_01_ASEReadCounter.table","NW_015090842.1:10103173",74,166,92
"CHMP1A","s954_F_PIT_01_ASEReadCounter.table","NW_015090842.1:10103334",52,137,85
"CHMP1A","s954_F_PIT_01_ASEReadCounter.table","NW_015090842.1:10103373",29,117,88
"CHMP1A","s954_F_PIT_01_ASEReadCounter.table","NW_015090842.1:10103408",50,144,94
"CHMP1A","s954_F_PIT_01_ASEReadCounter.table","NW_015090842.1:10103412",55,150,95
"CHMP1A","s954_F_PIT_01_ASEReadCounter.table","NW_015090842.1:10103512",83,185,102
"CHMP1A","s954_F_PIT_01_ASEReadCounter.table","NW_015090842.1:10103513",82,184,102
"CHMP1A","s954_F_PIT_01_ASEReadCounter.table","NW_015090842.1:10103583",61,137,76
"CHMP1A","s954_F_PIT_01_ASEReadCounter.table","NW_015090842.1:10103614",59,136,77
"CHMP1A","s954_F_PIT_01_ASEReadCounter.table","NW_015090842.1:10103657",66,142,76
"CHMP1A","s954_F_PIT_01_ASEReadCounter.table","NW_015090842.1:10103669",49,121,72
"CHMP1A","s954_F_PIT_01_ASEReadCounter.table","NW_015090842.1:10103674",49,112,63
"CHMP1A","s954_F_PIT_01_ASEReadCounter.table","NW_015090842.1:10103677",46,112,66
"CHMP1A","s954_F_PIT_01_ASEReadCounter.table","NW_015090842.1:10103729",62,125,63
"CHMP1A","s954_F_PIT_01_ASEReadCounter.table","NW_015090842.1:10103758",75,139,64
"CHMP1A","s954_F_PIT_01_ASEReadCounter.table","NW_015090842.1:10103761",76,141,65
"CHMP1A","s954_F_PIT_01_ASEReadCounter.table","NW_015090842.1:10103788",95,173,78
"CHMP1A","s954_F_PIT_01_ASEReadCounter.table","NW_015090842.1:10103789",96,175,79
"CHMP1A","s954_F_PIT_01_ASEReadCounter.table","NW_015090842.1:10103790",90,170,80
"CHMP1A","s954_F_PIT_01_ASEReadCounter.table","NW_015090842.1:10103950",95,219,124
"CHMP1A","s954_F_PIT_01_ASEReadCounter.table","NW_015090842.1:10104335",59,135,76
"CHMP1A","s954_F_PIT_01_ASEReadCounter.table","NW_015090842.1:10104429",97,200,103
"CHMP1A","s954_F_PIT_01_ASEReadCounter.table","NW_015090842.1:10104532",92,214,122
"CHMP1A","s954_F_PIT_01_ASEReadCounter.table","NW_015090842.1:10104633",88,192,104
"CHMP1A","s954_F_PIT_01_ASEReadCounter.table","NW_015090842.1:10104759",71,173,102
"CHMP1A","s954_F_PIT_01_ASEReadCounter.table","NW_015090842.1:10104794",102,206,104
"CHMP1A","s954_F_PIT_01_ASEReadCounter.table","NW_015090842.1:10104841",151,151,0
"CHMP1A","s954_F_PIT_01_ASEReadCounter.table","NW_015090842.1:10104844",70,149,79
"CHMP1A","s954_F_PIT_01_ASEReadCounter.table","NW_015090842.1:10106242",67,159,92
"CHMP1A","s954_F_PIT_01_ASEReadCounter.table","NW_015090842.1:10106290",65,134,69
"CHMP1A","s954_F_PIT_01_ASEReadCounter.table","NW_015090842.1:10106335",97,181,84
"CHMP1A","s954_F_PIT_01_ASEReadCounter.table","NW_015090842.1:10106383",111,231,120
"CHMP1A","s954_F_PIT_01_ASEReadCounter.table","NW_015090842.1:10106747",88,229,141
"CHMP1A","s954_F_PIT_01_ASEReadCounter.table","NW_015090842.1:10107404",98,215,117
"CHMP1A","s954_F_PIT_01_ASEReadCounter.table","NW_015090842.1:10107876",94,213,119
"CDK10","s954_F_PIT_01_ASEReadCounter.table","NW_015090842.1:10109030",13,16,3
"CDK10","s954_F_PIT_01_ASEReadCounter.table","NW_015090842.1:10109963",50,108,58
"CDK10","s954_F_PIT_01_ASEReadCounter.table","NW_015090842.1:10110887",38,87,49
"CDK10","s954_F_PIT_01_ASEReadCounter.table","NW_015090842.1:10111254",29,68,39
"CDK10","s954_F_PIT_01_ASEReadCounter.table","NW_015090842.1:10111380",27,72,45
"CDK10","s954_F_PIT_01_ASEReadCounter.table","NW_015090842.1:10111395",27,73,46
"CDK10","s954_F_PIT_01_ASEReadCounter.table","NW_015090842.1:10111437",11,60,49
"CDK10","s954_F_PIT_01_ASEReadCounter.table","NW_015090842.1:10111798",28,69,41
"CDK10","s954_F_PIT_01_ASEReadCounter.table","NW_015090842.1:10111840",29,79,50
"CDK10","s954_F_PIT_01_ASEReadCounter.table","NW_015090842.1:10112031",35,90,55
"CDK10","s954_F_PIT_01_ASEReadCounter.table","NW_015090842.1:10112285",36,83,47
"CDK10","s954_F_PIT_01_ASEReadCounter.table","NW_015090842.1:10112398",35,84,49
"CDK10","s954_F_PIT_01_ASEReadCounter.table","NW_015090842.1:10112455",27,74,47
"CDK10","s954_F_PIT_01_ASEReadCounter.table","NW_015090842.1:10112461",26,65,39
"CDK10","s954_F_PIT_01_ASEReadCounter.table","NW_015090842.1:10112497",28,72,44
"CDK10","s954_F_PIT_01_ASEReadCounter.table","NW_015090842.1:10112508",23,66,43
"CDK10","s954_F_PIT_01_ASEReadCounter.table","NW_015090842.1:10112518",19,63,44
"CDK10","s954_F_PIT_01_ASEReadCounter.table","NW_015090842.1:10112540",8,53,45
"CDK10","s954_F_PIT_01_ASEReadCounter.table","NW_015090842.1:10112556",19,64,45
"CDK10","s954_F_PIT_01_ASEReadCounter.table","NW_015090842.1:10112561",21,70,49
"CDK10","s954_F_PIT_01_ASEReadCounter.table","NW_015090842.1:10112596",22,62,40
"CDK10","s954_F_PIT_01_ASEReadCounter.table","NW_015090842.1:10112630",19,51,32
"CDK10","s954_F_PIT_01_ASEReadCounter.table","NW_015090842.1:10112656",13,46,33
"CDK10","s954_F_PIT_01_ASEReadCounter.table","NW_015090842.1:10112665",11,37,26
"CDK10","s954_F_PIT_01_ASEReadCounter.table","NW_015090842.1:10112668",11,38,27
"CDK10","s954_F_PIT_01_ASEReadCounter.table","NW_015090842.1:10112781",10,27,17
"CDK10","s954_F_PIT_01_ASEReadCounter.table","NW_015090842.1:10112782",10,26,16
"CDK10","s954_F_PIT_01_ASEReadCounter.table","NW_015090842.1:10112795",7,23,16
"CDK10","s954_F_PIT_01_ASEReadCounter.table","NW_015090842.1:10112841",1,7,6
"CDK10","s954_F_PIT_01_ASEReadCounter.table","NW_015090842.1:10112861",1,6,5
"SPATA2L","s954_F_PIT_01_ASEReadCounter.table","NW_015090842.1:10113212",10,22,12
"SPATA2L","s954_F_PIT_01_ASEReadCounter.table","NW_015090842.1:10113280",19,43,24
"SPATA2L","s954_F_PIT_01_ASEReadCounter.table","NW_015090842.1:10113296",18,47,29
"SPATA2L","s954_F_PIT_01_ASEReadCounter.table","NW_015090842.1:10113321",20,53,33
"SPATA2L","s954_F_PIT_01_ASEReadCounter.table","NW_015090842.1:10113332",22,58,36
"SPATA2L","s954_F_PIT_01_ASEReadCounter.table","NW_015090842.1:10113380",22,53,31
"SPATA2L","s954_F_PIT_01_ASEReadCounter.table","NW_015090842.1:10113381",21,54,33
"SPATA2L","s954_F_PIT_01_ASEReadCounter.table","NW_015090842.1:10113412",20,56,36
"SPATA2L","s954_F_PIT_01_ASEReadCounter.table","NW_015090842.1:10113421",21,61,40
"SPATA2L","s954_F_PIT_01_ASEReadCounter.table","NW_015090842.1:10113465",21,54,33
"SPATA2L","s954_F_PIT_01_ASEReadCounter.table","NW_015090842.1:10113535",22,48,26
"SPATA2L","s954_F_PIT_01_ASEReadCounter.table","NW_015090842.1:10113645",31,72,41
"SPATA2L","s954_F_PIT_01_ASEReadCounter.table","NW_015090842.1:10113682",39,87,48
"SPATA2L","s954_F_PIT_01_ASEReadCounter.table","NW_015090842.1:10113696",43,89,46
"SPATA2L","s954_F_PIT_01_ASEReadCounter.table","NW_015090842.1:10113727",48,96,48
"SPATA2L","s954_F_PIT_01_ASEReadCounter.table","NW_015090842.1:10113799",41,75,34
"SPATA2L","s954_F_PIT_01_ASEReadCounter.table","NW_015090842.1:10113809",44,84,40
"SPATA2L","s954_F_PIT_01_ASEReadCounter.table","NW_015090842.1:10113827",43,79,36
"SPATA2L","s954_F_PIT_01_ASEReadCounter.table","NW_015090842.1:10113831",44,78,34
"SPATA2L","s954_F_PIT_01_ASEReadCounter.table","NW_015090842.1:10113894",40,72,32
"SPATA2L","s954_F_PIT_01_ASEReadCounter.table","NW_015090842.1:10113905",32,65,33
"SPATA2L","s954_F_PIT_01_ASEReadCounter.table","NW_015090842.1:10113914",30,62,32
"SPATA2L","s954_F_PIT_01_ASEReadCounter.table","NW_015090842.1:10113920",32,67,35
"SPATA2L","s954_F_PIT_01_ASEReadCounter.table","NW_015090842.1:10113937",43,81,38
"SPATA2L","s954_F_PIT_01_ASEReadCounter.table","NW_015090842.1:10113971",34,77,43
"SPATA2L","s954_F_PIT_01_ASEReadCounter.table","NW_015090842.1:10113976",38,82,44
"SPATA2L","s954_F_PIT_01_ASEReadCounter.table","NW_015090842.1:10113985",38,79,41
"SPATA2L","s954_F_PIT_01_ASEReadCounter.table","NW_015090842.1:10113994",45,85,40
"SPATA2L","s954_F_PIT_01_ASEReadCounter.table","NW_015090842.1:10114063",23,53,30
"SPATA2L","s954_F_PIT_01_ASEReadCounter.table","NW_015090842.1:10114066",23,51,28
"SPATA2L","s954_F_PIT_01_ASEReadCounter.table","NW_015090842.1:10114069",24,51,27
"SPATA2L","s954_F_PIT_01_ASEReadCounter.table","NW_015090842.1:10114121",19,47,28
"SPATA2L","s954_F_PIT_01_ASEReadCounter.table","NW_015090842.1:10114159",22,56,34
"SPATA2L","s954_F_PIT_01_ASEReadCounter.table","NW_015090842.1:10114282",57,57,0
"SPATA2L","s954_F_PIT_01_ASEReadCounter.table","NW_015090842.1:10114470",21,48,27
"SPATA2L","s954_F_PIT_01_ASEReadCounter.table","NW_015090842.1:10114524",16,40,24
"VPS9D1","s954_F_PIT_01_ASEReadCounter.table","NW_015090842.1:10116377",19,36,17
"VPS9D1","s954_F_PIT_01_ASEReadCounter.table","NW_015090842.1:10116415",20,44,24
"VPS9D1","s954_F_PIT_01_ASEReadCounter.table","NW_015090842.1:10116607",17,39,22
"VPS9D1","s954_F_PIT_01_ASEReadCounter.table","NW_015090842.1:10116816",32,32,0
"VPS9D1","s954_F_PIT_01_ASEReadCounter.table","NW_015090842.1:10116821",17,37,20
"VPS9D1","s954_F_PIT_01_ASEReadCounter.table","NW_015090842.1:10116825",16,33,17
"VPS9D1","s954_F_PIT_01_ASEReadCounter.table","NW_015090842.1:10116882",26,46,20
"VPS9D1","s954_F_PIT_01_ASEReadCounter.table","NW_015090842.1:10116885",28,46,18
"VPS9D1","s954_F_PIT_01_ASEReadCounter.table","NW_015090842.1:10116933",28,45,17
"VPS9D1","s954_F_PIT_01_ASEReadCounter.table","NW_015090842.1:10116942",31,51,20
"VPS9D1","s954_F_PIT_01_ASEReadCounter.table","NW_015090842.1:10117152",23,49,26
"VPS9D1","s954_F_PIT_01_ASEReadCounter.table","NW_015090842.1:10117396",25,25,0
"VPS9D1","s954_F_PIT_01_ASEReadCounter.table","NW_015090842.1:10117405",14,14,0
"VPS9D1","s954_F_PIT_01_ASEReadCounter.table","NW_015090842.1:10117480",12,32,20
"VPS9D1","s954_F_PIT_01_ASEReadCounter.table","NW_015090842.1:10117497",13,32,19
"VPS9D1","s954_F_PIT_01_ASEReadCounter.table","NW_015090842.1:10117499",11,29,18
"VPS9D1","s954_F_PIT_01_ASEReadCounter.table","NW_015090842.1:10117516",19,43,24
"VPS9D1","s954_F_PIT_01_ASEReadCounter.table","NW_015090842.1:10117525",21,42,21
"VPS9D1","s954_F_PIT_01_ASEReadCounter.table","NW_015090842.1:10117579",18,39,21
"VPS9D1","s954_F_PIT_01_ASEReadCounter.table","NW_015090842.1:10117627",20,40,20
"VPS9D1","s954_F_PIT_01_ASEReadCounter.table","NW_015090842.1:10117678",20,40,20
"VPS9D1","s954_F_PIT_01_ASEReadCounter.table","NW_015090842.1:10117773",19,55,36
"VPS9D1","s954_F_PIT_01_ASEReadCounter.table","NW_015090842.1:10117937",27,52,25
"VPS9D1","s954_F_PIT_01_ASEReadCounter.table","NW_015090842.1:10117961",29,53,24
"VPS9D1","s954_F_PIT_01_ASEReadCounter.table","NW_015090842.1:10118236",29,55,26
"VPS9D1","s954_F_PIT_01_ASEReadCounter.table","NW_015090842.1:10118414",28,52,24
"VPS9D1","s954_F_PIT_01_ASEReadCounter.table","NW_015090842.1:10118973",39,60,21
"VPS9D1","s954_F_PIT_01_ASEReadCounter.table","NW_015090842.1:10119500",21,30,9
"ZNF276","s954_F_PIT_01_ASEReadCounter.table","NW_015090842.1:10121760",8,18,10
"ZNF276","s954_F_PIT_01_ASEReadCounter.table","NW_015090842.1:10121769",7,18,11
"ZNF276","s954_F_PIT_01_ASEReadCounter.table","NW_015090842.1:10121802",11,21,10
"ZNF276","s954_F_PIT_01_ASEReadCounter.table","NW_015090842.1:10121971",23,41,18
"ZNF276","s954_F_PIT_01_ASEReadCounter.table","NW_015090842.1:10122883",16,29,13
"ZNF276","s954_F_PIT_01_ASEReadCounter.table","NW_015090842.1:10123069",13,29,16
"ZNF276","s954_F_PIT_01_ASEReadCounter.table","NW_015090842.1:10123207",31,52,21
"ZNF276","s954_F_PIT_01_ASEReadCounter.table","NW_015090842.1:10125787",30,59,29
"ZNF276","s954_F_PIT_01_ASEReadCounter.table","NW_015090842.1:10126309",25,49,24
"ZNF276","s954_F_PIT_01_ASEReadCounter.table","NW_015090842.1:10126348",30,63,33
"ZNF276","s954_F_PIT_01_ASEReadCounter.table","NW_015090842.1:10126978",31,65,34
"ZNF276","s954_F_PIT_01_ASEReadCounter.table","NW_015090842.1:10126991",27,57,30
"ZNF276","s954_F_PIT_01_ASEReadCounter.table","NW_015090842.1:10127023",28,58,30
"ZNF276","s954_F_PIT_01_ASEReadCounter.table","NW_015090842.1:10127063",27,56,29
"ZNF276","s954_F_PIT_01_ASEReadCounter.table","NW_015090842.1:10127373",37,64,27
"ZNF276","s954_F_PIT_01_ASEReadCounter.table","NW_015090842.1:10127931",29,64,35
"ZNF276","s954_F_PIT_01_ASEReadCounter.table","NW_015090842.1:10128070",37,66,29
"ZNF276","s954_F_PIT_01_ASEReadCounter.table","NW_015090842.1:10128102",33,62,29
"ZNF276","s954_F_PIT_01_ASEReadCounter.table","NW_015090842.1:10128356",22,46,24
"ZNF276","s954_F_PIT_01_ASEReadCounter.table","NW_015090842.1:10128497",22,43,21
"FANCA","s954_F_PIT_01_ASEReadCounter.table","NW_015090842.1:10128743",2,3,1
"FANCA","s954_F_PIT_01_ASEReadCounter.table","NW_015090842.1:10128822",3,4,1
"FANCA","s954_F_PIT_01_ASEReadCounter.table","NW_015090842.1:10129383",3,5,2
"FANCA","s954_F_PIT_01_ASEReadCounter.table","NW_015090842.1:10129390",4,6,2
"FANCA","s954_F_PIT_01_ASEReadCounter.table","NW_015090842.1:10129422",6,9,3
"FANCA","s954_F_PIT_01_ASEReadCounter.table","NW_015090842.1:10129969",6,9,3
"FANCA","s954_F_PIT_01_ASEReadCounter.table","NW_015090842.1:10130399",3,5,2
"FANCA","s954_F_PIT_01_ASEReadCounter.table","NW_015090842.1:10130857",3,4,1
"FANCA","s954_F_PIT_01_ASEReadCounter.table","NW_015090842.1:10130878",3,6,3
"FANCA","s954_F_PIT_01_ASEReadCounter.table","NW_015090842.1:10133530",1,1,0
"FANCA","s954_F_PIT_01_ASEReadCounter.table","NW_015090842.1:10133533",1,1,0
"FANCA","s954_F_PIT_01_ASEReadCounter.table","NW_015090842.1:10133536",1,1,0
"FANCA","s954_F_PIT_01_ASEReadCounter.table","NW_015090842.1:10133601",2,5,3
"FANCA","s954_F_PIT_01_ASEReadCounter.table","NW_015090842.1:10134492",1,2,1
"FANCA","s954_F_PIT_01_ASEReadCounter.table","NW_015090842.1:10134531",0,2,2
"FANCA","s954_F_PIT_01_ASEReadCounter.table","NW_015090842.1:10136957",0,3,3
"FANCA","s954_F_PIT_01_ASEReadCounter.table","NW_015090842.1:10136982",0,1,1
"FANCA","s954_F_PIT_01_ASEReadCounter.table","NW_015090842.1:10136999",0,1,1
"FANCA","s954_F_PIT_01_ASEReadCounter.table","NW_015090842.1:10137019",1,4,3
"FANCA","s954_F_PIT_01_ASEReadCounter.table","NW_015090842.1:10137673",3,7,4
"FANCA","s954_F_PIT_01_ASEReadCounter.table","NW_015090842.1:10138618",2,5,3
"FANCA","s954_F_PIT_01_ASEReadCounter.table","NW_015090842.1:10139140",3,5,2
"FANCA","s954_F_PIT_01_ASEReadCounter.table","NW_015090842.1:10140699",4,5,1
"FANCA","s954_F_PIT_01_ASEReadCounter.table","NW_015090842.1:10141234",1,3,2
"FANCA","s954_F_PIT_01_ASEReadCounter.table","NW_015090842.1:10145030",2,5,3
"FANCA","s954_F_PIT_01_ASEReadCounter.table","NW_015090842.1:10150518",4,5,1
"FANCA","s954_F_PIT_01_ASEReadCounter.table","NW_015090842.1:10152863",1,4,3
"FANCA","s954_F_PIT_01_ASEReadCounter.table","NW_015090842.1:10154490",1,1,0
"FANCA","s954_F_PIT_01_ASEReadCounter.table","NW_015090842.1:10158957",0,2,2
"FANCA","s954_F_PIT_01_ASEReadCounter.table","NW_015090842.1:10160177",1,2,1
"FANCA","s954_F_PIT_01_ASEReadCounter.table","NW_015090842.1:10162980",0,1,1
"FANCA","s954_F_PIT_01_ASEReadCounter.table","NW_015090842.1:10163667",1,3,2
"FANCA","s954_F_PIT_01_ASEReadCounter.table","NW_015090842.1:10164257",2,4,2
"FANCA","s954_F_PIT_01_ASEReadCounter.table","NW_015090842.1:10165331",2,4,2
"SPIRE2","s954_F_PIT_01_ASEReadCounter.table","NW_015090842.1:10172284",7,16,9
"SPIRE2","s954_F_PIT_01_ASEReadCounter.table","NW_015090842.1:10175262",18,31,13
"SPIRE2","s954_F_PIT_01_ASEReadCounter.table","NW_015090842.1:10175352",8,16,8
"SPIRE2","s954_F_PIT_01_ASEReadCounter.table","NW_015090842.1:10175400",27,45,18
"SPIRE2","s954_F_PIT_01_ASEReadCounter.table","NW_015090842.1:10175418",30,49,19
"SPIRE2","s954_F_PIT_01_ASEReadCounter.table","NW_015090842.1:10175704",44,74,30
"SPIRE2","s954_F_PIT_01_ASEReadCounter.table","NW_015090842.1:10176115",39,76,37
"SPIRE2","s954_F_PIT_01_ASEReadCounter.table","NW_015090842.1:10176561",43,90,47
"SPIRE2","s954_F_PIT_01_ASEReadCounter.table","NW_015090842.1:10176817",30,72,42
"SPIRE2","s954_F_PIT_01_ASEReadCounter.table","NW_015090842.1:10177084",16,44,28
"SPIRE2","s954_F_PIT_01_ASEReadCounter.table","NW_015090842.1:10177110",22,53,31
"SPIRE2","s954_F_PIT_01_ASEReadCounter.table","NW_015090842.1:10177838",48,95,47
"SPIRE2","s954_F_PIT_01_ASEReadCounter.table","NW_015090842.1:10178000",42,87,45
"SPIRE2","s954_F_PIT_01_ASEReadCounter.table","NW_015090842.1:10178164",43,78,35
"SPIRE2","s954_F_PIT_01_ASEReadCounter.table","NW_015090842.1:10178216",43,78,35
"SPIRE2","s954_F_PIT_01_ASEReadCounter.table","NW_015090842.1:10178403",33,70,37
"SPIRE2","s954_F_PIT_01_ASEReadCounter.table","NW_015090842.1:10178409",36,70,34
"SPIRE2","s954_F_PIT_01_ASEReadCounter.table","NW_015090842.1:10178524",30,54,24
"SPIRE2","s954_F_PIT_01_ASEReadCounter.table","NW_015090842.1:10178526",30,54,24
"SPIRE2","s954_F_PIT_01_ASEReadCounter.table","NW_015090842.1:10178531",31,54,23
"SPIRE2","s954_F_PIT_01_ASEReadCounter.table","NW_015090842.1:10178565",28,49,21
"SPIRE2","s954_F_PIT_01_ASEReadCounter.table","NW_015090842.1:10178587",27,45,18
"SPIRE2","s954_F_PIT_01_ASEReadCounter.table","NW_015090842.1:10178640",16,34,18
"SPIRE2","s954_F_PIT_01_ASEReadCounter.table","NW_015090842.1:10178651",16,38,22
"SPIRE2","s954_F_PIT_01_ASEReadCounter.table","NW_015090842.1:10178682",17,34,17
"TCF25","s954_F_PIT_01_ASEReadCounter.table","NW_015090842.1:10180912",22,44,22
"TCF25","s954_F_PIT_01_ASEReadCounter.table","NW_015090842.1:10180924",26,49,23
"TCF25","s954_F_PIT_01_ASEReadCounter.table","NW_015090842.1:10180931",28,51,23
"TCF25","s954_F_PIT_01_ASEReadCounter.table","NW_015090842.1:10185332",96,180,84
"TCF25","s954_F_PIT_01_ASEReadCounter.table","NW_015090842.1:10188816",77,140,63
"DBNDD1","s954_F_PIT_01_ASEReadCounter.table","NW_015090842.1:10223105",25,51,26
"GAS8","s954_F_PIT_01_ASEReadCounter.table","NW_015090842.1:10228982",45,99,54
"GAS8","s954_F_PIT_01_ASEReadCounter.table","NW_015090842.1:10229832",34,66,32
"GAS8","s954_F_PIT_01_ASEReadCounter.table","NW_015090842.1:10232375",33,55,22
"GAS8","s954_F_PIT_01_ASEReadCounter.table","NW_015090842.1:10232901",25,53,28
"GAS8","s954_F_PIT_01_ASEReadCounter.table","NW_015090842.1:10232928",35,53,18
"GAS8","s954_F_PIT_01_ASEReadCounter.table","NW_015090842.1:10232967",32,59,27
"GAS8","s954_F_PIT_01_ASEReadCounter.table","NW_015090842.1:10233032",17,41,24
"GAS8","s954_F_PIT_01_ASEReadCounter.table","NW_015090842.1:10233057",17,33,16
"GAS8","s954_F_PIT_01_ASEReadCounter.table","NW_015090842.1:10233058",17,33,16
"GAS8","s954_F_PIT_01_ASEReadCounter.table","NW_015090842.1:10233176",22,37,15
"GAS8","s954_F_PIT_01_ASEReadCounter.table","NW_015090842.1:10233196",24,38,14
"GAS8","s954_F_PIT_01_ASEReadCounter.table","NW_015090842.1:10233252",17,28,11
"GAS8","s954_F_PIT_01_ASEReadCounter.table","NW_015090842.1:10233303",6,10,4
"LOC106888094","s954_F_PIT_01_ASEReadCounter.table","NW_015090842.1:10233334",2,4,2
"LOC106888094","s954_F_PIT_01_ASEReadCounter.table","NW_015090842.1:10233362",5,14,9
"LOC106888094","s954_F_PIT_01_ASEReadCounter.table","NW_015090842.1:10233373",5,14,9
"LOC106888094","s954_F_PIT_01_ASEReadCounter.table","NW_015090842.1:10233388",6,16,10
"LOC106888094","s954_F_PIT_01_ASEReadCounter.table","NW_015090842.1:10233402",7,16,9
"LOC106888094","s954_F_PIT_01_ASEReadCounter.table","NW_015090842.1:10233465",7,24,17
"LOC106888094","s954_F_PIT_01_ASEReadCounter.table","NW_015090842.1:10233803",7,29,22
"LOC106888094","s954_F_PIT_01_ASEReadCounter.table","NW_015090842.1:10233815",8,30,22
"LOC106888094","s954_F_PIT_01_ASEReadCounter.table","NW_015090842.1:10235484",0,4,4
"LOC106888094","s954_F_PIT_01_ASEReadCounter.table","NW_015090842.1:10235611",0,5,5
"LOC106888094","s954_F_PIT_01_ASEReadCounter.table","NW_015090842.1:10236098",1,8,7
"LOC106888094","s954_F_PIT_01_ASEReadCounter.table","NW_015090842.1:10236161",1,7,6
"LOC106888094","s954_F_PIT_01_ASEReadCounter.table","NW_015090842.1:10236380",0,2,2
"LOC106888094","s954_F_PIT_01_ASEReadCounter.table","NW_015090842.1:10236388",0,2,2
"LOC106888094","s954_F_PIT_01_ASEReadCounter.table","NW_015090842.1:10236425",0,2,2
"LOC106888094","s954_F_PIT_01_ASEReadCounter.table","NW_015090842.1:10236426",0,2,2
"LOC106888094","s954_F_PIT_01_ASEReadCounter.table","NW_015090842.1:10236603",0,2,2
"LOC106888173","s954_F_PIT_01_ASEReadCounter.table","NW_015090842.1:10239596",11,28,17
"LOC106888173","s954_F_PIT_01_ASEReadCounter.table","NW_015090842.1:10240036",16,52,36
"LOC106888173","s954_F_PIT_01_ASEReadCounter.table","NW_015090842.1:10240095",20,61,41
"LOC106888173","s954_F_PIT_01_ASEReadCounter.table","NW_015090842.1:10240280",18,72,54
"LOC106888173","s954_F_PIT_01_ASEReadCounter.table","NW_015090842.1:10240557",34,79,45
"LOC106888173","s954_F_PIT_01_ASEReadCounter.table","NW_015090842.1:10240603",33,75,42
"LOC106888173","s954_F_PIT_01_ASEReadCounter.table","NW_015090842.1:10240609",31,73,42
"LOC106888173","s954_F_PIT_01_ASEReadCounter.table","NW_015090842.1:10240690",30,67,37
"LOC106888173","s954_F_PIT_01_ASEReadCounter.table","NW_015090842.1:10240924",24,55,31
"LOC106888173","s954_F_PIT_01_ASEReadCounter.table","NW_015090842.1:10241037",14,48,34
"LOC106888173","s954_F_PIT_01_ASEReadCounter.table","NW_015090842.1:10241046",18,53,35
"LOC106888173","s954_F_PIT_01_ASEReadCounter.table","NW_015090842.1:10241058",19,61,42
"LOC106888173","s954_F_PIT_01_ASEReadCounter.table","NW_015090842.1:10241064",28,72,44
"LOC106888173","s954_F_PIT_01_ASEReadCounter.table","NW_015090842.1:10241103",99,99,0
"LOC106888173","s954_F_PIT_01_ASEReadCounter.table","NW_015090842.1:10241163",33,82,49
"LOC106888173","s954_F_PIT_01_ASEReadCounter.table","NW_015090842.1:10241803",38,86,48
"LOC106888173","s954_F_PIT_01_ASEReadCounter.table","NW_015090842.1:10241827",30,77,47
"LOC106888173","s954_F_PIT_01_ASEReadCounter.table","NW_015090842.1:10241869",39,88,49
"LOC106888173","s954_F_PIT_01_ASEReadCounter.table","NW_015090842.1:10242079",38,97,59
"LOC106888173","s954_F_PIT_01_ASEReadCounter.table","NW_015090842.1:10242103",38,102,64
"LOC106888173","s954_F_PIT_01_ASEReadCounter.table","NW_015090842.1:10242157",47,108,61
"LOC106888173","s954_F_PIT_01_ASEReadCounter.table","NW_015090842.1:10242455",56,110,54
"LOC106888173","s954_F_PIT_01_ASEReadCounter.table","NW_015090842.1:10242481",62,123,61
"LOC106888173","s954_F_PIT_01_ASEReadCounter.table","NW_015090842.1:10242590",40,81,41
"LOC106888173","s954_F_PIT_01_ASEReadCounter.table","NW_015090842.1:10242794",34,81,47
"LOC106888173","s954_F_PIT_01_ASEReadCounter.table","NW_015090842.1:10242909",41,83,42
"LOC106888173","s954_F_PIT_01_ASEReadCounter.table","NW_015090842.1:10243094",44,87,43
"LOC106888173","s954_F_PIT_01_ASEReadCounter.table","NW_015090842.1:10243133",31,71,40
"LOC106888173","s954_F_PIT_01_ASEReadCounter.table","NW_015090842.1:10243273",41,90,49
"LOC106888173","s954_F_PIT_01_ASEReadCounter.table","NW_015090842.1:10243278",43,94,51
"LOC106888173","s954_F_PIT_01_ASEReadCounter.table","NW_015090842.1:10243281",42,94,52
"LOC106888173","s954_F_PIT_01_ASEReadCounter.table","NW_015090842.1:10243347",57,58,1
"LOC106888173","s954_F_PIT_01_ASEReadCounter.table","NW_015090842.1:10243353",28,57,29
"LOC106888173","s954_F_PIT_01_ASEReadCounter.table","NW_015090842.1:10243363",17,36,19
"LOC106888173","s954_F_PIT_01_ASEReadCounter.table","NW_015090842.1:10243365",14,36,22
"LOC106888173","s954_F_PIT_01_ASEReadCounter.table","NW_015090842.1:10243566",34,80,46
"LOC106888173","s954_F_PIT_01_ASEReadCounter.table","NW_015090842.1:10243605",32,79,47
"LOC106888173","s954_F_PIT_01_ASEReadCounter.table","NW_015090842.1:10243614",27,76,49
"LOC106888173","s954_F_PIT_01_ASEReadCounter.table","NW_015090842.1:10243615",27,77,50
"LOC106888173","s954_F_PIT_01_ASEReadCounter.table","NW_015090842.1:10243640",23,72,49
"LOC106888173","s954_F_PIT_01_ASEReadCounter.table","NW_015090842.1:10243680",23,61,38
"LOC106888173","s954_F_PIT_01_ASEReadCounter.table","NW_015090842.1:10243742",39,73,34
"LOC106888173","s954_F_PIT_01_ASEReadCounter.table","NW_015090842.1:10243804",29,49,20
"LOC106888173","s954_F_PIT_01_ASEReadCounter.table","NW_015090842.1:10243913",13,21,8
"LOC106888173","s954_F_PIT_01_ASEReadCounter.table","NW_015090842.1:10243921",13,19,6
"LOC106888384","s954_F_PIT_01_ASEReadCounter.table","NW_015090842.1:10244714",0,3,3
"LOC106888384","s954_F_PIT_01_ASEReadCounter.table","NW_015090842.1:10244942",3,7,4
"LOC106888384","s954_F_PIT_01_ASEReadCounter.table","NW_015090842.1:10244998",6,13,7
"LOC106888384","s954_F_PIT_01_ASEReadCounter.table","NW_015090842.1:10250743",6,12,6
"LOC106888384","s954_F_PIT_01_ASEReadCounter.table","NW_015090842.1:10250771",6,12,6
"LOC106888384","s954_F_PIT_01_ASEReadCounter.table","NW_015090842.1:10251339",6,6,0
"LOC106888384","s954_F_PIT_01_ASEReadCounter.table","NW_015090842.1:10251343",6,6,0
"LOC106888384","s954_F_PIT_01_ASEReadCounter.table","NW_015090842.1:10251344",6,6,0
"LOC106888384","s954_F_PIT_01_ASEReadCounter.table","NW_015090842.1:10251349",6,6,0
"LOC106888384","s954_F_PIT_01_ASEReadCounter.table","NW_015090842.1:10251354",5,12,7
"LOC106888384","s954_F_PIT_01_ASEReadCounter.table","NW_015090842.1:10251358",5,12,7
"LOC106888384","s954_F_PIT_01_ASEReadCounter.table","NW_015090842.1:10251369",1,10,9
"LOC106888384","s954_F_PIT_01_ASEReadCounter.table","NW_015090842.1:10251370",3,10,7
"LOC106888384","s954_F_PIT_01_ASEReadCounter.table","NW_015090842.1:10251375",3,10,7
"LOC106888384","s954_F_PIT_01_ASEReadCounter.table","NW_015090842.1:10251388",1,7,6
"LOC106888384","s954_F_PIT_01_ASEReadCounter.table","NW_015090842.1:10251390",1,7,6
"LOC106888384","s954_F_PIT_01_ASEReadCounter.table","NW_015090842.1:10251393",0,6,6
"LOC106888384","s954_F_PIT_01_ASEReadCounter.table","NW_015090842.1:10251399",0,6,6
"LOC106888384","s954_F_PIT_01_ASEReadCounter.table","NW_015090842.1:10251492",1,1,0
"LOC106888384","s954_F_PIT_01_ASEReadCounter.table","NW_015090842.1:10253165",4,15,11
"LOC106888384","s954_F_PIT_01_ASEReadCounter.table","NW_015090842.1:10253284",4,13,9
"LOC106888384","s954_F_PIT_01_ASEReadCounter.table","NW_015090842.1:10254028",9,19,10
"LOC106888384","s954_F_PIT_01_ASEReadCounter.table","NW_015090842.1:10254227",7,16,9
"LOC106888384","s954_F_PIT_01_ASEReadCounter.table","NW_015090842.1:10254233",7,17,10
"LOC106888384","s954_F_PIT_01_ASEReadCounter.table","NW_015090842.1:10254263",5,14,9
"LOC106888384","s954_F_PIT_01_ASEReadCounter.table","NW_015090842.1:10254293",9,17,8
"LOC106888384","s954_F_PIT_01_ASEReadCounter.table","NW_015090842.1:10254570",9,19,10
"LOC106888384","s954_F_PIT_01_ASEReadCounter.table","NW_015090842.1:10254605",18,18,0
"LOC106888384","s954_F_PIT_01_ASEReadCounter.table","NW_015090842.1:10254608",18,18,0
"LOC106888384","s954_F_PIT_01_ASEReadCounter.table","NW_015090842.1:10254618",14,17,3
"LOC106888384","s954_F_PIT_01_ASEReadCounter.table","NW_015090842.1:10254620",12,15,3
"LOC106888384","s954_F_PIT_01_ASEReadCounter.table","NW_015090842.1:10254623",12,15,3
"LOC106888384","s954_F_PIT_01_ASEReadCounter.table","NW_015090842.1:10254624",10,13,3
"LOC106888384","s954_F_PIT_01_ASEReadCounter.table","NW_015090842.1:10254627",13,16,3
"LOC106888384","s954_F_PIT_01_ASEReadCounter.table","NW_015090842.1:10254629",13,15,2
"LOC106888384","s954_F_PIT_01_ASEReadCounter.table","NW_015090842.1:10254647",4,11,7
"LOC106888384","s954_F_PIT_01_ASEReadCounter.table","NW_015090842.1:10254663",2,9,7
"LOC106888384","s954_F_PIT_01_ASEReadCounter.table","NW_015090842.1:10254840",2,10,8
"LOC106888384","s954_F_PIT_01_ASEReadCounter.table","NW_015090842.1:10254891",9,11,2
"LOC106888384","s954_F_PIT_01_ASEReadCounter.table","NW_015090842.1:10254900",4,12,8
"LOC106888384","s954_F_PIT_01_ASEReadCounter.table","NW_015090842.1:10254915",4,15,11
"LOC106888384","s954_F_PIT_01_ASEReadCounter.table","NW_015090842.1:10254965",12,13,1
"LOC106888384","s954_F_PIT_01_ASEReadCounter.table","NW_015090842.1:10254975",0,12,12
"LOC106888384","s954_F_PIT_01_ASEReadCounter.table","NW_015090842.1:10255077",6,12,6
"LOC106888384","s954_F_PIT_01_ASEReadCounter.table","NW_015090842.1:10255117",6,11,5
"LOC106888384","s954_F_PIT_01_ASEReadCounter.table","NW_015090842.1:10255138",5,10,5
"LOC106888384","s954_F_PIT_01_ASEReadCounter.table","NW_015090842.1:10255139",5,9,4
"LOC106888384","s954_F_PIT_01_ASEReadCounter.table","NW_015090842.1:10255209",3,12,9
"LOC106888384","s954_F_PIT_01_ASEReadCounter.table","NW_015090842.1:10255211",5,13,8
"LOC106888384","s954_F_PIT_01_ASEReadCounter.table","NW_015090842.1:10255236",2,9,7
"LOC106888384","s954_F_PIT_01_ASEReadCounter.table","NW_015090842.1:10255262",4,13,9
"LOC106888384","s954_F_PIT_01_ASEReadCounter.table","NW_015090842.1:10255264",5,15,10
"LOC106888384","s954_F_PIT_01_ASEReadCounter.table","NW_015090842.1:10255306",8,22,14
"LOC106888384","s954_F_PIT_01_ASEReadCounter.table","NW_015090842.1:10255340",6,21,15
"LOC106888384","s954_F_PIT_01_ASEReadCounter.table","NW_015090842.1:10255410",1,9,8
"LOC106888384","s954_F_PIT_01_ASEReadCounter.table","NW_015090842.1:10255449",2,11,9
"LOC106888384","s954_F_PIT_01_ASEReadCounter.table","NW_015090842.1:10255496",5,17,12
"LOC106888384","s954_F_PIT_01_ASEReadCounter.table","NW_015090842.1:10255505",5,16,11
"LOC106888384","s954_F_PIT_01_ASEReadCounter.table","NW_015090842.1:10255531",5,18,13
"LOC106888384","s954_F_PIT_01_ASEReadCounter.table","NW_015090842.1:10255608",7,17,10
"LOC106888384","s954_F_PIT_01_ASEReadCounter.table","NW_015090842.1:10255704",10,21,11
"LOC106888384","s954_F_PIT_01_ASEReadCounter.table","NW_015090842.1:10255731",9,18,9
"LOC106888384","s954_F_PIT_01_ASEReadCounter.table","NW_015090842.1:10255771",4,5,1
"TANGO6","s954_F_PIT_01_ASEReadCounter.table","NW_015090842.1:10257782",10,18,8
"TANGO6","s954_F_PIT_01_ASEReadCounter.table","NW_015090842.1:10258162",6,22,16
"TANGO6","s954_F_PIT_01_ASEReadCounter.table","NW_015090842.1:10258185",6,20,14
"TANGO6","s954_F_PIT_01_ASEReadCounter.table","NW_015090842.1:10259267",4,22,18
"TANGO6","s954_F_PIT_01_ASEReadCounter.table","NW_015090842.1:10260250",39,70,31
"TANGO6","s954_F_PIT_01_ASEReadCounter.table","NW_015090842.1:10260289",37,65,28
"TANGO6","s954_F_PIT_01_ASEReadCounter.table","NW_015090842.1:10260309",33,58,25
"TANGO6","s954_F_PIT_01_ASEReadCounter.table","NW_015090842.1:10260979",20,47,27
"TANGO6","s954_F_PIT_01_ASEReadCounter.table","NW_015090842.1:10261599",17,32,15
"TANGO6","s954_F_PIT_01_ASEReadCounter.table","NW_015090842.1:10268425",25,51,26
"TANGO6","s954_F_PIT_01_ASEReadCounter.table","NW_015090842.1:10269831",27,51,24
"TANGO6","s954_F_PIT_01_ASEReadCounter.table","NW_015090842.1:10270813",17,39,22
"TANGO6","s954_F_PIT_01_ASEReadCounter.table","NW_015090842.1:10274018",19,35,16
"TANGO6","s954_F_PIT_01_ASEReadCounter.table","NW_015090842.1:10275974",17,33,16
"TANGO6","s954_F_PIT_01_ASEReadCounter.table","NW_015090842.1:10275976",17,33,16
"TANGO6","s954_F_PIT_01_ASEReadCounter.table","NW_015090842.1:10276123",15,30,15
"TANGO6","s954_F_PIT_01_ASEReadCounter.table","NW_015090842.1:10276271",15,31,16
"TANGO6","s954_F_PIT_01_ASEReadCounter.table","NW_015090842.1:10276272",15,32,17
"TANGO6","s954_F_PIT_01_ASEReadCounter.table","NW_015090842.1:10276275",16,33,17
"TANGO6","s954_F_PIT_01_ASEReadCounter.table","NW_015090842.1:10276278",15,32,17
"TANGO6","s954_F_PIT_01_ASEReadCounter.table","NW_015090842.1:10276368",16,27,11
"TANGO6","s954_F_PIT_01_ASEReadCounter.table","NW_015090842.1:10276373",14,24,10
"TANGO6","s954_F_PIT_01_ASEReadCounter.table","NW_015090842.1:10276630",13,23,10
"TANGO6","s954_F_PIT_01_ASEReadCounter.table","NW_015090842.1:10281498",10,18,8
"TANGO6","s954_F_PIT_01_ASEReadCounter.table","NW_015090842.1:10281516",14,24,10
"TANGO6","s954_F_PIT_01_ASEReadCounter.table","NW_015090842.1:10282842",14,24,10
"TANGO6","s954_F_PIT_01_ASEReadCounter.table","NW_015090842.1:10282863",10,17,7
"TANGO6","s954_F_PIT_01_ASEReadCounter.table","NW_015090842.1:10282869",12,18,6
"TANGO6","s954_F_PIT_01_ASEReadCounter.table","NW_015090842.1:10282903",14,26,12
"TANGO6","s954_F_PIT_01_ASEReadCounter.table","NW_015090842.1:10283757",21,32,11
"TANGO6","s954_F_PIT_01_ASEReadCounter.table","NW_015090842.1:10283785",18,29,11
"HAS3","s954_F_PIT_01_ASEReadCounter.table","NW_015090842.1:10290609",1,1,0
"HAS3","s954_F_PIT_01_ASEReadCounter.table","NW_015090842.1:10290666",1,1,0
"HAS3","s954_F_PIT_01_ASEReadCounter.table","NW_015090842.1:10291004",1,3,2
"CHTF8","s954_F_PIT_01_ASEReadCounter.table","NW_015090842.1:10291319",4,6,2
"CHTF8","s954_F_PIT_01_ASEReadCounter.table","NW_015090842.1:10291491",10,16,6
"CHTF8","s954_F_PIT_01_ASEReadCounter.table","NW_015090842.1:10291520",10,18,8
"CHTF8","s954_F_PIT_01_ASEReadCounter.table","NW_015090842.1:10291593",16,32,16
"CHTF8","s954_F_PIT_01_ASEReadCounter.table","NW_015090842.1:10291600",15,31,16
"CHTF8","s954_F_PIT_01_ASEReadCounter.table","NW_015090842.1:10291609",14,30,16
"CHTF8","s954_F_PIT_01_ASEReadCounter.table","NW_015090842.1:10291639",20,32,12
"CHTF8","s954_F_PIT_01_ASEReadCounter.table","NW_015090842.1:10291641",19,31,12
"CHTF8","s954_F_PIT_01_ASEReadCounter.table","NW_015090842.1:10291648",20,32,12
"CHTF8","s954_F_PIT_01_ASEReadCounter.table","NW_015090842.1:10291656",23,34,11
"CHTF8","s954_F_PIT_01_ASEReadCounter.table","NW_015090842.1:10291675",18,31,13
"CHTF8","s954_F_PIT_01_ASEReadCounter.table","NW_015090842.1:10291696",16,28,12
"CHTF8","s954_F_PIT_01_ASEReadCounter.table","NW_015090842.1:10291714",17,30,13
"CHTF8","s954_F_PIT_01_ASEReadCounter.table","NW_015090842.1:10291732",21,34,13
"CHTF8","s954_F_PIT_01_ASEReadCounter.table","NW_015090842.1:10291755",17,30,13
"CHTF8","s954_F_PIT_01_ASEReadCounter.table","NW_015090842.1:10291756",17,27,10
"CHTF8","s954_F_PIT_01_ASEReadCounter.table","NW_015090842.1:10291758",17,31,14
"CHTF8","s954_F_PIT_01_ASEReadCounter.table","NW_015090842.1:10291792",21,35,14
"CHTF8","s954_F_PIT_01_ASEReadCounter.table","NW_015090842.1:10291895",30,43,13
"CHTF8","s954_F_PIT_01_ASEReadCounter.table","NW_015090842.1:10292132",23,34,11
"CHTF8","s954_F_PIT_01_ASEReadCounter.table","NW_015090842.1:10292314",23,41,18
"CHTF8","s954_F_PIT_01_ASEReadCounter.table","NW_015090842.1:10292317",24,43,19
"CHTF8","s954_F_PIT_01_ASEReadCounter.table","NW_015090842.1:10292928",6,6,0
"UTP4","s954_F_PIT_01_ASEReadCounter.table","NW_015090842.1:10293146",30,53,23
"UTP4","s954_F_PIT_01_ASEReadCounter.table","NW_015090842.1:10293151",32,56,24
"UTP4","s954_F_PIT_01_ASEReadCounter.table","NW_015090842.1:10293191",24,41,17
"UTP4","s954_F_PIT_01_ASEReadCounter.table","NW_015090842.1:10293362",34,61,27
"UTP4","s954_F_PIT_01_ASEReadCounter.table","NW_015090842.1:10293430",34,56,22
"UTP4","s954_F_PIT_01_ASEReadCounter.table","NW_015090842.1:10293625",28,47,19
"UTP4","s954_F_PIT_01_ASEReadCounter.table","NW_015090842.1:10293684",28,53,25
"UTP4","s954_F_PIT_01_ASEReadCounter.table","NW_015090842.1:10294093",23,49,26
"UTP4","s954_F_PIT_01_ASEReadCounter.table","NW_015090842.1:10294622",22,45,23
"UTP4","s954_F_PIT_01_ASEReadCounter.table","NW_015090842.1:10294632",20,44,24
"UTP4","s954_F_PIT_01_ASEReadCounter.table","NW_015090842.1:10295238",17,42,25
"UTP4","s954_F_PIT_01_ASEReadCounter.table","NW_015090842.1:10295880",23,57,34
"UTP4","s954_F_PIT_01_ASEReadCounter.table","NW_015090842.1:10295884",23,58,35
"UTP4","s954_F_PIT_01_ASEReadCounter.table","NW_015090842.1:10295903",23,50,27
"UTP4","s954_F_PIT_01_ASEReadCounter.table","NW_015090842.1:10295906",23,49,26
"UTP4","s954_F_PIT_01_ASEReadCounter.table","NW_015090842.1:10295915",22,48,26
"UTP4","s954_F_PIT_01_ASEReadCounter.table","NW_015090842.1:10295938",20,38,18
"UTP4","s954_F_PIT_01_ASEReadCounter.table","NW_015090842.1:10296175",23,46,23
"UTP4","s954_F_PIT_01_ASEReadCounter.table","NW_015090842.1:10296660",28,53,25
"UTP4","s954_F_PIT_01_ASEReadCounter.table","NW_015090842.1:10296679",31,56,25
"UTP4","s954_F_PIT_01_ASEReadCounter.table","NW_015090842.1:10297193",23,50,27
"UTP4","s954_F_PIT_01_ASEReadCounter.table","NW_015090842.1:10297220",23,53,30
"UTP4","s954_F_PIT_01_ASEReadCounter.table","NW_015090842.1:10297307",26,61,35
"UTP4","s954_F_PIT_01_ASEReadCounter.table","NW_015090842.1:10297558",19,51,32
"UTP4","s954_F_PIT_01_ASEReadCounter.table","NW_015090842.1:10297943",17,40,23
"UTP4","s954_F_PIT_01_ASEReadCounter.table","NW_015090842.1:10297979",9,29,20
"UTP4","s954_F_PIT_01_ASEReadCounter.table","NW_015090842.1:10298022",12,25,13
"UTP4","s954_F_PIT_01_ASEReadCounter.table","NW_015090842.1:10298079",5,10,5
"UTP4","s954_F_PIT_01_ASEReadCounter.table","NW_015090842.1:10298081",4,8,4
"UTP4","s954_F_PIT_01_ASEReadCounter.table","NW_015090842.1:10298082",4,8,4
"SNTB2","s954_F_PIT_01_ASEReadCounter.table","NW_015090842.1:10298905",2,2,0
"SNTB2","s954_F_PIT_01_ASEReadCounter.table","NW_015090842.1:10298928",3,3,0
"SNTB2","s954_F_PIT_01_ASEReadCounter.table","NW_015090842.1:10303506",29,53,24
"SNTB2","s954_F_PIT_01_ASEReadCounter.table","NW_015090842.1:10303524",24,43,19
"SNTB2","s954_F_PIT_01_ASEReadCounter.table","NW_015090842.1:10304059",16,30,14
"SNTB2","s954_F_PIT_01_ASEReadCounter.table","NW_015090842.1:10304089",17,30,13
"SNTB2","s954_F_PIT_01_ASEReadCounter.table","NW_015090842.1:10304167",20,28,8
"SNTB2","s954_F_PIT_01_ASEReadCounter.table","NW_015090842.1:10304176",19,28,9
"SNTB2","s954_F_PIT_01_ASEReadCounter.table","NW_015090842.1:10305069",24,42,18
"SNTB2","s954_F_PIT_01_ASEReadCounter.table","NW_015090842.1:10305099",18,29,11
"SNTB2","s954_F_PIT_01_ASEReadCounter.table","NW_015090842.1:10305171",14,21,7
"SNTB2","s954_F_PIT_01_ASEReadCounter.table","NW_015090842.1:10305177",13,19,6
"SNTB2","s954_F_PIT_01_ASEReadCounter.table","NW_015090842.1:10305451",12,28,16
"SNTB2","s954_F_PIT_01_ASEReadCounter.table","NW_015090842.1:10305547",23,41,18
"SNTB2","s954_F_PIT_01_ASEReadCounter.table","NW_015090842.1:10305847",14,36,22
"SNTB2","s954_F_PIT_01_ASEReadCounter.table","NW_015090842.1:10306173",18,36,18
"SNTB2","s954_F_PIT_01_ASEReadCounter.table","NW_015090842.1:10306275",16,34,18
"SNTB2","s954_F_PIT_01_ASEReadCounter.table","NW_015090842.1:10306457",22,33,11
"SNTB2","s954_F_PIT_01_ASEReadCounter.table","NW_015090842.1:10306496",9,20,11
"SNTB2","s954_F_PIT_01_ASEReadCounter.table","NW_015090842.1:10306499",8,17,9
"VPS4A","s954_F_PIT_01_ASEReadCounter.table","NW_015090842.1:10308566",65,140,75
"VPS4A","s954_F_PIT_01_ASEReadCounter.table","NW_015090842.1:10308573",66,140,74
"VPS4A","s954_F_PIT_01_ASEReadCounter.table","NW_015090842.1:10308856",104,244,140
"VPS4A","s954_F_PIT_01_ASEReadCounter.table","NW_015090842.1:10309056",124,278,154
"VPS4A","s954_F_PIT_01_ASEReadCounter.table","NW_015090842.1:10309089",138,303,165
"VPS4A","s954_F_PIT_01_ASEReadCounter.table","NW_015090842.1:10309392",134,270,136
"VPS4A","s954_F_PIT_01_ASEReadCounter.table","NW_015090842.1:10309413",134,288,154
"VPS4A","s954_F_PIT_01_ASEReadCounter.table","NW_015090842.1:10309467",144,329,185
"VPS4A","s954_F_PIT_01_ASEReadCounter.table","NW_015090842.1:10310230",146,346,200
"VPS4A","s954_F_PIT_01_ASEReadCounter.table","NW_015090842.1:10310425",139,307,168
"VPS4A","s954_F_PIT_01_ASEReadCounter.table","NW_015090842.1:10310639",171,349,178
"VPS4A","s954_F_PIT_01_ASEReadCounter.table","NW_015090842.1:10310734",113,273,160
"VPS4A","s954_F_PIT_01_ASEReadCounter.table","NW_015090842.1:10310737",115,276,161
"VPS4A","s954_F_PIT_01_ASEReadCounter.table","NW_015090842.1:10310746",116,284,168
"VPS4A","s954_F_PIT_01_ASEReadCounter.table","NW_015090842.1:10310767",123,284,161
"VPS4A","s954_F_PIT_01_ASEReadCounter.table","NW_015090842.1:10310995",126,284,158
"VPS4A","s954_F_PIT_01_ASEReadCounter.table","NW_015090842.1:10311004",123,275,152
"VPS4A","s954_F_PIT_01_ASEReadCounter.table","NW_015090842.1:10311007",128,289,161
"VPS4A","s954_F_PIT_01_ASEReadCounter.table","NW_015090842.1:10311013",144,294,150
"VPS4A","s954_F_PIT_01_ASEReadCounter.table","NW_015090842.1:10311022",130,288,158
"VPS4A","s954_F_PIT_01_ASEReadCounter.table","NW_015090842.1:10311023",129,282,153
"VPS4A","s954_F_PIT_01_ASEReadCounter.table","NW_015090842.1:10311426",146,306,160
"VPS4A","s954_F_PIT_01_ASEReadCounter.table","NW_015090842.1:10311489",0,7,7
"VPS4A","s954_F_PIT_01_ASEReadCounter.table","NW_015090842.1:10311490",0,6,6
"VPS4A","s954_F_PIT_01_ASEReadCounter.table","NW_015090842.1:10311525",6,11,5
"VPS4A","s954_F_PIT_01_ASEReadCounter.table","NW_015090842.1:10311529",6,13,7
"VPS4A","s954_F_PIT_01_ASEReadCounter.table","NW_015090842.1:10311530",6,16,10
"VPS4A","s954_F_PIT_01_ASEReadCounter.table","NW_015090842.1:10311552",19,39,20
"VPS4A","s954_F_PIT_01_ASEReadCounter.table","NW_015090842.1:10311689",22,54,32
"VPS4A","s954_F_PIT_01_ASEReadCounter.table","NW_015090842.1:10311700",29,60,31
"VPS4A","s954_F_PIT_01_ASEReadCounter.table","NW_015090842.1:10311701",27,57,30
"VPS4A","s954_F_PIT_01_ASEReadCounter.table","NW_015090842.1:10311703",29,59,30
"COG8","s954_F_PIT_01_ASEReadCounter.table","NW_015090842.1:10313487",27,57,30
"COG8","s954_F_PIT_01_ASEReadCounter.table","NW_015090842.1:10313559",39,70,31
"COG8","s954_F_PIT_01_ASEReadCounter.table","NW_015090842.1:10313579",35,67,32
"COG8","s954_F_PIT_01_ASEReadCounter.table","NW_015090842.1:10313665",31,52,21
"COG8","s954_F_PIT_01_ASEReadCounter.table","NW_015090842.1:10313681",28,55,27
"COG8","s954_F_PIT_01_ASEReadCounter.table","NW_015090842.1:10313768",41,78,37
"COG8","s954_F_PIT_01_ASEReadCounter.table","NW_015090842.1:10313775",42,79,37
"COG8","s954_F_PIT_01_ASEReadCounter.table","NW_015090842.1:10313811",34,61,27
"COG8","s954_F_PIT_01_ASEReadCounter.table","NW_015090842.1:10313858",28,50,22
"COG8","s954_F_PIT_01_ASEReadCounter.table","NW_015090842.1:10314100",34,59,25
"COG8","s954_F_PIT_01_ASEReadCounter.table","NW_015090842.1:10314213",26,54,28
"COG8","s954_F_PIT_01_ASEReadCounter.table","NW_015090842.1:10315093",23,46,23
"COG8","s954_F_PIT_01_ASEReadCounter.table","NW_015090842.1:10315162",20,48,28
"COG8","s954_F_PIT_01_ASEReadCounter.table","NW_015090842.1:10315285",26,70,44
"COG8","s954_F_PIT_01_ASEReadCounter.table","NW_015090842.1:10315360",13,41,28
"COG8","s954_F_PIT_01_ASEReadCounter.table","NW_015090842.1:10315369",17,49,32
"COG8","s954_F_PIT_01_ASEReadCounter.table","NW_015090842.1:10315504",18,46,28
"COG8","s954_F_PIT_01_ASEReadCounter.table","NW_015090842.1:10315508",19,48,29
"COG8","s954_F_PIT_01_ASEReadCounter.table","NW_015090842.1:10315624",25,52,27
"COG8","s954_F_PIT_01_ASEReadCounter.table","NW_015090842.1:10315693",19,65,46
"COG8","s954_F_PIT_01_ASEReadCounter.table","NW_015090842.1:10315698",20,66,46
"COG8","s954_F_PIT_01_ASEReadCounter.table","NW_015090842.1:10315768",21,53,32
"COG8","s954_F_PIT_01_ASEReadCounter.table","NW_015090842.1:10315769",20,51,31
"COG8","s954_F_PIT_01_ASEReadCounter.table","NW_015090842.1:10315784",27,54,27
"COG8","s954_F_PIT_01_ASEReadCounter.table","NW_015090842.1:10316093",34,55,21
"COG8","s954_F_PIT_01_ASEReadCounter.table","NW_015090842.1:10316133",30,48,18
"NIP7","s954_F_PIT_01_ASEReadCounter.table","NW_015090842.1:10316759",16,31,15
"NIP7","s954_F_PIT_01_ASEReadCounter.table","NW_015090842.1:10316967",73,145,72
"NIP7","s954_F_PIT_01_ASEReadCounter.table","NW_015090842.1:10316995",87,171,84
"NIP7","s954_F_PIT_01_ASEReadCounter.table","NW_015090842.1:10317240",126,228,102
"NIP7","s954_F_PIT_01_ASEReadCounter.table","NW_015090842.1:10317247",127,222,95
"NIP7","s954_F_PIT_01_ASEReadCounter.table","NW_015090842.1:10317264",131,217,86
"NIP7","s954_F_PIT_01_ASEReadCounter.table","NW_015090842.1:10317433",119,224,105
"NIP7","s954_F_PIT_01_ASEReadCounter.table","NW_015090842.1:10317738",78,178,100
"NIP7","s954_F_PIT_01_ASEReadCounter.table","NW_015090842.1:10317769",82,182,100
"NIP7","s954_F_PIT_01_ASEReadCounter.table","NW_015090842.1:10317808",51,120,69
"NIP7","s954_F_PIT_01_ASEReadCounter.table","NW_015090842.1:10317870",40,84,44
"NIP7","s954_F_PIT_01_ASEReadCounter.table","NW_015090842.1:10317871",40,83,43
"NIP7","s954_F_PIT_01_ASEReadCounter.table","NW_015090842.1:10317898",27,60,33
"NIP7","s954_F_PIT_01_ASEReadCounter.table","NW_015090842.1:10317911",25,56,31
"TMED6","s954_F_PIT_01_ASEReadCounter.table","NW_015090842.1:10318731",4,5,1
"TERF2","s954_F_PIT_01_ASEReadCounter.table","NW_015090842.1:10321665",15,15,0
"TERF2","s954_F_PIT_01_ASEReadCounter.table","NW_015090842.1:10321768",17,48,31
"TERF2","s954_F_PIT_01_ASEReadCounter.table","NW_015090842.1:10321777",18,42,24
"TERF2","s954_F_PIT_01_ASEReadCounter.table","NW_015090842.1:10321805",21,48,27
"TERF2","s954_F_PIT_01_ASEReadCounter.table","NW_015090842.1:10321878",32,69,37
"TERF2","s954_F_PIT_01_ASEReadCounter.table","NW_015090842.1:10321893",3,57,54
"TERF2","s954_F_PIT_01_ASEReadCounter.table","NW_015090842.1:10321897",22,49,27
"TERF2","s954_F_PIT_01_ASEReadCounter.table","NW_015090842.1:10321908",23,48,25
"TERF2","s954_F_PIT_01_ASEReadCounter.table","NW_015090842.1:10322001",39,94,55
"TERF2","s954_F_PIT_01_ASEReadCounter.table","NW_015090842.1:10322035",33,81,48
"TERF2","s954_F_PIT_01_ASEReadCounter.table","NW_015090842.1:10322051",34,88,54
"TERF2","s954_F_PIT_01_ASEReadCounter.table","NW_015090842.1:10322137",20,63,43
"TERF2","s954_F_PIT_01_ASEReadCounter.table","NW_015090842.1:10322144",24,63,39
"TERF2","s954_F_PIT_01_ASEReadCounter.table","NW_015090842.1:10322388",23,99,76
"TERF2","s954_F_PIT_01_ASEReadCounter.table","NW_015090842.1:10322396",26,96,70
"TERF2","s954_F_PIT_01_ASEReadCounter.table","NW_015090842.1:10322502",33,89,56
"TERF2","s954_F_PIT_01_ASEReadCounter.table","NW_015090842.1:10322504",34,92,58
"TERF2","s954_F_PIT_01_ASEReadCounter.table","NW_015090842.1:10322510",36,99,63
"TERF2","s954_F_PIT_01_ASEReadCounter.table","NW_015090842.1:10323580",60,129,69
"TERF2","s954_F_PIT_01_ASEReadCounter.table","NW_015090842.1:10324314",43,112,69
"TERF2","s954_F_PIT_01_ASEReadCounter.table","NW_015090842.1:10326832",37,96,59
"TERF2","s954_F_PIT_01_ASEReadCounter.table","NW_015090842.1:10327787",24,50,26
"TERF2","s954_F_PIT_01_ASEReadCounter.table","NW_015090842.1:10328588",36,83,47
"TERF2","s954_F_PIT_01_ASEReadCounter.table","NW_015090842.1:10328644",33,69,36
"TERF2","s954_F_PIT_01_ASEReadCounter.table","NW_015090842.1:10329813",33,72,39
"TERF2","s954_F_PIT_01_ASEReadCounter.table","NW_015090842.1:10330749",26,59,33
"TERF2","s954_F_PIT_01_ASEReadCounter.table","NW_015090842.1:10330789",32,64,32
"CYB5B","s954_F_PIT_01_ASEReadCounter.table","NW_015090842.1:10336595",5,22,17
"CYB5B","s954_F_PIT_01_ASEReadCounter.table","NW_015090842.1:10336667",67,170,103
"CYB5B","s954_F_PIT_01_ASEReadCounter.table","NW_015090842.1:10336689",104,242,138
"CYB5B","s954_F_PIT_01_ASEReadCounter.table","NW_015090842.1:10336728",164,384,220
"CYB5B","s954_F_PIT_01_ASEReadCounter.table","NW_015090842.1:10345068",136,323,187
"CYB5B","s954_F_PIT_01_ASEReadCounter.table","NW_015090842.1:10348800",176,387,211
"CYB5B","s954_F_PIT_01_ASEReadCounter.table","NW_015090842.1:10348888",135,309,174
"CYB5B","s954_F_PIT_01_ASEReadCounter.table","NW_015090842.1:10349046",129,294,165
"CYB5B","s954_F_PIT_01_ASEReadCounter.table","NW_015090842.1:10349119",78,235,157
"CYB5B","s954_F_PIT_01_ASEReadCounter.table","NW_015090842.1:10349146",47,203,156
"CYB5B","s954_F_PIT_01_ASEReadCounter.table","NW_015090842.1:10349157",80,236,156
