"gene","id","snp","ref_count","total_count","alt_count"
"CENPN","s954_F_GON_01_ASEReadCounter.table","NW_015090842.1:5801612",18,271,253
"CENPN","s954_F_GON_01_ASEReadCounter.table","NW_015090842.1:5801618",23,283,260
"CENPN","s954_F_GON_01_ASEReadCounter.table","NW_015090842.1:5801623",46,303,257
"CENPN","s954_F_GON_01_ASEReadCounter.table","NW_015090842.1:5801631",70,332,262
"CENPN","s954_F_GON_01_ASEReadCounter.table","NW_015090842.1:5801632",71,336,265
"CENPN","s954_F_GON_01_ASEReadCounter.table","NW_015090842.1:5801655",90,310,220
"CENPN","s954_F_GON_01_ASEReadCounter.table","NW_015090842.1:5801662",97,338,241
"CENPN","s954_F_GON_01_ASEReadCounter.table","NW_015090842.1:5801670",104,358,254
"CENPN","s954_F_GON_01_ASEReadCounter.table","NW_015090842.1:5801674",105,365,260
"CENPN","s954_F_GON_01_ASEReadCounter.table","NW_015090842.1:5801692",116,407,291
"CENPN","s954_F_GON_01_ASEReadCounter.table","NW_015090842.1:5801697",116,399,283
"CENPN","s954_F_GON_01_ASEReadCounter.table","NW_015090842.1:5802008",130,584,454
"CENPN","s954_F_GON_01_ASEReadCounter.table","NW_015090842.1:5802012",132,586,454
"CENPN","s954_F_GON_01_ASEReadCounter.table","NW_015090842.1:5802087",184,834,650
"CENPN","s954_F_GON_01_ASEReadCounter.table","NW_015090842.1:5810113",23,33,10
"CENPN","s954_F_GON_01_ASEReadCounter.table","NW_015090842.1:5810147",31,40,9
"CENPN","s954_F_GON_01_ASEReadCounter.table","NW_015090842.1:5810148",32,40,8
"ATMIN","s954_F_GON_01_ASEReadCounter.table","NW_015090842.1:5818789",29,31,2
"ATMIN","s954_F_GON_01_ASEReadCounter.table","NW_015090842.1:5819958",19,30,11
"ATMIN","s954_F_GON_01_ASEReadCounter.table","NW_015090842.1:5820004",20,28,8
"ATMIN","s954_F_GON_01_ASEReadCounter.table","NW_015090842.1:5820217",13,18,5
"ATMIN","s954_F_GON_01_ASEReadCounter.table","NW_015090842.1:5820250",13,16,3
"ATMIN","s954_F_GON_01_ASEReadCounter.table","NW_015090842.1:5820298",15,21,6
"ATMIN","s954_F_GON_01_ASEReadCounter.table","NW_015090842.1:5820417",6,15,9
"ATMIN","s954_F_GON_01_ASEReadCounter.table","NW_015090842.1:5820421",6,15,9
"ATMIN","s954_F_GON_01_ASEReadCounter.table","NW_015090842.1:5820448",5,8,3
"ATMIN","s954_F_GON_01_ASEReadCounter.table","NW_015090842.1:5820457",4,6,2
"ATMIN","s954_F_GON_01_ASEReadCounter.table","NW_015090842.1:5820510",5,10,5
"ATMIN","s954_F_GON_01_ASEReadCounter.table","NW_015090842.1:5820673",8,14,6
"ATMIN","s954_F_GON_01_ASEReadCounter.table","NW_015090842.1:5820754",5,8,3
"ATMIN","s954_F_GON_01_ASEReadCounter.table","NW_015090842.1:5820820",6,11,5
"ATMIN","s954_F_GON_01_ASEReadCounter.table","NW_015090842.1:5820865",7,11,4
"ATMIN","s954_F_GON_01_ASEReadCounter.table","NW_015090842.1:5820889",7,14,7
"ATMIN","s954_F_GON_01_ASEReadCounter.table","NW_015090842.1:5820891",7,13,6
"ATMIN","s954_F_GON_01_ASEReadCounter.table","NW_015090842.1:5820997",4,9,5
"ATMIN","s954_F_GON_01_ASEReadCounter.table","NW_015090842.1:5821063",4,8,4
"ATMIN","s954_F_GON_01_ASEReadCounter.table","NW_015090842.1:5821132",7,11,4
"ATMIN","s954_F_GON_01_ASEReadCounter.table","NW_015090842.1:5821645",8,17,9
"ATMIN","s954_F_GON_01_ASEReadCounter.table","NW_015090842.1:5825066",9,16,7
"ATMIN","s954_F_GON_01_ASEReadCounter.table","NW_015090842.1:5825106",9,18,9
"ATMIN","s954_F_GON_01_ASEReadCounter.table","NW_015090842.1:5825122",8,16,8
"ATMIN","s954_F_GON_01_ASEReadCounter.table","NW_015090842.1:5825178",20,30,10
"ATMIN","s954_F_GON_01_ASEReadCounter.table","NW_015090842.1:5825194",20,31,11
"ATMIN","s954_F_GON_01_ASEReadCounter.table","NW_015090842.1:5825195",20,31,11
"ATMIN","s954_F_GON_01_ASEReadCounter.table","NW_015090842.1:5825220",17,26,9
"ATMIN","s954_F_GON_01_ASEReadCounter.table","NW_015090842.1:5825240",17,28,11
"ATMIN","s954_F_GON_01_ASEReadCounter.table","NW_015090842.1:5825303",19,38,19
"ATMIN","s954_F_GON_01_ASEReadCounter.table","NW_015090842.1:5825304",19,39,20
"ATMIN","s954_F_GON_01_ASEReadCounter.table","NW_015090842.1:5825310",21,41,20
"ATMIN","s954_F_GON_01_ASEReadCounter.table","NW_015090842.1:5825406",14,19,5
"ATMIN","s954_F_GON_01_ASEReadCounter.table","NW_015090842.1:5825415",18,24,6
"ATMIN","s954_F_GON_01_ASEReadCounter.table","NW_015090842.1:5825438",20,31,11
"ATMIN","s954_F_GON_01_ASEReadCounter.table","NW_015090842.1:5825485",22,35,13
"ATMIN","s954_F_GON_01_ASEReadCounter.table","NW_015090842.1:5825524",19,30,11
"ATMIN","s954_F_GON_01_ASEReadCounter.table","NW_015090842.1:5825557",20,32,12
"ATMIN","s954_F_GON_01_ASEReadCounter.table","NW_015090842.1:5825571",20,33,13
"ATMIN","s954_F_GON_01_ASEReadCounter.table","NW_015090842.1:5825579",20,34,14
"ATMIN","s954_F_GON_01_ASEReadCounter.table","NW_015090842.1:5825590",15,26,11
"ATMIN","s954_F_GON_01_ASEReadCounter.table","NW_015090842.1:5825689",23,35,12
"ATMIN","s954_F_GON_01_ASEReadCounter.table","NW_015090842.1:5825703",25,39,14
"ATMIN","s954_F_GON_01_ASEReadCounter.table","NW_015090842.1:5825787",19,34,15
"ATMIN","s954_F_GON_01_ASEReadCounter.table","NW_015090842.1:5825833",22,36,14
"ATMIN","s954_F_GON_01_ASEReadCounter.table","NW_015090842.1:5825841",18,33,15
"ATMIN","s954_F_GON_01_ASEReadCounter.table","NW_015090842.1:5825895",25,46,21
"ATMIN","s954_F_GON_01_ASEReadCounter.table","NW_015090842.1:5825984",24,51,27
"ATMIN","s954_F_GON_01_ASEReadCounter.table","NW_015090842.1:5826162",26,43,17
"ATMIN","s954_F_GON_01_ASEReadCounter.table","NW_015090842.1:5826194",27,52,25
"ATMIN","s954_F_GON_01_ASEReadCounter.table","NW_015090842.1:5826235",21,51,30
"ATMIN","s954_F_GON_01_ASEReadCounter.table","NW_015090842.1:5826245",22,54,32
"ATMIN","s954_F_GON_01_ASEReadCounter.table","NW_015090842.1:5826335",9,30,21
"ATMIN","s954_F_GON_01_ASEReadCounter.table","NW_015090842.1:5826417",14,34,20
"ATMIN","s954_F_GON_01_ASEReadCounter.table","NW_015090842.1:5826431",13,36,23
"ATMIN","s954_F_GON_01_ASEReadCounter.table","NW_015090842.1:5826438",14,42,28
"ATMIN","s954_F_GON_01_ASEReadCounter.table","NW_015090842.1:5826463",18,49,31
"ATMIN","s954_F_GON_01_ASEReadCounter.table","NW_015090842.1:5826502",13,42,29
"ATMIN","s954_F_GON_01_ASEReadCounter.table","NW_015090842.1:5826511",16,43,27
"ATMIN","s954_F_GON_01_ASEReadCounter.table","NW_015090842.1:5826659",26,44,18
"ATMIN","s954_F_GON_01_ASEReadCounter.table","NW_015090842.1:5826701",26,47,21
"ATMIN","s954_F_GON_01_ASEReadCounter.table","NW_015090842.1:5826702",27,48,21
"ATMIN","s954_F_GON_01_ASEReadCounter.table","NW_015090842.1:5826732",32,54,22
"ATMIN","s954_F_GON_01_ASEReadCounter.table","NW_015090842.1:5826745",33,58,25
"ATMIN","s954_F_GON_01_ASEReadCounter.table","NW_015090842.1:5826835",39,73,34
"ATMIN","s954_F_GON_01_ASEReadCounter.table","NW_015090842.1:5826942",18,59,41
"ATMIN","s954_F_GON_01_ASEReadCounter.table","NW_015090842.1:5827193",51,96,45
"ATMIN","s954_F_GON_01_ASEReadCounter.table","NW_015090842.1:5827196",48,92,44
"ATMIN","s954_F_GON_01_ASEReadCounter.table","NW_015090842.1:5827269",46,91,45
"ATMIN","s954_F_GON_01_ASEReadCounter.table","NW_015090842.1:5827315",32,72,40
"ATMIN","s954_F_GON_01_ASEReadCounter.table","NW_015090842.1:5827316",32,71,39
"ATMIN","s954_F_GON_01_ASEReadCounter.table","NW_015090842.1:5827333",30,66,36
"PPP1R3E","s954_F_GON_01_ASEReadCounter.table","NW_015090842.1:5837733",4,12,8
"PPP1R3E","s954_F_GON_01_ASEReadCounter.table","NW_015090842.1:5837947",3,8,5
"PKD1L2","s954_F_GON_01_ASEReadCounter.table","NW_015090842.1:5867509",12,34,22
"PKD1L2","s954_F_GON_01_ASEReadCounter.table","NW_015090842.1:5867597",16,45,29
"PKD1L2","s954_F_GON_01_ASEReadCounter.table","NW_015090842.1:5867600",16,48,32
"PKD1L2","s954_F_GON_01_ASEReadCounter.table","NW_015090842.1:5867660",25,57,32
"PKD1L2","s954_F_GON_01_ASEReadCounter.table","NW_015090842.1:5867675",26,68,42
"PKD1L2","s954_F_GON_01_ASEReadCounter.table","NW_015090842.1:5867788",27,58,31
"PKD1L2","s954_F_GON_01_ASEReadCounter.table","NW_015090842.1:5867843",27,57,30
"PKD1L2","s954_F_GON_01_ASEReadCounter.table","NW_015090842.1:5871422",3,6,3
"PKD1L2","s954_F_GON_01_ASEReadCounter.table","NW_015090842.1:5872825",7,11,4
"PKD1L2","s954_F_GON_01_ASEReadCounter.table","NW_015090842.1:5872876",2,3,1
"PKD1L2","s954_F_GON_01_ASEReadCounter.table","NW_015090842.1:5872924",5,8,3
"PKD1L2","s954_F_GON_01_ASEReadCounter.table","NW_015090842.1:5872948",4,7,3
"BCO1","s954_F_GON_01_ASEReadCounter.table","NW_015090842.1:5915610",14,37,23
"BCO1","s954_F_GON_01_ASEReadCounter.table","NW_015090842.1:5915646",9,30,21
"BCO1","s954_F_GON_01_ASEReadCounter.table","NW_015090842.1:5917836",12,31,19
"BCO1","s954_F_GON_01_ASEReadCounter.table","NW_015090842.1:5917912",18,38,20
"BCO1","s954_F_GON_01_ASEReadCounter.table","NW_015090842.1:5917941",16,39,23
"BCO1","s954_F_GON_01_ASEReadCounter.table","NW_015090842.1:5917971",18,46,28
"BCO1","s954_F_GON_01_ASEReadCounter.table","NW_015090842.1:5921679",14,43,29
"BCO1","s954_F_GON_01_ASEReadCounter.table","NW_015090842.1:5921726",11,32,21
"BCO1","s954_F_GON_01_ASEReadCounter.table","NW_015090842.1:5925669",21,35,14
"BCO1","s954_F_GON_01_ASEReadCounter.table","NW_015090842.1:5926937",18,35,17
"BCO1","s954_F_GON_01_ASEReadCounter.table","NW_015090842.1:5927921",23,48,25
"BCO1","s954_F_GON_01_ASEReadCounter.table","NW_015090842.1:5927948",23,46,23
"BCO1","s954_F_GON_01_ASEReadCounter.table","NW_015090842.1:5927968",21,49,28
"BCO1","s954_F_GON_01_ASEReadCounter.table","NW_015090842.1:5928052",28,54,26
"BCO1","s954_F_GON_01_ASEReadCounter.table","NW_015090842.1:5932726",29,71,42
"BCO1","s954_F_GON_01_ASEReadCounter.table","NW_015090842.1:5932801",31,61,30
"BCO1","s954_F_GON_01_ASEReadCounter.table","NW_015090842.1:5934558",32,55,23
"BCO1","s954_F_GON_01_ASEReadCounter.table","NW_015090842.1:5934575",35,60,25
"BCO1","s954_F_GON_01_ASEReadCounter.table","NW_015090842.1:5934608",37,68,31
"BCO1","s954_F_GON_01_ASEReadCounter.table","NW_015090842.1:5934647",35,58,23
"BCO1","s954_F_GON_01_ASEReadCounter.table","NW_015090842.1:5934725",37,54,17
"BCO1","s954_F_GON_01_ASEReadCounter.table","NW_015090842.1:5934726",37,53,16
"BCO1","s954_F_GON_01_ASEReadCounter.table","NW_015090842.1:5934733",38,51,13
"BCO1","s954_F_GON_01_ASEReadCounter.table","NW_015090842.1:5934821",31,45,14
"BCO1","s954_F_GON_01_ASEReadCounter.table","NW_015090842.1:5934826",23,41,18
"BCO1","s954_F_GON_01_ASEReadCounter.table","NW_015090842.1:5934844",21,38,17
"BCO1","s954_F_GON_01_ASEReadCounter.table","NW_015090842.1:5934958",47,64,17
"BCO1","s954_F_GON_01_ASEReadCounter.table","NW_015090842.1:5934976",48,69,21
"GAN","s954_F_GON_01_ASEReadCounter.table","NW_015090842.1:5939249",0,2,2
"GAN","s954_F_GON_01_ASEReadCounter.table","NW_015090842.1:5953759",11,22,11
"GAN","s954_F_GON_01_ASEReadCounter.table","NW_015090842.1:5957502",11,33,22
"GAN","s954_F_GON_01_ASEReadCounter.table","NW_015090842.1:5957578",20,44,24
"GAN","s954_F_GON_01_ASEReadCounter.table","NW_015090842.1:5966047",26,47,21
"GAN","s954_F_GON_01_ASEReadCounter.table","NW_015090842.1:5966126",14,39,25
"GAN","s954_F_GON_01_ASEReadCounter.table","NW_015090842.1:5966127",14,39,25
"GAN","s954_F_GON_01_ASEReadCounter.table","NW_015090842.1:5966162",27,56,29
"GAN","s954_F_GON_01_ASEReadCounter.table","NW_015090842.1:5966483",8,26,18
"CMIP","s954_F_GON_01_ASEReadCounter.table","NW_015090842.1:6109159",21,28,7
"CMIP","s954_F_GON_01_ASEReadCounter.table","NW_015090842.1:6109166",16,23,7
"CMIP","s954_F_GON_01_ASEReadCounter.table","NW_015090842.1:6114641",26,42,16
"CMIP","s954_F_GON_01_ASEReadCounter.table","NW_015090842.1:6114751",13,24,11
"CMIP","s954_F_GON_01_ASEReadCounter.table","NW_015090842.1:6114824",17,35,18
"CMIP","s954_F_GON_01_ASEReadCounter.table","NW_015090842.1:6126295",47,47,0
"CMIP","s954_F_GON_01_ASEReadCounter.table","NW_015090842.1:6128998",31,60,29
"CMIP","s954_F_GON_01_ASEReadCounter.table","NW_015090842.1:6130562",56,83,27
"CMIP","s954_F_GON_01_ASEReadCounter.table","NW_015090842.1:6132522",28,52,24
"CMIP","s954_F_GON_01_ASEReadCounter.table","NW_015090842.1:6138265",46,93,47
"CMIP","s954_F_GON_01_ASEReadCounter.table","NW_015090842.1:6138300",44,92,48
"CMIP","s954_F_GON_01_ASEReadCounter.table","NW_015090842.1:6138342",40,76,36
"CMIP","s954_F_GON_01_ASEReadCounter.table","NW_015090842.1:6138343",40,76,36
"CMIP","s954_F_GON_01_ASEReadCounter.table","NW_015090842.1:6138345",41,80,39
"CMIP","s954_F_GON_01_ASEReadCounter.table","NW_015090842.1:6138647",26,51,25
"CMIP","s954_F_GON_01_ASEReadCounter.table","NW_015090842.1:6138745",30,64,34
"CMIP","s954_F_GON_01_ASEReadCounter.table","NW_015090842.1:6138832",6,14,8
"CMIP","s954_F_GON_01_ASEReadCounter.table","NW_015090842.1:6138967",26,60,34
"CMIP","s954_F_GON_01_ASEReadCounter.table","NW_015090842.1:6139131",3,14,11
"CMIP","s954_F_GON_01_ASEReadCounter.table","NW_015090842.1:6139163",0,12,12
"CMIP","s954_F_GON_01_ASEReadCounter.table","NW_015090842.1:6139212",42,46,4
"CMIP","s954_F_GON_01_ASEReadCounter.table","NW_015090842.1:6139360",5,18,13
"CMIP","s954_F_GON_01_ASEReadCounter.table","NW_015090842.1:6139572",8,15,7
"PLCG2","s954_F_GON_01_ASEReadCounter.table","NW_015090842.1:6179613",8,11,3
"PLCG2","s954_F_GON_01_ASEReadCounter.table","NW_015090842.1:6179658",9,10,1
"PLCG2","s954_F_GON_01_ASEReadCounter.table","NW_015090842.1:6203766",8,8,0
"PLCG2","s954_F_GON_01_ASEReadCounter.table","NW_015090842.1:6203775",8,8,0
"PLCG2","s954_F_GON_01_ASEReadCounter.table","NW_015090842.1:6203787",8,8,0
"PLCG2","s954_F_GON_01_ASEReadCounter.table","NW_015090842.1:6209741",6,8,2
"PLCG2","s954_F_GON_01_ASEReadCounter.table","NW_015090842.1:6209798",7,8,1
"PLCG2","s954_F_GON_01_ASEReadCounter.table","NW_015090842.1:6209816",5,6,1
"PLCG2","s954_F_GON_01_ASEReadCounter.table","NW_015090842.1:6217547",14,20,6
"PLCG2","s954_F_GON_01_ASEReadCounter.table","NW_015090842.1:6218641",7,13,6
"PLCG2","s954_F_GON_01_ASEReadCounter.table","NW_015090842.1:6220552",10,12,2
"PLCG2","s954_F_GON_01_ASEReadCounter.table","NW_015090842.1:6221969",11,14,3
"PLCG2","s954_F_GON_01_ASEReadCounter.table","NW_015090842.1:6228672",11,13,2
"PLCG2","s954_F_GON_01_ASEReadCounter.table","NW_015090842.1:6228694",7,9,2
"PLCG2","s954_F_GON_01_ASEReadCounter.table","NW_015090842.1:6228722",7,9,2
"PLCG2","s954_F_GON_01_ASEReadCounter.table","NW_015090842.1:6228747",5,8,3
"PLCG2","s954_F_GON_01_ASEReadCounter.table","NW_015090842.1:6228835",14,17,3
"PLCG2","s954_F_GON_01_ASEReadCounter.table","NW_015090842.1:6228841",14,17,3
"PLCG2","s954_F_GON_01_ASEReadCounter.table","NW_015090842.1:6228865",15,17,2
"PLCG2","s954_F_GON_01_ASEReadCounter.table","NW_015090842.1:6228917",13,14,1
"PLCG2","s954_F_GON_01_ASEReadCounter.table","NW_015090842.1:6228926",10,11,1
"PLCG2","s954_F_GON_01_ASEReadCounter.table","NW_015090842.1:6228954",8,8,0
"PLCG2","s954_F_GON_01_ASEReadCounter.table","NW_015090842.1:6229002",7,7,0
"PLCG2","s954_F_GON_01_ASEReadCounter.table","NW_015090842.1:6229006",6,6,0
"PLCG2","s954_F_GON_01_ASEReadCounter.table","NW_015090842.1:6229081",6,6,0
"PLCG2","s954_F_GON_01_ASEReadCounter.table","NW_015090842.1:6229097",4,4,0
"PLCG2","s954_F_GON_01_ASEReadCounter.table","NW_015090842.1:6229160",5,8,3
"PLCG2","s954_F_GON_01_ASEReadCounter.table","NW_015090842.1:6229213",8,10,2
"PLCG2","s954_F_GON_01_ASEReadCounter.table","NW_015090842.1:6229231",11,13,2
"PLCG2","s954_F_GON_01_ASEReadCounter.table","NW_015090842.1:6229663",16,17,1
"PLCG2","s954_F_GON_01_ASEReadCounter.table","NW_015090842.1:6229748",10,14,4
"PLCG2","s954_F_GON_01_ASEReadCounter.table","NW_015090842.1:6229892",14,17,3
"PLCG2","s954_F_GON_01_ASEReadCounter.table","NW_015090842.1:6230248",8,12,4
"PLCG2","s954_F_GON_01_ASEReadCounter.table","NW_015090842.1:6230255",8,12,4
"PLCG2","s954_F_GON_01_ASEReadCounter.table","NW_015090842.1:6230276",6,9,3
"PLCG2","s954_F_GON_01_ASEReadCounter.table","NW_015090842.1:6230296",4,7,3
"PLCG2","s954_F_GON_01_ASEReadCounter.table","NW_015090842.1:6230349",11,13,2
"PLCG2","s954_F_GON_01_ASEReadCounter.table","NW_015090842.1:6230408",17,20,3
"PLCG2","s954_F_GON_01_ASEReadCounter.table","NW_015090842.1:6230439",14,17,3
"PLCG2","s954_F_GON_01_ASEReadCounter.table","NW_015090842.1:6230757",3,3,0
"PLCG2","s954_F_GON_01_ASEReadCounter.table","NW_015090842.1:6230758",3,3,0
"PLCG2","s954_F_GON_01_ASEReadCounter.table","NW_015090842.1:6230898",22,23,1
"PLCG2","s954_F_GON_01_ASEReadCounter.table","NW_015090842.1:6230976",15,19,4
"PLCG2","s954_F_GON_01_ASEReadCounter.table","NW_015090842.1:6231078",22,25,3
"PLCG2","s954_F_GON_01_ASEReadCounter.table","NW_015090842.1:6231138",28,32,4
"PLCG2","s954_F_GON_01_ASEReadCounter.table","NW_015090842.1:6231177",30,33,3
"PLCG2","s954_F_GON_01_ASEReadCounter.table","NW_015090842.1:6231263",22,24,2
"SDR42E1","s954_F_GON_01_ASEReadCounter.table","NW_015090842.1:6235292",9,23,14
"SDR42E1","s954_F_GON_01_ASEReadCounter.table","NW_015090842.1:6235315",13,42,29
"SDR42E1","s954_F_GON_01_ASEReadCounter.table","NW_015090842.1:6235348",29,68,39
"SDR42E1","s954_F_GON_01_ASEReadCounter.table","NW_015090842.1:6235355",30,71,41
"SDR42E1","s954_F_GON_01_ASEReadCounter.table","NW_015090842.1:6235417",34,80,46
"SDR42E1","s954_F_GON_01_ASEReadCounter.table","NW_015090842.1:6235558",39,103,64
"SDR42E1","s954_F_GON_01_ASEReadCounter.table","NW_015090842.1:6235741",57,103,46
"SDR42E1","s954_F_GON_01_ASEReadCounter.table","NW_015090842.1:6235777",52,103,51
"SDR42E1","s954_F_GON_01_ASEReadCounter.table","NW_015090842.1:6235806",65,124,59
"SDR42E1","s954_F_GON_01_ASEReadCounter.table","NW_015090842.1:6235809",62,121,59
"SDR42E1","s954_F_GON_01_ASEReadCounter.table","NW_015090842.1:6235816",66,124,58
"SDR42E1","s954_F_GON_01_ASEReadCounter.table","NW_015090842.1:6235914",49,88,39
"SDR42E1","s954_F_GON_01_ASEReadCounter.table","NW_015090842.1:6235935",48,89,41
"SDR42E1","s954_F_GON_01_ASEReadCounter.table","NW_015090842.1:6235957",47,87,40
"SDR42E1","s954_F_GON_01_ASEReadCounter.table","NW_015090842.1:6236040",41,74,33
"SDR42E1","s954_F_GON_01_ASEReadCounter.table","NW_015090842.1:6236260",37,64,27
"SDR42E1","s954_F_GON_01_ASEReadCounter.table","NW_015090842.1:6236281",38,71,33
"SDR42E1","s954_F_GON_01_ASEReadCounter.table","NW_015090842.1:6236305",46,78,32
"SDR42E1","s954_F_GON_01_ASEReadCounter.table","NW_015090842.1:6236458",35,74,39
"SDR42E1","s954_F_GON_01_ASEReadCounter.table","NW_015090842.1:6236476",43,87,44
"SDR42E1","s954_F_GON_01_ASEReadCounter.table","NW_015090842.1:6236608",37,71,34
"SDR42E1","s954_F_GON_01_ASEReadCounter.table","NW_015090842.1:6238244",19,41,22
"SDR42E1","s954_F_GON_01_ASEReadCounter.table","NW_015090842.1:6238829",15,32,17
"HSD17B2","s954_F_GON_01_ASEReadCounter.table","NW_015090842.1:6262951",1,2,1
"HSD17B2","s954_F_GON_01_ASEReadCounter.table","NW_015090842.1:6262974",2,4,2
"HSD17B2","s954_F_GON_01_ASEReadCounter.table","NW_015090842.1:6266125",4,5,1
"HSD17B2","s954_F_GON_01_ASEReadCounter.table","NW_015090842.1:6266135",5,7,2
"HSD17B2","s954_F_GON_01_ASEReadCounter.table","NW_015090842.1:6266795",2,4,2
"HSD17B2","s954_F_GON_01_ASEReadCounter.table","NW_015090842.1:6266944",5,7,2
"HSD17B2","s954_F_GON_01_ASEReadCounter.table","NW_015090842.1:6267053",2,7,5
"HSD17B2","s954_F_GON_01_ASEReadCounter.table","NW_015090842.1:6267196",0,3,3
"HSD17B2","s954_F_GON_01_ASEReadCounter.table","NW_015090842.1:6267273",3,7,4
"HSD17B2","s954_F_GON_01_ASEReadCounter.table","NW_015090842.1:6267674",0,1,1
"HSD17B2","s954_F_GON_01_ASEReadCounter.table","NW_015090842.1:6267913",1,4,3
"HSD17B2","s954_F_GON_01_ASEReadCounter.table","NW_015090842.1:6268098",0,2,2
"HSD17B2","s954_F_GON_01_ASEReadCounter.table","NW_015090842.1:6268203",1,6,5
"ARY2","s954_F_GON_01_ASEReadCounter.table","NW_015090842.1:6303922",24,24,0
"ARY2","s954_F_GON_01_ASEReadCounter.table","NW_015090842.1:6303954",28,28,0
"ARY2","s954_F_GON_01_ASEReadCounter.table","NW_015090842.1:6303979",28,30,2
"ARY2","s954_F_GON_01_ASEReadCounter.table","NW_015090842.1:6305848",26,28,2
"ARY2","s954_F_GON_01_ASEReadCounter.table","NW_015090842.1:6305856",23,25,2
"ARY2","s954_F_GON_01_ASEReadCounter.table","NW_015090842.1:6305857",23,25,2
"ARY2","s954_F_GON_01_ASEReadCounter.table","NW_015090842.1:6306017",18,20,2
"ARY2","s954_F_GON_01_ASEReadCounter.table","NW_015090842.1:6306052",15,16,1
"ARY2","s954_F_GON_01_ASEReadCounter.table","NW_015090842.1:6306094",17,19,2
"ARY2","s954_F_GON_01_ASEReadCounter.table","NW_015090842.1:6306100",19,21,2
"ARY2","s954_F_GON_01_ASEReadCounter.table","NW_015090842.1:6306146",19,20,1
"ARY2","s954_F_GON_01_ASEReadCounter.table","NW_015090842.1:6306147",19,20,1
"ARY2","s954_F_GON_01_ASEReadCounter.table","NW_015090842.1:6306390",27,29,2
"ARY2","s954_F_GON_01_ASEReadCounter.table","NW_015090842.1:6306567",15,16,1
"ARY2","s954_F_GON_01_ASEReadCounter.table","NW_015090842.1:6306705",1,1,0
"ARY2","s954_F_GON_01_ASEReadCounter.table","NW_015090842.1:6307039",1,1,0
"ARY2","s954_F_GON_01_ASEReadCounter.table","NW_015090842.1:6307043",1,1,0
"ARY2","s954_F_GON_01_ASEReadCounter.table","NW_015090842.1:6307093",1,1,0
"ARY2","s954_F_GON_01_ASEReadCounter.table","NW_015090842.1:6307187",1,1,0
"ARY2","s954_F_GON_01_ASEReadCounter.table","NW_015090842.1:6307204",1,1,0
"ARY2","s954_F_GON_01_ASEReadCounter.table","NW_015090842.1:6307278",9,11,2
"ARY2","s954_F_GON_01_ASEReadCounter.table","NW_015090842.1:6307305",7,10,3
"ARY2","s954_F_GON_01_ASEReadCounter.table","NW_015090842.1:6307318",6,9,3
"ARY2","s954_F_GON_01_ASEReadCounter.table","NW_015090842.1:6307429",3,7,4
"ARY2","s954_F_GON_01_ASEReadCounter.table","NW_015090842.1:6307670",0,1,1
"ARYL","s954_F_GON_01_ASEReadCounter.table","NW_015090842.1:6313360",3,12,9
"ARYL","s954_F_GON_01_ASEReadCounter.table","NW_015090842.1:6313377",4,13,9
"ARYL","s954_F_GON_01_ASEReadCounter.table","NW_015090842.1:6313767",3,5,2
"ARY1","s954_F_GON_01_ASEReadCounter.table","NW_015090842.1:6314296",3,8,5
"ARY1","s954_F_GON_01_ASEReadCounter.table","NW_015090842.1:6314541",3,5,2
"ARY1","s954_F_GON_01_ASEReadCounter.table","NW_015090842.1:6314597",2,6,4
"ARY1","s954_F_GON_01_ASEReadCounter.table","NW_015090842.1:6314750",3,11,8
"ARY1","s954_F_GON_01_ASEReadCounter.table","NW_015090842.1:6314794",7,12,5
"ARY1","s954_F_GON_01_ASEReadCounter.table","NW_015090842.1:6314827",7,14,7
"ARY1","s954_F_GON_01_ASEReadCounter.table","NW_015090842.1:6314859",9,16,7
"ARY1","s954_F_GON_01_ASEReadCounter.table","NW_015090842.1:6314886",8,16,8
"ARY1","s954_F_GON_01_ASEReadCounter.table","NW_015090842.1:6315022",5,11,6
"ARY1","s954_F_GON_01_ASEReadCounter.table","NW_015090842.1:6315026",5,11,6
"ARY1","s954_F_GON_01_ASEReadCounter.table","NW_015090842.1:6315043",6,11,5
"ARY1","s954_F_GON_01_ASEReadCounter.table","NW_015090842.1:6315065",8,10,2
"ARY1","s954_F_GON_01_ASEReadCounter.table","NW_015090842.1:6315409",4,6,2
"ARY1","s954_F_GON_01_ASEReadCounter.table","NW_015090842.1:6315479",9,12,3
"ARY1","s954_F_GON_01_ASEReadCounter.table","NW_015090842.1:6318342",10,14,4
"ARY1","s954_F_GON_01_ASEReadCounter.table","NW_015090842.1:6318427",13,19,6
"ARY1","s954_F_GON_01_ASEReadCounter.table","NW_015090842.1:6318603",10,19,9
"ARY1","s954_F_GON_01_ASEReadCounter.table","NW_015090842.1:6318708",6,12,6
"ARY1","s954_F_GON_01_ASEReadCounter.table","NW_015090842.1:6318858",8,17,9
"ARY1","s954_F_GON_01_ASEReadCounter.table","NW_015090842.1:6318952",11,23,12
"MPHOSPH6","s954_F_GON_01_ASEReadCounter.table","NW_015090842.1:6324063",18,30,12
"MPHOSPH6","s954_F_GON_01_ASEReadCounter.table","NW_015090842.1:6324174",34,62,28
"MPHOSPH6","s954_F_GON_01_ASEReadCounter.table","NW_015090842.1:6324270",37,75,38
"MPHOSPH6","s954_F_GON_01_ASEReadCounter.table","NW_015090842.1:6324762",43,86,43
"MPHOSPH6","s954_F_GON_01_ASEReadCounter.table","NW_015090842.1:6324780",39,76,37
"MPHOSPH6","s954_F_GON_01_ASEReadCounter.table","NW_015090842.1:6324902",36,84,48
"MPHOSPH6","s954_F_GON_01_ASEReadCounter.table","NW_015090842.1:6325066",36,74,38
"MPHOSPH6","s954_F_GON_01_ASEReadCounter.table","NW_015090842.1:6325089",44,97,53
"MPHOSPH6","s954_F_GON_01_ASEReadCounter.table","NW_015090842.1:6325877",74,147,73
"MPHOSPH6","s954_F_GON_01_ASEReadCounter.table","NW_015090842.1:6326976",47,118,71
"CDH13","s954_F_GON_01_ASEReadCounter.table","NW_015090842.1:6662283",1,4,3
"CDH13","s954_F_GON_01_ASEReadCounter.table","NW_015090842.1:6693665",1,4,3
"CDH13","s954_F_GON_01_ASEReadCounter.table","NW_015090842.1:6693697",0,1,1
"CDH13","s954_F_GON_01_ASEReadCounter.table","NW_015090842.1:6693738",1,1,0
"CDH13","s954_F_GON_01_ASEReadCounter.table","NW_015090842.1:6823730",4,6,2
"CDH13","s954_F_GON_01_ASEReadCounter.table","NW_015090842.1:6889713",2,7,5
"CDH13","s954_F_GON_01_ASEReadCounter.table","NW_015090842.1:6955167",7,10,3
"MLYCD","s954_F_GON_01_ASEReadCounter.table","NW_015090842.1:7150054",22,41,19
"MLYCD","s954_F_GON_01_ASEReadCounter.table","NW_015090842.1:7150131",39,79,40
"MLYCD","s954_F_GON_01_ASEReadCounter.table","NW_015090842.1:7150585",32,76,44
"MLYCD","s954_F_GON_01_ASEReadCounter.table","NW_015090842.1:7150686",21,45,24
"MLYCD","s954_F_GON_01_ASEReadCounter.table","NW_015090842.1:7150696",25,53,28
"MLYCD","s954_F_GON_01_ASEReadCounter.table","NW_015090842.1:7150869",24,48,24
"MLYCD","s954_F_GON_01_ASEReadCounter.table","NW_015090842.1:7151100",30,61,31
"MLYCD","s954_F_GON_01_ASEReadCounter.table","NW_015090842.1:7151127",25,59,34
"MLYCD","s954_F_GON_01_ASEReadCounter.table","NW_015090842.1:7157538",18,54,36
"MLYCD","s954_F_GON_01_ASEReadCounter.table","NW_015090842.1:7167662",11,20,9
"MLYCD","s954_F_GON_01_ASEReadCounter.table","NW_015090842.1:7167675",12,21,9
"MLYCD","s954_F_GON_01_ASEReadCounter.table","NW_015090842.1:7167710",9,18,9
"MLYCD","s954_F_GON_01_ASEReadCounter.table","NW_015090842.1:7167781",9,12,3
"MLYCD","s954_F_GON_01_ASEReadCounter.table","NW_015090842.1:7167803",6,10,4
"MLYCD","s954_F_GON_01_ASEReadCounter.table","NW_015090842.1:7167812",4,7,3
"MLYCD","s954_F_GON_01_ASEReadCounter.table","NW_015090842.1:7167845",6,11,5
"MLYCD","s954_F_GON_01_ASEReadCounter.table","NW_015090842.1:7167862",5,12,7
"MLYCD","s954_F_GON_01_ASEReadCounter.table","NW_015090842.1:7167929",5,15,10
"MLYCD","s954_F_GON_01_ASEReadCounter.table","NW_015090842.1:7167995",7,14,7
"MLYCD","s954_F_GON_01_ASEReadCounter.table","NW_015090842.1:7168005",7,14,7
"MLYCD","s954_F_GON_01_ASEReadCounter.table","NW_015090842.1:7168037",5,11,6
"HSBP1","s954_F_GON_01_ASEReadCounter.table","NW_015090842.1:7245192",108,208,100
"HSBP1","s954_F_GON_01_ASEReadCounter.table","NW_015090842.1:7245226",117,240,123
"HSBP1","s954_F_GON_01_ASEReadCounter.table","NW_015090842.1:7245257",101,206,105
"HSBP1","s954_F_GON_01_ASEReadCounter.table","NW_015090842.1:7245296",91,212,121
"HSBP1","s954_F_GON_01_ASEReadCounter.table","NW_015090842.1:7245389",134,270,136
"HSBP1","s954_F_GON_01_ASEReadCounter.table","NW_015090842.1:7245400",134,259,125
"HSBP1","s954_F_GON_01_ASEReadCounter.table","NW_015090842.1:7245445",119,239,120
"HSBP1","s954_F_GON_01_ASEReadCounter.table","NW_015090842.1:7245495",130,253,123
"HSBP1","s954_F_GON_01_ASEReadCounter.table","NW_015090842.1:7245733",92,183,91
"HSBP1","s954_F_GON_01_ASEReadCounter.table","NW_015090842.1:7245771",104,191,87
"HSBP1","s954_F_GON_01_ASEReadCounter.table","NW_015090842.1:7245813",98,174,76
"HSBP1","s954_F_GON_01_ASEReadCounter.table","NW_015090842.1:7245926",113,220,107
"HSBP1","s954_F_GON_01_ASEReadCounter.table","NW_015090842.1:7245927",112,220,108
"HSBP1","s954_F_GON_01_ASEReadCounter.table","NW_015090842.1:7245933",116,219,103
"HSBP1","s954_F_GON_01_ASEReadCounter.table","NW_015090842.1:7246002",79,184,105
"HSBP1","s954_F_GON_01_ASEReadCounter.table","NW_015090842.1:7246094",110,204,94
"HSBP1","s954_F_GON_01_ASEReadCounter.table","NW_015090842.1:7246167",112,199,87
"HSBP1","s954_F_GON_01_ASEReadCounter.table","NW_015090842.1:7246183",108,191,83
"HSBP1","s954_F_GON_01_ASEReadCounter.table","NW_015090842.1:7247285",33,44,11
"HSBP1","s954_F_GON_01_ASEReadCounter.table","NW_015090842.1:7247651",279,597,318
"HSBP1","s954_F_GON_01_ASEReadCounter.table","NW_015090842.1:7247657",274,601,327
"HSBP1","s954_F_GON_01_ASEReadCounter.table","NW_015090842.1:7248520",238,474,236
"HSBP1","s954_F_GON_01_ASEReadCounter.table","NW_015090842.1:7248535",210,396,186
"KCNG4","s954_F_GON_01_ASEReadCounter.table","NW_015090842.1:7282481",16,37,21
"KCNG4","s954_F_GON_01_ASEReadCounter.table","NW_015090842.1:7282500",14,31,17
"KCNG4","s954_F_GON_01_ASEReadCounter.table","NW_015090842.1:7282542",15,31,16
"KCNG4","s954_F_GON_01_ASEReadCounter.table","NW_015090842.1:7282579",12,31,19
"KCNG4","s954_F_GON_01_ASEReadCounter.table","NW_015090842.1:7282630",13,31,18
"KCNG4","s954_F_GON_01_ASEReadCounter.table","NW_015090842.1:7283056",17,35,18
"KCNG4","s954_F_GON_01_ASEReadCounter.table","NW_015090842.1:7283245",9,26,17
"KCNG4","s954_F_GON_01_ASEReadCounter.table","NW_015090842.1:7301195",6,15,9
"KCNG4","s954_F_GON_01_ASEReadCounter.table","NW_015090842.1:7301227",8,21,13
"KCNG4","s954_F_GON_01_ASEReadCounter.table","NW_015090842.1:7301240",11,25,14
"KCNG4","s954_F_GON_01_ASEReadCounter.table","NW_015090842.1:7301413",9,20,11
"WFDC1","s954_F_GON_01_ASEReadCounter.table","NW_015090842.1:7366517",2,5,3
"WFDC1","s954_F_GON_01_ASEReadCounter.table","NW_015090842.1:7373367",3,7,4
"WFDC1","s954_F_GON_01_ASEReadCounter.table","NW_015090842.1:7375828",5,9,4
"WFDC1","s954_F_GON_01_ASEReadCounter.table","NW_015090842.1:7378036",6,14,8
"WFDC1","s954_F_GON_01_ASEReadCounter.table","NW_015090842.1:7379125",3,7,4
"WFDC1","s954_F_GON_01_ASEReadCounter.table","NW_015090842.1:7379451",4,9,5
"WFDC1","s954_F_GON_01_ASEReadCounter.table","NW_015090842.1:7379471",4,11,7
"WFDC1","s954_F_GON_01_ASEReadCounter.table","NW_015090842.1:7379576",4,10,6
"WFDC1","s954_F_GON_01_ASEReadCounter.table","NW_015090842.1:7379596",4,10,6
"WFDC1","s954_F_GON_01_ASEReadCounter.table","NW_015090842.1:7379605",4,10,6
"WFDC1","s954_F_GON_01_ASEReadCounter.table","NW_015090842.1:7379626",5,9,4
"WFDC1","s954_F_GON_01_ASEReadCounter.table","NW_015090842.1:7379631",2,5,3
"WFDC1","s954_F_GON_01_ASEReadCounter.table","NW_015090842.1:7379632",3,6,3
"WFDC1","s954_F_GON_01_ASEReadCounter.table","NW_015090842.1:7379652",5,9,4
"WFDC1","s954_F_GON_01_ASEReadCounter.table","NW_015090842.1:7379669",5,8,3
"WFDC1","s954_F_GON_01_ASEReadCounter.table","NW_015090842.1:7379674",5,8,3
"WFDC1","s954_F_GON_01_ASEReadCounter.table","NW_015090842.1:7379719",2,6,4
"WFDC1","s954_F_GON_01_ASEReadCounter.table","NW_015090842.1:7379735",2,6,4
"WFDC1","s954_F_GON_01_ASEReadCounter.table","NW_015090842.1:7379739",1,5,4
"WFDC1","s954_F_GON_01_ASEReadCounter.table","NW_015090842.1:7379821",5,8,3
"WFDC1","s954_F_GON_01_ASEReadCounter.table","NW_015090842.1:7379840",6,10,4
"WFDC1","s954_F_GON_01_ASEReadCounter.table","NW_015090842.1:7379933",3,7,4
"WFDC1","s954_F_GON_01_ASEReadCounter.table","NW_015090842.1:7379935",4,8,4
"WFDC1","s954_F_GON_01_ASEReadCounter.table","NW_015090842.1:7379983",5,9,4
"WFDC1","s954_F_GON_01_ASEReadCounter.table","NW_015090842.1:7380060",6,12,6
"WFDC1","s954_F_GON_01_ASEReadCounter.table","NW_015090842.1:7380136",2,5,3
"WFDC1","s954_F_GON_01_ASEReadCounter.table","NW_015090842.1:7380150",2,7,5
"WFDC1","s954_F_GON_01_ASEReadCounter.table","NW_015090842.1:7380164",2,6,4
"WFDC1","s954_F_GON_01_ASEReadCounter.table","NW_015090842.1:7380237",6,13,7
"WFDC1","s954_F_GON_01_ASEReadCounter.table","NW_015090842.1:7380261",6,14,8
"WFDC1","s954_F_GON_01_ASEReadCounter.table","NW_015090842.1:7380322",4,13,9
"WFDC1","s954_F_GON_01_ASEReadCounter.table","NW_015090842.1:7380491",3,8,5
"WFDC1","s954_F_GON_01_ASEReadCounter.table","NW_015090842.1:7380567",2,7,5
"WFDC1","s954_F_GON_01_ASEReadCounter.table","NW_015090842.1:7380672",4,7,3
"WFDC1","s954_F_GON_01_ASEReadCounter.table","NW_015090842.1:7380721",6,13,7
"WFDC1","s954_F_GON_01_ASEReadCounter.table","NW_015090842.1:7380743",6,13,7
"WFDC1","s954_F_GON_01_ASEReadCounter.table","NW_015090842.1:7380852",1,6,5
"WFDC1","s954_F_GON_01_ASEReadCounter.table","NW_015090842.1:7380878",1,8,7
"WFDC1","s954_F_GON_01_ASEReadCounter.table","NW_015090842.1:7381081",4,20,16
"WFDC1","s954_F_GON_01_ASEReadCounter.table","NW_015090842.1:7381127",7,20,13
"WFDC1","s954_F_GON_01_ASEReadCounter.table","NW_015090842.1:7381195",1,12,11
"WFDC1","s954_F_GON_01_ASEReadCounter.table","NW_015090842.1:7381253",4,12,8
"WFDC1","s954_F_GON_01_ASEReadCounter.table","NW_015090842.1:7381378",3,12,9
"WFDC1","s954_F_GON_01_ASEReadCounter.table","NW_015090842.1:7381433",6,16,10
"WFDC1","s954_F_GON_01_ASEReadCounter.table","NW_015090842.1:7381434",6,16,10
"WFDC1","s954_F_GON_01_ASEReadCounter.table","NW_015090842.1:7381442",6,16,10
"WFDC1","s954_F_GON_01_ASEReadCounter.table","NW_015090842.1:7381517",2,8,6
"WFDC1","s954_F_GON_01_ASEReadCounter.table","NW_015090842.1:7381520",3,9,6
"WFDC1","s954_F_GON_01_ASEReadCounter.table","NW_015090842.1:7381677",1,6,5
"WFDC1","s954_F_GON_01_ASEReadCounter.table","NW_015090842.1:7381709",0,4,4
"ATP2C2","s954_F_GON_01_ASEReadCounter.table","NW_015090842.1:7395230",1,1,0
"ATP2C2","s954_F_GON_01_ASEReadCounter.table","NW_015090842.1:7395366",1,2,1
"ATP2C2","s954_F_GON_01_ASEReadCounter.table","NW_015090842.1:7396756",1,3,2
"ATP2C2","s954_F_GON_01_ASEReadCounter.table","NW_015090842.1:7397049",0,6,6
"ATP2C2","s954_F_GON_01_ASEReadCounter.table","NW_015090842.1:7398395",0,5,5
"ATP2C2","s954_F_GON_01_ASEReadCounter.table","NW_015090842.1:7399774",1,5,4
"ATP2C2","s954_F_GON_01_ASEReadCounter.table","NW_015090842.1:7402554",1,4,3
"ATP2C2","s954_F_GON_01_ASEReadCounter.table","NW_015090842.1:7402578",1,7,6
"ATP2C2","s954_F_GON_01_ASEReadCounter.table","NW_015090842.1:7405621",0,2,2
"ATP2C2","s954_F_GON_01_ASEReadCounter.table","NW_015090842.1:7413855",2,2,0
"TLDC1","s954_F_GON_01_ASEReadCounter.table","NW_015090842.1:7421137",13,19,6
"TLDC1","s954_F_GON_01_ASEReadCounter.table","NW_015090842.1:7421155",15,24,9
"TLDC1","s954_F_GON_01_ASEReadCounter.table","NW_015090842.1:7421218",18,27,9
"TLDC1","s954_F_GON_01_ASEReadCounter.table","NW_015090842.1:7421399",13,22,9
"TLDC1","s954_F_GON_01_ASEReadCounter.table","NW_015090842.1:7421402",12,21,9
"TLDC1","s954_F_GON_01_ASEReadCounter.table","NW_015090842.1:7421528",23,37,14
"TLDC1","s954_F_GON_01_ASEReadCounter.table","NW_015090842.1:7421532",24,38,14
"TLDC1","s954_F_GON_01_ASEReadCounter.table","NW_015090842.1:7421621",12,29,17
"TLDC1","s954_F_GON_01_ASEReadCounter.table","NW_015090842.1:7421647",10,27,17
"TLDC1","s954_F_GON_01_ASEReadCounter.table","NW_015090842.1:7421657",10,27,17
"TLDC1","s954_F_GON_01_ASEReadCounter.table","NW_015090842.1:7421693",12,26,14
"TLDC1","s954_F_GON_01_ASEReadCounter.table","NW_015090842.1:7421796",15,32,17
"TLDC1","s954_F_GON_01_ASEReadCounter.table","NW_015090842.1:7421810",16,36,20
"TLDC1","s954_F_GON_01_ASEReadCounter.table","NW_015090842.1:7421833",14,34,20
"TLDC1","s954_F_GON_01_ASEReadCounter.table","NW_015090842.1:7421879",15,37,22
"TLDC1","s954_F_GON_01_ASEReadCounter.table","NW_015090842.1:7421914",17,41,24
"TLDC1","s954_F_GON_01_ASEReadCounter.table","NW_015090842.1:7421969",9,21,12
"TLDC1","s954_F_GON_01_ASEReadCounter.table","NW_015090842.1:7422015",6,19,13
"TLDC1","s954_F_GON_01_ASEReadCounter.table","NW_015090842.1:7422042",8,22,14
"TLDC1","s954_F_GON_01_ASEReadCounter.table","NW_015090842.1:7422230",17,32,15
"TLDC1","s954_F_GON_01_ASEReadCounter.table","NW_015090842.1:7423349",21,29,8
"TLDC1","s954_F_GON_01_ASEReadCounter.table","NW_015090842.1:7423362",21,31,10
"TLDC1","s954_F_GON_01_ASEReadCounter.table","NW_015090842.1:7426091",11,20,9
"TLDC1","s954_F_GON_01_ASEReadCounter.table","NW_015090842.1:7426485",20,30,10
"TLDC1","s954_F_GON_01_ASEReadCounter.table","NW_015090842.1:7427211",14,27,13
"TLDC1","s954_F_GON_01_ASEReadCounter.table","NW_015090842.1:7428179",9,19,10
"COTL1","s954_F_GON_01_ASEReadCounter.table","NW_015090842.1:7490744",18,36,18
"COTL1","s954_F_GON_01_ASEReadCounter.table","NW_015090842.1:7491051",17,46,29
"COTL1","s954_F_GON_01_ASEReadCounter.table","NW_015090842.1:7491124",19,40,21
"COTL1","s954_F_GON_01_ASEReadCounter.table","NW_015090842.1:7491418",19,30,11
"COTL1","s954_F_GON_01_ASEReadCounter.table","NW_015090842.1:7491539",7,28,21
"COTL1","s954_F_GON_01_ASEReadCounter.table","NW_015090842.1:7491585",15,35,20
"COTL1","s954_F_GON_01_ASEReadCounter.table","NW_015090842.1:7491586",15,40,25
"COTL1","s954_F_GON_01_ASEReadCounter.table","NW_015090842.1:7491646",16,49,33
"COTL1","s954_F_GON_01_ASEReadCounter.table","NW_015090842.1:7491747",19,41,22
"COTL1","s954_F_GON_01_ASEReadCounter.table","NW_015090842.1:7491803",26,45,19
"COTL1","s954_F_GON_01_ASEReadCounter.table","NW_015090842.1:7506078",1,1,0
"COTL1","s954_F_GON_01_ASEReadCounter.table","NW_015090842.1:7507551",3,5,2
"COTL1","s954_F_GON_01_ASEReadCounter.table","NW_015090842.1:7507563",2,3,1
"COTL1","s954_F_GON_01_ASEReadCounter.table","NW_015090842.1:7510900",2,5,3
"COTL1","s954_F_GON_01_ASEReadCounter.table","NW_015090842.1:7513196",5,8,3
"COTL1","s954_F_GON_01_ASEReadCounter.table","NW_015090842.1:7513223",5,7,2
"COTL1","s954_F_GON_01_ASEReadCounter.table","NW_015090842.1:7513239",5,6,1
"KLHL36","s954_F_GON_01_ASEReadCounter.table","NW_015090842.1:7514700",3,5,2
"KLHL36","s954_F_GON_01_ASEReadCounter.table","NW_015090842.1:7519691",0,1,1
"KLHL36","s954_F_GON_01_ASEReadCounter.table","NW_015090842.1:7519696",0,1,1
"KLHL36","s954_F_GON_01_ASEReadCounter.table","NW_015090842.1:7526160",2,7,5
"KLHL36","s954_F_GON_01_ASEReadCounter.table","NW_015090842.1:7526469",4,7,3
"KLHL36","s954_F_GON_01_ASEReadCounter.table","NW_015090842.1:7526587",2,9,7
"KLHL36","s954_F_GON_01_ASEReadCounter.table","NW_015090842.1:7526997",1,2,1
"KLHL36","s954_F_GON_01_ASEReadCounter.table","NW_015090842.1:7527142",0,3,3
"KLHL36","s954_F_GON_01_ASEReadCounter.table","NW_015090842.1:7535174",2,9,7
"KLHL36","s954_F_GON_01_ASEReadCounter.table","NW_015090842.1:7535384",3,9,6
"KLHL36","s954_F_GON_01_ASEReadCounter.table","NW_015090842.1:7535420",3,10,7
"KLHL36","s954_F_GON_01_ASEReadCounter.table","NW_015090842.1:7535545",2,4,2
"KLHL36","s954_F_GON_01_ASEReadCounter.table","NW_015090842.1:7535829",3,7,4
"KLHL36","s954_F_GON_01_ASEReadCounter.table","NW_015090842.1:7535977",2,7,5
"KLHL36","s954_F_GON_01_ASEReadCounter.table","NW_015090842.1:7536010",4,10,6
"KLHL36","s954_F_GON_01_ASEReadCounter.table","NW_015090842.1:7536051",3,8,5
"KLHL36","s954_F_GON_01_ASEReadCounter.table","NW_015090842.1:7536096",2,9,7
"KLHL36","s954_F_GON_01_ASEReadCounter.table","NW_015090842.1:7536135",4,8,4
"KLHL36","s954_F_GON_01_ASEReadCounter.table","NW_015090842.1:7536136",4,8,4
"KLHL36","s954_F_GON_01_ASEReadCounter.table","NW_015090842.1:7536160",4,8,4
"KLHL36","s954_F_GON_01_ASEReadCounter.table","NW_015090842.1:7536336",3,8,5
"KLHL36","s954_F_GON_01_ASEReadCounter.table","NW_015090842.1:7536352",3,8,5
"KLHL36","s954_F_GON_01_ASEReadCounter.table","NW_015090842.1:7536412",2,10,8
"KLHL36","s954_F_GON_01_ASEReadCounter.table","NW_015090842.1:7536418",2,11,9
"KLHL36","s954_F_GON_01_ASEReadCounter.table","NW_015090842.1:7536465",1,8,7
"KLHL36","s954_F_GON_01_ASEReadCounter.table","NW_015090842.1:7536466",1,7,6
"KLHL36","s954_F_GON_01_ASEReadCounter.table","NW_015090842.1:7536553",2,8,6
"KLHL36","s954_F_GON_01_ASEReadCounter.table","NW_015090842.1:7536698",5,13,8
"KLHL36","s954_F_GON_01_ASEReadCounter.table","NW_015090842.1:7536713",4,14,10
"KLHL36","s954_F_GON_01_ASEReadCounter.table","NW_015090842.1:7536720",6,14,8
"KLHL36","s954_F_GON_01_ASEReadCounter.table","NW_015090842.1:7536791",4,10,6
"KLHL36","s954_F_GON_01_ASEReadCounter.table","NW_015090842.1:7536849",5,7,2
"KLHL36","s954_F_GON_01_ASEReadCounter.table","NW_015090842.1:7536872",5,9,4
"KLHL36","s954_F_GON_01_ASEReadCounter.table","NW_015090842.1:7536878",5,9,4
"KLHL36","s954_F_GON_01_ASEReadCounter.table","NW_015090842.1:7536916",7,12,5
"KLHL36","s954_F_GON_01_ASEReadCounter.table","NW_015090842.1:7536927",7,13,6
"KLHL36","s954_F_GON_01_ASEReadCounter.table","NW_015090842.1:7537315",6,10,4
"KLHL36","s954_F_GON_01_ASEReadCounter.table","NW_015090842.1:7537352",4,6,2
"KLHL36","s954_F_GON_01_ASEReadCounter.table","NW_015090842.1:7537631",5,13,8
"KLHL36","s954_F_GON_01_ASEReadCounter.table","NW_015090842.1:7537830",9,16,7
"KLHL36","s954_F_GON_01_ASEReadCounter.table","NW_015090842.1:7537838",9,16,7
"KLHL36","s954_F_GON_01_ASEReadCounter.table","NW_015090842.1:7538153",5,12,7
"KLHL36","s954_F_GON_01_ASEReadCounter.table","NW_015090842.1:7538256",5,8,3
"KLHL36","s954_F_GON_01_ASEReadCounter.table","NW_015090842.1:7538265",5,8,3
"KLHL36","s954_F_GON_01_ASEReadCounter.table","NW_015090842.1:7538300",6,9,3
"USP10","s954_F_GON_01_ASEReadCounter.table","NW_015090842.1:7563972",2,5,3
"USP10","s954_F_GON_01_ASEReadCounter.table","NW_015090842.1:7571816",5,22,17
"USP10","s954_F_GON_01_ASEReadCounter.table","NW_015090842.1:7571993",17,26,9
"USP10","s954_F_GON_01_ASEReadCounter.table","NW_015090842.1:7572580",17,34,17
"USP10","s954_F_GON_01_ASEReadCounter.table","NW_015090842.1:7587372",32,67,35
"CRISPLD2","s954_F_GON_01_ASEReadCounter.table","NW_015090842.1:7604605",5,6,1
"CRISPLD2","s954_F_GON_01_ASEReadCounter.table","NW_015090842.1:7609844",5,5,0
"CRISPLD2","s954_F_GON_01_ASEReadCounter.table","NW_015090842.1:7609845",5,5,0
"CRISPLD2","s954_F_GON_01_ASEReadCounter.table","NW_015090842.1:7609883",5,5,0
"CRISPLD2","s954_F_GON_01_ASEReadCounter.table","NW_015090842.1:7610084",7,8,1
"CRISPLD2","s954_F_GON_01_ASEReadCounter.table","NW_015090842.1:7617757",2,4,2
"CRISPLD2","s954_F_GON_01_ASEReadCounter.table","NW_015090842.1:7617781",5,7,2
"CRISPLD2","s954_F_GON_01_ASEReadCounter.table","NW_015090842.1:7617790",4,6,2
"CRISPLD2","s954_F_GON_01_ASEReadCounter.table","NW_015090842.1:7621452",3,4,1
"CRISPLD2","s954_F_GON_01_ASEReadCounter.table","NW_015090842.1:7625451",13,13,0
"CRISPLD2","s954_F_GON_01_ASEReadCounter.table","NW_015090842.1:7626214",6,7,1
"CRISPLD2","s954_F_GON_01_ASEReadCounter.table","NW_015090842.1:7630784",9,9,0
"CRISPLD2","s954_F_GON_01_ASEReadCounter.table","NW_015090842.1:7630823",5,5,0
"CRISPLD2","s954_F_GON_01_ASEReadCounter.table","NW_015090842.1:7633172",5,5,0
"CRISPLD2","s954_F_GON_01_ASEReadCounter.table","NW_015090842.1:7633326",8,9,1
"CRISPLD2","s954_F_GON_01_ASEReadCounter.table","NW_015090842.1:7633336",8,11,3
"CRISPLD2","s954_F_GON_01_ASEReadCounter.table","NW_015090842.1:7633381",7,10,3
"CRISPLD2","s954_F_GON_01_ASEReadCounter.table","NW_015090842.1:7633388",8,11,3
"CRISPLD2","s954_F_GON_01_ASEReadCounter.table","NW_015090842.1:7633400",8,11,3
"CRISPLD2","s954_F_GON_01_ASEReadCounter.table","NW_015090842.1:7633486",7,8,1
"CRISPLD2","s954_F_GON_01_ASEReadCounter.table","NW_015090842.1:7633503",9,10,1
"CRISPLD2","s954_F_GON_01_ASEReadCounter.table","NW_015090842.1:7633504",9,10,1
"CRISPLD2","s954_F_GON_01_ASEReadCounter.table","NW_015090842.1:7633557",13,14,1
"CRISPLD2","s954_F_GON_01_ASEReadCounter.table","NW_015090842.1:7633571",14,15,1
"CRISPLD2","s954_F_GON_01_ASEReadCounter.table","NW_015090842.1:7633588",15,16,1
"CRISPLD2","s954_F_GON_01_ASEReadCounter.table","NW_015090842.1:7633617",13,13,0
"CRISPLD2","s954_F_GON_01_ASEReadCounter.table","NW_015090842.1:7633695",18,19,1
"CRISPLD2","s954_F_GON_01_ASEReadCounter.table","NW_015090842.1:7633721",19,20,1
"CRISPLD2","s954_F_GON_01_ASEReadCounter.table","NW_015090842.1:7633888",3,3,0
"CRISPLD2","s954_F_GON_01_ASEReadCounter.table","NW_015090842.1:7633910",5,5,0
"CRISPLD2","s954_F_GON_01_ASEReadCounter.table","NW_015090842.1:7634142",19,20,1
"CRISPLD2","s954_F_GON_01_ASEReadCounter.table","NW_015090842.1:7634417",8,10,2
"CRISPLD2","s954_F_GON_01_ASEReadCounter.table","NW_015090842.1:7634825",14,16,2
"CRISPLD2","s954_F_GON_01_ASEReadCounter.table","NW_015090842.1:7634852",13,14,1
"CRISPLD2","s954_F_GON_01_ASEReadCounter.table","NW_015090842.1:7635009",14,16,2
"CRISPLD2","s954_F_GON_01_ASEReadCounter.table","NW_015090842.1:7635208",16,19,3
"CRISPLD2","s954_F_GON_01_ASEReadCounter.table","NW_015090842.1:7635373",6,8,2
"CRISPLD2","s954_F_GON_01_ASEReadCounter.table","NW_015090842.1:7635525",14,15,1
"CRISPLD2","s954_F_GON_01_ASEReadCounter.table","NW_015090842.1:7635583",19,21,2
"CRISPLD2","s954_F_GON_01_ASEReadCounter.table","NW_015090842.1:7635924",15,15,0
"LOC106888312","s954_F_GON_01_ASEReadCounter.table","NW_015090842.1:7713031",3,4,1
"LOC106888312","s954_F_GON_01_ASEReadCounter.table","NW_015090842.1:7727001",2,7,5
"LOC106888312","s954_F_GON_01_ASEReadCounter.table","NW_015090842.1:7727036",1,5,4
"LOC106888312","s954_F_GON_01_ASEReadCounter.table","NW_015090842.1:7727072",1,5,4
"LOC106888312","s954_F_GON_01_ASEReadCounter.table","NW_015090842.1:7727961",7,8,1
"LOC106888312","s954_F_GON_01_ASEReadCounter.table","NW_015090842.1:7731961",0,1,1
"LOC106888312","s954_F_GON_01_ASEReadCounter.table","NW_015090842.1:7732244",2,8,6
"LOC106888312","s954_F_GON_01_ASEReadCounter.table","NW_015090842.1:7732443",4,6,2
"LOC106888312","s954_F_GON_01_ASEReadCounter.table","NW_015090842.1:7732444",4,6,2
"LOC106888312","s954_F_GON_01_ASEReadCounter.table","NW_015090842.1:7732538",1,1,0
"LOC106888312","s954_F_GON_01_ASEReadCounter.table","NW_015090842.1:7732548",1,1,0
"LOC106888312","s954_F_GON_01_ASEReadCounter.table","NW_015090842.1:7732682",0,1,1
"LOC106888312","s954_F_GON_01_ASEReadCounter.table","NW_015090842.1:7732696",0,2,2
"LOC106888312","s954_F_GON_01_ASEReadCounter.table","NW_015090842.1:7732709",0,2,2
"LOC106888312","s954_F_GON_01_ASEReadCounter.table","NW_015090842.1:7732718",0,2,2
"LOC106888312","s954_F_GON_01_ASEReadCounter.table","NW_015090842.1:7732739",0,2,2
"LOC106888312","s954_F_GON_01_ASEReadCounter.table","NW_015090842.1:7732743",0,2,2
"LOC106888312","s954_F_GON_01_ASEReadCounter.table","NW_015090842.1:7732744",0,2,2
"LOC106888312","s954_F_GON_01_ASEReadCounter.table","NW_015090842.1:7732756",0,2,2
"LOC106888312","s954_F_GON_01_ASEReadCounter.table","NW_015090842.1:7732757",0,2,2
"LOC106888312","s954_F_GON_01_ASEReadCounter.table","NW_015090842.1:7732782",0,2,2
"LOC106888312","s954_F_GON_01_ASEReadCounter.table","NW_015090842.1:7732796",0,2,2
"LOC106888312","s954_F_GON_01_ASEReadCounter.table","NW_015090842.1:7732860",0,2,2
"LOC106888312","s954_F_GON_01_ASEReadCounter.table","NW_015090842.1:7732861",0,2,2
"LOC106888312","s954_F_GON_01_ASEReadCounter.table","NW_015090842.1:7732997",1,1,0
"LOC106888312","s954_F_GON_01_ASEReadCounter.table","NW_015090842.1:7733011",1,1,0
"LOC106888312","s954_F_GON_01_ASEReadCounter.table","NW_015090842.1:7733068",1,1,0
"LOC106888312","s954_F_GON_01_ASEReadCounter.table","NW_015090842.1:7733077",1,1,0
"LOC106888312","s954_F_GON_01_ASEReadCounter.table","NW_015090842.1:7733096",2,2,0
"LOC106888312","s954_F_GON_01_ASEReadCounter.table","NW_015090842.1:7733142",1,1,0
"LOC106888312","s954_F_GON_01_ASEReadCounter.table","NW_015090842.1:7733196",1,1,0
"LOC106888312","s954_F_GON_01_ASEReadCounter.table","NW_015090842.1:7733299",1,1,0
"LOC106888312","s954_F_GON_01_ASEReadCounter.table","NW_015090842.1:7733609",1,1,0
"LOC106888312","s954_F_GON_01_ASEReadCounter.table","NW_015090842.1:7733631",1,1,0
"LOC106888312","s954_F_GON_01_ASEReadCounter.table","NW_015090842.1:7733674",1,1,0
"ZDHHC7","s954_F_GON_01_ASEReadCounter.table","NW_015090842.1:7737199",9,21,12
"ZDHHC7","s954_F_GON_01_ASEReadCounter.table","NW_015090842.1:7737332",8,22,14
"ZDHHC7","s954_F_GON_01_ASEReadCounter.table","NW_015090842.1:7737553",15,25,10
"ZDHHC7","s954_F_GON_01_ASEReadCounter.table","NW_015090842.1:7737920",8,16,8
"ZDHHC7","s954_F_GON_01_ASEReadCounter.table","NW_015090842.1:7737953",5,12,7
"ZDHHC7","s954_F_GON_01_ASEReadCounter.table","NW_015090842.1:7737987",5,10,5
"ZDHHC7","s954_F_GON_01_ASEReadCounter.table","NW_015090842.1:7738068",6,8,2
"ZDHHC7","s954_F_GON_01_ASEReadCounter.table","NW_015090842.1:7738204",6,10,4
"LOC106888097","s954_F_GON_01_ASEReadCounter.table","NW_015090842.1:7767178",4,10,6
"LOC106888097","s954_F_GON_01_ASEReadCounter.table","NW_015090842.1:7767187",5,11,6
"LOC106888097","s954_F_GON_01_ASEReadCounter.table","NW_015090842.1:7768144",4,10,6
"LOC106888097","s954_F_GON_01_ASEReadCounter.table","NW_015090842.1:7768196",7,12,5
"LOC106888097","s954_F_GON_01_ASEReadCounter.table","NW_015090842.1:7769884",7,15,8
"LOC106888097","s954_F_GON_01_ASEReadCounter.table","NW_015090842.1:7769893",6,13,7
"LOC106888097","s954_F_GON_01_ASEReadCounter.table","NW_015090842.1:7770245",10,16,6
"LOC106888097","s954_F_GON_01_ASEReadCounter.table","NW_015090842.1:7772402",10,19,9
"LOC106888097","s954_F_GON_01_ASEReadCounter.table","NW_015090842.1:7772483",7,23,16
"LOC106888097","s954_F_GON_01_ASEReadCounter.table","NW_015090842.1:7772490",8,24,16
"LOC106888097","s954_F_GON_01_ASEReadCounter.table","NW_015090842.1:7774281",4,17,13
"LOC106888097","s954_F_GON_01_ASEReadCounter.table","NW_015090842.1:7774552",14,42,28
"LOC106888097","s954_F_GON_01_ASEReadCounter.table","NW_015090842.1:7774564",14,41,27
"LOC106888097","s954_F_GON_01_ASEReadCounter.table","NW_015090842.1:7774611",6,36,30
"LOC106888097","s954_F_GON_01_ASEReadCounter.table","NW_015090842.1:7774681",9,24,15
"LOC106888097","s954_F_GON_01_ASEReadCounter.table","NW_015090842.1:7774698",7,22,15
"LOC106888097","s954_F_GON_01_ASEReadCounter.table","NW_015090842.1:7774730",4,10,6
"FOXL1","s954_F_GON_01_ASEReadCounter.table","NW_015090842.1:8113043",0,1,1
"FOXC2","s954_F_GON_01_ASEReadCounter.table","NW_015090842.1:8129599",0,2,2
"FOXC2","s954_F_GON_01_ASEReadCounter.table","NW_015090842.1:8129616",0,2,2
"FOXC2","s954_F_GON_01_ASEReadCounter.table","NW_015090842.1:8129715",0,3,3
"FOXC2","s954_F_GON_01_ASEReadCounter.table","NW_015090842.1:8129719",0,3,3
"FOXC2","s954_F_GON_01_ASEReadCounter.table","NW_015090842.1:8130244",1,1,0
"FOXC2","s954_F_GON_01_ASEReadCounter.table","NW_015090842.1:8130472",0,2,2
"FOXC2","s954_F_GON_01_ASEReadCounter.table","NW_015090842.1:8130490",0,2,2
"FOXC2","s954_F_GON_01_ASEReadCounter.table","NW_015090842.1:8130547",0,2,2
"FOXC2","s954_F_GON_01_ASEReadCounter.table","NW_015090842.1:8130550",0,2,2
"FOXC2","s954_F_GON_01_ASEReadCounter.table","NW_015090842.1:8130573",0,1,1
"FOXC2","s954_F_GON_01_ASEReadCounter.table","NW_015090842.1:8130575",0,1,1
"MTHFSD","s954_F_GON_01_ASEReadCounter.table","NW_015090842.1:8140051",52,103,51
"MTHFSD","s954_F_GON_01_ASEReadCounter.table","NW_015090842.1:8142923",111,220,109
"MTHFSD","s954_F_GON_01_ASEReadCounter.table","NW_015090842.1:8143029",125,224,99
"MTHFSD","s954_F_GON_01_ASEReadCounter.table","NW_015090842.1:8152035",78,141,63
"MTHFSD","s954_F_GON_01_ASEReadCounter.table","NW_015090842.1:8152315",44,105,61
"MTHFSD","s954_F_GON_01_ASEReadCounter.table","NW_015090842.1:8152511",39,89,50
"MTHFSD","s954_F_GON_01_ASEReadCounter.table","NW_015090842.1:8152518",39,90,51
"MTHFSD","s954_F_GON_01_ASEReadCounter.table","NW_015090842.1:8152553",42,95,53
"MTHFSD","s954_F_GON_01_ASEReadCounter.table","NW_015090842.1:8152773",23,73,50
"MTHFSD","s954_F_GON_01_ASEReadCounter.table","NW_015090842.1:8152805",28,85,57
"IRF8","s954_F_GON_01_ASEReadCounter.table","NW_015090842.1:8406652",3,6,3
"IRF8","s954_F_GON_01_ASEReadCounter.table","NW_015090842.1:8406703",2,3,1
"IRF8","s954_F_GON_01_ASEReadCounter.table","NW_015090842.1:8406704",2,3,1
"IRF8","s954_F_GON_01_ASEReadCounter.table","NW_015090842.1:8406757",2,2,0
"IRF8","s954_F_GON_01_ASEReadCounter.table","NW_015090842.1:8406778",2,2,0
"IRF8","s954_F_GON_01_ASEReadCounter.table","NW_015090842.1:8406819",2,3,1
"IRF8","s954_F_GON_01_ASEReadCounter.table","NW_015090842.1:8406941",4,7,3
"IRF8","s954_F_GON_01_ASEReadCounter.table","NW_015090842.1:8407008",1,3,2
"IRF8","s954_F_GON_01_ASEReadCounter.table","NW_015090842.1:8407057",1,2,1
"IRF8","s954_F_GON_01_ASEReadCounter.table","NW_015090842.1:8407064",2,2,0
"IRF8","s954_F_GON_01_ASEReadCounter.table","NW_015090842.1:8407069",1,1,0
"IRF8","s954_F_GON_01_ASEReadCounter.table","NW_015090842.1:8407120",2,3,1
"IRF8","s954_F_GON_01_ASEReadCounter.table","NW_015090842.1:8407157",4,5,1
"IRF8","s954_F_GON_01_ASEReadCounter.table","NW_015090842.1:8407203",4,8,4
"IRF8","s954_F_GON_01_ASEReadCounter.table","NW_015090842.1:8407272",2,8,6
"IRF8","s954_F_GON_01_ASEReadCounter.table","NW_015090842.1:8407276",2,9,7
"IRF8","s954_F_GON_01_ASEReadCounter.table","NW_015090842.1:8407303",1,7,6
"IRF8","s954_F_GON_01_ASEReadCounter.table","NW_015090842.1:8407451",1,3,2
"IRF8","s954_F_GON_01_ASEReadCounter.table","NW_015090842.1:8407456",1,3,2
"IRF8","s954_F_GON_01_ASEReadCounter.table","NW_015090842.1:8408564",0,3,3
"IRF8","s954_F_GON_01_ASEReadCounter.table","NW_015090842.1:8408585",4,4,0
"IRF8","s954_F_GON_01_ASEReadCounter.table","NW_015090842.1:8408973",2,4,2
"IRF8","s954_F_GON_01_ASEReadCounter.table","NW_015090842.1:8409060",1,1,0
"IRF8","s954_F_GON_01_ASEReadCounter.table","NW_015090842.1:8409065",1,1,0
"IRF8","s954_F_GON_01_ASEReadCounter.table","NW_015090842.1:8409254",1,1,0
"IRF8","s954_F_GON_01_ASEReadCounter.table","NW_015090842.1:8409255",1,1,0
"IRF8","s954_F_GON_01_ASEReadCounter.table","NW_015090842.1:8409258",1,1,0
"IRF8","s954_F_GON_01_ASEReadCounter.table","NW_015090842.1:8409312",0,3,3
"IRF8","s954_F_GON_01_ASEReadCounter.table","NW_015090842.1:8410216",2,6,4
"IRF8","s954_F_GON_01_ASEReadCounter.table","NW_015090842.1:8410237",2,6,4
"IRF8","s954_F_GON_01_ASEReadCounter.table","NW_015090842.1:8410276",3,3,0
"IRF8","s954_F_GON_01_ASEReadCounter.table","NW_015090842.1:8410813",1,2,1
"IRF8","s954_F_GON_01_ASEReadCounter.table","NW_015090842.1:8410861",2,4,2
"IRF8","s954_F_GON_01_ASEReadCounter.table","NW_015090842.1:8411940",3,5,2
"IRF8","s954_F_GON_01_ASEReadCounter.table","NW_015090842.1:8412006",2,2,0
"DUSP15","s954_F_GON_01_ASEReadCounter.table","NW_015090842.1:8422787",1,1,0
"DUSP15","s954_F_GON_01_ASEReadCounter.table","NW_015090842.1:8422832",1,1,0
"COX4I1","s954_F_GON_01_ASEReadCounter.table","NW_015090842.1:8442258",961,1965,1004
"COX4I1","s954_F_GON_01_ASEReadCounter.table","NW_015090842.1:8442333",828,1664,836
"EMC8","s954_F_GON_01_ASEReadCounter.table","NW_015090842.1:8444046",90,246,156
"EMC8","s954_F_GON_01_ASEReadCounter.table","NW_015090842.1:8444064",80,196,116
"EMC8","s954_F_GON_01_ASEReadCounter.table","NW_015090842.1:8452029",16,58,42
"EMC8","s954_F_GON_01_ASEReadCounter.table","NW_015090842.1:8452116",25,80,55
"EMC8","s954_F_GON_01_ASEReadCounter.table","NW_015090842.1:8452121",27,83,56
"EMC8","s954_F_GON_01_ASEReadCounter.table","NW_015090842.1:8452222",22,53,31
"EMC8","s954_F_GON_01_ASEReadCounter.table","NW_015090842.1:8452244",29,60,31
"EMC8","s954_F_GON_01_ASEReadCounter.table","NW_015090842.1:8452477",10,18,8
"EMC8","s954_F_GON_01_ASEReadCounter.table","NW_015090842.1:8452498",8,16,8
"EMC8","s954_F_GON_01_ASEReadCounter.table","NW_015090842.1:8452535",2,10,8
"EMC8","s954_F_GON_01_ASEReadCounter.table","NW_015090842.1:8452575",2,8,6
"EMC8","s954_F_GON_01_ASEReadCounter.table","NW_015090842.1:8452600",2,10,8
"EMC8","s954_F_GON_01_ASEReadCounter.table","NW_015090842.1:8452616",4,12,8
"EMC8","s954_F_GON_01_ASEReadCounter.table","NW_015090842.1:8452630",5,9,4
"EMC8","s954_F_GON_01_ASEReadCounter.table","NW_015090842.1:8452650",4,10,6
"EMC8","s954_F_GON_01_ASEReadCounter.table","NW_015090842.1:8452678",3,10,7
"EMC8","s954_F_GON_01_ASEReadCounter.table","NW_015090842.1:8452724",2,5,3
"EMC8","s954_F_GON_01_ASEReadCounter.table","NW_015090842.1:8452731",2,6,4
"EMC8","s954_F_GON_01_ASEReadCounter.table","NW_015090842.1:8452743",2,8,6
"EMC8","s954_F_GON_01_ASEReadCounter.table","NW_015090842.1:8452750",2,9,7
"EMC8","s954_F_GON_01_ASEReadCounter.table","NW_015090842.1:8452778",1,9,8
"EMC8","s954_F_GON_01_ASEReadCounter.table","NW_015090842.1:8452783",1,9,8
"EMC8","s954_F_GON_01_ASEReadCounter.table","NW_015090842.1:8452800",1,12,11
"EMC8","s954_F_GON_01_ASEReadCounter.table","NW_015090842.1:8452804",2,14,12
"EMC8","s954_F_GON_01_ASEReadCounter.table","NW_015090842.1:8452812",3,13,10
"EMC8","s954_F_GON_01_ASEReadCounter.table","NW_015090842.1:8452858",7,21,14
"EMC8","s954_F_GON_01_ASEReadCounter.table","NW_015090842.1:8452906",12,24,12
"EMC8","s954_F_GON_01_ASEReadCounter.table","NW_015090842.1:8452913",12,24,12
"EMC8","s954_F_GON_01_ASEReadCounter.table","NW_015090842.1:8453000",14,34,20
"EMC8","s954_F_GON_01_ASEReadCounter.table","NW_015090842.1:8453007",15,36,21
"EMC8","s954_F_GON_01_ASEReadCounter.table","NW_015090842.1:8453058",15,29,14
"EMC8","s954_F_GON_01_ASEReadCounter.table","NW_015090842.1:8453106",15,26,11
"GINS2","s954_F_GON_01_ASEReadCounter.table","NW_015090842.1:8466420",84,105,21
"GINS2","s954_F_GON_01_ASEReadCounter.table","NW_015090842.1:8466424",86,107,21
"GINS2","s954_F_GON_01_ASEReadCounter.table","NW_015090842.1:8466518",91,117,26
"GINS2","s954_F_GON_01_ASEReadCounter.table","NW_015090842.1:8468482",182,254,72
"GINS2","s954_F_GON_01_ASEReadCounter.table","NW_015090842.1:8470290",196,269,73
"GINS2","s954_F_GON_01_ASEReadCounter.table","NW_015090842.1:8470305",187,251,64
"GINS2","s954_F_GON_01_ASEReadCounter.table","NW_015090842.1:8470381",202,258,56
"GINS2","s954_F_GON_01_ASEReadCounter.table","NW_015090842.1:8470418",179,239,60
"GINS2","s954_F_GON_01_ASEReadCounter.table","NW_015090842.1:8470421",161,216,55
"GINS2","s954_F_GON_01_ASEReadCounter.table","NW_015090842.1:8470430",131,191,60
"GINS2","s954_F_GON_01_ASEReadCounter.table","NW_015090842.1:8470433",120,180,60
"GINS2","s954_F_GON_01_ASEReadCounter.table","NW_015090842.1:8470457",66,114,48
"GINS2","s954_F_GON_01_ASEReadCounter.table","NW_015090842.1:8470491",110,153,43
"GINS2","s954_F_GON_01_ASEReadCounter.table","NW_015090842.1:8470548",116,149,33
"GINS2","s954_F_GON_01_ASEReadCounter.table","NW_015090842.1:8470649",88,124,36
"GSE1","s954_F_GON_01_ASEReadCounter.table","NW_015090842.1:8475362",4,7,3
"GSE1","s954_F_GON_01_ASEReadCounter.table","NW_015090842.1:8475961",2,2,0
"GSE1","s954_F_GON_01_ASEReadCounter.table","NW_015090842.1:8476027",1,3,2
"GSE1","s954_F_GON_01_ASEReadCounter.table","NW_015090842.1:8476159",1,2,1
"GSE1","s954_F_GON_01_ASEReadCounter.table","NW_015090842.1:8477442",0,1,1
"GSE1","s954_F_GON_01_ASEReadCounter.table","NW_015090842.1:8477448",0,1,1
"GSE1","s954_F_GON_01_ASEReadCounter.table","NW_015090842.1:8477662",0,1,1
"GSE1","s954_F_GON_01_ASEReadCounter.table","NW_015090842.1:8477933",2,5,3
"GSE1","s954_F_GON_01_ASEReadCounter.table","NW_015090842.1:8477945",2,6,4
"GSE1","s954_F_GON_01_ASEReadCounter.table","NW_015090842.1:8483272",0,3,3
"GSE1","s954_F_GON_01_ASEReadCounter.table","NW_015090842.1:8483411",0,1,1
"GSE1","s954_F_GON_01_ASEReadCounter.table","NW_015090842.1:8483756",1,2,1
"GSE1","s954_F_GON_01_ASEReadCounter.table","NW_015090842.1:8486867",1,3,2
"GSE1","s954_F_GON_01_ASEReadCounter.table","NW_015090842.1:8486939",2,7,5
"GSE1","s954_F_GON_01_ASEReadCounter.table","NW_015090842.1:8486945",1,7,6
"GSE1","s954_F_GON_01_ASEReadCounter.table","NW_015090842.1:8486993",1,5,4
"GSE1","s954_F_GON_01_ASEReadCounter.table","NW_015090842.1:8487062",0,1,1
"GSE1","s954_F_GON_01_ASEReadCounter.table","NW_015090842.1:8488065",2,2,0
"GSE1","s954_F_GON_01_ASEReadCounter.table","NW_015090842.1:8488457",0,1,1
"GSE1","s954_F_GON_01_ASEReadCounter.table","NW_015090842.1:8488463",0,1,1
"GSE1","s954_F_GON_01_ASEReadCounter.table","NW_015090842.1:8488490",3,3,0
"GSE1","s954_F_GON_01_ASEReadCounter.table","NW_015090842.1:8488505",1,3,2
"GSE1","s954_F_GON_01_ASEReadCounter.table","NW_015090842.1:8490180",0,3,3
"KIAA0513","s954_F_GON_01_ASEReadCounter.table","NW_015090842.1:8668363",21,36,15
"KIAA0513","s954_F_GON_01_ASEReadCounter.table","NW_015090842.1:8668387",27,37,10
"KIAA0513","s954_F_GON_01_ASEReadCounter.table","NW_015090842.1:8668390",27,35,8
"KIAA0513","s954_F_GON_01_ASEReadCounter.table","NW_015090842.1:8673107",27,47,20
"KIAA0513","s954_F_GON_01_ASEReadCounter.table","NW_015090842.1:8673147",32,52,20
"KIAA0513","s954_F_GON_01_ASEReadCounter.table","NW_015090842.1:8674661",24,39,15
"KIAA0513","s954_F_GON_01_ASEReadCounter.table","NW_015090842.1:8674685",21,32,11
"KIAA0513","s954_F_GON_01_ASEReadCounter.table","NW_015090842.1:8674730",17,30,13
"KIAA0513","s954_F_GON_01_ASEReadCounter.table","NW_015090842.1:8675525",15,22,7
"KIAA0513","s954_F_GON_01_ASEReadCounter.table","NW_015090842.1:8675561",15,20,5
"KIAA0513","s954_F_GON_01_ASEReadCounter.table","NW_015090842.1:8678608",1,5,4
"KIAA0513","s954_F_GON_01_ASEReadCounter.table","NW_015090842.1:8686508",0,1,1
"KIAA0513","s954_F_GON_01_ASEReadCounter.table","NW_015090842.1:8686521",0,1,1
"KIAA0513","s954_F_GON_01_ASEReadCounter.table","NW_015090842.1:8693642",6,9,3
"KIAA0513","s954_F_GON_01_ASEReadCounter.table","NW_015090842.1:8693712",7,11,4
"KIAA0513","s954_F_GON_01_ASEReadCounter.table","NW_015090842.1:8695794",1,1,0
"FBXO31","s954_F_GON_01_ASEReadCounter.table","NW_015090842.1:8710240",273,610,337
"FBXO31","s954_F_GON_01_ASEReadCounter.table","NW_015090842.1:8710372",227,518,291
"FBXO31","s954_F_GON_01_ASEReadCounter.table","NW_015090842.1:8711239",272,618,346
"FBXO31","s954_F_GON_01_ASEReadCounter.table","NW_015090842.1:8714565",316,684,368
"FBXO31","s954_F_GON_01_ASEReadCounter.table","NW_015090842.1:8716001",209,472,263
"FBXO31","s954_F_GON_01_ASEReadCounter.table","NW_015090842.1:8725050",2,5,3
"FBXO31","s954_F_GON_01_ASEReadCounter.table","NW_015090842.1:8725057",3,6,3
"FBXO31","s954_F_GON_01_ASEReadCounter.table","NW_015090842.1:8725162",3,3,0
"FBXO31","s954_F_GON_01_ASEReadCounter.table","NW_015090842.1:8725163",3,3,0
"FBXO31","s954_F_GON_01_ASEReadCounter.table","NW_015090842.1:8725170",2,2,0
"FBXO31","s954_F_GON_01_ASEReadCounter.table","NW_015090842.1:8725187",1,1,0
"FBXO31","s954_F_GON_01_ASEReadCounter.table","NW_015090842.1:8725188",1,1,0
"FBXO31","s954_F_GON_01_ASEReadCounter.table","NW_015090842.1:8725190",1,1,0
"ZCCHC14","s954_F_GON_01_ASEReadCounter.table","NW_015090842.1:8750174",49,77,28
"ZCCHC14","s954_F_GON_01_ASEReadCounter.table","NW_015090842.1:8750189",69,85,16
"ZCCHC14","s954_F_GON_01_ASEReadCounter.table","NW_015090842.1:8750365",41,66,25
"ZCCHC14","s954_F_GON_01_ASEReadCounter.table","NW_015090842.1:8750433",29,53,24
"ZCCHC14","s954_F_GON_01_ASEReadCounter.table","NW_015090842.1:8750449",23,50,27
"ZCCHC14","s954_F_GON_01_ASEReadCounter.table","NW_015090842.1:8750456",19,43,24
"ZCCHC14","s954_F_GON_01_ASEReadCounter.table","NW_015090842.1:8750497",45,64,19
"ZCCHC14","s954_F_GON_01_ASEReadCounter.table","NW_015090842.1:8750547",47,65,18
"ZCCHC14","s954_F_GON_01_ASEReadCounter.table","NW_015090842.1:8751100",14,16,2
"ZCCHC14","s954_F_GON_01_ASEReadCounter.table","NW_015090842.1:8751374",13,26,13
"ZCCHC14","s954_F_GON_01_ASEReadCounter.table","NW_015090842.1:8751403",19,34,15
"ZCCHC14","s954_F_GON_01_ASEReadCounter.table","NW_015090842.1:8751517",20,36,16
"ZCCHC14","s954_F_GON_01_ASEReadCounter.table","NW_015090842.1:8752060",14,26,12
"ZCCHC14","s954_F_GON_01_ASEReadCounter.table","NW_015090842.1:8752172",16,31,15
"ZCCHC14","s954_F_GON_01_ASEReadCounter.table","NW_015090842.1:8752183",17,31,14
"ZCCHC14","s954_F_GON_01_ASEReadCounter.table","NW_015090842.1:8752198",19,35,16
"ZCCHC14","s954_F_GON_01_ASEReadCounter.table","NW_015090842.1:8752248",25,40,15
"ZCCHC14","s954_F_GON_01_ASEReadCounter.table","NW_015090842.1:8752326",24,34,10
"ZCCHC14","s954_F_GON_01_ASEReadCounter.table","NW_015090842.1:8752393",23,43,20
"ZCCHC14","s954_F_GON_01_ASEReadCounter.table","NW_015090842.1:8752914",7,20,13
"ZCCHC14","s954_F_GON_01_ASEReadCounter.table","NW_015090842.1:8753528",7,14,7
"ZCCHC14","s954_F_GON_01_ASEReadCounter.table","NW_015090842.1:8753892",6,14,8
"ZCCHC14","s954_F_GON_01_ASEReadCounter.table","NW_015090842.1:8753910",8,17,9
"ZCCHC14","s954_F_GON_01_ASEReadCounter.table","NW_015090842.1:8755096",7,13,6
"ZCCHC14","s954_F_GON_01_ASEReadCounter.table","NW_015090842.1:8755327",4,8,4
"ZCCHC14","s954_F_GON_01_ASEReadCounter.table","NW_015090842.1:8755723",3,8,5
"ZCCHC14","s954_F_GON_01_ASEReadCounter.table","NW_015090842.1:8755739",1,7,6
"ZCCHC14","s954_F_GON_01_ASEReadCounter.table","NW_015090842.1:8756149",3,8,5
"ZCCHC14","s954_F_GON_01_ASEReadCounter.table","NW_015090842.1:8756347",9,13,4
"ZCCHC14","s954_F_GON_01_ASEReadCounter.table","NW_015090842.1:8756361",7,12,5
"ZCCHC14","s954_F_GON_01_ASEReadCounter.table","NW_015090842.1:8756388",4,6,2
"ZCCHC14","s954_F_GON_01_ASEReadCounter.table","NW_015090842.1:8756389",3,6,3
"ZCCHC14","s954_F_GON_01_ASEReadCounter.table","NW_015090842.1:8757160",11,19,8
"ZCCHC14","s954_F_GON_01_ASEReadCounter.table","NW_015090842.1:8804511",5,12,7
"ZCCHC14","s954_F_GON_01_ASEReadCounter.table","NW_015090842.1:8804979",1,2,1
"JPH3","s954_F_GON_01_ASEReadCounter.table","NW_015090842.1:8872283",1,1,0
"JPH3","s954_F_GON_01_ASEReadCounter.table","NW_015090842.1:8872294",2,2,0
"JPH3","s954_F_GON_01_ASEReadCounter.table","NW_015090842.1:8872730",1,1,0
"JPH3","s954_F_GON_01_ASEReadCounter.table","NW_015090842.1:8885260",0,3,3
"JPH3","s954_F_GON_01_ASEReadCounter.table","NW_015090842.1:8885315",1,2,1
"JPH3","s954_F_GON_01_ASEReadCounter.table","NW_015090842.1:8885328",1,3,2
"JPH3","s954_F_GON_01_ASEReadCounter.table","NW_015090842.1:8885438",0,2,2
"KLHDC4","s954_F_GON_01_ASEReadCounter.table","NW_015090842.1:8890729",81,126,45
"KLHDC4","s954_F_GON_01_ASEReadCounter.table","NW_015090842.1:8890749",98,142,44
"KLHDC4","s954_F_GON_01_ASEReadCounter.table","NW_015090842.1:8890761",104,151,47
"KLHDC4","s954_F_GON_01_ASEReadCounter.table","NW_015090842.1:8891123",169,231,62
"KLHDC4","s954_F_GON_01_ASEReadCounter.table","NW_015090842.1:8893124",93,153,60
"KLHDC4","s954_F_GON_01_ASEReadCounter.table","NW_015090842.1:8894542",104,152,48
"KLHDC4","s954_F_GON_01_ASEReadCounter.table","NW_015090842.1:8896726",76,115,39
"KLHDC4","s954_F_GON_01_ASEReadCounter.table","NW_015090842.1:8896767",72,112,40
"KLHDC4","s954_F_GON_01_ASEReadCounter.table","NW_015090842.1:8904174",54,80,26
"KLHDC4","s954_F_GON_01_ASEReadCounter.table","NW_015090842.1:8904231",49,76,27
"KLHDC4","s954_F_GON_01_ASEReadCounter.table","NW_015090842.1:8905251",42,72,30
"KLHDC4","s954_F_GON_01_ASEReadCounter.table","NW_015090842.1:8905263",49,85,36
"KLHDC4","s954_F_GON_01_ASEReadCounter.table","NW_015090842.1:8919626",8,9,1
"SLC7A5","s954_F_GON_01_ASEReadCounter.table","NW_015090842.1:8938782",65,117,52
"SLC7A5","s954_F_GON_01_ASEReadCounter.table","NW_015090842.1:8938943",48,105,57
"SLC7A5","s954_F_GON_01_ASEReadCounter.table","NW_015090842.1:8939611",23,43,20
"SLC7A5","s954_F_GON_01_ASEReadCounter.table","NW_015090842.1:8939738",45,89,44
"SLC7A5","s954_F_GON_01_ASEReadCounter.table","NW_015090842.1:8939739",45,89,44
"SLC7A5","s954_F_GON_01_ASEReadCounter.table","NW_015090842.1:8939740",45,91,46
"SLC7A5","s954_F_GON_01_ASEReadCounter.table","NW_015090842.1:8939795",50,83,33
"SLC7A5","s954_F_GON_01_ASEReadCounter.table","NW_015090842.1:8939815",45,81,36
"SLC7A5","s954_F_GON_01_ASEReadCounter.table","NW_015090842.1:8939816",45,83,38
"SLC7A5","s954_F_GON_01_ASEReadCounter.table","NW_015090842.1:8939817",46,92,46
"SLC7A5","s954_F_GON_01_ASEReadCounter.table","NW_015090842.1:8939845",56,100,44
"SLC7A5","s954_F_GON_01_ASEReadCounter.table","NW_015090842.1:8939894",38,79,41
"SLC7A5","s954_F_GON_01_ASEReadCounter.table","NW_015090842.1:8939895",38,78,40
"SLC7A5","s954_F_GON_01_ASEReadCounter.table","NW_015090842.1:8939997",129,129,0
"SLC7A5","s954_F_GON_01_ASEReadCounter.table","NW_015090842.1:8940172",43,73,30
"SLC7A5","s954_F_GON_01_ASEReadCounter.table","NW_015090842.1:8940331",20,43,23
"SLC7A5","s954_F_GON_01_ASEReadCounter.table","NW_015090842.1:8940696",20,33,13
"SLC7A5","s954_F_GON_01_ASEReadCounter.table","NW_015090842.1:8940719",18,40,22
"SLC7A5","s954_F_GON_01_ASEReadCounter.table","NW_015090842.1:8940737",20,45,25
"SLC7A5","s954_F_GON_01_ASEReadCounter.table","NW_015090842.1:8940743",21,44,23
"SLC7A5","s954_F_GON_01_ASEReadCounter.table","NW_015090842.1:8940766",27,48,21
"SLC7A5","s954_F_GON_01_ASEReadCounter.table","NW_015090842.1:8940769",27,50,23
"SLC7A5","s954_F_GON_01_ASEReadCounter.table","NW_015090842.1:8940861",29,47,18
"SLC7A5","s954_F_GON_01_ASEReadCounter.table","NW_015090842.1:8941068",38,66,28
"SLC7A5","s954_F_GON_01_ASEReadCounter.table","NW_015090842.1:8941467",20,43,23
"SLC7A5","s954_F_GON_01_ASEReadCounter.table","NW_015090842.1:8941531",25,45,20
"SLC7A5","s954_F_GON_01_ASEReadCounter.table","NW_015090842.1:8941588",32,55,23
"SLC7A5","s954_F_GON_01_ASEReadCounter.table","NW_015090842.1:8941698",29,43,14
"SLC7A5","s954_F_GON_01_ASEReadCounter.table","NW_015090842.1:8941717",31,47,16
"SLC7A5","s954_F_GON_01_ASEReadCounter.table","NW_015090842.1:8941745",29,48,19
"SLC7A5","s954_F_GON_01_ASEReadCounter.table","NW_015090842.1:8941781",31,57,26
"SLC7A5","s954_F_GON_01_ASEReadCounter.table","NW_015090842.1:8941887",16,27,11
"SLC7A5","s954_F_GON_01_ASEReadCounter.table","NW_015090842.1:8941968",8,28,20
"SLC7A5","s954_F_GON_01_ASEReadCounter.table","NW_015090842.1:8942025",13,36,23
"SLC7A5","s954_F_GON_01_ASEReadCounter.table","NW_015090842.1:8942069",25,44,19
"SLC7A5","s954_F_GON_01_ASEReadCounter.table","NW_015090842.1:8942170",23,52,29
"SLC7A5","s954_F_GON_01_ASEReadCounter.table","NW_015090842.1:8942241",28,53,25
"SLC7A5","s954_F_GON_01_ASEReadCounter.table","NW_015090842.1:8942283",34,50,16
"SLC7A5","s954_F_GON_01_ASEReadCounter.table","NW_015090842.1:8942717",35,67,32
"SLC7A5","s954_F_GON_01_ASEReadCounter.table","NW_015090842.1:8942756",37,73,36
"SLC7A5","s954_F_GON_01_ASEReadCounter.table","NW_015090842.1:8942766",39,73,34
"SLC7A5","s954_F_GON_01_ASEReadCounter.table","NW_015090842.1:8943271",32,54,22
"SLC7A5","s954_F_GON_01_ASEReadCounter.table","NW_015090842.1:8943524",28,44,16
"SLC7A5","s954_F_GON_01_ASEReadCounter.table","NW_015090842.1:8943530",27,43,16
"SLC7A5","s954_F_GON_01_ASEReadCounter.table","NW_015090842.1:8943602",31,48,17
"SLC7A5","s954_F_GON_01_ASEReadCounter.table","NW_015090842.1:8943622",26,41,15
"SLC7A5","s954_F_GON_01_ASEReadCounter.table","NW_015090842.1:8943661",22,39,17
"SLC7A5","s954_F_GON_01_ASEReadCounter.table","NW_015090842.1:8943686",24,42,18
"SLC7A5","s954_F_GON_01_ASEReadCounter.table","NW_015090842.1:8943788",26,48,22
"SLC7A5","s954_F_GON_01_ASEReadCounter.table","NW_015090842.1:8943814",24,46,22
"SLC7A5","s954_F_GON_01_ASEReadCounter.table","NW_015090842.1:8943876",19,40,21
"SLC7A5","s954_F_GON_01_ASEReadCounter.table","NW_015090842.1:8943892",19,38,19
"SLC7A5","s954_F_GON_01_ASEReadCounter.table","NW_015090842.1:8944097",17,27,10
"SLC7A5","s954_F_GON_01_ASEReadCounter.table","NW_015090842.1:8944104",16,25,9
"SLC7A5","s954_F_GON_01_ASEReadCounter.table","NW_015090842.1:8944293",14,23,9
"SLC7A5","s954_F_GON_01_ASEReadCounter.table","NW_015090842.1:8944297",16,24,8
"SLC7A5","s954_F_GON_01_ASEReadCounter.table","NW_015090842.1:8944397",13,22,9
"SLC7A5","s954_F_GON_01_ASEReadCounter.table","NW_015090842.1:8944552",18,30,12
"SLC7A5","s954_F_GON_01_ASEReadCounter.table","NW_015090842.1:8944629",19,39,20
"CA5A","s954_F_GON_01_ASEReadCounter.table","NW_015090842.1:8989479",20,49,29
"CA5A","s954_F_GON_01_ASEReadCounter.table","NW_015090842.1:8989562",27,65,38
"CA5A","s954_F_GON_01_ASEReadCounter.table","NW_015090842.1:8989609",28,70,42
"CA5A","s954_F_GON_01_ASEReadCounter.table","NW_015090842.1:8989693",18,70,52
"CA5A","s954_F_GON_01_ASEReadCounter.table","NW_015090842.1:8989702",24,74,50
"CA5A","s954_F_GON_01_ASEReadCounter.table","NW_015090842.1:8989746",24,73,49
"CA5A","s954_F_GON_01_ASEReadCounter.table","NW_015090842.1:8989880",19,67,48
"CA5A","s954_F_GON_01_ASEReadCounter.table","NW_015090842.1:8989885",20,69,49
"CA5A","s954_F_GON_01_ASEReadCounter.table","NW_015090842.1:8989929",31,74,43
"CA5A","s954_F_GON_01_ASEReadCounter.table","NW_015090842.1:8990002",35,75,40
"CA5A","s954_F_GON_01_ASEReadCounter.table","NW_015090842.1:8990004",35,76,41
"CA5A","s954_F_GON_01_ASEReadCounter.table","NW_015090842.1:8990005",35,75,40
"CA5A","s954_F_GON_01_ASEReadCounter.table","NW_015090842.1:8990017",32,68,36
"CA5A","s954_F_GON_01_ASEReadCounter.table","NW_015090842.1:8990043",24,53,29
"CA5A","s954_F_GON_01_ASEReadCounter.table","NW_015090842.1:8990060",56,56,0
"CA5A","s954_F_GON_01_ASEReadCounter.table","NW_015090842.1:8990080",17,52,35
"CA5A","s954_F_GON_01_ASEReadCounter.table","NW_015090842.1:8990084",19,55,36
"CA5A","s954_F_GON_01_ASEReadCounter.table","NW_015090842.1:8990090",21,55,34
"CA5A","s954_F_GON_01_ASEReadCounter.table","NW_015090842.1:8990095",21,52,31
"CA5A","s954_F_GON_01_ASEReadCounter.table","NW_015090842.1:8990111",17,46,29
"CA5A","s954_F_GON_01_ASEReadCounter.table","NW_015090842.1:8990112",17,45,28
"CA5A","s954_F_GON_01_ASEReadCounter.table","NW_015090842.1:8990115",19,43,24
"CA5A","s954_F_GON_01_ASEReadCounter.table","NW_015090842.1:8990166",19,42,23
"CA5A","s954_F_GON_01_ASEReadCounter.table","NW_015090842.1:8990169",21,44,23
"CA5A","s954_F_GON_01_ASEReadCounter.table","NW_015090842.1:8990193",49,49,0
"CA5A","s954_F_GON_01_ASEReadCounter.table","NW_015090842.1:8990222",18,46,28
"CA5A","s954_F_GON_01_ASEReadCounter.table","NW_015090842.1:8990289",13,49,36
"CA5A","s954_F_GON_01_ASEReadCounter.table","NW_015090842.1:8990314",13,50,37
"CA5A","s954_F_GON_01_ASEReadCounter.table","NW_015090842.1:8990361",12,40,28
"CA5A","s954_F_GON_01_ASEReadCounter.table","NW_015090842.1:8990368",14,39,25
"CA5A","s954_F_GON_01_ASEReadCounter.table","NW_015090842.1:8990429",13,41,28
"CA5A","s954_F_GON_01_ASEReadCounter.table","NW_015090842.1:8990466",17,40,23
"CA5A","s954_F_GON_01_ASEReadCounter.table","NW_015090842.1:8990663",14,34,20
"CA5A","s954_F_GON_01_ASEReadCounter.table","NW_015090842.1:8990797",12,28,16
"CA5A","s954_F_GON_01_ASEReadCounter.table","NW_015090842.1:8990836",17,34,17
"CA5A","s954_F_GON_01_ASEReadCounter.table","NW_015090842.1:8990842",15,33,18
"CA5A","s954_F_GON_01_ASEReadCounter.table","NW_015090842.1:8990851",16,35,19
"CA5A","s954_F_GON_01_ASEReadCounter.table","NW_015090842.1:8990918",14,32,18
"CA5A","s954_F_GON_01_ASEReadCounter.table","NW_015090842.1:8990921",13,34,21
"CA5A","s954_F_GON_01_ASEReadCounter.table","NW_015090842.1:8990942",17,36,19
"CA5A","s954_F_GON_01_ASEReadCounter.table","NW_015090842.1:8991001",18,37,19
"CA5A","s954_F_GON_01_ASEReadCounter.table","NW_015090842.1:8991038",15,30,15
"CA5A","s954_F_GON_01_ASEReadCounter.table","NW_015090842.1:8991149",13,36,23
"CA5A","s954_F_GON_01_ASEReadCounter.table","NW_015090842.1:8991176",15,38,23
"CA5A","s954_F_GON_01_ASEReadCounter.table","NW_015090842.1:8991241",12,31,19
"CA5A","s954_F_GON_01_ASEReadCounter.table","NW_015090842.1:8991262",12,28,16
"CA5A","s954_F_GON_01_ASEReadCounter.table","NW_015090842.1:8991316",13,16,3
"CA5A","s954_F_GON_01_ASEReadCounter.table","NW_015090842.1:8991319",12,14,2
"CA5A","s954_F_GON_01_ASEReadCounter.table","NW_015090842.1:8991330",11,12,1
"CA5A","s954_F_GON_01_ASEReadCounter.table","NW_015090842.1:8991334",13,14,1
"CA5A","s954_F_GON_01_ASEReadCounter.table","NW_015090842.1:8991362",11,23,12
"CA5A","s954_F_GON_01_ASEReadCounter.table","NW_015090842.1:8991368",13,26,13
"CA5A","s954_F_GON_01_ASEReadCounter.table","NW_015090842.1:8991390",11,24,13
"CA5A","s954_F_GON_01_ASEReadCounter.table","NW_015090842.1:8991395",14,28,14
"CA5A","s954_F_GON_01_ASEReadCounter.table","NW_015090842.1:8991422",15,32,17
"CA5A","s954_F_GON_01_ASEReadCounter.table","NW_015090842.1:8991467",17,35,18
"CA5A","s954_F_GON_01_ASEReadCounter.table","NW_015090842.1:8991576",2,17,15
"CA5A","s954_F_GON_01_ASEReadCounter.table","NW_015090842.1:8991587",2,19,17
"CA5A","s954_F_GON_01_ASEReadCounter.table","NW_015090842.1:8991655",10,26,16
"CA5A","s954_F_GON_01_ASEReadCounter.table","NW_015090842.1:8991717",9,24,15
"CA5A","s954_F_GON_01_ASEReadCounter.table","NW_015090842.1:8991726",10,24,14
"CA5A","s954_F_GON_01_ASEReadCounter.table","NW_015090842.1:8991799",7,19,12
"CA5A","s954_F_GON_01_ASEReadCounter.table","NW_015090842.1:8991809",8,20,12
"CA5A","s954_F_GON_01_ASEReadCounter.table","NW_015090842.1:8991848",8,27,19
"CA5A","s954_F_GON_01_ASEReadCounter.table","NW_015090842.1:8991849",8,27,19
"CA5A","s954_F_GON_01_ASEReadCounter.table","NW_015090842.1:8991927",6,26,20
"CA5A","s954_F_GON_01_ASEReadCounter.table","NW_015090842.1:8991941",7,26,19
"CA5A","s954_F_GON_01_ASEReadCounter.table","NW_015090842.1:8992121",3,8,5
"CA5A","s954_F_GON_01_ASEReadCounter.table","NW_015090842.1:8992224",10,23,13
"CA5A","s954_F_GON_01_ASEReadCounter.table","NW_015090842.1:9002570",22,43,21
"CA5A","s954_F_GON_01_ASEReadCounter.table","NW_015090842.1:9002600",19,33,14
"CA5A","s954_F_GON_01_ASEReadCounter.table","NW_015090842.1:9004312",24,35,11
"CA5A","s954_F_GON_01_ASEReadCounter.table","NW_015090842.1:9004506",11,15,4
"CA5A","s954_F_GON_01_ASEReadCounter.table","NW_015090842.1:9004523",14,17,3
"CA5A","s954_F_GON_01_ASEReadCounter.table","NW_015090842.1:9004530",15,18,3
"CA5A","s954_F_GON_01_ASEReadCounter.table","NW_015090842.1:9004556",21,26,5
"CA5A","s954_F_GON_01_ASEReadCounter.table","NW_015090842.1:9005116",24,51,27
"CA5A","s954_F_GON_01_ASEReadCounter.table","NW_015090842.1:9005120",25,52,27
"CA5A","s954_F_GON_01_ASEReadCounter.table","NW_015090842.1:9005140",21,45,24
"CA5A","s954_F_GON_01_ASEReadCounter.table","NW_015090842.1:9005152",26,50,24
"CA5A","s954_F_GON_01_ASEReadCounter.table","NW_015090842.1:9011011",2,2,0
"BANP","s954_F_GON_01_ASEReadCounter.table","NW_015090842.1:9033407",3,9,6
"BANP","s954_F_GON_01_ASEReadCounter.table","NW_015090842.1:9033409",3,10,7
"BANP","s954_F_GON_01_ASEReadCounter.table","NW_015090842.1:9033420",4,13,9
"BANP","s954_F_GON_01_ASEReadCounter.table","NW_015090842.1:9067974",0,19,19
"BANP","s954_F_GON_01_ASEReadCounter.table","NW_015090842.1:9102510",11,35,24
"BANP","s954_F_GON_01_ASEReadCounter.table","NW_015090842.1:9168534",15,37,22
"BANP","s954_F_GON_01_ASEReadCounter.table","NW_015090842.1:9168818",15,21,6
"ZNF469","s954_F_GON_01_ASEReadCounter.table","NW_015090842.1:9424301",3,4,1
"ZNF469","s954_F_GON_01_ASEReadCounter.table","NW_015090842.1:9424333",3,4,1
"ZNF469","s954_F_GON_01_ASEReadCounter.table","NW_015090842.1:9425089",1,1,0
"ZNF469","s954_F_GON_01_ASEReadCounter.table","NW_015090842.1:9425108",1,1,0
"ZNF469","s954_F_GON_01_ASEReadCounter.table","NW_015090842.1:9426367",0,2,2
"ZNF469","s954_F_GON_01_ASEReadCounter.table","NW_015090842.1:9427067",0,4,4
"ZNF469","s954_F_GON_01_ASEReadCounter.table","NW_015090842.1:9427614",0,1,1
"ZNF469","s954_F_GON_01_ASEReadCounter.table","NW_015090842.1:9428122",2,3,1
"ZNF469","s954_F_GON_01_ASEReadCounter.table","NW_015090842.1:9428178",1,1,0
"ZNF469","s954_F_GON_01_ASEReadCounter.table","NW_015090842.1:9429633",0,1,1
"ZNF469","s954_F_GON_01_ASEReadCounter.table","NW_015090842.1:9429758",0,2,2
"ZNF469","s954_F_GON_01_ASEReadCounter.table","NW_015090842.1:9429759",0,2,2
"ZNF469","s954_F_GON_01_ASEReadCounter.table","NW_015090842.1:9429794",0,2,2
"ZNF469","s954_F_GON_01_ASEReadCounter.table","NW_015090842.1:9430560",0,2,2
"ZNF469","s954_F_GON_01_ASEReadCounter.table","NW_015090842.1:9430668",2,4,2
"ZNF469","s954_F_GON_01_ASEReadCounter.table","NW_015090842.1:9430700",2,6,4
"ZNF469","s954_F_GON_01_ASEReadCounter.table","NW_015090842.1:9431031",1,4,3
"ZNF469","s954_F_GON_01_ASEReadCounter.table","NW_015090842.1:9431073",1,4,3
"ZNF469","s954_F_GON_01_ASEReadCounter.table","NW_015090842.1:9431091",0,1,1
"ZNF469","s954_F_GON_01_ASEReadCounter.table","NW_015090842.1:9431150",1,2,1
"ZNF469","s954_F_GON_01_ASEReadCounter.table","NW_015090842.1:9431162",2,4,2
"ZNF469","s954_F_GON_01_ASEReadCounter.table","NW_015090842.1:9431214",1,3,2
"ZNF469","s954_F_GON_01_ASEReadCounter.table","NW_015090842.1:9431317",2,3,1
"ZNF469","s954_F_GON_01_ASEReadCounter.table","NW_015090842.1:9431325",2,3,1
"ZNF469","s954_F_GON_01_ASEReadCounter.table","NW_015090842.1:9431700",0,1,1
"ZNF469","s954_F_GON_01_ASEReadCounter.table","NW_015090842.1:9431901",2,3,1
"ZNF469","s954_F_GON_01_ASEReadCounter.table","NW_015090842.1:9432110",2,4,2
"ZNF469","s954_F_GON_01_ASEReadCounter.table","NW_015090842.1:9432302",1,3,2
"ZNF469","s954_F_GON_01_ASEReadCounter.table","NW_015090842.1:9432361",2,5,3
"ZNF469","s954_F_GON_01_ASEReadCounter.table","NW_015090842.1:9432374",3,7,4
"ZNF469","s954_F_GON_01_ASEReadCounter.table","NW_015090842.1:9432382",3,7,4
"ZNF469","s954_F_GON_01_ASEReadCounter.table","NW_015090842.1:9432481",2,3,1
"ZNF469","s954_F_GON_01_ASEReadCounter.table","NW_015090842.1:9432498",2,4,2
"ZNF469","s954_F_GON_01_ASEReadCounter.table","NW_015090842.1:9433268",5,6,1
"ZNF469","s954_F_GON_01_ASEReadCounter.table","NW_015090842.1:9433678",3,8,5
"ZNF469","s954_F_GON_01_ASEReadCounter.table","NW_015090842.1:9433902",1,7,6
"ZNF469","s954_F_GON_01_ASEReadCounter.table","NW_015090842.1:9433980",0,6,6
"ZNF469","s954_F_GON_01_ASEReadCounter.table","NW_015090842.1:9434259",2,5,3
"ZNF469","s954_F_GON_01_ASEReadCounter.table","NW_015090842.1:9435221",4,10,6
"ZFPM1","s954_F_GON_01_ASEReadCounter.table","NW_015090842.1:9458862",13,42,29
"ZFPM1","s954_F_GON_01_ASEReadCounter.table","NW_015090842.1:9458888",12,49,37
"ZFPM1","s954_F_GON_01_ASEReadCounter.table","NW_015090842.1:9458904",14,51,37
"ZFPM1","s954_F_GON_01_ASEReadCounter.table","NW_015090842.1:9458916",14,53,39
"ZFPM1","s954_F_GON_01_ASEReadCounter.table","NW_015090842.1:9468568",16,51,35
"ZFPM1","s954_F_GON_01_ASEReadCounter.table","NW_015090842.1:9468593",14,44,30
"ZFPM1","s954_F_GON_01_ASEReadCounter.table","NW_015090842.1:9471561",16,40,24
"ZFPM1","s954_F_GON_01_ASEReadCounter.table","NW_015090842.1:9472557",16,38,22
"ZFPM1","s954_F_GON_01_ASEReadCounter.table","NW_015090842.1:9472565",16,37,21
"ZFPM1","s954_F_GON_01_ASEReadCounter.table","NW_015090842.1:9472608",24,56,32
"ZFPM1","s954_F_GON_01_ASEReadCounter.table","NW_015090842.1:9472627",30,64,34
"ZFPM1","s954_F_GON_01_ASEReadCounter.table","NW_015090842.1:9472668",21,56,35
"ZFPM1","s954_F_GON_01_ASEReadCounter.table","NW_015090842.1:9473655",18,42,24
"ZFPM1","s954_F_GON_01_ASEReadCounter.table","NW_015090842.1:9475827",17,55,38
"ZFPM1","s954_F_GON_01_ASEReadCounter.table","NW_015090842.1:9475842",19,61,42
"ZFPM1","s954_F_GON_01_ASEReadCounter.table","NW_015090842.1:9476119",21,41,20
"ZFPM1","s954_F_GON_01_ASEReadCounter.table","NW_015090842.1:9476161",24,40,16
"ZFPM1","s954_F_GON_01_ASEReadCounter.table","NW_015090842.1:9476219",13,36,23
"ZFPM1","s954_F_GON_01_ASEReadCounter.table","NW_015090842.1:9476233",9,36,27
"ZFPM1","s954_F_GON_01_ASEReadCounter.table","NW_015090842.1:9476305",12,53,41
"ZFPM1","s954_F_GON_01_ASEReadCounter.table","NW_015090842.1:9476395",11,48,37
"ZFPM1","s954_F_GON_01_ASEReadCounter.table","NW_015090842.1:9476421",14,63,49
"ZFPM1","s954_F_GON_01_ASEReadCounter.table","NW_015090842.1:9476539",17,53,36
"ZFPM1","s954_F_GON_01_ASEReadCounter.table","NW_015090842.1:9476576",20,59,39
"ZFPM1","s954_F_GON_01_ASEReadCounter.table","NW_015090842.1:9476599",54,54,0
"ZFPM1","s954_F_GON_01_ASEReadCounter.table","NW_015090842.1:9476792",23,56,33
"ZFPM1","s954_F_GON_01_ASEReadCounter.table","NW_015090842.1:9476803",23,54,31
"ZFPM1","s954_F_GON_01_ASEReadCounter.table","NW_015090842.1:9477115",15,45,30
"ZFPM1","s954_F_GON_01_ASEReadCounter.table","NW_015090842.1:9477299",6,40,34
"ZFPM1","s954_F_GON_01_ASEReadCounter.table","NW_015090842.1:9477398",48,48,0
"ZFPM1","s954_F_GON_01_ASEReadCounter.table","NW_015090842.1:9477422",14,50,36
"ZFPM1","s954_F_GON_01_ASEReadCounter.table","NW_015090842.1:9477554",20,62,42
"ZFPM1","s954_F_GON_01_ASEReadCounter.table","NW_015090842.1:9477575",63,64,1
"ZFPM1","s954_F_GON_01_ASEReadCounter.table","NW_015090842.1:9477595",21,66,45
"ZFPM1","s954_F_GON_01_ASEReadCounter.table","NW_015090842.1:9477611",23,79,56
"ZFPM1","s954_F_GON_01_ASEReadCounter.table","NW_015090842.1:9477659",20,72,52
"ZFPM1","s954_F_GON_01_ASEReadCounter.table","NW_015090842.1:9477737",16,59,43
"ZFPM1","s954_F_GON_01_ASEReadCounter.table","NW_015090842.1:9477791",9,48,39
"ZFPM1","s954_F_GON_01_ASEReadCounter.table","NW_015090842.1:9477844",12,43,31
"ZFPM1","s954_F_GON_01_ASEReadCounter.table","NW_015090842.1:9477917",27,54,27
"ZFPM1","s954_F_GON_01_ASEReadCounter.table","NW_015090842.1:9478295",15,53,38
"ZFPM1","s954_F_GON_01_ASEReadCounter.table","NW_015090842.1:9478349",16,65,49
"ZFPM1","s954_F_GON_01_ASEReadCounter.table","NW_015090842.1:9478524",19,62,43
"ZFPM1","s954_F_GON_01_ASEReadCounter.table","NW_015090842.1:9478546",18,55,37
"ZFPM1","s954_F_GON_01_ASEReadCounter.table","NW_015090842.1:9478573",18,54,36
"ZFPM1","s954_F_GON_01_ASEReadCounter.table","NW_015090842.1:9478582",19,42,23
"ZFPM1","s954_F_GON_01_ASEReadCounter.table","NW_015090842.1:9478684",3,14,11
"ZFPM1","s954_F_GON_01_ASEReadCounter.table","NW_015090842.1:9478711",5,15,10
"ZFPM1","s954_F_GON_01_ASEReadCounter.table","NW_015090842.1:9478761",5,15,10
"ZFPM1","s954_F_GON_01_ASEReadCounter.table","NW_015090842.1:9478829",9,9,0
"CIDEC","s954_F_GON_01_ASEReadCounter.table","NW_015090842.1:9480170",4,6,2
"CIDEC","s954_F_GON_01_ASEReadCounter.table","NW_015090842.1:9480171",4,6,2
"CIDEC","s954_F_GON_01_ASEReadCounter.table","NW_015090842.1:9480212",2,4,2
"CIDEC","s954_F_GON_01_ASEReadCounter.table","NW_015090842.1:9480252",5,5,0
"CIDEC","s954_F_GON_01_ASEReadCounter.table","NW_015090842.1:9480391",9,10,1
"CIDEC","s954_F_GON_01_ASEReadCounter.table","NW_015090842.1:9480394",8,9,1
"CIDEC","s954_F_GON_01_ASEReadCounter.table","NW_015090842.1:9480630",10,16,6
"CIDEC","s954_F_GON_01_ASEReadCounter.table","NW_015090842.1:9480675",12,17,5
"CIDEC","s954_F_GON_01_ASEReadCounter.table","NW_015090842.1:9480686",11,18,7
"CIDEC","s954_F_GON_01_ASEReadCounter.table","NW_015090842.1:9480693",10,16,6
"CIDEC","s954_F_GON_01_ASEReadCounter.table","NW_015090842.1:9480756",9,13,4
"CIDEC","s954_F_GON_01_ASEReadCounter.table","NW_015090842.1:9481199",9,9,0
"CIDEC","s954_F_GON_01_ASEReadCounter.table","NW_015090842.1:9481604",1,1,0
"ZC3H18","s954_F_GON_01_ASEReadCounter.table","NW_015090842.1:9494271",14,40,26
"ZC3H18","s954_F_GON_01_ASEReadCounter.table","NW_015090842.1:9501427",35,107,72
"ZC3H18","s954_F_GON_01_ASEReadCounter.table","NW_015090842.1:9501442",25,96,71
"ZC3H18","s954_F_GON_01_ASEReadCounter.table","NW_015090842.1:9505538",31,89,58
"ZC3H18","s954_F_GON_01_ASEReadCounter.table","NW_015090842.1:9506778",35,126,91
"ZC3H18","s954_F_GON_01_ASEReadCounter.table","NW_015090842.1:9522538",36,89,53
"ZC3H18","s954_F_GON_01_ASEReadCounter.table","NW_015090842.1:9524350",40,93,53
"ZC3H18","s954_F_GON_01_ASEReadCounter.table","NW_015090842.1:9524366",38,99,61
"ZC3H18","s954_F_GON_01_ASEReadCounter.table","NW_015090842.1:9524424",32,80,48
"ZC3H18","s954_F_GON_01_ASEReadCounter.table","NW_015090842.1:9529649",55,124,69
"ZC3H18","s954_F_GON_01_ASEReadCounter.table","NW_015090842.1:9529688",56,115,59
"ZC3H18","s954_F_GON_01_ASEReadCounter.table","NW_015090842.1:9529691",52,102,50
"ZC3H18","s954_F_GON_01_ASEReadCounter.table","NW_015090842.1:9530977",62,119,57
"ZC3H18","s954_F_GON_01_ASEReadCounter.table","NW_015090842.1:9536699",0,45,45
"CYBA","s954_F_GON_01_ASEReadCounter.table","NW_015090842.1:9547281",48,66,18
"CYBA","s954_F_GON_01_ASEReadCounter.table","NW_015090842.1:9547402",146,207,61
"CYBA","s954_F_GON_01_ASEReadCounter.table","NW_015090842.1:9547553",78,137,59
"CYBA","s954_F_GON_01_ASEReadCounter.table","NW_015090842.1:9548052",76,115,39
"CYBA","s954_F_GON_01_ASEReadCounter.table","NW_015090842.1:9548436",93,134,41
"CYBA","s954_F_GON_01_ASEReadCounter.table","NW_015090842.1:9548442",96,138,42
"CYBA","s954_F_GON_01_ASEReadCounter.table","NW_015090842.1:9548478",117,161,44
"CYBA","s954_F_GON_01_ASEReadCounter.table","NW_015090842.1:9548487",108,149,41
"CYBA","s954_F_GON_01_ASEReadCounter.table","NW_015090842.1:9548490",106,147,41
"CYBA","s954_F_GON_01_ASEReadCounter.table","NW_015090842.1:9548717",99,129,30
"CYBA","s954_F_GON_01_ASEReadCounter.table","NW_015090842.1:9548750",80,110,30
"CYBA","s954_F_GON_01_ASEReadCounter.table","NW_015090842.1:9548766",51,71,20
"MVD","s954_F_GON_01_ASEReadCounter.table","NW_015090842.1:9550678",15,30,15
"MVD","s954_F_GON_01_ASEReadCounter.table","NW_015090842.1:9550690",17,34,17
"MVD","s954_F_GON_01_ASEReadCounter.table","NW_015090842.1:9550691",16,33,17
"MVD","s954_F_GON_01_ASEReadCounter.table","NW_015090842.1:9550699",20,39,19
"MVD","s954_F_GON_01_ASEReadCounter.table","NW_015090842.1:9550719",21,34,13
"MVD","s954_F_GON_01_ASEReadCounter.table","NW_015090842.1:9551596",29,63,34
"MVD","s954_F_GON_01_ASEReadCounter.table","NW_015090842.1:9551638",35,66,31
"MVD","s954_F_GON_01_ASEReadCounter.table","NW_015090842.1:9551899",0,2,2
"MVD","s954_F_GON_01_ASEReadCounter.table","NW_015090842.1:9552193",26,62,36
"MVD","s954_F_GON_01_ASEReadCounter.table","NW_015090842.1:9552202",27,64,37
"MVD","s954_F_GON_01_ASEReadCounter.table","NW_015090842.1:9552208",25,59,34
"MVD","s954_F_GON_01_ASEReadCounter.table","NW_015090842.1:9552625",24,37,13
"MVD","s954_F_GON_01_ASEReadCounter.table","NW_015090842.1:9552629",40,40,0
"MVD","s954_F_GON_01_ASEReadCounter.table","NW_015090842.1:9552644",24,39,15
"MVD","s954_F_GON_01_ASEReadCounter.table","NW_015090842.1:9553093",21,45,24
"MVD","s954_F_GON_01_ASEReadCounter.table","NW_015090842.1:9553114",20,44,24
"RNF166","s954_F_GON_01_ASEReadCounter.table","NW_015090842.1:9557900",7,21,14
"RNF166","s954_F_GON_01_ASEReadCounter.table","NW_015090842.1:9558048",13,36,23
"RNF166","s954_F_GON_01_ASEReadCounter.table","NW_015090842.1:9558116",22,51,29
"RNF166","s954_F_GON_01_ASEReadCounter.table","NW_015090842.1:9558308",19,44,25
"RNF166","s954_F_GON_01_ASEReadCounter.table","NW_015090842.1:9558405",14,29,15
"RNF166","s954_F_GON_01_ASEReadCounter.table","NW_015090842.1:9558549",38,69,31
"RNF166","s954_F_GON_01_ASEReadCounter.table","NW_015090842.1:9558556",37,67,30
"RNF166","s954_F_GON_01_ASEReadCounter.table","NW_015090842.1:9558579",44,76,32
"RNF166","s954_F_GON_01_ASEReadCounter.table","NW_015090842.1:9558599",39,69,30
"RNF166","s954_F_GON_01_ASEReadCounter.table","NW_015090842.1:9558688",38,66,28
"RNF166","s954_F_GON_01_ASEReadCounter.table","NW_015090842.1:9558711",40,68,28
"RNF166","s954_F_GON_01_ASEReadCounter.table","NW_015090842.1:9558733",38,57,19
"RNF166","s954_F_GON_01_ASEReadCounter.table","NW_015090842.1:9558847",37,56,19
"RNF166","s954_F_GON_01_ASEReadCounter.table","NW_015090842.1:9559798",47,64,17
"RNF166","s954_F_GON_01_ASEReadCounter.table","NW_015090842.1:9560575",51,91,40
"RNF166","s954_F_GON_01_ASEReadCounter.table","NW_015090842.1:9561055",46,68,22
"RNF166","s954_F_GON_01_ASEReadCounter.table","NW_015090842.1:9562458",57,77,20
"RNF166","s954_F_GON_01_ASEReadCounter.table","NW_015090842.1:9562497",47,67,20
"RNF166","s954_F_GON_01_ASEReadCounter.table","NW_015090842.1:9562539",34,57,23
"RNF166","s954_F_GON_01_ASEReadCounter.table","NW_015090842.1:9564056",33,55,22
"CTU2","s954_F_GON_01_ASEReadCounter.table","NW_015090842.1:9565149",14,25,11
"CTU2","s954_F_GON_01_ASEReadCounter.table","NW_015090842.1:9565193",15,27,12
"CTU2","s954_F_GON_01_ASEReadCounter.table","NW_015090842.1:9565300",12,26,14
"CTU2","s954_F_GON_01_ASEReadCounter.table","NW_015090842.1:9565321",10,25,15
"CTU2","s954_F_GON_01_ASEReadCounter.table","NW_015090842.1:9565721",15,27,12
"CTU2","s954_F_GON_01_ASEReadCounter.table","NW_015090842.1:9565739",15,27,12
"CTU2","s954_F_GON_01_ASEReadCounter.table","NW_015090842.1:9565905",20,36,16
"CTU2","s954_F_GON_01_ASEReadCounter.table","NW_015090842.1:9566013",27,27,0
"CTU2","s954_F_GON_01_ASEReadCounter.table","NW_015090842.1:9566055",11,24,13
"CTU2","s954_F_GON_01_ASEReadCounter.table","NW_015090842.1:9566056",11,25,14
"CTU2","s954_F_GON_01_ASEReadCounter.table","NW_015090842.1:9566151",11,17,6
"CTU2","s954_F_GON_01_ASEReadCounter.table","NW_015090842.1:9566300",8,12,4
"CTU2","s954_F_GON_01_ASEReadCounter.table","NW_015090842.1:9566342",10,15,5
"CTU2","s954_F_GON_01_ASEReadCounter.table","NW_015090842.1:9566548",14,23,9
"CTU2","s954_F_GON_01_ASEReadCounter.table","NW_015090842.1:9566625",18,32,14
"CTU2","s954_F_GON_01_ASEReadCounter.table","NW_015090842.1:9566633",18,33,15
"CTU2","s954_F_GON_01_ASEReadCounter.table","NW_015090842.1:9566807",10,24,14
"CTU2","s954_F_GON_01_ASEReadCounter.table","NW_015090842.1:9567139",14,28,14
"CTU2","s954_F_GON_01_ASEReadCounter.table","NW_015090842.1:9567156",13,28,15
"CTU2","s954_F_GON_01_ASEReadCounter.table","NW_015090842.1:9567614",17,39,22
"CTU2","s954_F_GON_01_ASEReadCounter.table","NW_015090842.1:9567677",17,33,16
"CTU2","s954_F_GON_01_ASEReadCounter.table","NW_015090842.1:9567747",13,27,14
"CTU2","s954_F_GON_01_ASEReadCounter.table","NW_015090842.1:9567828",10,19,9
"CTU2","s954_F_GON_01_ASEReadCounter.table","NW_015090842.1:9567829",10,19,9
"CTU2","s954_F_GON_01_ASEReadCounter.table","NW_015090842.1:9567885",7,15,8
"PIEZO1","s954_F_GON_01_ASEReadCounter.table","NW_015090842.1:9568093",37,55,18
"PIEZO1","s954_F_GON_01_ASEReadCounter.table","NW_015090842.1:9568672",39,67,28
"PIEZO1","s954_F_GON_01_ASEReadCounter.table","NW_015090842.1:9568948",27,46,19
"PIEZO1","s954_F_GON_01_ASEReadCounter.table","NW_015090842.1:9568987",42,42,0
"PIEZO1","s954_F_GON_01_ASEReadCounter.table","NW_015090842.1:9569040",24,37,13
"PIEZO1","s954_F_GON_01_ASEReadCounter.table","NW_015090842.1:9569180",18,34,16
"PIEZO1","s954_F_GON_01_ASEReadCounter.table","NW_015090842.1:9569192",16,29,13
"PIEZO1","s954_F_GON_01_ASEReadCounter.table","NW_015090842.1:9570088",23,39,16
"PIEZO1","s954_F_GON_01_ASEReadCounter.table","NW_015090842.1:9570480",28,37,9
"PIEZO1","s954_F_GON_01_ASEReadCounter.table","NW_015090842.1:9570639",21,27,6
"PIEZO1","s954_F_GON_01_ASEReadCounter.table","NW_015090842.1:9571847",27,38,11
"PIEZO1","s954_F_GON_01_ASEReadCounter.table","NW_015090842.1:9572371",20,25,5
"PIEZO1","s954_F_GON_01_ASEReadCounter.table","NW_015090842.1:9572638",9,11,2
"PIEZO1","s954_F_GON_01_ASEReadCounter.table","NW_015090842.1:9573156",22,41,19
"PIEZO1","s954_F_GON_01_ASEReadCounter.table","NW_015090842.1:9573280",23,45,22
"PIEZO1","s954_F_GON_01_ASEReadCounter.table","NW_015090842.1:9573566",12,25,13
"PIEZO1","s954_F_GON_01_ASEReadCounter.table","NW_015090842.1:9575341",10,18,8
"PIEZO1","s954_F_GON_01_ASEReadCounter.table","NW_015090842.1:9575367",8,18,10
"PIEZO1","s954_F_GON_01_ASEReadCounter.table","NW_015090842.1:9575645",12,20,8
"PIEZO1","s954_F_GON_01_ASEReadCounter.table","NW_015090842.1:9575696",17,23,6
"PIEZO1","s954_F_GON_01_ASEReadCounter.table","NW_015090842.1:9575897",10,14,4
"PIEZO1","s954_F_GON_01_ASEReadCounter.table","NW_015090842.1:9576060",12,13,1
"PIEZO1","s954_F_GON_01_ASEReadCounter.table","NW_015090842.1:9576087",13,17,4
"PIEZO1","s954_F_GON_01_ASEReadCounter.table","NW_015090842.1:9576093",12,17,5
"PIEZO1","s954_F_GON_01_ASEReadCounter.table","NW_015090842.1:9576120",14,18,4
"PIEZO1","s954_F_GON_01_ASEReadCounter.table","NW_015090842.1:9576687",6,10,4
"PIEZO1","s954_F_GON_01_ASEReadCounter.table","NW_015090842.1:9576710",14,14,0
"PIEZO1","s954_F_GON_01_ASEReadCounter.table","NW_015090842.1:9576723",7,14,7
"PIEZO1","s954_F_GON_01_ASEReadCounter.table","NW_015090842.1:9578268",7,11,4
"PIEZO1","s954_F_GON_01_ASEReadCounter.table","NW_015090842.1:9578770",9,16,7
"PIEZO1","s954_F_GON_01_ASEReadCounter.table","NW_015090842.1:9578806",10,12,2
"PIEZO1","s954_F_GON_01_ASEReadCounter.table","NW_015090842.1:9579064",8,12,4
"PIEZO1","s954_F_GON_01_ASEReadCounter.table","NW_015090842.1:9579065",8,12,4
"PIEZO1","s954_F_GON_01_ASEReadCounter.table","NW_015090842.1:9579347",10,11,1
"PIEZO1","s954_F_GON_01_ASEReadCounter.table","NW_015090842.1:9580765",1,5,4
"PIEZO1","s954_F_GON_01_ASEReadCounter.table","NW_015090842.1:9580996",4,5,1
"PIEZO1","s954_F_GON_01_ASEReadCounter.table","NW_015090842.1:9581101",8,12,4
"PIEZO1","s954_F_GON_01_ASEReadCounter.table","NW_015090842.1:9581299",5,8,3
"PIEZO1","s954_F_GON_01_ASEReadCounter.table","NW_015090842.1:9581875",5,7,2
"PIEZO1","s954_F_GON_01_ASEReadCounter.table","NW_015090842.1:9582046",1,5,4
"PIEZO1","s954_F_GON_01_ASEReadCounter.table","NW_015090842.1:9582961",3,4,1
"PIEZO1","s954_F_GON_01_ASEReadCounter.table","NW_015090842.1:9583298",1,2,1
"PIEZO1","s954_F_GON_01_ASEReadCounter.table","NW_015090842.1:9584337",1,3,2
"PIEZO1","s954_F_GON_01_ASEReadCounter.table","NW_015090842.1:9584425",2,4,2
"PIEZO1","s954_F_GON_01_ASEReadCounter.table","NW_015090842.1:9584435",2,3,1
"PIEZO1","s954_F_GON_01_ASEReadCounter.table","NW_015090842.1:9584438",2,4,2
"PIEZO1","s954_F_GON_01_ASEReadCounter.table","NW_015090842.1:9584441",1,3,2
"CDT1","s954_F_GON_01_ASEReadCounter.table","NW_015090842.1:9596596",5,16,11
"CDT1","s954_F_GON_01_ASEReadCounter.table","NW_015090842.1:9596766",12,24,12
"CDT1","s954_F_GON_01_ASEReadCounter.table","NW_015090842.1:9597054",29,44,15
"CDT1","s954_F_GON_01_ASEReadCounter.table","NW_015090842.1:9597074",23,38,15
"CDT1","s954_F_GON_01_ASEReadCounter.table","NW_015090842.1:9597137",25,51,26
"CDT1","s954_F_GON_01_ASEReadCounter.table","NW_015090842.1:9597756",26,43,17
"CDT1","s954_F_GON_01_ASEReadCounter.table","NW_015090842.1:9597766",28,47,19
"CDT1","s954_F_GON_01_ASEReadCounter.table","NW_015090842.1:9598496",37,61,24
"CDT1","s954_F_GON_01_ASEReadCounter.table","NW_015090842.1:9598498",36,60,24
"CDT1","s954_F_GON_01_ASEReadCounter.table","NW_015090842.1:9598816",27,55,28
"CDT1","s954_F_GON_01_ASEReadCounter.table","NW_015090842.1:9598879",28,56,28
"CDT1","s954_F_GON_01_ASEReadCounter.table","NW_015090842.1:9598912",25,59,34
"CDT1","s954_F_GON_01_ASEReadCounter.table","NW_015090842.1:9598959",21,58,37
"CDT1","s954_F_GON_01_ASEReadCounter.table","NW_015090842.1:9599807",40,65,25
"CDT1","s954_F_GON_01_ASEReadCounter.table","NW_015090842.1:9599819",40,63,23
"CDT1","s954_F_GON_01_ASEReadCounter.table","NW_015090842.1:9599845",38,66,28
"CDT1","s954_F_GON_01_ASEReadCounter.table","NW_015090842.1:9600148",45,76,31
"CDT1","s954_F_GON_01_ASEReadCounter.table","NW_015090842.1:9600151",42,75,33
"CDT1","s954_F_GON_01_ASEReadCounter.table","NW_015090842.1:9600217",45,76,31
"CDT1","s954_F_GON_01_ASEReadCounter.table","NW_015090842.1:9600226",42,69,27
"CDT1","s954_F_GON_01_ASEReadCounter.table","NW_015090842.1:9600260",43,70,27
"CDT1","s954_F_GON_01_ASEReadCounter.table","NW_015090842.1:9600268",40,65,25
"CDT1","s954_F_GON_01_ASEReadCounter.table","NW_015090842.1:9600305",49,77,28
"CDT1","s954_F_GON_01_ASEReadCounter.table","NW_015090842.1:9600397",34,59,25
"CDT1","s954_F_GON_01_ASEReadCounter.table","NW_015090842.1:9600447",23,48,25
"CDT1","s954_F_GON_01_ASEReadCounter.table","NW_015090842.1:9600450",20,46,26
"CDT1","s954_F_GON_01_ASEReadCounter.table","NW_015090842.1:9600485",35,60,25
"CDT1","s954_F_GON_01_ASEReadCounter.table","NW_015090842.1:9600579",35,68,33
"APRT","s954_F_GON_01_ASEReadCounter.table","NW_015090842.1:9602308",11,27,16
"APRT","s954_F_GON_01_ASEReadCounter.table","NW_015090842.1:9602440",39,75,36
"APRT","s954_F_GON_01_ASEReadCounter.table","NW_015090842.1:9602449",40,71,31
"APRT","s954_F_GON_01_ASEReadCounter.table","NW_015090842.1:9602451",40,73,33
"APRT","s954_F_GON_01_ASEReadCounter.table","NW_015090842.1:9602455",41,73,32
"APRT","s954_F_GON_01_ASEReadCounter.table","NW_015090842.1:9602462",39,70,31
"APRT","s954_F_GON_01_ASEReadCounter.table","NW_015090842.1:9602507",38,70,32
"APRT","s954_F_GON_01_ASEReadCounter.table","NW_015090842.1:9602514",36,70,34
"APRT","s954_F_GON_01_ASEReadCounter.table","NW_015090842.1:9602530",36,66,30
"APRT","s954_F_GON_01_ASEReadCounter.table","NW_015090842.1:9602582",36,62,26
"APRT","s954_F_GON_01_ASEReadCounter.table","NW_015090842.1:9602583",37,62,25
"APRT","s954_F_GON_01_ASEReadCounter.table","NW_015090842.1:9602650",35,68,33
"APRT","s954_F_GON_01_ASEReadCounter.table","NW_015090842.1:9602655",31,61,30
"APRT","s954_F_GON_01_ASEReadCounter.table","NW_015090842.1:9602712",28,64,36
"APRT","s954_F_GON_01_ASEReadCounter.table","NW_015090842.1:9602764",25,59,34
"APRT","s954_F_GON_01_ASEReadCounter.table","NW_015090842.1:9602821",27,53,26
"APRT","s954_F_GON_01_ASEReadCounter.table","NW_015090842.1:9602867",31,52,21
"APRT","s954_F_GON_01_ASEReadCounter.table","NW_015090842.1:9602883",31,52,21
"APRT","s954_F_GON_01_ASEReadCounter.table","NW_015090842.1:9602886",34,55,21
"APRT","s954_F_GON_01_ASEReadCounter.table","NW_015090842.1:9602948",29,61,32
"APRT","s954_F_GON_01_ASEReadCounter.table","NW_015090842.1:9602958",28,61,33
"APRT","s954_F_GON_01_ASEReadCounter.table","NW_015090842.1:9603020",41,84,43
"APRT","s954_F_GON_01_ASEReadCounter.table","NW_015090842.1:9603025",44,85,41
"APRT","s954_F_GON_01_ASEReadCounter.table","NW_015090842.1:9603154",37,66,29
"APRT","s954_F_GON_01_ASEReadCounter.table","NW_015090842.1:9603166",39,75,36
"APRT","s954_F_GON_01_ASEReadCounter.table","NW_015090842.1:9603326",32,63,31
"APRT","s954_F_GON_01_ASEReadCounter.table","NW_015090842.1:9603419",30,55,25
"APRT","s954_F_GON_01_ASEReadCounter.table","NW_015090842.1:9603420",31,57,26
"APRT","s954_F_GON_01_ASEReadCounter.table","NW_015090842.1:9603464",29,55,26
"APRT","s954_F_GON_01_ASEReadCounter.table","NW_015090842.1:9603528",49,104,55
"APRT","s954_F_GON_01_ASEReadCounter.table","NW_015090842.1:9603607",54,123,69
"APRT","s954_F_GON_01_ASEReadCounter.table","NW_015090842.1:9603622",52,114,62
"APRT","s954_F_GON_01_ASEReadCounter.table","NW_015090842.1:9604361",48,135,87
"APRT","s954_F_GON_01_ASEReadCounter.table","NW_015090842.1:9605317",44,122,78
"APRT","s954_F_GON_01_ASEReadCounter.table","NW_015090842.1:9605336",44,124,80
"GALNS","s954_F_GON_01_ASEReadCounter.table","NW_015090842.1:9612872",23,40,17
"GALNS","s954_F_GON_01_ASEReadCounter.table","NW_015090842.1:9612873",20,37,17
"GALNS","s954_F_GON_01_ASEReadCounter.table","NW_015090842.1:9612877",21,38,17
"GALNS","s954_F_GON_01_ASEReadCounter.table","NW_015090842.1:9612942",96,155,59
"GALNS","s954_F_GON_01_ASEReadCounter.table","NW_015090842.1:9612987",135,135,0
"GALNS","s954_F_GON_01_ASEReadCounter.table","NW_015090842.1:9613064",68,144,76
"GALNS","s954_F_GON_01_ASEReadCounter.table","NW_015090842.1:9613096",147,235,88
"GALNS","s954_F_GON_01_ASEReadCounter.table","NW_015090842.1:9613123",137,222,85
"GALNS","s954_F_GON_01_ASEReadCounter.table","NW_015090842.1:9613125",135,218,83
"GALNS","s954_F_GON_01_ASEReadCounter.table","NW_015090842.1:9613193",129,219,90
"GALNS","s954_F_GON_01_ASEReadCounter.table","NW_015090842.1:9613226",133,231,98
"GALNS","s954_F_GON_01_ASEReadCounter.table","NW_015090842.1:9613249",153,264,111
"GALNS","s954_F_GON_01_ASEReadCounter.table","NW_015090842.1:9613256",169,284,115
"GALNS","s954_F_GON_01_ASEReadCounter.table","NW_015090842.1:9613317",150,263,113
"GALNS","s954_F_GON_01_ASEReadCounter.table","NW_015090842.1:9613343",132,231,99
"GALNS","s954_F_GON_01_ASEReadCounter.table","NW_015090842.1:9613344",130,229,99
"GALNS","s954_F_GON_01_ASEReadCounter.table","NW_015090842.1:9613371",123,228,105
"GALNS","s954_F_GON_01_ASEReadCounter.table","NW_015090842.1:9613378",120,233,113
"GALNS","s954_F_GON_01_ASEReadCounter.table","NW_015090842.1:9613379",122,234,112
"GALNS","s954_F_GON_01_ASEReadCounter.table","NW_015090842.1:9613516",128,227,99
"GALNS","s954_F_GON_01_ASEReadCounter.table","NW_015090842.1:9613572",120,226,106
"GALNS","s954_F_GON_01_ASEReadCounter.table","NW_015090842.1:9613597",101,216,115
"GALNS","s954_F_GON_01_ASEReadCounter.table","NW_015090842.1:9613627",85,186,101
"GALNS","s954_F_GON_01_ASEReadCounter.table","NW_015090842.1:9613640",90,211,121
"GALNS","s954_F_GON_01_ASEReadCounter.table","NW_015090842.1:9614025",109,214,105
"GALNS","s954_F_GON_01_ASEReadCounter.table","NW_015090842.1:9614169",109,195,86
"GALNS","s954_F_GON_01_ASEReadCounter.table","NW_015090842.1:9614232",192,192,0
"GALNS","s954_F_GON_01_ASEReadCounter.table","NW_015090842.1:9614667",104,180,76
"GALNS","s954_F_GON_01_ASEReadCounter.table","NW_015090842.1:9614709",112,194,82
"GALNS","s954_F_GON_01_ASEReadCounter.table","NW_015090842.1:9614880",119,203,84
"GALNS","s954_F_GON_01_ASEReadCounter.table","NW_015090842.1:9614902",113,194,81
"GALNS","s954_F_GON_01_ASEReadCounter.table","NW_015090842.1:9614960",99,165,66
"GALNS","s954_F_GON_01_ASEReadCounter.table","NW_015090842.1:9615114",144,288,144
"GALNS","s954_F_GON_01_ASEReadCounter.table","NW_015090842.1:9615199",134,279,145
"GALNS","s954_F_GON_01_ASEReadCounter.table","NW_015090842.1:9615217",121,260,139
"GALNS","s954_F_GON_01_ASEReadCounter.table","NW_015090842.1:9615277",98,258,160
"GALNS","s954_F_GON_01_ASEReadCounter.table","NW_015090842.1:9615377",153,450,297
"GALNS","s954_F_GON_01_ASEReadCounter.table","NW_015090842.1:9647858",109,452,343
"GALNS","s954_F_GON_01_ASEReadCounter.table","NW_015090842.1:9649186",112,412,300
"GALNS","s954_F_GON_01_ASEReadCounter.table","NW_015090842.1:9649237",102,410,308
"GALNS","s954_F_GON_01_ASEReadCounter.table","NW_015090842.1:9661193",58,188,130
"TRAPPC2L","s954_F_GON_01_ASEReadCounter.table","NW_015090842.1:9662951",333,512,179
"TRAPPC2L","s954_F_GON_01_ASEReadCounter.table","NW_015090842.1:9663014",318,512,194
"TRAPPC2L","s954_F_GON_01_ASEReadCounter.table","NW_015090842.1:9664305",388,389,1
"TRAPPC2L","s954_F_GON_01_ASEReadCounter.table","NW_015090842.1:9665155",216,376,160
"TRAPPC2L","s954_F_GON_01_ASEReadCounter.table","NW_015090842.1:9665211",49,98,49
"PABPN1L","s954_F_GON_01_ASEReadCounter.table","NW_015090842.1:9669959",10,15,5
"CBFA2T3","s954_F_GON_01_ASEReadCounter.table","NW_015090842.1:9712157",0,1,1
"CBFA2T3","s954_F_GON_01_ASEReadCounter.table","NW_015090842.1:9712160",0,1,1
"CBFA2T3","s954_F_GON_01_ASEReadCounter.table","NW_015090842.1:9712166",0,1,1
"CBFA2T3","s954_F_GON_01_ASEReadCounter.table","NW_015090842.1:9712787",0,1,1
"CBFA2T3","s954_F_GON_01_ASEReadCounter.table","NW_015090842.1:9712791",0,1,1
"CBFA2T3","s954_F_GON_01_ASEReadCounter.table","NW_015090842.1:9712805",0,1,1
"CBFA2T3","s954_F_GON_01_ASEReadCounter.table","NW_015090842.1:9712811",0,2,2
"CBFA2T3","s954_F_GON_01_ASEReadCounter.table","NW_015090842.1:9712848",1,2,1
"CBFA2T3","s954_F_GON_01_ASEReadCounter.table","NW_015090842.1:9713088",1,2,1
"CBFA2T3","s954_F_GON_01_ASEReadCounter.table","NW_015090842.1:9713121",1,2,1
"CBFA2T3","s954_F_GON_01_ASEReadCounter.table","NW_015090842.1:9717058",3,7,4
"CBFA2T3","s954_F_GON_01_ASEReadCounter.table","NW_015090842.1:9717093",4,9,5
"CBFA2T3","s954_F_GON_01_ASEReadCounter.table","NW_015090842.1:9717114",4,8,4
"CBFA2T3","s954_F_GON_01_ASEReadCounter.table","NW_015090842.1:9717139",2,4,2
"CBFA2T3","s954_F_GON_01_ASEReadCounter.table","NW_015090842.1:9719788",1,1,0
"ACSF3","s954_F_GON_01_ASEReadCounter.table","NW_015090842.1:9773379",0,10,10
"ACSF3","s954_F_GON_01_ASEReadCounter.table","NW_015090842.1:9773382",0,9,9
"ACSF3","s954_F_GON_01_ASEReadCounter.table","NW_015090842.1:9773384",0,8,8
"ACSF3","s954_F_GON_01_ASEReadCounter.table","NW_015090842.1:9773388",1,10,9
"ACSF3","s954_F_GON_01_ASEReadCounter.table","NW_015090842.1:9776753",6,19,13
"ACSF3","s954_F_GON_01_ASEReadCounter.table","NW_015090842.1:9776783",12,26,14
"ACSF3","s954_F_GON_01_ASEReadCounter.table","NW_015090842.1:9776879",11,33,22
"ACSF3","s954_F_GON_01_ASEReadCounter.table","NW_015090842.1:9776965",25,47,22
"ACSF3","s954_F_GON_01_ASEReadCounter.table","NW_015090842.1:9777091",22,48,26
"ACSF3","s954_F_GON_01_ASEReadCounter.table","NW_015090842.1:9777206",22,53,31
"ACSF3","s954_F_GON_01_ASEReadCounter.table","NW_015090842.1:9777283",23,63,40
"ACSF3","s954_F_GON_01_ASEReadCounter.table","NW_015090842.1:9778955",26,70,44
"ACSF3","s954_F_GON_01_ASEReadCounter.table","NW_015090842.1:9778997",35,80,45
"ACSF3","s954_F_GON_01_ASEReadCounter.table","NW_015090842.1:9789311",16,33,17
"ACSF3","s954_F_GON_01_ASEReadCounter.table","NW_015090842.1:9789906",2,16,14
"ACSF3","s954_F_GON_01_ASEReadCounter.table","NW_015090842.1:9834743",16,36,20
"ACSF3","s954_F_GON_01_ASEReadCounter.table","NW_015090842.1:9834852",23,45,22
"ACSF3","s954_F_GON_01_ASEReadCounter.table","NW_015090842.1:9834861",21,44,23
"ACSF3","s954_F_GON_01_ASEReadCounter.table","NW_015090842.1:9839359",17,37,20
"ACSF3","s954_F_GON_01_ASEReadCounter.table","NW_015090842.1:9839378",17,33,16
"ACSF3","s954_F_GON_01_ASEReadCounter.table","NW_015090842.1:9839455",19,36,17
"ACSF3","s954_F_GON_01_ASEReadCounter.table","NW_015090842.1:9839457",19,34,15
"ACSF3","s954_F_GON_01_ASEReadCounter.table","NW_015090842.1:9839489",17,28,11
"ACSF3","s954_F_GON_01_ASEReadCounter.table","NW_015090842.1:9839500",14,24,10
"ACSF3","s954_F_GON_01_ASEReadCounter.table","NW_015090842.1:9839501",14,24,10
"ACSF3","s954_F_GON_01_ASEReadCounter.table","NW_015090842.1:9839504",16,26,10
"ACSF3","s954_F_GON_01_ASEReadCounter.table","NW_015090842.1:9839512",13,20,7
"ACSF3","s954_F_GON_01_ASEReadCounter.table","NW_015090842.1:9839527",4,11,7
"ACSF3","s954_F_GON_01_ASEReadCounter.table","NW_015090842.1:9839533",2,9,7
"ACSF3","s954_F_GON_01_ASEReadCounter.table","NW_015090842.1:9839535",2,9,7
"ACSF3","s954_F_GON_01_ASEReadCounter.table","NW_015090842.1:9839545",2,7,5
"ACSF3","s954_F_GON_01_ASEReadCounter.table","NW_015090842.1:9839550",2,7,5
"ACSF3","s954_F_GON_01_ASEReadCounter.table","NW_015090842.1:9839551",2,7,5
"CDH15","s954_F_GON_01_ASEReadCounter.table","NW_015090842.1:9848004",0,1,1
"CDH15","s954_F_GON_01_ASEReadCounter.table","NW_015090842.1:9848265",1,2,1
"CDH15","s954_F_GON_01_ASEReadCounter.table","NW_015090842.1:9848307",2,3,1
"CDH15","s954_F_GON_01_ASEReadCounter.table","NW_015090842.1:9848310",2,3,1
"CDH15","s954_F_GON_01_ASEReadCounter.table","NW_015090842.1:9848313",2,3,1
"CDH15","s954_F_GON_01_ASEReadCounter.table","NW_015090842.1:9848531",0,1,1
"CDH15","s954_F_GON_01_ASEReadCounter.table","NW_015090842.1:9848552",2,2,0
"CDH15","s954_F_GON_01_ASEReadCounter.table","NW_015090842.1:9848888",1,1,0
"CDH15","s954_F_GON_01_ASEReadCounter.table","NW_015090842.1:9848936",1,1,0
"CDH15","s954_F_GON_01_ASEReadCounter.table","NW_015090842.1:9849473",1,1,0
"CDH15","s954_F_GON_01_ASEReadCounter.table","NW_015090842.1:9850141",3,3,0
"CDH15","s954_F_GON_01_ASEReadCounter.table","NW_015090842.1:9850386",1,3,2
"CDH15","s954_F_GON_01_ASEReadCounter.table","NW_015090842.1:9850432",1,2,1
"CDH15","s954_F_GON_01_ASEReadCounter.table","NW_015090842.1:9850609",1,1,0
"SLC22A31","s954_F_GON_01_ASEReadCounter.table","NW_015090842.1:9850797",1,1,0
"SLC22A31","s954_F_GON_01_ASEReadCounter.table","NW_015090842.1:9850818",1,1,0
"SLC22A31","s954_F_GON_01_ASEReadCounter.table","NW_015090842.1:9850929",3,4,1
"SLC22A31","s954_F_GON_01_ASEReadCounter.table","NW_015090842.1:9850936",3,4,1
"SLC22A31","s954_F_GON_01_ASEReadCounter.table","NW_015090842.1:9850940",3,4,1
"SLC22A31","s954_F_GON_01_ASEReadCounter.table","NW_015090842.1:9850948",3,3,0
"SLC22A31","s954_F_GON_01_ASEReadCounter.table","NW_015090842.1:9850961",3,3,0
"SLC22A31","s954_F_GON_01_ASEReadCounter.table","NW_015090842.1:9850970",2,2,0
"SLC22A31","s954_F_GON_01_ASEReadCounter.table","NW_015090842.1:9850978",2,2,0
"SLC22A31","s954_F_GON_01_ASEReadCounter.table","NW_015090842.1:9850981",2,2,0
"SLC22A31","s954_F_GON_01_ASEReadCounter.table","NW_015090842.1:9851117",38,60,22
"SLC22A31","s954_F_GON_01_ASEReadCounter.table","NW_015090842.1:9851130",42,64,22
"SLC22A31","s954_F_GON_01_ASEReadCounter.table","NW_015090842.1:9851139",44,68,24
"SLC22A31","s954_F_GON_01_ASEReadCounter.table","NW_015090842.1:9851265",76,125,49
"SLC22A31","s954_F_GON_01_ASEReadCounter.table","NW_015090842.1:9851302",92,141,49
"SLC22A31","s954_F_GON_01_ASEReadCounter.table","NW_015090842.1:9851303",94,141,47
"SLC22A31","s954_F_GON_01_ASEReadCounter.table","NW_015090842.1:9851305",93,142,49
"SLC22A31","s954_F_GON_01_ASEReadCounter.table","NW_015090842.1:9851343",83,118,35
"SLC22A31","s954_F_GON_01_ASEReadCounter.table","NW_015090842.1:9851344",101,135,34
"SLC22A31","s954_F_GON_01_ASEReadCounter.table","NW_015090842.1:9851361",144,144,0
"SLC22A31","s954_F_GON_01_ASEReadCounter.table","NW_015090842.1:9851381",128,166,38
"SLC22A31","s954_F_GON_01_ASEReadCounter.table","NW_015090842.1:9851421",147,186,39
"SLC22A31","s954_F_GON_01_ASEReadCounter.table","NW_015090842.1:9851501",113,149,36
"SLC22A31","s954_F_GON_01_ASEReadCounter.table","NW_015090842.1:9851526",146,197,51
"SLC22A31","s954_F_GON_01_ASEReadCounter.table","NW_015090842.1:9851589",171,232,61
"SLC22A31","s954_F_GON_01_ASEReadCounter.table","NW_015090842.1:9851712",156,229,73
"SLC22A31","s954_F_GON_01_ASEReadCounter.table","NW_015090842.1:9851899",152,216,64
"SLC22A31","s954_F_GON_01_ASEReadCounter.table","NW_015090842.1:9852139",172,246,74
"SLC22A31","s954_F_GON_01_ASEReadCounter.table","NW_015090842.1:9852380",179,254,75
"SLC22A31","s954_F_GON_01_ASEReadCounter.table","NW_015090842.1:9852431",111,170,59
"SLC22A31","s954_F_GON_01_ASEReadCounter.table","NW_015090842.1:9852630",124,176,52
"SLC22A31","s954_F_GON_01_ASEReadCounter.table","NW_015090842.1:9852711",91,131,40
"SLC22A31","s954_F_GON_01_ASEReadCounter.table","NW_015090842.1:9853099",110,145,35
"SLC22A31","s954_F_GON_01_ASEReadCounter.table","NW_015090842.1:9853102",115,150,35
"SLC22A31","s954_F_GON_01_ASEReadCounter.table","NW_015090842.1:9853421",114,116,2
"SLC22A31","s954_F_GON_01_ASEReadCounter.table","NW_015090842.1:9853457",130,131,1
"SLC22A31","s954_F_GON_01_ASEReadCounter.table","NW_015090842.1:9853502",83,83,0
"ANKRD11","s954_F_GON_01_ASEReadCounter.table","NW_015090842.1:9858863",1,2,1
"ANKRD11","s954_F_GON_01_ASEReadCounter.table","NW_015090842.1:9859101",34,62,28
"ANKRD11","s954_F_GON_01_ASEReadCounter.table","NW_015090842.1:9859352",37,77,40
"ANKRD11","s954_F_GON_01_ASEReadCounter.table","NW_015090842.1:9859381",13,45,32
"ANKRD11","s954_F_GON_01_ASEReadCounter.table","NW_015090842.1:9859679",24,66,42
"ANKRD11","s954_F_GON_01_ASEReadCounter.table","NW_015090842.1:9861097",35,53,18
"ANKRD11","s954_F_GON_01_ASEReadCounter.table","NW_015090842.1:9862571",14,28,14
"ANKRD11","s954_F_GON_01_ASEReadCounter.table","NW_015090842.1:9862652",7,17,10
"ANKRD11","s954_F_GON_01_ASEReadCounter.table","NW_015090842.1:9866071",0,25,25
"ANKRD11","s954_F_GON_01_ASEReadCounter.table","NW_015090842.1:9866200",0,24,24
"ANKRD11","s954_F_GON_01_ASEReadCounter.table","NW_015090842.1:9867391",6,12,6
"ANKRD11","s954_F_GON_01_ASEReadCounter.table","NW_015090842.1:9867472",14,21,7
"ANKRD11","s954_F_GON_01_ASEReadCounter.table","NW_015090842.1:9867559",12,17,5
"ANKRD11","s954_F_GON_01_ASEReadCounter.table","NW_015090842.1:9867667",13,24,11
"ANKRD11","s954_F_GON_01_ASEReadCounter.table","NW_015090842.1:9867934",17,37,20
"ANKRD11","s954_F_GON_01_ASEReadCounter.table","NW_015090842.1:9868064",13,29,16
"ANKRD11","s954_F_GON_01_ASEReadCounter.table","NW_015090842.1:9868093",11,30,19
"ANKRD11","s954_F_GON_01_ASEReadCounter.table","NW_015090842.1:9868222",7,18,11
"ANKRD11","s954_F_GON_01_ASEReadCounter.table","NW_015090842.1:9868327",14,29,15
"ANKRD11","s954_F_GON_01_ASEReadCounter.table","NW_015090842.1:9868414",12,28,16
"ANKRD11","s954_F_GON_01_ASEReadCounter.table","NW_015090842.1:9868441",7,21,14
"ANKRD11","s954_F_GON_01_ASEReadCounter.table","NW_015090842.1:9868444",10,24,14
"ANKRD11","s954_F_GON_01_ASEReadCounter.table","NW_015090842.1:9868519",17,32,15
"ANKRD11","s954_F_GON_01_ASEReadCounter.table","NW_015090842.1:9868609",19,42,23
"ANKRD11","s954_F_GON_01_ASEReadCounter.table","NW_015090842.1:9868666",15,29,14
"ANKRD11","s954_F_GON_01_ASEReadCounter.table","NW_015090842.1:9868738",36,36,0
"ANKRD11","s954_F_GON_01_ASEReadCounter.table","NW_015090842.1:9869431",9,28,19
"ANKRD11","s954_F_GON_01_ASEReadCounter.table","NW_015090842.1:9869578",14,33,19
"ANKRD11","s954_F_GON_01_ASEReadCounter.table","NW_015090842.1:9869734",25,41,16
"ANKRD11","s954_F_GON_01_ASEReadCounter.table","NW_015090842.1:9870070",22,35,13
"ANKRD11","s954_F_GON_01_ASEReadCounter.table","NW_015090842.1:9870349",21,38,17
"ANKRD11","s954_F_GON_01_ASEReadCounter.table","NW_015090842.1:9870604",21,39,18
"ANKRD11","s954_F_GON_01_ASEReadCounter.table","NW_015090842.1:9870613",24,47,23
"ANKRD11","s954_F_GON_01_ASEReadCounter.table","NW_015090842.1:9870685",27,53,26
"ANKRD11","s954_F_GON_01_ASEReadCounter.table","NW_015090842.1:9870760",13,31,18
"ANKRD11","s954_F_GON_01_ASEReadCounter.table","NW_015090842.1:9870847",10,27,17
"ANKRD11","s954_F_GON_01_ASEReadCounter.table","NW_015090842.1:9871103",12,23,11
"ANKRD11","s954_F_GON_01_ASEReadCounter.table","NW_015090842.1:9871165",11,23,12
"ANKRD11","s954_F_GON_01_ASEReadCounter.table","NW_015090842.1:9871508",24,24,0
"ANKRD11","s954_F_GON_01_ASEReadCounter.table","NW_015090842.1:9871820",4,14,10
"ANKRD11","s954_F_GON_01_ASEReadCounter.table","NW_015090842.1:9872118",13,22,9
"ANKRD11","s954_F_GON_01_ASEReadCounter.table","NW_015090842.1:9877406",6,13,7
"SPG7","s954_F_GON_01_ASEReadCounter.table","NW_015090842.1:10051190",108,246,138
"SPG7","s954_F_GON_01_ASEReadCounter.table","NW_015090842.1:10051218",114,297,183
"SPG7","s954_F_GON_01_ASEReadCounter.table","NW_015090842.1:10052348",125,306,181
"SPG7","s954_F_GON_01_ASEReadCounter.table","NW_015090842.1:10052366",124,308,184
"SPG7","s954_F_GON_01_ASEReadCounter.table","NW_015090842.1:10065173",171,411,240
"SPG7","s954_F_GON_01_ASEReadCounter.table","NW_015090842.1:10065215",145,360,215
"SPG7","s954_F_GON_01_ASEReadCounter.table","NW_015090842.1:10066365",123,305,182
"SPG7","s954_F_GON_01_ASEReadCounter.table","NW_015090842.1:10069752",150,393,243
"SPG7","s954_F_GON_01_ASEReadCounter.table","NW_015090842.1:10069800",161,420,259
"SPG7","s954_F_GON_01_ASEReadCounter.table","NW_015090842.1:10071192",169,473,304
"SPG7","s954_F_GON_01_ASEReadCounter.table","NW_015090842.1:10071219",157,434,277
"SPG7","s954_F_GON_01_ASEReadCounter.table","NW_015090842.1:10071967",174,399,225
"SPG7","s954_F_GON_01_ASEReadCounter.table","NW_015090842.1:10075109",202,468,266
"SPG7","s954_F_GON_01_ASEReadCounter.table","NW_015090842.1:10075114",210,476,266
"SPG7","s954_F_GON_01_ASEReadCounter.table","NW_015090842.1:10075198",171,413,242
"SPG7","s954_F_GON_01_ASEReadCounter.table","NW_015090842.1:10075487",142,352,210
"SPG7","s954_F_GON_01_ASEReadCounter.table","NW_015090842.1:10075488",142,354,212
"SPG7","s954_F_GON_01_ASEReadCounter.table","NW_015090842.1:10075548",98,236,138
"RPL13","s954_F_GON_01_ASEReadCounter.table","NW_015090842.1:10077387",488,976,488
"RPL13","s954_F_GON_01_ASEReadCounter.table","NW_015090842.1:10077978",760,1499,739
"RPL13","s954_F_GON_01_ASEReadCounter.table","NW_015090842.1:10077992",743,1458,715
"CPNE7","s954_F_GON_01_ASEReadCounter.table","NW_015090842.1:10084001",1,3,2
"CPNE7","s954_F_GON_01_ASEReadCounter.table","NW_015090842.1:10084856",0,2,2
"CPNE7","s954_F_GON_01_ASEReadCounter.table","NW_015090842.1:10084872",0,1,1
"CPNE7","s954_F_GON_01_ASEReadCounter.table","NW_015090842.1:10084892",1,3,2
"CPNE7","s954_F_GON_01_ASEReadCounter.table","NW_015090842.1:10084921",2,4,2
"CPNE7","s954_F_GON_01_ASEReadCounter.table","NW_015090842.1:10084935",2,4,2
"CPNE7","s954_F_GON_01_ASEReadCounter.table","NW_015090842.1:10085000",2,3,1
"CPNE7","s954_F_GON_01_ASEReadCounter.table","NW_015090842.1:10085089",1,4,3
"CPNE7","s954_F_GON_01_ASEReadCounter.table","NW_015090842.1:10085096",1,4,3
"CPNE7","s954_F_GON_01_ASEReadCounter.table","NW_015090842.1:10085126",1,4,3
"CPNE7","s954_F_GON_01_ASEReadCounter.table","NW_015090842.1:10085167",1,1,0
"CPNE7","s954_F_GON_01_ASEReadCounter.table","NW_015090842.1:10085180",1,2,1
"CPNE7","s954_F_GON_01_ASEReadCounter.table","NW_015090842.1:10085201",1,3,2
"CPNE7","s954_F_GON_01_ASEReadCounter.table","NW_015090842.1:10088134",2,5,3
"CPNE7","s954_F_GON_01_ASEReadCounter.table","NW_015090842.1:10088146",2,3,1
"CPNE7","s954_F_GON_01_ASEReadCounter.table","NW_015090842.1:10088806",1,2,1
"CPNE7","s954_F_GON_01_ASEReadCounter.table","NW_015090842.1:10088940",2,3,1
"CPNE7","s954_F_GON_01_ASEReadCounter.table","NW_015090842.1:10088965",3,5,2
"CPNE7","s954_F_GON_01_ASEReadCounter.table","NW_015090842.1:10088967",3,5,2
"CPNE7","s954_F_GON_01_ASEReadCounter.table","NW_015090842.1:10088973",3,4,1
"CPNE7","s954_F_GON_01_ASEReadCounter.table","NW_015090842.1:10090924",9,13,4
"CPNE7","s954_F_GON_01_ASEReadCounter.table","NW_015090842.1:10090930",9,13,4
"CPNE7","s954_F_GON_01_ASEReadCounter.table","NW_015090842.1:10091075",8,12,4
"CPNE7","s954_F_GON_01_ASEReadCounter.table","NW_015090842.1:10091389",6,11,5
"CPNE7","s954_F_GON_01_ASEReadCounter.table","NW_015090842.1:10091407",6,11,5
"CPNE7","s954_F_GON_01_ASEReadCounter.table","NW_015090842.1:10091488",6,6,0
"CPNE7","s954_F_GON_01_ASEReadCounter.table","NW_015090842.1:10091491",6,6,0
"CPNE7","s954_F_GON_01_ASEReadCounter.table","NW_015090842.1:10091530",5,9,4
"CPNE7","s954_F_GON_01_ASEReadCounter.table","NW_015090842.1:10091875",7,12,5
"CPNE7","s954_F_GON_01_ASEReadCounter.table","NW_015090842.1:10091983",5,10,5
"CPNE7","s954_F_GON_01_ASEReadCounter.table","NW_015090842.1:10091997",4,9,5
"CPNE7","s954_F_GON_01_ASEReadCounter.table","NW_015090842.1:10092038",0,2,2
"CPNE7","s954_F_GON_01_ASEReadCounter.table","NW_015090842.1:10092140",5,9,4
"CPNE7","s954_F_GON_01_ASEReadCounter.table","NW_015090842.1:10092183",0,2,2
"CPNE7","s954_F_GON_01_ASEReadCounter.table","NW_015090842.1:10092201",0,2,2
"CPNE7","s954_F_GON_01_ASEReadCounter.table","NW_015090842.1:10092230",0,1,1
"CPNE7","s954_F_GON_01_ASEReadCounter.table","NW_015090842.1:10092246",0,1,1
"LOC106888185","s954_F_GON_01_ASEReadCounter.table","NW_015090842.1:10094965",1,2,1
"LOC106888185","s954_F_GON_01_ASEReadCounter.table","NW_015090842.1:10094966",1,2,1
"LOC106888185","s954_F_GON_01_ASEReadCounter.table","NW_015090842.1:10094985",3,4,1
"LOC106888185","s954_F_GON_01_ASEReadCounter.table","NW_015090842.1:10095055",0,4,4
"LOC106888185","s954_F_GON_01_ASEReadCounter.table","NW_015090842.1:10095062",1,6,5
"LOC106888185","s954_F_GON_01_ASEReadCounter.table","NW_015090842.1:10095130",0,4,4
"LOC106888185","s954_F_GON_01_ASEReadCounter.table","NW_015090842.1:10095265",16,29,13
"LOC106888185","s954_F_GON_01_ASEReadCounter.table","NW_015090842.1:10095586",21,50,29
"LOC106888185","s954_F_GON_01_ASEReadCounter.table","NW_015090842.1:10095593",21,51,30
"LOC106888185","s954_F_GON_01_ASEReadCounter.table","NW_015090842.1:10095616",16,41,25
"LOC106888185","s954_F_GON_01_ASEReadCounter.table","NW_015090842.1:10095662",10,25,15
"LOC106888185","s954_F_GON_01_ASEReadCounter.table","NW_015090842.1:10095674",9,24,15
"LOC106888185","s954_F_GON_01_ASEReadCounter.table","NW_015090842.1:10095786",14,33,19
"LOC106888185","s954_F_GON_01_ASEReadCounter.table","NW_015090842.1:10095831",13,36,23
"LOC106888185","s954_F_GON_01_ASEReadCounter.table","NW_015090842.1:10096230",12,31,19
"LOC106888185","s954_F_GON_01_ASEReadCounter.table","NW_015090842.1:10096249",16,35,19
"LOC106888185","s954_F_GON_01_ASEReadCounter.table","NW_015090842.1:10096272",15,43,28
"LOC106888185","s954_F_GON_01_ASEReadCounter.table","NW_015090842.1:10096288",16,44,28
"LOC106888185","s954_F_GON_01_ASEReadCounter.table","NW_015090842.1:10097248",13,49,36
"LOC106888185","s954_F_GON_01_ASEReadCounter.table","NW_015090842.1:10097265",19,57,38
"LOC106888185","s954_F_GON_01_ASEReadCounter.table","NW_015090842.1:10097446",1,8,7
"DPEP1","s954_F_GON_01_ASEReadCounter.table","NW_015090842.1:10098017",0,4,4
"DPEP1","s954_F_GON_01_ASEReadCounter.table","NW_015090842.1:10098518",0,8,8
"DPEP1","s954_F_GON_01_ASEReadCounter.table","NW_015090842.1:10098595",2,8,6
"DPEP1","s954_F_GON_01_ASEReadCounter.table","NW_015090842.1:10098597",2,7,5
"DPEP1","s954_F_GON_01_ASEReadCounter.table","NW_015090842.1:10098601",2,8,6
"DPEP1","s954_F_GON_01_ASEReadCounter.table","NW_015090842.1:10098608",2,9,7
"DPEP1","s954_F_GON_01_ASEReadCounter.table","NW_015090842.1:10098630",2,8,6
"DPEP1","s954_F_GON_01_ASEReadCounter.table","NW_015090842.1:10098659",4,11,7
"DPEP1","s954_F_GON_01_ASEReadCounter.table","NW_015090842.1:10099765",8,26,18
"DPEP1","s954_F_GON_01_ASEReadCounter.table","NW_015090842.1:10099985",2,19,17
"DPEP1","s954_F_GON_01_ASEReadCounter.table","NW_015090842.1:10099986",2,19,17
"DPEP1","s954_F_GON_01_ASEReadCounter.table","NW_015090842.1:10099991",2,18,16
"DPEP1","s954_F_GON_01_ASEReadCounter.table","NW_015090842.1:10100044",4,27,23
"DPEP1","s954_F_GON_01_ASEReadCounter.table","NW_015090842.1:10100045",4,27,23
"DPEP1","s954_F_GON_01_ASEReadCounter.table","NW_015090842.1:10100084",3,20,17
"DPEP1","s954_F_GON_01_ASEReadCounter.table","NW_015090842.1:10100295",8,17,9
"DPEP1","s954_F_GON_01_ASEReadCounter.table","NW_015090842.1:10100529",1,18,17
"DPEP1","s954_F_GON_01_ASEReadCounter.table","NW_015090842.1:10100893",5,24,19
"DPEP1","s954_F_GON_01_ASEReadCounter.table","NW_015090842.1:10100902",5,23,18
"DPEP1","s954_F_GON_01_ASEReadCounter.table","NW_015090842.1:10101072",3,25,22
"DPEP1","s954_F_GON_01_ASEReadCounter.table","NW_015090842.1:10101199",4,31,27
"DPEP1","s954_F_GON_01_ASEReadCounter.table","NW_015090842.1:10101483",2,22,20
"DPEP1","s954_F_GON_01_ASEReadCounter.table","NW_015090842.1:10101497",3,27,24
"DPEP1","s954_F_GON_01_ASEReadCounter.table","NW_015090842.1:10101525",4,29,25
"DPEP1","s954_F_GON_01_ASEReadCounter.table","NW_015090842.1:10101875",4,24,20
"DPEP1","s954_F_GON_01_ASEReadCounter.table","NW_015090842.1:10101913",3,18,15
"DPEP1","s954_F_GON_01_ASEReadCounter.table","NW_015090842.1:10101996",2,16,14
"DPEP1","s954_F_GON_01_ASEReadCounter.table","NW_015090842.1:10102014",2,14,12
"DPEP1","s954_F_GON_01_ASEReadCounter.table","NW_015090842.1:10102035",2,13,11
"CHMP1A","s954_F_GON_01_ASEReadCounter.table","NW_015090842.1:10102901",58,165,107
"CHMP1A","s954_F_GON_01_ASEReadCounter.table","NW_015090842.1:10102961",47,180,133
"CHMP1A","s954_F_GON_01_ASEReadCounter.table","NW_015090842.1:10102996",45,170,125
"CHMP1A","s954_F_GON_01_ASEReadCounter.table","NW_015090842.1:10103004",55,185,130
"CHMP1A","s954_F_GON_01_ASEReadCounter.table","NW_015090842.1:10103006",55,186,131
"CHMP1A","s954_F_GON_01_ASEReadCounter.table","NW_015090842.1:10103052",104,244,140
"CHMP1A","s954_F_GON_01_ASEReadCounter.table","NW_015090842.1:10103095",93,222,129
"CHMP1A","s954_F_GON_01_ASEReadCounter.table","NW_015090842.1:10103096",97,225,128
"CHMP1A","s954_F_GON_01_ASEReadCounter.table","NW_015090842.1:10103152",75,146,71
"CHMP1A","s954_F_GON_01_ASEReadCounter.table","NW_015090842.1:10103173",77,161,84
"CHMP1A","s954_F_GON_01_ASEReadCounter.table","NW_015090842.1:10103334",57,116,59
"CHMP1A","s954_F_GON_01_ASEReadCounter.table","NW_015090842.1:10103373",34,118,84
"CHMP1A","s954_F_GON_01_ASEReadCounter.table","NW_015090842.1:10103408",51,149,98
"CHMP1A","s954_F_GON_01_ASEReadCounter.table","NW_015090842.1:10103412",52,146,94
"CHMP1A","s954_F_GON_01_ASEReadCounter.table","NW_015090842.1:10103512",87,175,88
"CHMP1A","s954_F_GON_01_ASEReadCounter.table","NW_015090842.1:10103513",86,175,89
"CHMP1A","s954_F_GON_01_ASEReadCounter.table","NW_015090842.1:10103583",55,130,75
"CHMP1A","s954_F_GON_01_ASEReadCounter.table","NW_015090842.1:10103614",59,125,66
"CHMP1A","s954_F_GON_01_ASEReadCounter.table","NW_015090842.1:10103657",62,136,74
"CHMP1A","s954_F_GON_01_ASEReadCounter.table","NW_015090842.1:10103669",52,122,70
"CHMP1A","s954_F_GON_01_ASEReadCounter.table","NW_015090842.1:10103674",51,114,63
"CHMP1A","s954_F_GON_01_ASEReadCounter.table","NW_015090842.1:10103677",52,112,60
"CHMP1A","s954_F_GON_01_ASEReadCounter.table","NW_015090842.1:10103729",74,139,65
"CHMP1A","s954_F_GON_01_ASEReadCounter.table","NW_015090842.1:10103758",78,140,62
"CHMP1A","s954_F_GON_01_ASEReadCounter.table","NW_015090842.1:10103761",75,140,65
"CHMP1A","s954_F_GON_01_ASEReadCounter.table","NW_015090842.1:10103788",77,167,90
"CHMP1A","s954_F_GON_01_ASEReadCounter.table","NW_015090842.1:10103789",77,168,91
"CHMP1A","s954_F_GON_01_ASEReadCounter.table","NW_015090842.1:10103790",76,167,91
"CHMP1A","s954_F_GON_01_ASEReadCounter.table","NW_015090842.1:10103950",77,155,78
"CHMP1A","s954_F_GON_01_ASEReadCounter.table","NW_015090842.1:10104335",57,123,66
"CHMP1A","s954_F_GON_01_ASEReadCounter.table","NW_015090842.1:10104429",73,157,84
"CHMP1A","s954_F_GON_01_ASEReadCounter.table","NW_015090842.1:10104532",82,181,99
"CHMP1A","s954_F_GON_01_ASEReadCounter.table","NW_015090842.1:10104633",67,142,75
"CHMP1A","s954_F_GON_01_ASEReadCounter.table","NW_015090842.1:10104759",60,139,79
"CHMP1A","s954_F_GON_01_ASEReadCounter.table","NW_015090842.1:10104794",77,150,73
"CHMP1A","s954_F_GON_01_ASEReadCounter.table","NW_015090842.1:10104841",106,106,0
"CHMP1A","s954_F_GON_01_ASEReadCounter.table","NW_015090842.1:10104844",53,108,55
"CHMP1A","s954_F_GON_01_ASEReadCounter.table","NW_015090842.1:10106242",68,135,67
"CHMP1A","s954_F_GON_01_ASEReadCounter.table","NW_015090842.1:10106290",60,132,72
"CHMP1A","s954_F_GON_01_ASEReadCounter.table","NW_015090842.1:10106335",76,151,75
"CHMP1A","s954_F_GON_01_ASEReadCounter.table","NW_015090842.1:10106383",93,196,103
"CHMP1A","s954_F_GON_01_ASEReadCounter.table","NW_015090842.1:10106747",75,168,93
"CHMP1A","s954_F_GON_01_ASEReadCounter.table","NW_015090842.1:10107404",84,187,103
"CHMP1A","s954_F_GON_01_ASEReadCounter.table","NW_015090842.1:10107876",64,161,97
"CDK10","s954_F_GON_01_ASEReadCounter.table","NW_015090842.1:10109030",9,9,0
"CDK10","s954_F_GON_01_ASEReadCounter.table","NW_015090842.1:10109963",54,124,70
"CDK10","s954_F_GON_01_ASEReadCounter.table","NW_015090842.1:10110887",56,118,62
"CDK10","s954_F_GON_01_ASEReadCounter.table","NW_015090842.1:10111254",50,103,53
"CDK10","s954_F_GON_01_ASEReadCounter.table","NW_015090842.1:10111380",57,121,64
"CDK10","s954_F_GON_01_ASEReadCounter.table","NW_015090842.1:10111395",62,123,61
"CDK10","s954_F_GON_01_ASEReadCounter.table","NW_015090842.1:10111437",35,93,58
"CDK10","s954_F_GON_01_ASEReadCounter.table","NW_015090842.1:10111798",50,125,75
"CDK10","s954_F_GON_01_ASEReadCounter.table","NW_015090842.1:10111840",53,118,65
"CDK10","s954_F_GON_01_ASEReadCounter.table","NW_015090842.1:10112031",69,154,85
"CDK10","s954_F_GON_01_ASEReadCounter.table","NW_015090842.1:10112285",71,161,90
"CDK10","s954_F_GON_01_ASEReadCounter.table","NW_015090842.1:10112398",80,165,85
"CDK10","s954_F_GON_01_ASEReadCounter.table","NW_015090842.1:10112455",63,129,66
"CDK10","s954_F_GON_01_ASEReadCounter.table","NW_015090842.1:10112461",60,120,60
"CDK10","s954_F_GON_01_ASEReadCounter.table","NW_015090842.1:10112497",49,108,59
"CDK10","s954_F_GON_01_ASEReadCounter.table","NW_015090842.1:10112508",38,100,62
"CDK10","s954_F_GON_01_ASEReadCounter.table","NW_015090842.1:10112518",33,95,62
"CDK10","s954_F_GON_01_ASEReadCounter.table","NW_015090842.1:10112540",20,82,62
"CDK10","s954_F_GON_01_ASEReadCounter.table","NW_015090842.1:10112556",36,95,59
"CDK10","s954_F_GON_01_ASEReadCounter.table","NW_015090842.1:10112561",38,102,64
"CDK10","s954_F_GON_01_ASEReadCounter.table","NW_015090842.1:10112596",44,111,67
"CDK10","s954_F_GON_01_ASEReadCounter.table","NW_015090842.1:10112630",37,94,57
"CDK10","s954_F_GON_01_ASEReadCounter.table","NW_015090842.1:10112656",40,104,64
"CDK10","s954_F_GON_01_ASEReadCounter.table","NW_015090842.1:10112665",38,88,50
"CDK10","s954_F_GON_01_ASEReadCounter.table","NW_015090842.1:10112668",38,85,47
"CDK10","s954_F_GON_01_ASEReadCounter.table","NW_015090842.1:10112781",21,41,20
"CDK10","s954_F_GON_01_ASEReadCounter.table","NW_015090842.1:10112782",21,40,19
"CDK10","s954_F_GON_01_ASEReadCounter.table","NW_015090842.1:10112795",20,37,17
"CDK10","s954_F_GON_01_ASEReadCounter.table","NW_015090842.1:10112841",7,15,8
"CDK10","s954_F_GON_01_ASEReadCounter.table","NW_015090842.1:10112861",6,14,8
"SPATA2L","s954_F_GON_01_ASEReadCounter.table","NW_015090842.1:10113212",5,18,13
"SPATA2L","s954_F_GON_01_ASEReadCounter.table","NW_015090842.1:10113280",9,28,19
"SPATA2L","s954_F_GON_01_ASEReadCounter.table","NW_015090842.1:10113296",9,28,19
"SPATA2L","s954_F_GON_01_ASEReadCounter.table","NW_015090842.1:10113321",9,32,23
"SPATA2L","s954_F_GON_01_ASEReadCounter.table","NW_015090842.1:10113332",8,34,26
"SPATA2L","s954_F_GON_01_ASEReadCounter.table","NW_015090842.1:10113380",9,28,19
"SPATA2L","s954_F_GON_01_ASEReadCounter.table","NW_015090842.1:10113381",9,28,19
"SPATA2L","s954_F_GON_01_ASEReadCounter.table","NW_015090842.1:10113412",8,28,20
"SPATA2L","s954_F_GON_01_ASEReadCounter.table","NW_015090842.1:10113421",9,29,20
"SPATA2L","s954_F_GON_01_ASEReadCounter.table","NW_015090842.1:10113465",6,24,18
"SPATA2L","s954_F_GON_01_ASEReadCounter.table","NW_015090842.1:10113535",26,43,17
"SPATA2L","s954_F_GON_01_ASEReadCounter.table","NW_015090842.1:10113645",6,23,17
"SPATA2L","s954_F_GON_01_ASEReadCounter.table","NW_015090842.1:10113682",10,32,22
"SPATA2L","s954_F_GON_01_ASEReadCounter.table","NW_015090842.1:10113696",10,29,19
"SPATA2L","s954_F_GON_01_ASEReadCounter.table","NW_015090842.1:10113727",15,32,17
"SPATA2L","s954_F_GON_01_ASEReadCounter.table","NW_015090842.1:10113799",19,36,17
"SPATA2L","s954_F_GON_01_ASEReadCounter.table","NW_015090842.1:10113809",20,38,18
"SPATA2L","s954_F_GON_01_ASEReadCounter.table","NW_015090842.1:10113827",17,35,18
"SPATA2L","s954_F_GON_01_ASEReadCounter.table","NW_015090842.1:10113831",16,36,20
"SPATA2L","s954_F_GON_01_ASEReadCounter.table","NW_015090842.1:10113894",18,37,19
"SPATA2L","s954_F_GON_01_ASEReadCounter.table","NW_015090842.1:10113905",13,30,17
"SPATA2L","s954_F_GON_01_ASEReadCounter.table","NW_015090842.1:10113914",17,33,16
"SPATA2L","s954_F_GON_01_ASEReadCounter.table","NW_015090842.1:10113920",18,33,15
"SPATA2L","s954_F_GON_01_ASEReadCounter.table","NW_015090842.1:10113937",17,32,15
"SPATA2L","s954_F_GON_01_ASEReadCounter.table","NW_015090842.1:10113971",12,27,15
"SPATA2L","s954_F_GON_01_ASEReadCounter.table","NW_015090842.1:10113976",13,30,17
"SPATA2L","s954_F_GON_01_ASEReadCounter.table","NW_015090842.1:10113985",14,26,12
"SPATA2L","s954_F_GON_01_ASEReadCounter.table","NW_015090842.1:10113994",16,32,16
"SPATA2L","s954_F_GON_01_ASEReadCounter.table","NW_015090842.1:10114063",18,34,16
"SPATA2L","s954_F_GON_01_ASEReadCounter.table","NW_015090842.1:10114066",18,33,15
"SPATA2L","s954_F_GON_01_ASEReadCounter.table","NW_015090842.1:10114069",19,35,16
"SPATA2L","s954_F_GON_01_ASEReadCounter.table","NW_015090842.1:10114121",9,20,11
"SPATA2L","s954_F_GON_01_ASEReadCounter.table","NW_015090842.1:10114159",13,24,11
"SPATA2L","s954_F_GON_01_ASEReadCounter.table","NW_015090842.1:10114282",22,22,0
"SPATA2L","s954_F_GON_01_ASEReadCounter.table","NW_015090842.1:10114470",9,22,13
"SPATA2L","s954_F_GON_01_ASEReadCounter.table","NW_015090842.1:10114524",7,17,10
"VPS9D1","s954_F_GON_01_ASEReadCounter.table","NW_015090842.1:10116377",10,17,7
"VPS9D1","s954_F_GON_01_ASEReadCounter.table","NW_015090842.1:10116415",7,18,11
"VPS9D1","s954_F_GON_01_ASEReadCounter.table","NW_015090842.1:10116607",8,21,13
"VPS9D1","s954_F_GON_01_ASEReadCounter.table","NW_015090842.1:10116816",15,15,0
"VPS9D1","s954_F_GON_01_ASEReadCounter.table","NW_015090842.1:10116821",8,15,7
"VPS9D1","s954_F_GON_01_ASEReadCounter.table","NW_015090842.1:10116825",7,14,7
"VPS9D1","s954_F_GON_01_ASEReadCounter.table","NW_015090842.1:10116882",7,11,4
"VPS9D1","s954_F_GON_01_ASEReadCounter.table","NW_015090842.1:10116885",5,9,4
"VPS9D1","s954_F_GON_01_ASEReadCounter.table","NW_015090842.1:10116933",9,14,5
"VPS9D1","s954_F_GON_01_ASEReadCounter.table","NW_015090842.1:10116942",11,18,7
"VPS9D1","s954_F_GON_01_ASEReadCounter.table","NW_015090842.1:10117152",5,8,3
"VPS9D1","s954_F_GON_01_ASEReadCounter.table","NW_015090842.1:10117396",11,11,0
"VPS9D1","s954_F_GON_01_ASEReadCounter.table","NW_015090842.1:10117405",5,5,0
"VPS9D1","s954_F_GON_01_ASEReadCounter.table","NW_015090842.1:10117480",4,7,3
"VPS9D1","s954_F_GON_01_ASEReadCounter.table","NW_015090842.1:10117497",4,7,3
"VPS9D1","s954_F_GON_01_ASEReadCounter.table","NW_015090842.1:10117499",4,7,3
"VPS9D1","s954_F_GON_01_ASEReadCounter.table","NW_015090842.1:10117516",3,6,3
"VPS9D1","s954_F_GON_01_ASEReadCounter.table","NW_015090842.1:10117525",2,5,3
"VPS9D1","s954_F_GON_01_ASEReadCounter.table","NW_015090842.1:10117579",1,6,5
"VPS9D1","s954_F_GON_01_ASEReadCounter.table","NW_015090842.1:10117627",5,10,5
"VPS9D1","s954_F_GON_01_ASEReadCounter.table","NW_015090842.1:10117678",6,10,4
"VPS9D1","s954_F_GON_01_ASEReadCounter.table","NW_015090842.1:10117773",5,11,6
"VPS9D1","s954_F_GON_01_ASEReadCounter.table","NW_015090842.1:10117937",8,12,4
"VPS9D1","s954_F_GON_01_ASEReadCounter.table","NW_015090842.1:10117961",7,12,5
"VPS9D1","s954_F_GON_01_ASEReadCounter.table","NW_015090842.1:10118236",4,10,6
"VPS9D1","s954_F_GON_01_ASEReadCounter.table","NW_015090842.1:10118414",8,10,2
"VPS9D1","s954_F_GON_01_ASEReadCounter.table","NW_015090842.1:10118973",5,12,7
"VPS9D1","s954_F_GON_01_ASEReadCounter.table","NW_015090842.1:10119500",3,5,2
"ZNF276","s954_F_GON_01_ASEReadCounter.table","NW_015090842.1:10121760",3,7,4
"ZNF276","s954_F_GON_01_ASEReadCounter.table","NW_015090842.1:10121769",3,8,5
"ZNF276","s954_F_GON_01_ASEReadCounter.table","NW_015090842.1:10121802",4,7,3
"ZNF276","s954_F_GON_01_ASEReadCounter.table","NW_015090842.1:10121971",3,7,4
"ZNF276","s954_F_GON_01_ASEReadCounter.table","NW_015090842.1:10122883",8,12,4
"ZNF276","s954_F_GON_01_ASEReadCounter.table","NW_015090842.1:10123069",9,15,6
"ZNF276","s954_F_GON_01_ASEReadCounter.table","NW_015090842.1:10123207",13,21,8
"ZNF276","s954_F_GON_01_ASEReadCounter.table","NW_015090842.1:10125787",13,23,10
"ZNF276","s954_F_GON_01_ASEReadCounter.table","NW_015090842.1:10126309",20,29,9
"ZNF276","s954_F_GON_01_ASEReadCounter.table","NW_015090842.1:10126348",22,29,7
"ZNF276","s954_F_GON_01_ASEReadCounter.table","NW_015090842.1:10126978",15,30,15
"ZNF276","s954_F_GON_01_ASEReadCounter.table","NW_015090842.1:10126991",14,29,15
"ZNF276","s954_F_GON_01_ASEReadCounter.table","NW_015090842.1:10127023",9,26,17
"ZNF276","s954_F_GON_01_ASEReadCounter.table","NW_015090842.1:10127063",7,22,15
"ZNF276","s954_F_GON_01_ASEReadCounter.table","NW_015090842.1:10127373",10,22,12
"ZNF276","s954_F_GON_01_ASEReadCounter.table","NW_015090842.1:10127931",15,36,21
"ZNF276","s954_F_GON_01_ASEReadCounter.table","NW_015090842.1:10128070",17,32,15
"ZNF276","s954_F_GON_01_ASEReadCounter.table","NW_015090842.1:10128102",20,41,21
"ZNF276","s954_F_GON_01_ASEReadCounter.table","NW_015090842.1:10128356",10,23,13
"ZNF276","s954_F_GON_01_ASEReadCounter.table","NW_015090842.1:10128497",9,23,14
"FANCA","s954_F_GON_01_ASEReadCounter.table","NW_015090842.1:10128743",17,35,18
"FANCA","s954_F_GON_01_ASEReadCounter.table","NW_015090842.1:10128822",28,56,28
"FANCA","s954_F_GON_01_ASEReadCounter.table","NW_015090842.1:10129383",29,56,27
"FANCA","s954_F_GON_01_ASEReadCounter.table","NW_015090842.1:10129390",29,62,33
"FANCA","s954_F_GON_01_ASEReadCounter.table","NW_015090842.1:10129422",31,67,36
"FANCA","s954_F_GON_01_ASEReadCounter.table","NW_015090842.1:10129969",29,59,30
"FANCA","s954_F_GON_01_ASEReadCounter.table","NW_015090842.1:10130399",34,59,25
"FANCA","s954_F_GON_01_ASEReadCounter.table","NW_015090842.1:10130857",18,44,26
"FANCA","s954_F_GON_01_ASEReadCounter.table","NW_015090842.1:10130878",17,43,26
"FANCA","s954_F_GON_01_ASEReadCounter.table","NW_015090842.1:10133530",19,40,21
"FANCA","s954_F_GON_01_ASEReadCounter.table","NW_015090842.1:10133533",20,41,21
"FANCA","s954_F_GON_01_ASEReadCounter.table","NW_015090842.1:10133536",21,42,21
"FANCA","s954_F_GON_01_ASEReadCounter.table","NW_015090842.1:10133601",17,43,26
"FANCA","s954_F_GON_01_ASEReadCounter.table","NW_015090842.1:10134492",19,37,18
"FANCA","s954_F_GON_01_ASEReadCounter.table","NW_015090842.1:10134531",16,30,14
"FANCA","s954_F_GON_01_ASEReadCounter.table","NW_015090842.1:10136957",9,36,27
"FANCA","s954_F_GON_01_ASEReadCounter.table","NW_015090842.1:10136982",7,32,25
"FANCA","s954_F_GON_01_ASEReadCounter.table","NW_015090842.1:10136999",8,33,25
"FANCA","s954_F_GON_01_ASEReadCounter.table","NW_015090842.1:10137019",13,35,22
"FANCA","s954_F_GON_01_ASEReadCounter.table","NW_015090842.1:10137673",15,34,19
"FANCA","s954_F_GON_01_ASEReadCounter.table","NW_015090842.1:10138618",7,22,15
"FANCA","s954_F_GON_01_ASEReadCounter.table","NW_015090842.1:10139140",14,27,13
"FANCA","s954_F_GON_01_ASEReadCounter.table","NW_015090842.1:10140699",11,17,6
"FANCA","s954_F_GON_01_ASEReadCounter.table","NW_015090842.1:10141234",3,8,5
"FANCA","s954_F_GON_01_ASEReadCounter.table","NW_015090842.1:10145030",3,13,10
"FANCA","s954_F_GON_01_ASEReadCounter.table","NW_015090842.1:10150518",1,7,6
"FANCA","s954_F_GON_01_ASEReadCounter.table","NW_015090842.1:10152863",4,10,6
"FANCA","s954_F_GON_01_ASEReadCounter.table","NW_015090842.1:10154490",4,14,10
"FANCA","s954_F_GON_01_ASEReadCounter.table","NW_015090842.1:10158162",2,8,6
"FANCA","s954_F_GON_01_ASEReadCounter.table","NW_015090842.1:10158957",8,13,5
"FANCA","s954_F_GON_01_ASEReadCounter.table","NW_015090842.1:10160177",2,6,4
"FANCA","s954_F_GON_01_ASEReadCounter.table","NW_015090842.1:10162980",2,9,7
"FANCA","s954_F_GON_01_ASEReadCounter.table","NW_015090842.1:10163667",5,6,1
"FANCA","s954_F_GON_01_ASEReadCounter.table","NW_015090842.1:10164257",6,10,4
"FANCA","s954_F_GON_01_ASEReadCounter.table","NW_015090842.1:10165331",3,4,1
"SPIRE2","s954_F_GON_01_ASEReadCounter.table","NW_015090842.1:10172284",3,3,0
"SPIRE2","s954_F_GON_01_ASEReadCounter.table","NW_015090842.1:10175262",5,5,0
"SPIRE2","s954_F_GON_01_ASEReadCounter.table","NW_015090842.1:10175352",4,4,0
"SPIRE2","s954_F_GON_01_ASEReadCounter.table","NW_015090842.1:10175400",9,10,1
"SPIRE2","s954_F_GON_01_ASEReadCounter.table","NW_015090842.1:10175418",11,12,1
"SPIRE2","s954_F_GON_01_ASEReadCounter.table","NW_015090842.1:10175704",16,17,1
"SPIRE2","s954_F_GON_01_ASEReadCounter.table","NW_015090842.1:10176115",19,20,1
"SPIRE2","s954_F_GON_01_ASEReadCounter.table","NW_015090842.1:10176561",25,28,3
"SPIRE2","s954_F_GON_01_ASEReadCounter.table","NW_015090842.1:10176817",16,18,2
"SPIRE2","s954_F_GON_01_ASEReadCounter.table","NW_015090842.1:10177084",9,12,3
"SPIRE2","s954_F_GON_01_ASEReadCounter.table","NW_015090842.1:10177110",5,8,3
"SPIRE2","s954_F_GON_01_ASEReadCounter.table","NW_015090842.1:10177838",9,9,0
"SPIRE2","s954_F_GON_01_ASEReadCounter.table","NW_015090842.1:10178000",17,19,2
"SPIRE2","s954_F_GON_01_ASEReadCounter.table","NW_015090842.1:10178164",17,18,1
"SPIRE2","s954_F_GON_01_ASEReadCounter.table","NW_015090842.1:10178216",17,21,4
"SPIRE2","s954_F_GON_01_ASEReadCounter.table","NW_015090842.1:10178403",7,9,2
"SPIRE2","s954_F_GON_01_ASEReadCounter.table","NW_015090842.1:10178409",5,6,1
"SPIRE2","s954_F_GON_01_ASEReadCounter.table","NW_015090842.1:10178524",10,10,0
"SPIRE2","s954_F_GON_01_ASEReadCounter.table","NW_015090842.1:10178526",10,10,0
"SPIRE2","s954_F_GON_01_ASEReadCounter.table","NW_015090842.1:10178531",10,10,0
"SPIRE2","s954_F_GON_01_ASEReadCounter.table","NW_015090842.1:10178565",8,9,1
"SPIRE2","s954_F_GON_01_ASEReadCounter.table","NW_015090842.1:10178587",7,9,2
"SPIRE2","s954_F_GON_01_ASEReadCounter.table","NW_015090842.1:10178640",5,7,2
"SPIRE2","s954_F_GON_01_ASEReadCounter.table","NW_015090842.1:10178651",6,8,2
"SPIRE2","s954_F_GON_01_ASEReadCounter.table","NW_015090842.1:10178682",5,7,2
"TCF25","s954_F_GON_01_ASEReadCounter.table","NW_015090842.1:10180912",43,87,44
"TCF25","s954_F_GON_01_ASEReadCounter.table","NW_015090842.1:10180924",47,89,42
"TCF25","s954_F_GON_01_ASEReadCounter.table","NW_015090842.1:10180931",45,87,42
"TCF25","s954_F_GON_01_ASEReadCounter.table","NW_015090842.1:10185332",97,236,139
"TCF25","s954_F_GON_01_ASEReadCounter.table","NW_015090842.1:10188816",103,187,84
"MC1R","s954_F_GON_01_ASEReadCounter.table","NW_015090842.1:10202160",2,2,0
"MC1R","s954_F_GON_01_ASEReadCounter.table","NW_015090842.1:10202460",1,2,1
"MC1R","s954_F_GON_01_ASEReadCounter.table","NW_015090842.1:10202465",1,2,1
"DBNDD1","s954_F_GON_01_ASEReadCounter.table","NW_015090842.1:10223105",83,188,105
"GAS8","s954_F_GON_01_ASEReadCounter.table","NW_015090842.1:10228982",650,1330,680
"GAS8","s954_F_GON_01_ASEReadCounter.table","NW_015090842.1:10229832",566,1155,589
"GAS8","s954_F_GON_01_ASEReadCounter.table","NW_015090842.1:10232375",541,1100,559
"GAS8","s954_F_GON_01_ASEReadCounter.table","NW_015090842.1:10232901",416,831,415
"GAS8","s954_F_GON_01_ASEReadCounter.table","NW_015090842.1:10232928",331,635,304
"GAS8","s954_F_GON_01_ASEReadCounter.table","NW_015090842.1:10232967",276,556,280
"GAS8","s954_F_GON_01_ASEReadCounter.table","NW_015090842.1:10233032",161,362,201
"GAS8","s954_F_GON_01_ASEReadCounter.table","NW_015090842.1:10233057",127,275,148
"GAS8","s954_F_GON_01_ASEReadCounter.table","NW_015090842.1:10233058",125,275,150
"GAS8","s954_F_GON_01_ASEReadCounter.table","NW_015090842.1:10233176",145,249,104
"GAS8","s954_F_GON_01_ASEReadCounter.table","NW_015090842.1:10233196",141,240,99
"GAS8","s954_F_GON_01_ASEReadCounter.table","NW_015090842.1:10233252",78,153,75
"GAS8","s954_F_GON_01_ASEReadCounter.table","NW_015090842.1:10233303",28,61,33
"LOC106888094","s954_F_GON_01_ASEReadCounter.table","NW_015090842.1:10233334",5,12,7
"LOC106888094","s954_F_GON_01_ASEReadCounter.table","NW_015090842.1:10233362",9,21,12
"LOC106888094","s954_F_GON_01_ASEReadCounter.table","NW_015090842.1:10233373",10,24,14
"LOC106888094","s954_F_GON_01_ASEReadCounter.table","NW_015090842.1:10233388",12,27,15
"LOC106888094","s954_F_GON_01_ASEReadCounter.table","NW_015090842.1:10233402",16,31,15
"LOC106888094","s954_F_GON_01_ASEReadCounter.table","NW_015090842.1:10233465",15,34,19
"LOC106888094","s954_F_GON_01_ASEReadCounter.table","NW_015090842.1:10233803",16,34,18
"LOC106888094","s954_F_GON_01_ASEReadCounter.table","NW_015090842.1:10233815",16,32,16
"LOC106888094","s954_F_GON_01_ASEReadCounter.table","NW_015090842.1:10235484",7,13,6
"LOC106888094","s954_F_GON_01_ASEReadCounter.table","NW_015090842.1:10235611",6,14,8
"LOC106888094","s954_F_GON_01_ASEReadCounter.table","NW_015090842.1:10236098",7,12,5
"LOC106888094","s954_F_GON_01_ASEReadCounter.table","NW_015090842.1:10236161",8,13,5
"LOC106888094","s954_F_GON_01_ASEReadCounter.table","NW_015090842.1:10236380",9,11,2
"LOC106888094","s954_F_GON_01_ASEReadCounter.table","NW_015090842.1:10236388",9,11,2
"LOC106888094","s954_F_GON_01_ASEReadCounter.table","NW_015090842.1:10236425",9,12,3
"LOC106888094","s954_F_GON_01_ASEReadCounter.table","NW_015090842.1:10236426",8,11,3
"LOC106888094","s954_F_GON_01_ASEReadCounter.table","NW_015090842.1:10236603",8,11,3
"LOC106888173","s954_F_GON_01_ASEReadCounter.table","NW_015090842.1:10239596",2,13,11
"LOC106888173","s954_F_GON_01_ASEReadCounter.table","NW_015090842.1:10240036",15,40,25
"LOC106888173","s954_F_GON_01_ASEReadCounter.table","NW_015090842.1:10240095",15,44,29
"LOC106888173","s954_F_GON_01_ASEReadCounter.table","NW_015090842.1:10240280",13,43,30
"LOC106888173","s954_F_GON_01_ASEReadCounter.table","NW_015090842.1:10240557",22,46,24
"LOC106888173","s954_F_GON_01_ASEReadCounter.table","NW_015090842.1:10240603",15,39,24
"LOC106888173","s954_F_GON_01_ASEReadCounter.table","NW_015090842.1:10240609",16,40,24
"LOC106888173","s954_F_GON_01_ASEReadCounter.table","NW_015090842.1:10240690",14,37,23
"LOC106888173","s954_F_GON_01_ASEReadCounter.table","NW_015090842.1:10240924",15,40,25
"LOC106888173","s954_F_GON_01_ASEReadCounter.table","NW_015090842.1:10241037",9,36,27
"LOC106888173","s954_F_GON_01_ASEReadCounter.table","NW_015090842.1:10241046",11,36,25
"LOC106888173","s954_F_GON_01_ASEReadCounter.table","NW_015090842.1:10241058",13,37,24
"LOC106888173","s954_F_GON_01_ASEReadCounter.table","NW_015090842.1:10241064",13,37,24
"LOC106888173","s954_F_GON_01_ASEReadCounter.table","NW_015090842.1:10241103",50,50,0
"LOC106888173","s954_F_GON_01_ASEReadCounter.table","NW_015090842.1:10241163",19,39,20
"LOC106888173","s954_F_GON_01_ASEReadCounter.table","NW_015090842.1:10241803",15,51,36
"LOC106888173","s954_F_GON_01_ASEReadCounter.table","NW_015090842.1:10241827",17,52,35
"LOC106888173","s954_F_GON_01_ASEReadCounter.table","NW_015090842.1:10241869",21,50,29
"LOC106888173","s954_F_GON_01_ASEReadCounter.table","NW_015090842.1:10242079",22,44,22
"LOC106888173","s954_F_GON_01_ASEReadCounter.table","NW_015090842.1:10242103",21,45,24
"LOC106888173","s954_F_GON_01_ASEReadCounter.table","NW_015090842.1:10242157",24,52,28
"LOC106888173","s954_F_GON_01_ASEReadCounter.table","NW_015090842.1:10242455",32,66,34
"LOC106888173","s954_F_GON_01_ASEReadCounter.table","NW_015090842.1:10242481",23,52,29
"LOC106888173","s954_F_GON_01_ASEReadCounter.table","NW_015090842.1:10242590",32,58,26
"LOC106888173","s954_F_GON_01_ASEReadCounter.table","NW_015090842.1:10242794",18,53,35
"LOC106888173","s954_F_GON_01_ASEReadCounter.table","NW_015090842.1:10242909",14,40,26
"LOC106888173","s954_F_GON_01_ASEReadCounter.table","NW_015090842.1:10243094",20,46,26
"LOC106888173","s954_F_GON_01_ASEReadCounter.table","NW_015090842.1:10243133",20,38,18
"LOC106888173","s954_F_GON_01_ASEReadCounter.table","NW_015090842.1:10243273",20,51,31
"LOC106888173","s954_F_GON_01_ASEReadCounter.table","NW_015090842.1:10243278",21,52,31
"LOC106888173","s954_F_GON_01_ASEReadCounter.table","NW_015090842.1:10243281",21,51,30
"LOC106888173","s954_F_GON_01_ASEReadCounter.table","NW_015090842.1:10243347",30,30,0
"LOC106888173","s954_F_GON_01_ASEReadCounter.table","NW_015090842.1:10243353",12,27,15
"LOC106888173","s954_F_GON_01_ASEReadCounter.table","NW_015090842.1:10243363",8,20,12
"LOC106888173","s954_F_GON_01_ASEReadCounter.table","NW_015090842.1:10243365",8,19,11
"LOC106888173","s954_F_GON_01_ASEReadCounter.table","NW_015090842.1:10243566",28,55,27
"LOC106888173","s954_F_GON_01_ASEReadCounter.table","NW_015090842.1:10243605",20,45,25
"LOC106888173","s954_F_GON_01_ASEReadCounter.table","NW_015090842.1:10243614",22,45,23
"LOC106888173","s954_F_GON_01_ASEReadCounter.table","NW_015090842.1:10243615",22,45,23
"LOC106888173","s954_F_GON_01_ASEReadCounter.table","NW_015090842.1:10243640",14,31,17
"LOC106888173","s954_F_GON_01_ASEReadCounter.table","NW_015090842.1:10243680",15,31,16
"LOC106888173","s954_F_GON_01_ASEReadCounter.table","NW_015090842.1:10243742",25,40,15
"LOC106888173","s954_F_GON_01_ASEReadCounter.table","NW_015090842.1:10243804",14,26,12
"LOC106888173","s954_F_GON_01_ASEReadCounter.table","NW_015090842.1:10243913",7,13,6
"LOC106888173","s954_F_GON_01_ASEReadCounter.table","NW_015090842.1:10243921",7,13,6
"LOC106888384","s954_F_GON_01_ASEReadCounter.table","NW_015090842.1:10244714",2,8,6
"LOC106888384","s954_F_GON_01_ASEReadCounter.table","NW_015090842.1:10244942",11,19,8
"LOC106888384","s954_F_GON_01_ASEReadCounter.table","NW_015090842.1:10244998",9,13,4
"LOC106888384","s954_F_GON_01_ASEReadCounter.table","NW_015090842.1:10250743",13,21,8
"LOC106888384","s954_F_GON_01_ASEReadCounter.table","NW_015090842.1:10250771",11,20,9
"LOC106888384","s954_F_GON_01_ASEReadCounter.table","NW_015090842.1:10251339",4,4,0
"LOC106888384","s954_F_GON_01_ASEReadCounter.table","NW_015090842.1:10251343",4,4,0
"LOC106888384","s954_F_GON_01_ASEReadCounter.table","NW_015090842.1:10251344",4,4,0
"LOC106888384","s954_F_GON_01_ASEReadCounter.table","NW_015090842.1:10251349",4,4,0
"LOC106888384","s954_F_GON_01_ASEReadCounter.table","NW_015090842.1:10251354",4,7,3
"LOC106888384","s954_F_GON_01_ASEReadCounter.table","NW_015090842.1:10251358",4,7,3
"LOC106888384","s954_F_GON_01_ASEReadCounter.table","NW_015090842.1:10251369",2,7,5
"LOC106888384","s954_F_GON_01_ASEReadCounter.table","NW_015090842.1:10251370",4,7,3
"LOC106888384","s954_F_GON_01_ASEReadCounter.table","NW_015090842.1:10251375",4,7,3
"LOC106888384","s954_F_GON_01_ASEReadCounter.table","NW_015090842.1:10251388",0,3,3
"LOC106888384","s954_F_GON_01_ASEReadCounter.table","NW_015090842.1:10251390",0,3,3
"LOC106888384","s954_F_GON_01_ASEReadCounter.table","NW_015090842.1:10251393",0,3,3
"LOC106888384","s954_F_GON_01_ASEReadCounter.table","NW_015090842.1:10251399",0,3,3
"LOC106888384","s954_F_GON_01_ASEReadCounter.table","NW_015090842.1:10251492",2,2,0
"LOC106888384","s954_F_GON_01_ASEReadCounter.table","NW_015090842.1:10253165",14,32,18
"LOC106888384","s954_F_GON_01_ASEReadCounter.table","NW_015090842.1:10253284",10,24,14
"LOC106888384","s954_F_GON_01_ASEReadCounter.table","NW_015090842.1:10254028",16,32,16
"LOC106888384","s954_F_GON_01_ASEReadCounter.table","NW_015090842.1:10254227",9,24,15
"LOC106888384","s954_F_GON_01_ASEReadCounter.table","NW_015090842.1:10254233",9,24,15
"LOC106888384","s954_F_GON_01_ASEReadCounter.table","NW_015090842.1:10254263",8,32,24
"LOC106888384","s954_F_GON_01_ASEReadCounter.table","NW_015090842.1:10254293",9,29,20
"LOC106888384","s954_F_GON_01_ASEReadCounter.table","NW_015090842.1:10254570",7,24,17
"LOC106888384","s954_F_GON_01_ASEReadCounter.table","NW_015090842.1:10254605",14,14,0
"LOC106888384","s954_F_GON_01_ASEReadCounter.table","NW_015090842.1:10254608",14,14,0
"LOC106888384","s954_F_GON_01_ASEReadCounter.table","NW_015090842.1:10254618",9,9,0
"LOC106888384","s954_F_GON_01_ASEReadCounter.table","NW_015090842.1:10254620",7,7,0
"LOC106888384","s954_F_GON_01_ASEReadCounter.table","NW_015090842.1:10254623",9,9,0
"LOC106888384","s954_F_GON_01_ASEReadCounter.table","NW_015090842.1:10254624",7,7,0
"LOC106888384","s954_F_GON_01_ASEReadCounter.table","NW_015090842.1:10254627",10,10,0
"LOC106888384","s954_F_GON_01_ASEReadCounter.table","NW_015090842.1:10254629",8,8,0
"LOC106888384","s954_F_GON_01_ASEReadCounter.table","NW_015090842.1:10254647",1,5,4
"LOC106888384","s954_F_GON_01_ASEReadCounter.table","NW_015090842.1:10254663",0,1,1
"LOC106888384","s954_F_GON_01_ASEReadCounter.table","NW_015090842.1:10254840",2,5,3
"LOC106888384","s954_F_GON_01_ASEReadCounter.table","NW_015090842.1:10254891",6,6,0
"LOC106888384","s954_F_GON_01_ASEReadCounter.table","NW_015090842.1:10254900",3,7,4
"LOC106888384","s954_F_GON_01_ASEReadCounter.table","NW_015090842.1:10254915",3,8,5
"LOC106888384","s954_F_GON_01_ASEReadCounter.table","NW_015090842.1:10254965",8,8,0
"LOC106888384","s954_F_GON_01_ASEReadCounter.table","NW_015090842.1:10254975",4,11,7
"LOC106888384","s954_F_GON_01_ASEReadCounter.table","NW_015090842.1:10255077",9,17,8
"LOC106888384","s954_F_GON_01_ASEReadCounter.table","NW_015090842.1:10255117",9,20,11
"LOC106888384","s954_F_GON_01_ASEReadCounter.table","NW_015090842.1:10255138",10,22,12
"LOC106888384","s954_F_GON_01_ASEReadCounter.table","NW_015090842.1:10255139",10,22,12
"LOC106888384","s954_F_GON_01_ASEReadCounter.table","NW_015090842.1:10255209",11,17,6
"LOC106888384","s954_F_GON_01_ASEReadCounter.table","NW_015090842.1:10255211",12,18,6
"LOC106888384","s954_F_GON_01_ASEReadCounter.table","NW_015090842.1:10255236",8,13,5
"LOC106888384","s954_F_GON_01_ASEReadCounter.table","NW_015090842.1:10255262",7,13,6
"LOC106888384","s954_F_GON_01_ASEReadCounter.table","NW_015090842.1:10255264",7,14,7
"LOC106888384","s954_F_GON_01_ASEReadCounter.table","NW_015090842.1:10255306",9,20,11
"LOC106888384","s954_F_GON_01_ASEReadCounter.table","NW_015090842.1:10255340",7,21,14
"LOC106888384","s954_F_GON_01_ASEReadCounter.table","NW_015090842.1:10255410",11,31,20
"LOC106888384","s954_F_GON_01_ASEReadCounter.table","NW_015090842.1:10255449",13,35,22
"LOC106888384","s954_F_GON_01_ASEReadCounter.table","NW_015090842.1:10255496",14,36,22
"LOC106888384","s954_F_GON_01_ASEReadCounter.table","NW_015090842.1:10255505",13,30,17
"LOC106888384","s954_F_GON_01_ASEReadCounter.table","NW_015090842.1:10255531",12,26,14
"LOC106888384","s954_F_GON_01_ASEReadCounter.table","NW_015090842.1:10255608",12,24,12
"LOC106888384","s954_F_GON_01_ASEReadCounter.table","NW_015090842.1:10255704",81,98,17
"LOC106888384","s954_F_GON_01_ASEReadCounter.table","NW_015090842.1:10255731",85,101,16
"LOC106888384","s954_F_GON_01_ASEReadCounter.table","NW_015090842.1:10255771",65,84,19
"TANGO6","s954_F_GON_01_ASEReadCounter.table","NW_015090842.1:10257782",30,51,21
"TANGO6","s954_F_GON_01_ASEReadCounter.table","NW_015090842.1:10258162",11,37,26
"TANGO6","s954_F_GON_01_ASEReadCounter.table","NW_015090842.1:10258185",15,40,25
"TANGO6","s954_F_GON_01_ASEReadCounter.table","NW_015090842.1:10259267",32,56,24
"TANGO6","s954_F_GON_01_ASEReadCounter.table","NW_015090842.1:10260250",75,128,53
"TANGO6","s954_F_GON_01_ASEReadCounter.table","NW_015090842.1:10260289",66,117,51
"TANGO6","s954_F_GON_01_ASEReadCounter.table","NW_015090842.1:10260309",50,98,48
"TANGO6","s954_F_GON_01_ASEReadCounter.table","NW_015090842.1:10260979",48,84,36
"TANGO6","s954_F_GON_01_ASEReadCounter.table","NW_015090842.1:10261599",37,73,36
"TANGO6","s954_F_GON_01_ASEReadCounter.table","NW_015090842.1:10268425",79,132,53
"TANGO6","s954_F_GON_01_ASEReadCounter.table","NW_015090842.1:10269831",67,119,52
"TANGO6","s954_F_GON_01_ASEReadCounter.table","NW_015090842.1:10270813",59,110,51
"TANGO6","s954_F_GON_01_ASEReadCounter.table","NW_015090842.1:10274018",22,28,6
"TANGO6","s954_F_GON_01_ASEReadCounter.table","NW_015090842.1:10275974",25,35,10
"TANGO6","s954_F_GON_01_ASEReadCounter.table","NW_015090842.1:10275976",24,34,10
"TANGO6","s954_F_GON_01_ASEReadCounter.table","NW_015090842.1:10276123",16,24,8
"TANGO6","s954_F_GON_01_ASEReadCounter.table","NW_015090842.1:10276271",17,25,8
"TANGO6","s954_F_GON_01_ASEReadCounter.table","NW_015090842.1:10276272",17,25,8
"TANGO6","s954_F_GON_01_ASEReadCounter.table","NW_015090842.1:10276275",20,29,9
"TANGO6","s954_F_GON_01_ASEReadCounter.table","NW_015090842.1:10276278",20,29,9
"TANGO6","s954_F_GON_01_ASEReadCounter.table","NW_015090842.1:10276368",11,18,7
"TANGO6","s954_F_GON_01_ASEReadCounter.table","NW_015090842.1:10276373",5,11,6
"TANGO6","s954_F_GON_01_ASEReadCounter.table","NW_015090842.1:10276630",15,23,8
"TANGO6","s954_F_GON_01_ASEReadCounter.table","NW_015090842.1:10281498",13,33,20
"TANGO6","s954_F_GON_01_ASEReadCounter.table","NW_015090842.1:10281516",14,35,21
"TANGO6","s954_F_GON_01_ASEReadCounter.table","NW_015090842.1:10282842",22,38,16
"TANGO6","s954_F_GON_01_ASEReadCounter.table","NW_015090842.1:10282863",19,29,10
"TANGO6","s954_F_GON_01_ASEReadCounter.table","NW_015090842.1:10282869",17,27,10
"TANGO6","s954_F_GON_01_ASEReadCounter.table","NW_015090842.1:10282903",26,39,13
"TANGO6","s954_F_GON_01_ASEReadCounter.table","NW_015090842.1:10283757",27,41,14
"TANGO6","s954_F_GON_01_ASEReadCounter.table","NW_015090842.1:10283785",35,49,14
"HAS3","s954_F_GON_01_ASEReadCounter.table","NW_015090842.1:10288093",1,2,1
"HAS3","s954_F_GON_01_ASEReadCounter.table","NW_015090842.1:10288266",1,4,3
"HAS3","s954_F_GON_01_ASEReadCounter.table","NW_015090842.1:10288274",1,4,3
"HAS3","s954_F_GON_01_ASEReadCounter.table","NW_015090842.1:10288364",0,3,3
"HAS3","s954_F_GON_01_ASEReadCounter.table","NW_015090842.1:10289269",1,4,3
"HAS3","s954_F_GON_01_ASEReadCounter.table","NW_015090842.1:10289272",0,3,3
"HAS3","s954_F_GON_01_ASEReadCounter.table","NW_015090842.1:10289469",2,3,1
"HAS3","s954_F_GON_01_ASEReadCounter.table","NW_015090842.1:10290375",3,9,6
"HAS3","s954_F_GON_01_ASEReadCounter.table","NW_015090842.1:10290395",2,7,5
"HAS3","s954_F_GON_01_ASEReadCounter.table","NW_015090842.1:10290439",6,6,0
"HAS3","s954_F_GON_01_ASEReadCounter.table","NW_015090842.1:10290561",3,10,7
"HAS3","s954_F_GON_01_ASEReadCounter.table","NW_015090842.1:10290609",2,6,4
"HAS3","s954_F_GON_01_ASEReadCounter.table","NW_015090842.1:10290666",1,5,4
"HAS3","s954_F_GON_01_ASEReadCounter.table","NW_015090842.1:10290723",0,6,6
"HAS3","s954_F_GON_01_ASEReadCounter.table","NW_015090842.1:10290927",3,8,5
"HAS3","s954_F_GON_01_ASEReadCounter.table","NW_015090842.1:10291004",3,9,6
"CHTF8","s954_F_GON_01_ASEReadCounter.table","NW_015090842.1:10291319",13,27,14
"CHTF8","s954_F_GON_01_ASEReadCounter.table","NW_015090842.1:10291491",55,75,20
"CHTF8","s954_F_GON_01_ASEReadCounter.table","NW_015090842.1:10291520",52,84,32
"CHTF8","s954_F_GON_01_ASEReadCounter.table","NW_015090842.1:10291593",57,97,40
"CHTF8","s954_F_GON_01_ASEReadCounter.table","NW_015090842.1:10291600",55,99,44
"CHTF8","s954_F_GON_01_ASEReadCounter.table","NW_015090842.1:10291609",58,103,45
"CHTF8","s954_F_GON_01_ASEReadCounter.table","NW_015090842.1:10291639",62,106,44
"CHTF8","s954_F_GON_01_ASEReadCounter.table","NW_015090842.1:10291641",57,99,42
"CHTF8","s954_F_GON_01_ASEReadCounter.table","NW_015090842.1:10291648",65,108,43
"CHTF8","s954_F_GON_01_ASEReadCounter.table","NW_015090842.1:10291656",66,106,40
"CHTF8","s954_F_GON_01_ASEReadCounter.table","NW_015090842.1:10291675",64,107,43
"CHTF8","s954_F_GON_01_ASEReadCounter.table","NW_015090842.1:10291696",59,103,44
"CHTF8","s954_F_GON_01_ASEReadCounter.table","NW_015090842.1:10291714",54,98,44
"CHTF8","s954_F_GON_01_ASEReadCounter.table","NW_015090842.1:10291732",59,113,54
"CHTF8","s954_F_GON_01_ASEReadCounter.table","NW_015090842.1:10291755",47,104,57
"CHTF8","s954_F_GON_01_ASEReadCounter.table","NW_015090842.1:10291756",50,107,57
"CHTF8","s954_F_GON_01_ASEReadCounter.table","NW_015090842.1:10291758",48,108,60
"CHTF8","s954_F_GON_01_ASEReadCounter.table","NW_015090842.1:10291792",60,117,57
"CHTF8","s954_F_GON_01_ASEReadCounter.table","NW_015090842.1:10291895",63,107,44
"CHTF8","s954_F_GON_01_ASEReadCounter.table","NW_015090842.1:10292132",45,85,40
"CHTF8","s954_F_GON_01_ASEReadCounter.table","NW_015090842.1:10292314",52,88,36
"CHTF8","s954_F_GON_01_ASEReadCounter.table","NW_015090842.1:10292317",53,88,35
"CHTF8","s954_F_GON_01_ASEReadCounter.table","NW_015090842.1:10292928",11,16,5
"UTP4","s954_F_GON_01_ASEReadCounter.table","NW_015090842.1:10293146",10,36,26
"UTP4","s954_F_GON_01_ASEReadCounter.table","NW_015090842.1:10293151",9,33,24
"UTP4","s954_F_GON_01_ASEReadCounter.table","NW_015090842.1:10293191",4,22,18
"UTP4","s954_F_GON_01_ASEReadCounter.table","NW_015090842.1:10293362",18,37,19
"UTP4","s954_F_GON_01_ASEReadCounter.table","NW_015090842.1:10293430",18,34,16
"UTP4","s954_F_GON_01_ASEReadCounter.table","NW_015090842.1:10293625",12,29,17
"UTP4","s954_F_GON_01_ASEReadCounter.table","NW_015090842.1:10293684",16,42,26
"UTP4","s954_F_GON_01_ASEReadCounter.table","NW_015090842.1:10294093",10,33,23
"UTP4","s954_F_GON_01_ASEReadCounter.table","NW_015090842.1:10294622",16,34,18
"UTP4","s954_F_GON_01_ASEReadCounter.table","NW_015090842.1:10294632",16,33,17
"UTP4","s954_F_GON_01_ASEReadCounter.table","NW_015090842.1:10295238",14,45,31
"UTP4","s954_F_GON_01_ASEReadCounter.table","NW_015090842.1:10295880",21,39,18
"UTP4","s954_F_GON_01_ASEReadCounter.table","NW_015090842.1:10295884",21,40,19
"UTP4","s954_F_GON_01_ASEReadCounter.table","NW_015090842.1:10295903",22,34,12
"UTP4","s954_F_GON_01_ASEReadCounter.table","NW_015090842.1:10295906",25,38,13
"UTP4","s954_F_GON_01_ASEReadCounter.table","NW_015090842.1:10295915",24,40,16
"UTP4","s954_F_GON_01_ASEReadCounter.table","NW_015090842.1:10295938",17,33,16
"UTP4","s954_F_GON_01_ASEReadCounter.table","NW_015090842.1:10296175",24,45,21
"UTP4","s954_F_GON_01_ASEReadCounter.table","NW_015090842.1:10296660",19,43,24
"UTP4","s954_F_GON_01_ASEReadCounter.table","NW_015090842.1:10296679",21,48,27
"UTP4","s954_F_GON_01_ASEReadCounter.table","NW_015090842.1:10297193",27,57,30
"UTP4","s954_F_GON_01_ASEReadCounter.table","NW_015090842.1:10297220",25,53,28
"UTP4","s954_F_GON_01_ASEReadCounter.table","NW_015090842.1:10297307",27,66,39
"UTP4","s954_F_GON_01_ASEReadCounter.table","NW_015090842.1:10297558",40,77,37
"UTP4","s954_F_GON_01_ASEReadCounter.table","NW_015090842.1:10297943",31,62,31
"UTP4","s954_F_GON_01_ASEReadCounter.table","NW_015090842.1:10297979",29,60,31
"UTP4","s954_F_GON_01_ASEReadCounter.table","NW_015090842.1:10298022",20,48,28
"UTP4","s954_F_GON_01_ASEReadCounter.table","NW_015090842.1:10298079",4,18,14
"UTP4","s954_F_GON_01_ASEReadCounter.table","NW_015090842.1:10298081",4,17,13
"UTP4","s954_F_GON_01_ASEReadCounter.table","NW_015090842.1:10298082",4,17,13
"SNTB2","s954_F_GON_01_ASEReadCounter.table","NW_015090842.1:10298905",0,2,2
"SNTB2","s954_F_GON_01_ASEReadCounter.table","NW_015090842.1:10298928",0,3,3
"SNTB2","s954_F_GON_01_ASEReadCounter.table","NW_015090842.1:10303506",9,19,10
"SNTB2","s954_F_GON_01_ASEReadCounter.table","NW_015090842.1:10303524",8,16,8
"SNTB2","s954_F_GON_01_ASEReadCounter.table","NW_015090842.1:10304059",13,21,8
"SNTB2","s954_F_GON_01_ASEReadCounter.table","NW_015090842.1:10304089",12,20,8
"SNTB2","s954_F_GON_01_ASEReadCounter.table","NW_015090842.1:10304167",10,18,8
"SNTB2","s954_F_GON_01_ASEReadCounter.table","NW_015090842.1:10304176",8,14,6
"SNTB2","s954_F_GON_01_ASEReadCounter.table","NW_015090842.1:10305069",4,11,7
"SNTB2","s954_F_GON_01_ASEReadCounter.table","NW_015090842.1:10305099",4,10,6
"SNTB2","s954_F_GON_01_ASEReadCounter.table","NW_015090842.1:10305171",7,15,8
"SNTB2","s954_F_GON_01_ASEReadCounter.table","NW_015090842.1:10305177",6,16,10
"SNTB2","s954_F_GON_01_ASEReadCounter.table","NW_015090842.1:10305451",6,14,8
"SNTB2","s954_F_GON_01_ASEReadCounter.table","NW_015090842.1:10305547",14,27,13
"SNTB2","s954_F_GON_01_ASEReadCounter.table","NW_015090842.1:10305847",5,11,6
"SNTB2","s954_F_GON_01_ASEReadCounter.table","NW_015090842.1:10306173",6,14,8
"SNTB2","s954_F_GON_01_ASEReadCounter.table","NW_015090842.1:10306275",7,14,7
"SNTB2","s954_F_GON_01_ASEReadCounter.table","NW_015090842.1:10306457",11,24,13
"SNTB2","s954_F_GON_01_ASEReadCounter.table","NW_015090842.1:10306496",8,20,12
"SNTB2","s954_F_GON_01_ASEReadCounter.table","NW_015090842.1:10306499",8,20,12
"VPS4A","s954_F_GON_01_ASEReadCounter.table","NW_015090842.1:10308566",73,176,103
"VPS4A","s954_F_GON_01_ASEReadCounter.table","NW_015090842.1:10308573",76,187,111
"VPS4A","s954_F_GON_01_ASEReadCounter.table","NW_015090842.1:10308856",98,248,150
"VPS4A","s954_F_GON_01_ASEReadCounter.table","NW_015090842.1:10309056",107,279,172
"VPS4A","s954_F_GON_01_ASEReadCounter.table","NW_015090842.1:10309089",137,321,184
"VPS4A","s954_F_GON_01_ASEReadCounter.table","NW_015090842.1:10309392",156,321,165
"VPS4A","s954_F_GON_01_ASEReadCounter.table","NW_015090842.1:10309413",150,332,182
"VPS4A","s954_F_GON_01_ASEReadCounter.table","NW_015090842.1:10309467",145,378,233
"VPS4A","s954_F_GON_01_ASEReadCounter.table","NW_015090842.1:10310230",157,395,238
"VPS4A","s954_F_GON_01_ASEReadCounter.table","NW_015090842.1:10310425",141,355,214
"VPS4A","s954_F_GON_01_ASEReadCounter.table","NW_015090842.1:10310639",168,401,233
"VPS4A","s954_F_GON_01_ASEReadCounter.table","NW_015090842.1:10310734",135,319,184
"VPS4A","s954_F_GON_01_ASEReadCounter.table","NW_015090842.1:10310737",134,324,190
"VPS4A","s954_F_GON_01_ASEReadCounter.table","NW_015090842.1:10310746",134,330,196
"VPS4A","s954_F_GON_01_ASEReadCounter.table","NW_015090842.1:10310767",123,312,189
"VPS4A","s954_F_GON_01_ASEReadCounter.table","NW_015090842.1:10310995",177,375,198
"VPS4A","s954_F_GON_01_ASEReadCounter.table","NW_015090842.1:10311004",175,359,184
"VPS4A","s954_F_GON_01_ASEReadCounter.table","NW_015090842.1:10311007",180,375,195
"VPS4A","s954_F_GON_01_ASEReadCounter.table","NW_015090842.1:10311013",185,383,198
"VPS4A","s954_F_GON_01_ASEReadCounter.table","NW_015090842.1:10311022",167,359,192
"VPS4A","s954_F_GON_01_ASEReadCounter.table","NW_015090842.1:10311023",165,353,188
"VPS4A","s954_F_GON_01_ASEReadCounter.table","NW_015090842.1:10311426",164,385,221
"VPS4A","s954_F_GON_01_ASEReadCounter.table","NW_015090842.1:10311489",1,13,12
"VPS4A","s954_F_GON_01_ASEReadCounter.table","NW_015090842.1:10311490",2,12,10
"VPS4A","s954_F_GON_01_ASEReadCounter.table","NW_015090842.1:10311525",4,14,10
"VPS4A","s954_F_GON_01_ASEReadCounter.table","NW_015090842.1:10311529",4,22,18
"VPS4A","s954_F_GON_01_ASEReadCounter.table","NW_015090842.1:10311530",4,24,20
"VPS4A","s954_F_GON_01_ASEReadCounter.table","NW_015090842.1:10311552",32,54,22
"VPS4A","s954_F_GON_01_ASEReadCounter.table","NW_015090842.1:10311689",27,61,34
"VPS4A","s954_F_GON_01_ASEReadCounter.table","NW_015090842.1:10311700",30,66,36
"VPS4A","s954_F_GON_01_ASEReadCounter.table","NW_015090842.1:10311701",30,68,38
"VPS4A","s954_F_GON_01_ASEReadCounter.table","NW_015090842.1:10311703",30,66,36
"COG8","s954_F_GON_01_ASEReadCounter.table","NW_015090842.1:10313487",7,50,43
"COG8","s954_F_GON_01_ASEReadCounter.table","NW_015090842.1:10313559",20,60,40
"COG8","s954_F_GON_01_ASEReadCounter.table","NW_015090842.1:10313579",20,58,38
"COG8","s954_F_GON_01_ASEReadCounter.table","NW_015090842.1:10313665",15,50,35
"COG8","s954_F_GON_01_ASEReadCounter.table","NW_015090842.1:10313681",14,50,36
"COG8","s954_F_GON_01_ASEReadCounter.table","NW_015090842.1:10313768",33,70,37
"COG8","s954_F_GON_01_ASEReadCounter.table","NW_015090842.1:10313775",35,74,39
"COG8","s954_F_GON_01_ASEReadCounter.table","NW_015090842.1:10313811",30,67,37
"COG8","s954_F_GON_01_ASEReadCounter.table","NW_015090842.1:10313858",21,58,37
"COG8","s954_F_GON_01_ASEReadCounter.table","NW_015090842.1:10314100",25,65,40
"COG8","s954_F_GON_01_ASEReadCounter.table","NW_015090842.1:10314213",24,60,36
"COG8","s954_F_GON_01_ASEReadCounter.table","NW_015090842.1:10315093",18,41,23
"COG8","s954_F_GON_01_ASEReadCounter.table","NW_015090842.1:10315162",23,55,32
"COG8","s954_F_GON_01_ASEReadCounter.table","NW_015090842.1:10315285",28,66,38
"COG8","s954_F_GON_01_ASEReadCounter.table","NW_015090842.1:10315360",20,43,23
"COG8","s954_F_GON_01_ASEReadCounter.table","NW_015090842.1:10315369",21,44,23
"COG8","s954_F_GON_01_ASEReadCounter.table","NW_015090842.1:10315504",7,24,17
"COG8","s954_F_GON_01_ASEReadCounter.table","NW_015090842.1:10315508",7,25,18
"COG8","s954_F_GON_01_ASEReadCounter.table","NW_015090842.1:10315624",24,54,30
"COG8","s954_F_GON_01_ASEReadCounter.table","NW_015090842.1:10315693",15,44,29
"COG8","s954_F_GON_01_ASEReadCounter.table","NW_015090842.1:10315698",15,46,31
"COG8","s954_F_GON_01_ASEReadCounter.table","NW_015090842.1:10315768",16,47,31
"COG8","s954_F_GON_01_ASEReadCounter.table","NW_015090842.1:10315769",16,48,32
"COG8","s954_F_GON_01_ASEReadCounter.table","NW_015090842.1:10315784",13,41,28
"COG8","s954_F_GON_01_ASEReadCounter.table","NW_015090842.1:10316093",18,44,26
"COG8","s954_F_GON_01_ASEReadCounter.table","NW_015090842.1:10316133",14,34,20
"NIP7","s954_F_GON_01_ASEReadCounter.table","NW_015090842.1:10316759",12,36,24
"NIP7","s954_F_GON_01_ASEReadCounter.table","NW_015090842.1:10316967",95,184,89
"NIP7","s954_F_GON_01_ASEReadCounter.table","NW_015090842.1:10316995",110,202,92
"NIP7","s954_F_GON_01_ASEReadCounter.table","NW_015090842.1:10317240",166,272,106
"NIP7","s954_F_GON_01_ASEReadCounter.table","NW_015090842.1:10317247",161,267,106
"NIP7","s954_F_GON_01_ASEReadCounter.table","NW_015090842.1:10317264",151,254,103
"NIP7","s954_F_GON_01_ASEReadCounter.table","NW_015090842.1:10317433",160,291,131
"NIP7","s954_F_GON_01_ASEReadCounter.table","NW_015090842.1:10317738",135,263,128
"NIP7","s954_F_GON_01_ASEReadCounter.table","NW_015090842.1:10317769",151,272,121
"NIP7","s954_F_GON_01_ASEReadCounter.table","NW_015090842.1:10317808",83,168,85
"NIP7","s954_F_GON_01_ASEReadCounter.table","NW_015090842.1:10317870",55,120,65
"NIP7","s954_F_GON_01_ASEReadCounter.table","NW_015090842.1:10317871",55,116,61
"NIP7","s954_F_GON_01_ASEReadCounter.table","NW_015090842.1:10317898",37,76,39
"NIP7","s954_F_GON_01_ASEReadCounter.table","NW_015090842.1:10317911",35,68,33
"TMED6","s954_F_GON_01_ASEReadCounter.table","NW_015090842.1:10318731",3,3,0
"TERF2","s954_F_GON_01_ASEReadCounter.table","NW_015090842.1:10321665",8,8,0
"TERF2","s954_F_GON_01_ASEReadCounter.table","NW_015090842.1:10321768",35,89,54
"TERF2","s954_F_GON_01_ASEReadCounter.table","NW_015090842.1:10321777",39,91,52
"TERF2","s954_F_GON_01_ASEReadCounter.table","NW_015090842.1:10321805",38,92,54
"TERF2","s954_F_GON_01_ASEReadCounter.table","NW_015090842.1:10321878",49,124,75
"TERF2","s954_F_GON_01_ASEReadCounter.table","NW_015090842.1:10321893",5,115,110
"TERF2","s954_F_GON_01_ASEReadCounter.table","NW_015090842.1:10321897",41,108,67
"TERF2","s954_F_GON_01_ASEReadCounter.table","NW_015090842.1:10321908",37,103,66
"TERF2","s954_F_GON_01_ASEReadCounter.table","NW_015090842.1:10322001",52,143,91
"TERF2","s954_F_GON_01_ASEReadCounter.table","NW_015090842.1:10322035",44,123,79
"TERF2","s954_F_GON_01_ASEReadCounter.table","NW_015090842.1:10322051",39,133,94
"TERF2","s954_F_GON_01_ASEReadCounter.table","NW_015090842.1:10322137",39,113,74
"TERF2","s954_F_GON_01_ASEReadCounter.table","NW_015090842.1:10322144",45,113,68
"TERF2","s954_F_GON_01_ASEReadCounter.table","NW_015090842.1:10322388",31,120,89
"TERF2","s954_F_GON_01_ASEReadCounter.table","NW_015090842.1:10322396",34,114,80
"TERF2","s954_F_GON_01_ASEReadCounter.table","NW_015090842.1:10322502",43,133,90
"TERF2","s954_F_GON_01_ASEReadCounter.table","NW_015090842.1:10322504",45,135,90
"TERF2","s954_F_GON_01_ASEReadCounter.table","NW_015090842.1:10322510",41,134,93
"TERF2","s954_F_GON_01_ASEReadCounter.table","NW_015090842.1:10323580",44,115,71
"TERF2","s954_F_GON_01_ASEReadCounter.table","NW_015090842.1:10324314",33,107,74
"TERF2","s954_F_GON_01_ASEReadCounter.table","NW_015090842.1:10326832",28,81,53
"TERF2","s954_F_GON_01_ASEReadCounter.table","NW_015090842.1:10327787",12,65,53
"TERF2","s954_F_GON_01_ASEReadCounter.table","NW_015090842.1:10328588",35,74,39
"TERF2","s954_F_GON_01_ASEReadCounter.table","NW_015090842.1:10328644",18,55,37
"TERF2","s954_F_GON_01_ASEReadCounter.table","NW_015090842.1:10329813",17,46,29
"TERF2","s954_F_GON_01_ASEReadCounter.table","NW_015090842.1:10330749",18,58,40
"TERF2","s954_F_GON_01_ASEReadCounter.table","NW_015090842.1:10330789",14,49,35
"CYB5B","s954_F_GON_01_ASEReadCounter.table","NW_015090842.1:10336595",14,34,20
"CYB5B","s954_F_GON_01_ASEReadCounter.table","NW_015090842.1:10336667",82,178,96
"CYB5B","s954_F_GON_01_ASEReadCounter.table","NW_015090842.1:10336689",109,252,143
"CYB5B","s954_F_GON_01_ASEReadCounter.table","NW_015090842.1:10336728",176,383,207
"CYB5B","s954_F_GON_01_ASEReadCounter.table","NW_015090842.1:10345068",171,370,199
"CYB5B","s954_F_GON_01_ASEReadCounter.table","NW_015090842.1:10348800",224,491,267
"CYB5B","s954_F_GON_01_ASEReadCounter.table","NW_015090842.1:10348888",183,432,249
"CYB5B","s954_F_GON_01_ASEReadCounter.table","NW_015090842.1:10349046",179,413,234
"CYB5B","s954_F_GON_01_ASEReadCounter.table","NW_015090842.1:10349119",107,345,238
"CYB5B","s954_F_GON_01_ASEReadCounter.table","NW_015090842.1:10349146",63,311,248
"CYB5B","s954_F_GON_01_ASEReadCounter.table","NW_015090842.1:10349157",103,356,253
