"gene","id","snp","ref_count","total_count","alt_count"
"CENPN","s954_F_VTA_03_ASEReadCounter.table","NW_015090842.1:5801612",0,1,1
"CENPN","s954_F_VTA_03_ASEReadCounter.table","NW_015090842.1:5801618",0,1,1
"CENPN","s954_F_VTA_03_ASEReadCounter.table","NW_015090842.1:5801623",0,1,1
"CENPN","s954_F_VTA_03_ASEReadCounter.table","NW_015090842.1:5801631",0,1,1
"CENPN","s954_F_VTA_03_ASEReadCounter.table","NW_015090842.1:5801632",0,1,1
"CENPN","s954_F_VTA_03_ASEReadCounter.table","NW_015090842.1:5802008",2,3,1
"CENPN","s954_F_VTA_03_ASEReadCounter.table","NW_015090842.1:5802012",3,4,1
"CENPN","s954_F_VTA_03_ASEReadCounter.table","NW_015090842.1:5802087",4,6,2
"CENPN","s954_F_VTA_03_ASEReadCounter.table","NW_015090842.1:5810113",6,6,0
"CENPN","s954_F_VTA_03_ASEReadCounter.table","NW_015090842.1:5810147",8,8,0
"CENPN","s954_F_VTA_03_ASEReadCounter.table","NW_015090842.1:5810148",8,8,0
"ATMIN","s954_F_VTA_03_ASEReadCounter.table","NW_015090842.1:5818789",2,6,4
"ATMIN","s954_F_VTA_03_ASEReadCounter.table","NW_015090842.1:5819958",1,7,6
"ATMIN","s954_F_VTA_03_ASEReadCounter.table","NW_015090842.1:5820004",0,5,5
"ATMIN","s954_F_VTA_03_ASEReadCounter.table","NW_015090842.1:5820217",1,3,2
"ATMIN","s954_F_VTA_03_ASEReadCounter.table","NW_015090842.1:5820250",1,2,1
"ATMIN","s954_F_VTA_03_ASEReadCounter.table","NW_015090842.1:5820298",3,7,4
"ATMIN","s954_F_VTA_03_ASEReadCounter.table","NW_015090842.1:5820417",2,4,2
"ATMIN","s954_F_VTA_03_ASEReadCounter.table","NW_015090842.1:5820421",1,4,3
"ATMIN","s954_F_VTA_03_ASEReadCounter.table","NW_015090842.1:5820448",1,7,6
"ATMIN","s954_F_VTA_03_ASEReadCounter.table","NW_015090842.1:5820457",1,7,6
"ATMIN","s954_F_VTA_03_ASEReadCounter.table","NW_015090842.1:5820510",4,11,7
"ATMIN","s954_F_VTA_03_ASEReadCounter.table","NW_015090842.1:5820673",2,3,1
"ATMIN","s954_F_VTA_03_ASEReadCounter.table","NW_015090842.1:5820754",1,3,2
"ATMIN","s954_F_VTA_03_ASEReadCounter.table","NW_015090842.1:5820820",0,5,5
"ATMIN","s954_F_VTA_03_ASEReadCounter.table","NW_015090842.1:5820865",4,10,6
"ATMIN","s954_F_VTA_03_ASEReadCounter.table","NW_015090842.1:5820889",5,12,7
"ATMIN","s954_F_VTA_03_ASEReadCounter.table","NW_015090842.1:5820891",5,11,6
"ATMIN","s954_F_VTA_03_ASEReadCounter.table","NW_015090842.1:5820997",4,10,6
"ATMIN","s954_F_VTA_03_ASEReadCounter.table","NW_015090842.1:5821063",4,12,8
"ATMIN","s954_F_VTA_03_ASEReadCounter.table","NW_015090842.1:5821132",3,12,9
"ATMIN","s954_F_VTA_03_ASEReadCounter.table","NW_015090842.1:5821645",10,18,8
"ATMIN","s954_F_VTA_03_ASEReadCounter.table","NW_015090842.1:5825066",15,25,10
"ATMIN","s954_F_VTA_03_ASEReadCounter.table","NW_015090842.1:5825106",15,29,14
"ATMIN","s954_F_VTA_03_ASEReadCounter.table","NW_015090842.1:5825122",13,29,16
"ATMIN","s954_F_VTA_03_ASEReadCounter.table","NW_015090842.1:5825178",8,24,16
"ATMIN","s954_F_VTA_03_ASEReadCounter.table","NW_015090842.1:5825194",9,20,11
"ATMIN","s954_F_VTA_03_ASEReadCounter.table","NW_015090842.1:5825195",9,21,12
"ATMIN","s954_F_VTA_03_ASEReadCounter.table","NW_015090842.1:5825220",11,27,16
"ATMIN","s954_F_VTA_03_ASEReadCounter.table","NW_015090842.1:5825240",12,34,22
"ATMIN","s954_F_VTA_03_ASEReadCounter.table","NW_015090842.1:5825303",12,43,31
"ATMIN","s954_F_VTA_03_ASEReadCounter.table","NW_015090842.1:5825304",12,43,31
"ATMIN","s954_F_VTA_03_ASEReadCounter.table","NW_015090842.1:5825310",15,44,29
"ATMIN","s954_F_VTA_03_ASEReadCounter.table","NW_015090842.1:5825406",9,30,21
"ATMIN","s954_F_VTA_03_ASEReadCounter.table","NW_015090842.1:5825415",10,34,24
"ATMIN","s954_F_VTA_03_ASEReadCounter.table","NW_015090842.1:5825438",12,38,26
"ATMIN","s954_F_VTA_03_ASEReadCounter.table","NW_015090842.1:5825485",16,42,26
"ATMIN","s954_F_VTA_03_ASEReadCounter.table","NW_015090842.1:5825524",19,39,20
"ATMIN","s954_F_VTA_03_ASEReadCounter.table","NW_015090842.1:5825557",18,40,22
"ATMIN","s954_F_VTA_03_ASEReadCounter.table","NW_015090842.1:5825571",19,45,26
"ATMIN","s954_F_VTA_03_ASEReadCounter.table","NW_015090842.1:5825579",19,44,25
"ATMIN","s954_F_VTA_03_ASEReadCounter.table","NW_015090842.1:5825590",17,40,23
"ATMIN","s954_F_VTA_03_ASEReadCounter.table","NW_015090842.1:5825689",19,46,27
"ATMIN","s954_F_VTA_03_ASEReadCounter.table","NW_015090842.1:5825703",24,50,26
"ATMIN","s954_F_VTA_03_ASEReadCounter.table","NW_015090842.1:5825787",16,32,16
"ATMIN","s954_F_VTA_03_ASEReadCounter.table","NW_015090842.1:5825833",20,40,20
"ATMIN","s954_F_VTA_03_ASEReadCounter.table","NW_015090842.1:5825841",13,32,19
"ATMIN","s954_F_VTA_03_ASEReadCounter.table","NW_015090842.1:5825895",21,50,29
"ATMIN","s954_F_VTA_03_ASEReadCounter.table","NW_015090842.1:5825984",13,39,26
"ATMIN","s954_F_VTA_03_ASEReadCounter.table","NW_015090842.1:5826162",20,50,30
"ATMIN","s954_F_VTA_03_ASEReadCounter.table","NW_015090842.1:5826194",20,54,34
"ATMIN","s954_F_VTA_03_ASEReadCounter.table","NW_015090842.1:5826235",19,55,36
"ATMIN","s954_F_VTA_03_ASEReadCounter.table","NW_015090842.1:5826245",21,61,40
"ATMIN","s954_F_VTA_03_ASEReadCounter.table","NW_015090842.1:5826335",14,34,20
"ATMIN","s954_F_VTA_03_ASEReadCounter.table","NW_015090842.1:5826417",24,49,25
"ATMIN","s954_F_VTA_03_ASEReadCounter.table","NW_015090842.1:5826431",19,63,44
"ATMIN","s954_F_VTA_03_ASEReadCounter.table","NW_015090842.1:5826438",24,60,36
"ATMIN","s954_F_VTA_03_ASEReadCounter.table","NW_015090842.1:5826463",35,83,48
"ATMIN","s954_F_VTA_03_ASEReadCounter.table","NW_015090842.1:5826502",28,76,48
"ATMIN","s954_F_VTA_03_ASEReadCounter.table","NW_015090842.1:5826511",28,78,50
"ATMIN","s954_F_VTA_03_ASEReadCounter.table","NW_015090842.1:5826659",26,55,29
"ATMIN","s954_F_VTA_03_ASEReadCounter.table","NW_015090842.1:5826701",34,69,35
"ATMIN","s954_F_VTA_03_ASEReadCounter.table","NW_015090842.1:5826702",33,72,39
"ATMIN","s954_F_VTA_03_ASEReadCounter.table","NW_015090842.1:5826732",30,73,43
"ATMIN","s954_F_VTA_03_ASEReadCounter.table","NW_015090842.1:5826745",34,76,42
"ATMIN","s954_F_VTA_03_ASEReadCounter.table","NW_015090842.1:5826835",47,91,44
"ATMIN","s954_F_VTA_03_ASEReadCounter.table","NW_015090842.1:5826942",19,66,47
"ATMIN","s954_F_VTA_03_ASEReadCounter.table","NW_015090842.1:5827193",41,132,91
"ATMIN","s954_F_VTA_03_ASEReadCounter.table","NW_015090842.1:5827196",39,129,90
"ATMIN","s954_F_VTA_03_ASEReadCounter.table","NW_015090842.1:5827269",46,117,71
"ATMIN","s954_F_VTA_03_ASEReadCounter.table","NW_015090842.1:5827315",28,83,55
"ATMIN","s954_F_VTA_03_ASEReadCounter.table","NW_015090842.1:5827316",28,87,59
"ATMIN","s954_F_VTA_03_ASEReadCounter.table","NW_015090842.1:5827333",28,86,58
"PPP1R3E","s954_F_VTA_03_ASEReadCounter.table","NW_015090842.1:5837733",4,6,2
"PPP1R3E","s954_F_VTA_03_ASEReadCounter.table","NW_015090842.1:5837947",4,5,1
"PKD1L2","s954_F_VTA_03_ASEReadCounter.table","NW_015090842.1:5867509",0,1,1
"PKD1L2","s954_F_VTA_03_ASEReadCounter.table","NW_015090842.1:5867597",1,2,1
"PKD1L2","s954_F_VTA_03_ASEReadCounter.table","NW_015090842.1:5867600",1,2,1
"PKD1L2","s954_F_VTA_03_ASEReadCounter.table","NW_015090842.1:5867660",2,3,1
"PKD1L2","s954_F_VTA_03_ASEReadCounter.table","NW_015090842.1:5867675",2,3,1
"PKD1L2","s954_F_VTA_03_ASEReadCounter.table","NW_015090842.1:5867788",2,4,2
"PKD1L2","s954_F_VTA_03_ASEReadCounter.table","NW_015090842.1:5867843",2,3,1
"PKD1L2","s954_F_VTA_03_ASEReadCounter.table","NW_015090842.1:5872924",1,1,0
"PKD1L2","s954_F_VTA_03_ASEReadCounter.table","NW_015090842.1:5872948",1,1,0
"BCO1","s954_F_VTA_03_ASEReadCounter.table","NW_015090842.1:5915610",0,1,1
"BCO1","s954_F_VTA_03_ASEReadCounter.table","NW_015090842.1:5915646",0,1,1
"BCO1","s954_F_VTA_03_ASEReadCounter.table","NW_015090842.1:5917836",1,1,0
"BCO1","s954_F_VTA_03_ASEReadCounter.table","NW_015090842.1:5917912",6,10,4
"BCO1","s954_F_VTA_03_ASEReadCounter.table","NW_015090842.1:5917941",8,11,3
"BCO1","s954_F_VTA_03_ASEReadCounter.table","NW_015090842.1:5917971",6,9,3
"BCO1","s954_F_VTA_03_ASEReadCounter.table","NW_015090842.1:5921679",12,15,3
"BCO1","s954_F_VTA_03_ASEReadCounter.table","NW_015090842.1:5921726",8,11,3
"BCO1","s954_F_VTA_03_ASEReadCounter.table","NW_015090842.1:5925669",3,5,2
"BCO1","s954_F_VTA_03_ASEReadCounter.table","NW_015090842.1:5926937",3,7,4
"BCO1","s954_F_VTA_03_ASEReadCounter.table","NW_015090842.1:5927921",9,12,3
"BCO1","s954_F_VTA_03_ASEReadCounter.table","NW_015090842.1:5927948",7,11,4
"BCO1","s954_F_VTA_03_ASEReadCounter.table","NW_015090842.1:5927968",8,13,5
"BCO1","s954_F_VTA_03_ASEReadCounter.table","NW_015090842.1:5928052",2,4,2
"BCO1","s954_F_VTA_03_ASEReadCounter.table","NW_015090842.1:5932726",10,12,2
"BCO1","s954_F_VTA_03_ASEReadCounter.table","NW_015090842.1:5932801",3,3,0
"BCO1","s954_F_VTA_03_ASEReadCounter.table","NW_015090842.1:5934558",6,12,6
"BCO1","s954_F_VTA_03_ASEReadCounter.table","NW_015090842.1:5934575",6,13,7
"BCO1","s954_F_VTA_03_ASEReadCounter.table","NW_015090842.1:5934608",4,11,7
"BCO1","s954_F_VTA_03_ASEReadCounter.table","NW_015090842.1:5934647",5,11,6
"BCO1","s954_F_VTA_03_ASEReadCounter.table","NW_015090842.1:5934725",7,13,6
"BCO1","s954_F_VTA_03_ASEReadCounter.table","NW_015090842.1:5934726",7,13,6
"BCO1","s954_F_VTA_03_ASEReadCounter.table","NW_015090842.1:5934733",6,10,4
"BCO1","s954_F_VTA_03_ASEReadCounter.table","NW_015090842.1:5934821",2,8,6
"BCO1","s954_F_VTA_03_ASEReadCounter.table","NW_015090842.1:5934826",4,10,6
"BCO1","s954_F_VTA_03_ASEReadCounter.table","NW_015090842.1:5934844",3,8,5
"BCO1","s954_F_VTA_03_ASEReadCounter.table","NW_015090842.1:5934958",12,18,6
"BCO1","s954_F_VTA_03_ASEReadCounter.table","NW_015090842.1:5934976",13,19,6
"GAN","s954_F_VTA_03_ASEReadCounter.table","NW_015090842.1:5939249",0,2,2
"GAN","s954_F_VTA_03_ASEReadCounter.table","NW_015090842.1:5953759",9,19,10
"GAN","s954_F_VTA_03_ASEReadCounter.table","NW_015090842.1:5957502",10,29,19
"GAN","s954_F_VTA_03_ASEReadCounter.table","NW_015090842.1:5957578",21,42,21
"GAN","s954_F_VTA_03_ASEReadCounter.table","NW_015090842.1:5966047",16,38,22
"GAN","s954_F_VTA_03_ASEReadCounter.table","NW_015090842.1:5966126",11,40,29
"GAN","s954_F_VTA_03_ASEReadCounter.table","NW_015090842.1:5966127",11,40,29
"GAN","s954_F_VTA_03_ASEReadCounter.table","NW_015090842.1:5966162",17,48,31
"GAN","s954_F_VTA_03_ASEReadCounter.table","NW_015090842.1:5966483",29,67,38
"CMIP","s954_F_VTA_03_ASEReadCounter.table","NW_015090842.1:6109159",26,47,21
"CMIP","s954_F_VTA_03_ASEReadCounter.table","NW_015090842.1:6109166",22,37,15
"CMIP","s954_F_VTA_03_ASEReadCounter.table","NW_015090842.1:6114641",34,60,26
"CMIP","s954_F_VTA_03_ASEReadCounter.table","NW_015090842.1:6114751",29,56,27
"CMIP","s954_F_VTA_03_ASEReadCounter.table","NW_015090842.1:6114824",31,64,33
"CMIP","s954_F_VTA_03_ASEReadCounter.table","NW_015090842.1:6126295",87,89,2
"CMIP","s954_F_VTA_03_ASEReadCounter.table","NW_015090842.1:6128998",52,99,47
"CMIP","s954_F_VTA_03_ASEReadCounter.table","NW_015090842.1:6130562",70,150,80
"CMIP","s954_F_VTA_03_ASEReadCounter.table","NW_015090842.1:6132522",62,133,71
"CMIP","s954_F_VTA_03_ASEReadCounter.table","NW_015090842.1:6138265",100,234,134
"CMIP","s954_F_VTA_03_ASEReadCounter.table","NW_015090842.1:6138300",102,238,136
"CMIP","s954_F_VTA_03_ASEReadCounter.table","NW_015090842.1:6138342",82,193,111
"CMIP","s954_F_VTA_03_ASEReadCounter.table","NW_015090842.1:6138343",82,193,111
"CMIP","s954_F_VTA_03_ASEReadCounter.table","NW_015090842.1:6138345",80,193,113
"CMIP","s954_F_VTA_03_ASEReadCounter.table","NW_015090842.1:6138647",82,170,88
"CMIP","s954_F_VTA_03_ASEReadCounter.table","NW_015090842.1:6138745",72,175,103
"CMIP","s954_F_VTA_03_ASEReadCounter.table","NW_015090842.1:6138832",14,55,41
"CMIP","s954_F_VTA_03_ASEReadCounter.table","NW_015090842.1:6138967",77,161,84
"CMIP","s954_F_VTA_03_ASEReadCounter.table","NW_015090842.1:6139131",40,98,58
"CMIP","s954_F_VTA_03_ASEReadCounter.table","NW_015090842.1:6139163",7,65,58
"CMIP","s954_F_VTA_03_ASEReadCounter.table","NW_015090842.1:6139212",139,147,8
"CMIP","s954_F_VTA_03_ASEReadCounter.table","NW_015090842.1:6139360",43,74,31
"CMIP","s954_F_VTA_03_ASEReadCounter.table","NW_015090842.1:6139572",15,38,23
"PLCG2","s954_F_VTA_03_ASEReadCounter.table","NW_015090842.1:6179613",5,5,0
"PLCG2","s954_F_VTA_03_ASEReadCounter.table","NW_015090842.1:6179658",3,3,0
"PLCG2","s954_F_VTA_03_ASEReadCounter.table","NW_015090842.1:6203766",1,1,0
"PLCG2","s954_F_VTA_03_ASEReadCounter.table","NW_015090842.1:6203775",1,1,0
"PLCG2","s954_F_VTA_03_ASEReadCounter.table","NW_015090842.1:6203787",1,1,0
"PLCG2","s954_F_VTA_03_ASEReadCounter.table","NW_015090842.1:6209741",3,4,1
"PLCG2","s954_F_VTA_03_ASEReadCounter.table","NW_015090842.1:6209798",2,3,1
"PLCG2","s954_F_VTA_03_ASEReadCounter.table","NW_015090842.1:6209816",0,1,1
"PLCG2","s954_F_VTA_03_ASEReadCounter.table","NW_015090842.1:6217547",0,4,4
"PLCG2","s954_F_VTA_03_ASEReadCounter.table","NW_015090842.1:6218641",1,5,4
"PLCG2","s954_F_VTA_03_ASEReadCounter.table","NW_015090842.1:6220552",1,4,3
"PLCG2","s954_F_VTA_03_ASEReadCounter.table","NW_015090842.1:6221969",1,3,2
"PLCG2","s954_F_VTA_03_ASEReadCounter.table","NW_015090842.1:6228672",1,3,2
"PLCG2","s954_F_VTA_03_ASEReadCounter.table","NW_015090842.1:6228694",1,4,3
"PLCG2","s954_F_VTA_03_ASEReadCounter.table","NW_015090842.1:6228722",3,6,3
"PLCG2","s954_F_VTA_03_ASEReadCounter.table","NW_015090842.1:6228747",2,5,3
"PLCG2","s954_F_VTA_03_ASEReadCounter.table","NW_015090842.1:6228835",3,6,3
"PLCG2","s954_F_VTA_03_ASEReadCounter.table","NW_015090842.1:6228841",3,6,3
"PLCG2","s954_F_VTA_03_ASEReadCounter.table","NW_015090842.1:6228865",4,6,2
"PLCG2","s954_F_VTA_03_ASEReadCounter.table","NW_015090842.1:6228917",4,5,1
"PLCG2","s954_F_VTA_03_ASEReadCounter.table","NW_015090842.1:6228926",4,5,1
"PLCG2","s954_F_VTA_03_ASEReadCounter.table","NW_015090842.1:6228954",1,3,2
"PLCG2","s954_F_VTA_03_ASEReadCounter.table","NW_015090842.1:6229002",4,5,1
"PLCG2","s954_F_VTA_03_ASEReadCounter.table","NW_015090842.1:6229006",4,6,2
"PLCG2","s954_F_VTA_03_ASEReadCounter.table","NW_015090842.1:6229081",2,4,2
"PLCG2","s954_F_VTA_03_ASEReadCounter.table","NW_015090842.1:6229097",2,4,2
"PLCG2","s954_F_VTA_03_ASEReadCounter.table","NW_015090842.1:6229160",2,4,2
"PLCG2","s954_F_VTA_03_ASEReadCounter.table","NW_015090842.1:6229213",3,5,2
"PLCG2","s954_F_VTA_03_ASEReadCounter.table","NW_015090842.1:6229231",2,3,1
"PLCG2","s954_F_VTA_03_ASEReadCounter.table","NW_015090842.1:6229663",1,2,1
"PLCG2","s954_F_VTA_03_ASEReadCounter.table","NW_015090842.1:6229748",0,2,2
"PLCG2","s954_F_VTA_03_ASEReadCounter.table","NW_015090842.1:6229892",1,2,1
"PLCG2","s954_F_VTA_03_ASEReadCounter.table","NW_015090842.1:6230248",4,5,1
"PLCG2","s954_F_VTA_03_ASEReadCounter.table","NW_015090842.1:6230255",4,5,1
"PLCG2","s954_F_VTA_03_ASEReadCounter.table","NW_015090842.1:6230276",4,4,0
"PLCG2","s954_F_VTA_03_ASEReadCounter.table","NW_015090842.1:6230296",3,4,1
"PLCG2","s954_F_VTA_03_ASEReadCounter.table","NW_015090842.1:6230349",5,5,0
"PLCG2","s954_F_VTA_03_ASEReadCounter.table","NW_015090842.1:6230408",4,4,0
"PLCG2","s954_F_VTA_03_ASEReadCounter.table","NW_015090842.1:6230439",5,6,1
"PLCG2","s954_F_VTA_03_ASEReadCounter.table","NW_015090842.1:6230898",7,8,1
"PLCG2","s954_F_VTA_03_ASEReadCounter.table","NW_015090842.1:6230976",4,6,2
"PLCG2","s954_F_VTA_03_ASEReadCounter.table","NW_015090842.1:6231078",9,12,3
"PLCG2","s954_F_VTA_03_ASEReadCounter.table","NW_015090842.1:6231138",8,10,2
"PLCG2","s954_F_VTA_03_ASEReadCounter.table","NW_015090842.1:6231177",7,9,2
"PLCG2","s954_F_VTA_03_ASEReadCounter.table","NW_015090842.1:6231263",8,9,1
"SDR42E1","s954_F_VTA_03_ASEReadCounter.table","NW_015090842.1:6235315",2,3,1
"SDR42E1","s954_F_VTA_03_ASEReadCounter.table","NW_015090842.1:6235348",2,4,2
"SDR42E1","s954_F_VTA_03_ASEReadCounter.table","NW_015090842.1:6235355",2,4,2
"SDR42E1","s954_F_VTA_03_ASEReadCounter.table","NW_015090842.1:6235417",3,7,4
"SDR42E1","s954_F_VTA_03_ASEReadCounter.table","NW_015090842.1:6235558",1,11,10
"SDR42E1","s954_F_VTA_03_ASEReadCounter.table","NW_015090842.1:6235741",3,12,9
"SDR42E1","s954_F_VTA_03_ASEReadCounter.table","NW_015090842.1:6235777",4,12,8
"SDR42E1","s954_F_VTA_03_ASEReadCounter.table","NW_015090842.1:6235806",6,16,10
"SDR42E1","s954_F_VTA_03_ASEReadCounter.table","NW_015090842.1:6235809",6,16,10
"SDR42E1","s954_F_VTA_03_ASEReadCounter.table","NW_015090842.1:6235816",6,15,9
"SDR42E1","s954_F_VTA_03_ASEReadCounter.table","NW_015090842.1:6235914",6,17,11
"SDR42E1","s954_F_VTA_03_ASEReadCounter.table","NW_015090842.1:6235935",6,17,11
"SDR42E1","s954_F_VTA_03_ASEReadCounter.table","NW_015090842.1:6235957",7,16,9
"SDR42E1","s954_F_VTA_03_ASEReadCounter.table","NW_015090842.1:6236040",4,10,6
"SDR42E1","s954_F_VTA_03_ASEReadCounter.table","NW_015090842.1:6236260",8,18,10
"SDR42E1","s954_F_VTA_03_ASEReadCounter.table","NW_015090842.1:6236281",7,14,7
"SDR42E1","s954_F_VTA_03_ASEReadCounter.table","NW_015090842.1:6236305",4,11,7
"SDR42E1","s954_F_VTA_03_ASEReadCounter.table","NW_015090842.1:6236458",1,3,2
"SDR42E1","s954_F_VTA_03_ASEReadCounter.table","NW_015090842.1:6236476",1,2,1
"SDR42E1","s954_F_VTA_03_ASEReadCounter.table","NW_015090842.1:6236608",1,5,4
"SDR42E1","s954_F_VTA_03_ASEReadCounter.table","NW_015090842.1:6238244",3,7,4
"SDR42E1","s954_F_VTA_03_ASEReadCounter.table","NW_015090842.1:6238829",1,2,1
"HSD17B2","s954_F_VTA_03_ASEReadCounter.table","NW_015090842.1:6257616",0,2,2
"HSD17B2","s954_F_VTA_03_ASEReadCounter.table","NW_015090842.1:6257711",0,2,2
"HSD17B2","s954_F_VTA_03_ASEReadCounter.table","NW_015090842.1:6257712",0,1,1
"HSD17B2","s954_F_VTA_03_ASEReadCounter.table","NW_015090842.1:6257737",0,1,1
"HSD17B2","s954_F_VTA_03_ASEReadCounter.table","NW_015090842.1:6257758",0,1,1
"HSD17B2","s954_F_VTA_03_ASEReadCounter.table","NW_015090842.1:6257767",0,1,1
"HSD17B2","s954_F_VTA_03_ASEReadCounter.table","NW_015090842.1:6257829",0,1,1
"HSD17B2","s954_F_VTA_03_ASEReadCounter.table","NW_015090842.1:6257851",0,1,1
"HSD17B2","s954_F_VTA_03_ASEReadCounter.table","NW_015090842.1:6257889",0,1,1
"HSD17B2","s954_F_VTA_03_ASEReadCounter.table","NW_015090842.1:6262951",0,1,1
"HSD17B2","s954_F_VTA_03_ASEReadCounter.table","NW_015090842.1:6262974",0,1,1
"HSD17B2","s954_F_VTA_03_ASEReadCounter.table","NW_015090842.1:6266125",0,2,2
"HSD17B2","s954_F_VTA_03_ASEReadCounter.table","NW_015090842.1:6266135",0,2,2
"HSD17B2","s954_F_VTA_03_ASEReadCounter.table","NW_015090842.1:6266795",0,3,3
"HSD17B2","s954_F_VTA_03_ASEReadCounter.table","NW_015090842.1:6266944",0,3,3
"HSD17B2","s954_F_VTA_03_ASEReadCounter.table","NW_015090842.1:6267053",0,5,5
"HSD17B2","s954_F_VTA_03_ASEReadCounter.table","NW_015090842.1:6267196",0,3,3
"HSD17B2","s954_F_VTA_03_ASEReadCounter.table","NW_015090842.1:6267273",0,3,3
"HSD17B2","s954_F_VTA_03_ASEReadCounter.table","NW_015090842.1:6267674",0,2,2
"HSD17B2","s954_F_VTA_03_ASEReadCounter.table","NW_015090842.1:6268098",0,2,2
"HSD17B2","s954_F_VTA_03_ASEReadCounter.table","NW_015090842.1:6268203",0,1,1
"ARY2","s954_F_VTA_03_ASEReadCounter.table","NW_015090842.1:6303922",11,26,15
"ARY2","s954_F_VTA_03_ASEReadCounter.table","NW_015090842.1:6303954",12,27,15
"ARY2","s954_F_VTA_03_ASEReadCounter.table","NW_015090842.1:6303979",14,28,14
"ARY2","s954_F_VTA_03_ASEReadCounter.table","NW_015090842.1:6305848",17,21,4
"ARY2","s954_F_VTA_03_ASEReadCounter.table","NW_015090842.1:6305856",15,19,4
"ARY2","s954_F_VTA_03_ASEReadCounter.table","NW_015090842.1:6305857",15,19,4
"ARY2","s954_F_VTA_03_ASEReadCounter.table","NW_015090842.1:6306017",20,29,9
"ARY2","s954_F_VTA_03_ASEReadCounter.table","NW_015090842.1:6306052",20,25,5
"ARY2","s954_F_VTA_03_ASEReadCounter.table","NW_015090842.1:6306094",22,33,11
"ARY2","s954_F_VTA_03_ASEReadCounter.table","NW_015090842.1:6306100",24,36,12
"ARY2","s954_F_VTA_03_ASEReadCounter.table","NW_015090842.1:6306146",18,28,10
"ARY2","s954_F_VTA_03_ASEReadCounter.table","NW_015090842.1:6306147",18,28,10
"ARY2","s954_F_VTA_03_ASEReadCounter.table","NW_015090842.1:6306390",24,36,12
"ARY2","s954_F_VTA_03_ASEReadCounter.table","NW_015090842.1:6306567",21,36,15
"ARY2","s954_F_VTA_03_ASEReadCounter.table","NW_015090842.1:6306705",21,25,4
"ARY2","s954_F_VTA_03_ASEReadCounter.table","NW_015090842.1:6306773",22,31,9
"ARY2","s954_F_VTA_03_ASEReadCounter.table","NW_015090842.1:6307039",19,32,13
"ARY2","s954_F_VTA_03_ASEReadCounter.table","NW_015090842.1:6307043",21,35,14
"ARY2","s954_F_VTA_03_ASEReadCounter.table","NW_015090842.1:6307093",25,36,11
"ARY2","s954_F_VTA_03_ASEReadCounter.table","NW_015090842.1:6307138",24,35,11
"ARY2","s954_F_VTA_03_ASEReadCounter.table","NW_015090842.1:6307157",31,43,12
"ARY2","s954_F_VTA_03_ASEReadCounter.table","NW_015090842.1:6307187",31,47,16
"ARY2","s954_F_VTA_03_ASEReadCounter.table","NW_015090842.1:6307204",31,45,14
"ARY2","s954_F_VTA_03_ASEReadCounter.table","NW_015090842.1:6307278",23,31,8
"ARY2","s954_F_VTA_03_ASEReadCounter.table","NW_015090842.1:6307305",27,36,9
"ARY2","s954_F_VTA_03_ASEReadCounter.table","NW_015090842.1:6307318",25,30,5
"ARY2","s954_F_VTA_03_ASEReadCounter.table","NW_015090842.1:6307429",21,29,8
"ARY2","s954_F_VTA_03_ASEReadCounter.table","NW_015090842.1:6307487",14,24,10
"ARY2","s954_F_VTA_03_ASEReadCounter.table","NW_015090842.1:6307670",21,26,5
"ARYL","s954_F_VTA_03_ASEReadCounter.table","NW_015090842.1:6313360",1,1,0
"ARYL","s954_F_VTA_03_ASEReadCounter.table","NW_015090842.1:6313377",1,1,0
"ARYL","s954_F_VTA_03_ASEReadCounter.table","NW_015090842.1:6313767",5,6,1
"ARY1","s954_F_VTA_03_ASEReadCounter.table","NW_015090842.1:6314296",3,6,3
"ARY1","s954_F_VTA_03_ASEReadCounter.table","NW_015090842.1:6314541",6,6,0
"ARY1","s954_F_VTA_03_ASEReadCounter.table","NW_015090842.1:6314597",3,5,2
"ARY1","s954_F_VTA_03_ASEReadCounter.table","NW_015090842.1:6314750",7,9,2
"ARY1","s954_F_VTA_03_ASEReadCounter.table","NW_015090842.1:6314794",6,9,3
"ARY1","s954_F_VTA_03_ASEReadCounter.table","NW_015090842.1:6314827",4,11,7
"ARY1","s954_F_VTA_03_ASEReadCounter.table","NW_015090842.1:6314859",5,12,7
"ARY1","s954_F_VTA_03_ASEReadCounter.table","NW_015090842.1:6314886",6,15,9
"ARY1","s954_F_VTA_03_ASEReadCounter.table","NW_015090842.1:6315022",4,8,4
"ARY1","s954_F_VTA_03_ASEReadCounter.table","NW_015090842.1:6315026",4,8,4
"ARY1","s954_F_VTA_03_ASEReadCounter.table","NW_015090842.1:6315043",4,8,4
"ARY1","s954_F_VTA_03_ASEReadCounter.table","NW_015090842.1:6315065",5,10,5
"ARY1","s954_F_VTA_03_ASEReadCounter.table","NW_015090842.1:6315409",5,6,1
"ARY1","s954_F_VTA_03_ASEReadCounter.table","NW_015090842.1:6315479",11,19,8
"ARY1","s954_F_VTA_03_ASEReadCounter.table","NW_015090842.1:6318342",4,8,4
"ARY1","s954_F_VTA_03_ASEReadCounter.table","NW_015090842.1:6318427",5,15,10
"ARY1","s954_F_VTA_03_ASEReadCounter.table","NW_015090842.1:6318603",8,15,7
"ARY1","s954_F_VTA_03_ASEReadCounter.table","NW_015090842.1:6318708",5,10,5
"ARY1","s954_F_VTA_03_ASEReadCounter.table","NW_015090842.1:6318858",17,19,2
"ARY1","s954_F_VTA_03_ASEReadCounter.table","NW_015090842.1:6318952",13,20,7
"MPHOSPH6","s954_F_VTA_03_ASEReadCounter.table","NW_015090842.1:6324063",30,76,46
"MPHOSPH6","s954_F_VTA_03_ASEReadCounter.table","NW_015090842.1:6324174",52,124,72
"MPHOSPH6","s954_F_VTA_03_ASEReadCounter.table","NW_015090842.1:6324270",79,171,92
"MPHOSPH6","s954_F_VTA_03_ASEReadCounter.table","NW_015090842.1:6324762",61,140,79
"MPHOSPH6","s954_F_VTA_03_ASEReadCounter.table","NW_015090842.1:6324780",50,124,74
"MPHOSPH6","s954_F_VTA_03_ASEReadCounter.table","NW_015090842.1:6324902",73,152,79
"MPHOSPH6","s954_F_VTA_03_ASEReadCounter.table","NW_015090842.1:6325066",62,143,81
"MPHOSPH6","s954_F_VTA_03_ASEReadCounter.table","NW_015090842.1:6325089",70,162,92
"MPHOSPH6","s954_F_VTA_03_ASEReadCounter.table","NW_015090842.1:6325877",53,134,81
"MPHOSPH6","s954_F_VTA_03_ASEReadCounter.table","NW_015090842.1:6326976",43,99,56
"CDH13","s954_F_VTA_03_ASEReadCounter.table","NW_015090842.1:6662283",19,29,10
"CDH13","s954_F_VTA_03_ASEReadCounter.table","NW_015090842.1:6693665",9,21,12
"CDH13","s954_F_VTA_03_ASEReadCounter.table","NW_015090842.1:6693697",8,18,10
"CDH13","s954_F_VTA_03_ASEReadCounter.table","NW_015090842.1:6693712",5,15,10
"CDH13","s954_F_VTA_03_ASEReadCounter.table","NW_015090842.1:6693723",5,15,10
"CDH13","s954_F_VTA_03_ASEReadCounter.table","NW_015090842.1:6693738",8,17,9
"CDH13","s954_F_VTA_03_ASEReadCounter.table","NW_015090842.1:6823730",11,27,16
"CDH13","s954_F_VTA_03_ASEReadCounter.table","NW_015090842.1:6889713",6,25,19
"CDH13","s954_F_VTA_03_ASEReadCounter.table","NW_015090842.1:6955167",23,51,28
"MLYCD","s954_F_VTA_03_ASEReadCounter.table","NW_015090842.1:7150054",54,99,45
"MLYCD","s954_F_VTA_03_ASEReadCounter.table","NW_015090842.1:7150131",89,170,81
"MLYCD","s954_F_VTA_03_ASEReadCounter.table","NW_015090842.1:7150585",62,126,64
"MLYCD","s954_F_VTA_03_ASEReadCounter.table","NW_015090842.1:7150686",45,89,44
"MLYCD","s954_F_VTA_03_ASEReadCounter.table","NW_015090842.1:7150696",47,99,52
"MLYCD","s954_F_VTA_03_ASEReadCounter.table","NW_015090842.1:7150869",47,99,52
"MLYCD","s954_F_VTA_03_ASEReadCounter.table","NW_015090842.1:7151100",47,88,41
"MLYCD","s954_F_VTA_03_ASEReadCounter.table","NW_015090842.1:7151127",44,92,48
"MLYCD","s954_F_VTA_03_ASEReadCounter.table","NW_015090842.1:7157538",51,90,39
"MLYCD","s954_F_VTA_03_ASEReadCounter.table","NW_015090842.1:7167662",17,48,31
"MLYCD","s954_F_VTA_03_ASEReadCounter.table","NW_015090842.1:7167675",16,46,30
"MLYCD","s954_F_VTA_03_ASEReadCounter.table","NW_015090842.1:7167710",14,39,25
"MLYCD","s954_F_VTA_03_ASEReadCounter.table","NW_015090842.1:7167781",11,30,19
"MLYCD","s954_F_VTA_03_ASEReadCounter.table","NW_015090842.1:7167803",9,18,9
"MLYCD","s954_F_VTA_03_ASEReadCounter.table","NW_015090842.1:7167812",7,16,9
"MLYCD","s954_F_VTA_03_ASEReadCounter.table","NW_015090842.1:7167845",10,23,13
"MLYCD","s954_F_VTA_03_ASEReadCounter.table","NW_015090842.1:7167862",9,21,12
"MLYCD","s954_F_VTA_03_ASEReadCounter.table","NW_015090842.1:7167929",16,24,8
"MLYCD","s954_F_VTA_03_ASEReadCounter.table","NW_015090842.1:7167995",15,21,6
"MLYCD","s954_F_VTA_03_ASEReadCounter.table","NW_015090842.1:7168005",14,22,8
"MLYCD","s954_F_VTA_03_ASEReadCounter.table","NW_015090842.1:7168037",12,22,10
"HSBP1","s954_F_VTA_03_ASEReadCounter.table","NW_015090842.1:7245192",258,471,213
"HSBP1","s954_F_VTA_03_ASEReadCounter.table","NW_015090842.1:7245226",288,535,247
"HSBP1","s954_F_VTA_03_ASEReadCounter.table","NW_015090842.1:7245257",252,452,200
"HSBP1","s954_F_VTA_03_ASEReadCounter.table","NW_015090842.1:7245296",218,430,212
"HSBP1","s954_F_VTA_03_ASEReadCounter.table","NW_015090842.1:7245389",369,640,271
"HSBP1","s954_F_VTA_03_ASEReadCounter.table","NW_015090842.1:7245400",362,618,256
"HSBP1","s954_F_VTA_03_ASEReadCounter.table","NW_015090842.1:7245445",330,581,251
"HSBP1","s954_F_VTA_03_ASEReadCounter.table","NW_015090842.1:7245495",323,571,248
"HSBP1","s954_F_VTA_03_ASEReadCounter.table","NW_015090842.1:7245733",212,408,196
"HSBP1","s954_F_VTA_03_ASEReadCounter.table","NW_015090842.1:7245771",225,406,181
"HSBP1","s954_F_VTA_03_ASEReadCounter.table","NW_015090842.1:7245813",210,399,189
"HSBP1","s954_F_VTA_03_ASEReadCounter.table","NW_015090842.1:7245926",258,449,191
"HSBP1","s954_F_VTA_03_ASEReadCounter.table","NW_015090842.1:7245927",258,448,190
"HSBP1","s954_F_VTA_03_ASEReadCounter.table","NW_015090842.1:7245933",256,434,178
"HSBP1","s954_F_VTA_03_ASEReadCounter.table","NW_015090842.1:7246002",178,331,153
"HSBP1","s954_F_VTA_03_ASEReadCounter.table","NW_015090842.1:7246094",248,445,197
"HSBP1","s954_F_VTA_03_ASEReadCounter.table","NW_015090842.1:7246167",241,412,171
"HSBP1","s954_F_VTA_03_ASEReadCounter.table","NW_015090842.1:7246183",223,397,174
"HSBP1","s954_F_VTA_03_ASEReadCounter.table","NW_015090842.1:7247285",35,42,7
"HSBP1","s954_F_VTA_03_ASEReadCounter.table","NW_015090842.1:7247651",250,526,276
"HSBP1","s954_F_VTA_03_ASEReadCounter.table","NW_015090842.1:7247657",251,532,281
"HSBP1","s954_F_VTA_03_ASEReadCounter.table","NW_015090842.1:7248520",188,367,179
"HSBP1","s954_F_VTA_03_ASEReadCounter.table","NW_015090842.1:7248535",164,304,140
"KCNG4","s954_F_VTA_03_ASEReadCounter.table","NW_015090842.1:7282481",7,14,7
"KCNG4","s954_F_VTA_03_ASEReadCounter.table","NW_015090842.1:7282500",8,14,6
"KCNG4","s954_F_VTA_03_ASEReadCounter.table","NW_015090842.1:7282542",3,10,7
"KCNG4","s954_F_VTA_03_ASEReadCounter.table","NW_015090842.1:7282579",4,11,7
"KCNG4","s954_F_VTA_03_ASEReadCounter.table","NW_015090842.1:7282630",4,8,4
"KCNG4","s954_F_VTA_03_ASEReadCounter.table","NW_015090842.1:7283056",6,7,1
"KCNG4","s954_F_VTA_03_ASEReadCounter.table","NW_015090842.1:7283245",3,4,1
"KCNG4","s954_F_VTA_03_ASEReadCounter.table","NW_015090842.1:7301195",1,3,2
"WFDC1","s954_F_VTA_03_ASEReadCounter.table","NW_015090842.1:7366517",5,8,3
"WFDC1","s954_F_VTA_03_ASEReadCounter.table","NW_015090842.1:7373367",2,5,3
"WFDC1","s954_F_VTA_03_ASEReadCounter.table","NW_015090842.1:7375828",2,8,6
"WFDC1","s954_F_VTA_03_ASEReadCounter.table","NW_015090842.1:7378036",1,10,9
"WFDC1","s954_F_VTA_03_ASEReadCounter.table","NW_015090842.1:7379125",2,6,4
"WFDC1","s954_F_VTA_03_ASEReadCounter.table","NW_015090842.1:7379451",1,7,6
"WFDC1","s954_F_VTA_03_ASEReadCounter.table","NW_015090842.1:7379471",2,6,4
"WFDC1","s954_F_VTA_03_ASEReadCounter.table","NW_015090842.1:7379576",3,12,9
"WFDC1","s954_F_VTA_03_ASEReadCounter.table","NW_015090842.1:7379596",3,12,9
"WFDC1","s954_F_VTA_03_ASEReadCounter.table","NW_015090842.1:7379605",4,14,10
"WFDC1","s954_F_VTA_03_ASEReadCounter.table","NW_015090842.1:7379626",4,10,6
"WFDC1","s954_F_VTA_03_ASEReadCounter.table","NW_015090842.1:7379631",2,8,6
"WFDC1","s954_F_VTA_03_ASEReadCounter.table","NW_015090842.1:7379632",2,9,7
"WFDC1","s954_F_VTA_03_ASEReadCounter.table","NW_015090842.1:7379652",2,6,4
"WFDC1","s954_F_VTA_03_ASEReadCounter.table","NW_015090842.1:7379669",3,6,3
"WFDC1","s954_F_VTA_03_ASEReadCounter.table","NW_015090842.1:7379674",2,5,3
"WFDC1","s954_F_VTA_03_ASEReadCounter.table","NW_015090842.1:7379719",2,6,4
"WFDC1","s954_F_VTA_03_ASEReadCounter.table","NW_015090842.1:7379735",2,7,5
"WFDC1","s954_F_VTA_03_ASEReadCounter.table","NW_015090842.1:7379739",2,7,5
"WFDC1","s954_F_VTA_03_ASEReadCounter.table","NW_015090842.1:7379821",4,12,8
"WFDC1","s954_F_VTA_03_ASEReadCounter.table","NW_015090842.1:7379840",6,12,6
"WFDC1","s954_F_VTA_03_ASEReadCounter.table","NW_015090842.1:7379933",6,11,5
"WFDC1","s954_F_VTA_03_ASEReadCounter.table","NW_015090842.1:7379935",6,12,6
"WFDC1","s954_F_VTA_03_ASEReadCounter.table","NW_015090842.1:7379983",5,13,8
"WFDC1","s954_F_VTA_03_ASEReadCounter.table","NW_015090842.1:7380060",3,13,10
"WFDC1","s954_F_VTA_03_ASEReadCounter.table","NW_015090842.1:7380136",3,14,11
"WFDC1","s954_F_VTA_03_ASEReadCounter.table","NW_015090842.1:7380150",3,14,11
"WFDC1","s954_F_VTA_03_ASEReadCounter.table","NW_015090842.1:7380164",3,13,10
"WFDC1","s954_F_VTA_03_ASEReadCounter.table","NW_015090842.1:7380237",3,14,11
"WFDC1","s954_F_VTA_03_ASEReadCounter.table","NW_015090842.1:7380261",3,15,12
"WFDC1","s954_F_VTA_03_ASEReadCounter.table","NW_015090842.1:7380322",5,14,9
"WFDC1","s954_F_VTA_03_ASEReadCounter.table","NW_015090842.1:7380491",5,16,11
"WFDC1","s954_F_VTA_03_ASEReadCounter.table","NW_015090842.1:7380567",5,16,11
"WFDC1","s954_F_VTA_03_ASEReadCounter.table","NW_015090842.1:7380672",3,13,10
"WFDC1","s954_F_VTA_03_ASEReadCounter.table","NW_015090842.1:7380721",8,16,8
"WFDC1","s954_F_VTA_03_ASEReadCounter.table","NW_015090842.1:7380743",8,14,6
"WFDC1","s954_F_VTA_03_ASEReadCounter.table","NW_015090842.1:7380852",7,13,6
"WFDC1","s954_F_VTA_03_ASEReadCounter.table","NW_015090842.1:7380878",5,11,6
"WFDC1","s954_F_VTA_03_ASEReadCounter.table","NW_015090842.1:7381081",3,21,18
"WFDC1","s954_F_VTA_03_ASEReadCounter.table","NW_015090842.1:7381127",2,15,13
"WFDC1","s954_F_VTA_03_ASEReadCounter.table","NW_015090842.1:7381195",4,13,9
"WFDC1","s954_F_VTA_03_ASEReadCounter.table","NW_015090842.1:7381253",4,15,11
"WFDC1","s954_F_VTA_03_ASEReadCounter.table","NW_015090842.1:7381378",4,13,9
"WFDC1","s954_F_VTA_03_ASEReadCounter.table","NW_015090842.1:7381433",2,15,13
"WFDC1","s954_F_VTA_03_ASEReadCounter.table","NW_015090842.1:7381434",2,15,13
"WFDC1","s954_F_VTA_03_ASEReadCounter.table","NW_015090842.1:7381442",3,17,14
"WFDC1","s954_F_VTA_03_ASEReadCounter.table","NW_015090842.1:7381517",6,14,8
"WFDC1","s954_F_VTA_03_ASEReadCounter.table","NW_015090842.1:7381520",6,16,10
"WFDC1","s954_F_VTA_03_ASEReadCounter.table","NW_015090842.1:7381677",4,13,9
"WFDC1","s954_F_VTA_03_ASEReadCounter.table","NW_015090842.1:7381709",3,7,4
"ATP2C2","s954_F_VTA_03_ASEReadCounter.table","NW_015090842.1:7392613",1,1,0
"ATP2C2","s954_F_VTA_03_ASEReadCounter.table","NW_015090842.1:7395230",1,2,1
"ATP2C2","s954_F_VTA_03_ASEReadCounter.table","NW_015090842.1:7395366",1,2,1
"ATP2C2","s954_F_VTA_03_ASEReadCounter.table","NW_015090842.1:7397049",0,2,2
"ATP2C2","s954_F_VTA_03_ASEReadCounter.table","NW_015090842.1:7398395",0,3,3
"ATP2C2","s954_F_VTA_03_ASEReadCounter.table","NW_015090842.1:7399774",0,2,2
"ATP2C2","s954_F_VTA_03_ASEReadCounter.table","NW_015090842.1:7402554",0,1,1
"ATP2C2","s954_F_VTA_03_ASEReadCounter.table","NW_015090842.1:7402578",0,3,3
"ATP2C2","s954_F_VTA_03_ASEReadCounter.table","NW_015090842.1:7405621",0,1,1
"ATP2C2","s954_F_VTA_03_ASEReadCounter.table","NW_015090842.1:7413855",18,30,12
"ATP2C2","s954_F_VTA_03_ASEReadCounter.table","NW_015090842.1:7413869",5,17,12
"ATP2C2","s954_F_VTA_03_ASEReadCounter.table","NW_015090842.1:7413875",6,19,13
"TLDC1","s954_F_VTA_03_ASEReadCounter.table","NW_015090842.1:7421137",38,75,37
"TLDC1","s954_F_VTA_03_ASEReadCounter.table","NW_015090842.1:7421155",33,66,33
"TLDC1","s954_F_VTA_03_ASEReadCounter.table","NW_015090842.1:7421218",33,55,22
"TLDC1","s954_F_VTA_03_ASEReadCounter.table","NW_015090842.1:7421399",31,57,26
"TLDC1","s954_F_VTA_03_ASEReadCounter.table","NW_015090842.1:7421402",31,55,24
"TLDC1","s954_F_VTA_03_ASEReadCounter.table","NW_015090842.1:7421528",29,57,28
"TLDC1","s954_F_VTA_03_ASEReadCounter.table","NW_015090842.1:7421532",30,58,28
"TLDC1","s954_F_VTA_03_ASEReadCounter.table","NW_015090842.1:7421621",21,45,24
"TLDC1","s954_F_VTA_03_ASEReadCounter.table","NW_015090842.1:7421647",27,48,21
"TLDC1","s954_F_VTA_03_ASEReadCounter.table","NW_015090842.1:7421657",24,42,18
"TLDC1","s954_F_VTA_03_ASEReadCounter.table","NW_015090842.1:7421693",27,48,21
"TLDC1","s954_F_VTA_03_ASEReadCounter.table","NW_015090842.1:7421796",26,43,17
"TLDC1","s954_F_VTA_03_ASEReadCounter.table","NW_015090842.1:7421810",32,49,17
"TLDC1","s954_F_VTA_03_ASEReadCounter.table","NW_015090842.1:7421833",26,49,23
"TLDC1","s954_F_VTA_03_ASEReadCounter.table","NW_015090842.1:7421879",27,48,21
"TLDC1","s954_F_VTA_03_ASEReadCounter.table","NW_015090842.1:7421914",22,53,31
"TLDC1","s954_F_VTA_03_ASEReadCounter.table","NW_015090842.1:7421969",19,46,27
"TLDC1","s954_F_VTA_03_ASEReadCounter.table","NW_015090842.1:7422015",18,39,21
"TLDC1","s954_F_VTA_03_ASEReadCounter.table","NW_015090842.1:7422042",25,54,29
"TLDC1","s954_F_VTA_03_ASEReadCounter.table","NW_015090842.1:7422230",36,60,24
"TLDC1","s954_F_VTA_03_ASEReadCounter.table","NW_015090842.1:7423349",27,48,21
"TLDC1","s954_F_VTA_03_ASEReadCounter.table","NW_015090842.1:7423362",25,49,24
"TLDC1","s954_F_VTA_03_ASEReadCounter.table","NW_015090842.1:7426091",13,29,16
"TLDC1","s954_F_VTA_03_ASEReadCounter.table","NW_015090842.1:7426485",17,31,14
"TLDC1","s954_F_VTA_03_ASEReadCounter.table","NW_015090842.1:7427211",21,32,11
"TLDC1","s954_F_VTA_03_ASEReadCounter.table","NW_015090842.1:7428179",12,25,13
"COTL1","s954_F_VTA_03_ASEReadCounter.table","NW_015090842.1:7490744",390,867,477
"COTL1","s954_F_VTA_03_ASEReadCounter.table","NW_015090842.1:7491051",320,679,359
"COTL1","s954_F_VTA_03_ASEReadCounter.table","NW_015090842.1:7491124",307,621,314
"COTL1","s954_F_VTA_03_ASEReadCounter.table","NW_015090842.1:7491418",205,452,247
"COTL1","s954_F_VTA_03_ASEReadCounter.table","NW_015090842.1:7491539",140,337,197
"COTL1","s954_F_VTA_03_ASEReadCounter.table","NW_015090842.1:7491585",268,520,252
"COTL1","s954_F_VTA_03_ASEReadCounter.table","NW_015090842.1:7491586",263,540,277
"COTL1","s954_F_VTA_03_ASEReadCounter.table","NW_015090842.1:7491646",279,604,325
"COTL1","s954_F_VTA_03_ASEReadCounter.table","NW_015090842.1:7491747",233,495,262
"COTL1","s954_F_VTA_03_ASEReadCounter.table","NW_015090842.1:7491803",231,465,234
"COTL1","s954_F_VTA_03_ASEReadCounter.table","NW_015090842.1:7507551",0,1,1
"COTL1","s954_F_VTA_03_ASEReadCounter.table","NW_015090842.1:7507563",0,1,1
"COTL1","s954_F_VTA_03_ASEReadCounter.table","NW_015090842.1:7513196",1,1,0
"COTL1","s954_F_VTA_03_ASEReadCounter.table","NW_015090842.1:7513223",1,1,0
"KLHL36","s954_F_VTA_03_ASEReadCounter.table","NW_015090842.1:7514700",27,39,12
"KLHL36","s954_F_VTA_03_ASEReadCounter.table","NW_015090842.1:7519691",2,6,4
"KLHL36","s954_F_VTA_03_ASEReadCounter.table","NW_015090842.1:7519696",2,7,5
"KLHL36","s954_F_VTA_03_ASEReadCounter.table","NW_015090842.1:7526160",19,42,23
"KLHL36","s954_F_VTA_03_ASEReadCounter.table","NW_015090842.1:7526469",14,38,24
"KLHL36","s954_F_VTA_03_ASEReadCounter.table","NW_015090842.1:7526587",25,44,19
"KLHL36","s954_F_VTA_03_ASEReadCounter.table","NW_015090842.1:7526997",19,33,14
"KLHL36","s954_F_VTA_03_ASEReadCounter.table","NW_015090842.1:7527142",16,39,23
"KLHL36","s954_F_VTA_03_ASEReadCounter.table","NW_015090842.1:7535174",31,71,40
"KLHL36","s954_F_VTA_03_ASEReadCounter.table","NW_015090842.1:7535384",23,49,26
"KLHL36","s954_F_VTA_03_ASEReadCounter.table","NW_015090842.1:7535420",26,53,27
"KLHL36","s954_F_VTA_03_ASEReadCounter.table","NW_015090842.1:7535545",21,44,23
"KLHL36","s954_F_VTA_03_ASEReadCounter.table","NW_015090842.1:7535829",27,59,32
"KLHL36","s954_F_VTA_03_ASEReadCounter.table","NW_015090842.1:7535977",23,45,22
"KLHL36","s954_F_VTA_03_ASEReadCounter.table","NW_015090842.1:7536010",25,45,20
"KLHL36","s954_F_VTA_03_ASEReadCounter.table","NW_015090842.1:7536051",26,50,24
"KLHL36","s954_F_VTA_03_ASEReadCounter.table","NW_015090842.1:7536096",20,55,35
"KLHL36","s954_F_VTA_03_ASEReadCounter.table","NW_015090842.1:7536135",30,63,33
"KLHL36","s954_F_VTA_03_ASEReadCounter.table","NW_015090842.1:7536136",30,60,30
"KLHL36","s954_F_VTA_03_ASEReadCounter.table","NW_015090842.1:7536160",38,70,32
"KLHL36","s954_F_VTA_03_ASEReadCounter.table","NW_015090842.1:7536336",30,59,29
"KLHL36","s954_F_VTA_03_ASEReadCounter.table","NW_015090842.1:7536352",25,56,31
"KLHL36","s954_F_VTA_03_ASEReadCounter.table","NW_015090842.1:7536412",15,49,34
"KLHL36","s954_F_VTA_03_ASEReadCounter.table","NW_015090842.1:7536418",15,48,33
"KLHL36","s954_F_VTA_03_ASEReadCounter.table","NW_015090842.1:7536465",19,49,30
"KLHL36","s954_F_VTA_03_ASEReadCounter.table","NW_015090842.1:7536466",19,47,28
"KLHL36","s954_F_VTA_03_ASEReadCounter.table","NW_015090842.1:7536553",24,51,27
"KLHL36","s954_F_VTA_03_ASEReadCounter.table","NW_015090842.1:7536698",33,70,37
"KLHL36","s954_F_VTA_03_ASEReadCounter.table","NW_015090842.1:7536713",16,62,46
"KLHL36","s954_F_VTA_03_ASEReadCounter.table","NW_015090842.1:7536720",32,61,29
"KLHL36","s954_F_VTA_03_ASEReadCounter.table","NW_015090842.1:7536791",31,68,37
"KLHL36","s954_F_VTA_03_ASEReadCounter.table","NW_015090842.1:7536849",29,54,25
"KLHL36","s954_F_VTA_03_ASEReadCounter.table","NW_015090842.1:7536872",31,55,24
"KLHL36","s954_F_VTA_03_ASEReadCounter.table","NW_015090842.1:7536878",37,55,18
"KLHL36","s954_F_VTA_03_ASEReadCounter.table","NW_015090842.1:7536916",35,54,19
"KLHL36","s954_F_VTA_03_ASEReadCounter.table","NW_015090842.1:7536927",38,74,36
"KLHL36","s954_F_VTA_03_ASEReadCounter.table","NW_015090842.1:7537315",43,85,42
"KLHL36","s954_F_VTA_03_ASEReadCounter.table","NW_015090842.1:7537352",39,82,43
"KLHL36","s954_F_VTA_03_ASEReadCounter.table","NW_015090842.1:7537631",46,94,48
"KLHL36","s954_F_VTA_03_ASEReadCounter.table","NW_015090842.1:7537830",63,113,50
"KLHL36","s954_F_VTA_03_ASEReadCounter.table","NW_015090842.1:7537838",62,114,52
"KLHL36","s954_F_VTA_03_ASEReadCounter.table","NW_015090842.1:7538153",56,120,64
"KLHL36","s954_F_VTA_03_ASEReadCounter.table","NW_015090842.1:7538256",27,72,45
"KLHL36","s954_F_VTA_03_ASEReadCounter.table","NW_015090842.1:7538265",26,71,45
"KLHL36","s954_F_VTA_03_ASEReadCounter.table","NW_015090842.1:7538300",31,81,50
"USP10","s954_F_VTA_03_ASEReadCounter.table","NW_015090842.1:7563972",4,10,6
"USP10","s954_F_VTA_03_ASEReadCounter.table","NW_015090842.1:7571816",12,39,27
"USP10","s954_F_VTA_03_ASEReadCounter.table","NW_015090842.1:7571993",18,47,29
"USP10","s954_F_VTA_03_ASEReadCounter.table","NW_015090842.1:7572580",31,68,37
"USP10","s954_F_VTA_03_ASEReadCounter.table","NW_015090842.1:7587372",72,163,91
"CRISPLD2","s954_F_VTA_03_ASEReadCounter.table","NW_015090842.1:7604605",3,4,1
"CRISPLD2","s954_F_VTA_03_ASEReadCounter.table","NW_015090842.1:7609844",4,5,1
"CRISPLD2","s954_F_VTA_03_ASEReadCounter.table","NW_015090842.1:7609845",4,6,2
"CRISPLD2","s954_F_VTA_03_ASEReadCounter.table","NW_015090842.1:7609883",4,6,2
"CRISPLD2","s954_F_VTA_03_ASEReadCounter.table","NW_015090842.1:7610084",6,7,1
"CRISPLD2","s954_F_VTA_03_ASEReadCounter.table","NW_015090842.1:7617757",3,3,0
"CRISPLD2","s954_F_VTA_03_ASEReadCounter.table","NW_015090842.1:7617781",3,3,0
"CRISPLD2","s954_F_VTA_03_ASEReadCounter.table","NW_015090842.1:7617790",3,3,0
"CRISPLD2","s954_F_VTA_03_ASEReadCounter.table","NW_015090842.1:7621452",3,4,1
"CRISPLD2","s954_F_VTA_03_ASEReadCounter.table","NW_015090842.1:7625451",3,4,1
"CRISPLD2","s954_F_VTA_03_ASEReadCounter.table","NW_015090842.1:7626214",5,5,0
"CRISPLD2","s954_F_VTA_03_ASEReadCounter.table","NW_015090842.1:7630784",8,8,0
"CRISPLD2","s954_F_VTA_03_ASEReadCounter.table","NW_015090842.1:7630823",9,10,1
"CRISPLD2","s954_F_VTA_03_ASEReadCounter.table","NW_015090842.1:7633172",7,8,1
"CRISPLD2","s954_F_VTA_03_ASEReadCounter.table","NW_015090842.1:7633326",7,8,1
"CRISPLD2","s954_F_VTA_03_ASEReadCounter.table","NW_015090842.1:7633336",5,6,1
"CRISPLD2","s954_F_VTA_03_ASEReadCounter.table","NW_015090842.1:7633381",8,9,1
"CRISPLD2","s954_F_VTA_03_ASEReadCounter.table","NW_015090842.1:7633388",7,7,0
"CRISPLD2","s954_F_VTA_03_ASEReadCounter.table","NW_015090842.1:7633400",6,7,1
"CRISPLD2","s954_F_VTA_03_ASEReadCounter.table","NW_015090842.1:7633486",8,9,1
"CRISPLD2","s954_F_VTA_03_ASEReadCounter.table","NW_015090842.1:7633503",8,10,2
"CRISPLD2","s954_F_VTA_03_ASEReadCounter.table","NW_015090842.1:7633504",8,10,2
"CRISPLD2","s954_F_VTA_03_ASEReadCounter.table","NW_015090842.1:7633557",10,12,2
"CRISPLD2","s954_F_VTA_03_ASEReadCounter.table","NW_015090842.1:7633571",9,11,2
"CRISPLD2","s954_F_VTA_03_ASEReadCounter.table","NW_015090842.1:7633588",11,12,1
"CRISPLD2","s954_F_VTA_03_ASEReadCounter.table","NW_015090842.1:7633617",9,9,0
"CRISPLD2","s954_F_VTA_03_ASEReadCounter.table","NW_015090842.1:7633695",9,13,4
"CRISPLD2","s954_F_VTA_03_ASEReadCounter.table","NW_015090842.1:7633721",11,20,9
"CRISPLD2","s954_F_VTA_03_ASEReadCounter.table","NW_015090842.1:7633888",8,11,3
"CRISPLD2","s954_F_VTA_03_ASEReadCounter.table","NW_015090842.1:7633910",9,11,2
"CRISPLD2","s954_F_VTA_03_ASEReadCounter.table","NW_015090842.1:7634142",8,11,3
"CRISPLD2","s954_F_VTA_03_ASEReadCounter.table","NW_015090842.1:7634417",6,9,3
"CRISPLD2","s954_F_VTA_03_ASEReadCounter.table","NW_015090842.1:7634825",9,10,1
"CRISPLD2","s954_F_VTA_03_ASEReadCounter.table","NW_015090842.1:7634852",13,15,2
"CRISPLD2","s954_F_VTA_03_ASEReadCounter.table","NW_015090842.1:7635009",4,8,4
"CRISPLD2","s954_F_VTA_03_ASEReadCounter.table","NW_015090842.1:7635208",12,15,3
"CRISPLD2","s954_F_VTA_03_ASEReadCounter.table","NW_015090842.1:7635373",11,14,3
"CRISPLD2","s954_F_VTA_03_ASEReadCounter.table","NW_015090842.1:7635525",7,13,6
"CRISPLD2","s954_F_VTA_03_ASEReadCounter.table","NW_015090842.1:7635583",6,14,8
"CRISPLD2","s954_F_VTA_03_ASEReadCounter.table","NW_015090842.1:7635924",7,10,3
"LOC106888312","s954_F_VTA_03_ASEReadCounter.table","NW_015090842.1:7727001",0,1,1
"LOC106888312","s954_F_VTA_03_ASEReadCounter.table","NW_015090842.1:7731961",0,1,1
"LOC106888312","s954_F_VTA_03_ASEReadCounter.table","NW_015090842.1:7732443",0,1,1
"LOC106888312","s954_F_VTA_03_ASEReadCounter.table","NW_015090842.1:7732444",0,1,1
"LOC106888312","s954_F_VTA_03_ASEReadCounter.table","NW_015090842.1:7732538",1,1,0
"LOC106888312","s954_F_VTA_03_ASEReadCounter.table","NW_015090842.1:7732548",1,1,0
"LOC106888312","s954_F_VTA_03_ASEReadCounter.table","NW_015090842.1:7732576",0,1,1
"LOC106888312","s954_F_VTA_03_ASEReadCounter.table","NW_015090842.1:7732580",0,1,1
"LOC106888312","s954_F_VTA_03_ASEReadCounter.table","NW_015090842.1:7732629",0,1,1
"LOC106888312","s954_F_VTA_03_ASEReadCounter.table","NW_015090842.1:7732630",0,1,1
"LOC106888312","s954_F_VTA_03_ASEReadCounter.table","NW_015090842.1:7732637",0,1,1
"LOC106888312","s954_F_VTA_03_ASEReadCounter.table","NW_015090842.1:7732782",0,1,1
"LOC106888312","s954_F_VTA_03_ASEReadCounter.table","NW_015090842.1:7732796",0,1,1
"LOC106888312","s954_F_VTA_03_ASEReadCounter.table","NW_015090842.1:7732860",0,1,1
"LOC106888312","s954_F_VTA_03_ASEReadCounter.table","NW_015090842.1:7732861",0,1,1
"LOC106888312","s954_F_VTA_03_ASEReadCounter.table","NW_015090842.1:7733046",0,1,1
"LOC106888312","s954_F_VTA_03_ASEReadCounter.table","NW_015090842.1:7733068",0,1,1
"LOC106888312","s954_F_VTA_03_ASEReadCounter.table","NW_015090842.1:7733077",0,1,1
"LOC106888312","s954_F_VTA_03_ASEReadCounter.table","NW_015090842.1:7733096",0,1,1
"LOC106888312","s954_F_VTA_03_ASEReadCounter.table","NW_015090842.1:7733142",0,1,1
"LOC106888312","s954_F_VTA_03_ASEReadCounter.table","NW_015090842.1:7733196",0,1,1
"LOC106888312","s954_F_VTA_03_ASEReadCounter.table","NW_015090842.1:7733979",0,1,1
"LOC106888312","s954_F_VTA_03_ASEReadCounter.table","NW_015090842.1:7733981",0,1,1
"ZDHHC7","s954_F_VTA_03_ASEReadCounter.table","NW_015090842.1:7737199",38,75,37
"ZDHHC7","s954_F_VTA_03_ASEReadCounter.table","NW_015090842.1:7737332",32,65,33
"ZDHHC7","s954_F_VTA_03_ASEReadCounter.table","NW_015090842.1:7737553",43,97,54
"ZDHHC7","s954_F_VTA_03_ASEReadCounter.table","NW_015090842.1:7737920",28,64,36
"ZDHHC7","s954_F_VTA_03_ASEReadCounter.table","NW_015090842.1:7737953",24,59,35
"ZDHHC7","s954_F_VTA_03_ASEReadCounter.table","NW_015090842.1:7737987",22,57,35
"ZDHHC7","s954_F_VTA_03_ASEReadCounter.table","NW_015090842.1:7738068",18,44,26
"ZDHHC7","s954_F_VTA_03_ASEReadCounter.table","NW_015090842.1:7738204",20,44,24
"LOC106888097","s954_F_VTA_03_ASEReadCounter.table","NW_015090842.1:7767178",10,16,6
"LOC106888097","s954_F_VTA_03_ASEReadCounter.table","NW_015090842.1:7767187",10,15,5
"LOC106888097","s954_F_VTA_03_ASEReadCounter.table","NW_015090842.1:7768144",13,32,19
"LOC106888097","s954_F_VTA_03_ASEReadCounter.table","NW_015090842.1:7768196",14,42,28
"LOC106888097","s954_F_VTA_03_ASEReadCounter.table","NW_015090842.1:7769884",20,28,8
"LOC106888097","s954_F_VTA_03_ASEReadCounter.table","NW_015090842.1:7769893",17,25,8
"LOC106888097","s954_F_VTA_03_ASEReadCounter.table","NW_015090842.1:7770245",21,43,22
"LOC106888097","s954_F_VTA_03_ASEReadCounter.table","NW_015090842.1:7772402",13,32,19
"LOC106888097","s954_F_VTA_03_ASEReadCounter.table","NW_015090842.1:7772483",22,50,28
"LOC106888097","s954_F_VTA_03_ASEReadCounter.table","NW_015090842.1:7772490",24,51,27
"LOC106888097","s954_F_VTA_03_ASEReadCounter.table","NW_015090842.1:7774281",27,51,24
"LOC106888097","s954_F_VTA_03_ASEReadCounter.table","NW_015090842.1:7774552",22,81,59
"LOC106888097","s954_F_VTA_03_ASEReadCounter.table","NW_015090842.1:7774564",23,81,58
"LOC106888097","s954_F_VTA_03_ASEReadCounter.table","NW_015090842.1:7774611",23,74,51
"LOC106888097","s954_F_VTA_03_ASEReadCounter.table","NW_015090842.1:7774681",24,70,46
"LOC106888097","s954_F_VTA_03_ASEReadCounter.table","NW_015090842.1:7774698",17,60,43
"LOC106888097","s954_F_VTA_03_ASEReadCounter.table","NW_015090842.1:7774730",9,39,30
"LOC106888097","s954_F_VTA_03_ASEReadCounter.table","NW_015090842.1:7774778",2,3,1
"LOC106888097","s954_F_VTA_03_ASEReadCounter.table","NW_015090842.1:7774793",2,3,1
"FOXL1","s954_F_VTA_03_ASEReadCounter.table","NW_015090842.1:8113043",3,3,0
"FOXC2","s954_F_VTA_03_ASEReadCounter.table","NW_015090842.1:8129599",9,14,5
"FOXC2","s954_F_VTA_03_ASEReadCounter.table","NW_015090842.1:8129616",7,12,5
"FOXC2","s954_F_VTA_03_ASEReadCounter.table","NW_015090842.1:8129715",5,15,10
"FOXC2","s954_F_VTA_03_ASEReadCounter.table","NW_015090842.1:8129719",6,16,10
"FOXC2","s954_F_VTA_03_ASEReadCounter.table","NW_015090842.1:8130244",5,14,9
"FOXC2","s954_F_VTA_03_ASEReadCounter.table","NW_015090842.1:8130472",6,12,6
"FOXC2","s954_F_VTA_03_ASEReadCounter.table","NW_015090842.1:8130490",5,10,5
"FOXC2","s954_F_VTA_03_ASEReadCounter.table","NW_015090842.1:8130547",8,11,3
"FOXC2","s954_F_VTA_03_ASEReadCounter.table","NW_015090842.1:8130550",8,11,3
"FOXC2","s954_F_VTA_03_ASEReadCounter.table","NW_015090842.1:8130573",8,11,3
"FOXC2","s954_F_VTA_03_ASEReadCounter.table","NW_015090842.1:8130575",8,11,3
"MTHFSD","s954_F_VTA_03_ASEReadCounter.table","NW_015090842.1:8140051",10,22,12
"MTHFSD","s954_F_VTA_03_ASEReadCounter.table","NW_015090842.1:8142923",18,41,23
"MTHFSD","s954_F_VTA_03_ASEReadCounter.table","NW_015090842.1:8143029",15,42,27
"MTHFSD","s954_F_VTA_03_ASEReadCounter.table","NW_015090842.1:8152035",24,46,22
"MTHFSD","s954_F_VTA_03_ASEReadCounter.table","NW_015090842.1:8152315",13,31,18
"MTHFSD","s954_F_VTA_03_ASEReadCounter.table","NW_015090842.1:8152511",13,31,18
"MTHFSD","s954_F_VTA_03_ASEReadCounter.table","NW_015090842.1:8152518",13,30,17
"MTHFSD","s954_F_VTA_03_ASEReadCounter.table","NW_015090842.1:8152553",10,26,16
"MTHFSD","s954_F_VTA_03_ASEReadCounter.table","NW_015090842.1:8152773",13,31,18
"MTHFSD","s954_F_VTA_03_ASEReadCounter.table","NW_015090842.1:8152805",12,30,18
"FOXF1","s954_F_VTA_03_ASEReadCounter.table","NW_015090842.1:8167113",0,1,1
"FOXF1","s954_F_VTA_03_ASEReadCounter.table","NW_015090842.1:8167588",1,1,0
"IRF8","s954_F_VTA_03_ASEReadCounter.table","NW_015090842.1:8406652",8,14,6
"IRF8","s954_F_VTA_03_ASEReadCounter.table","NW_015090842.1:8406703",11,19,8
"IRF8","s954_F_VTA_03_ASEReadCounter.table","NW_015090842.1:8406704",11,19,8
"IRF8","s954_F_VTA_03_ASEReadCounter.table","NW_015090842.1:8406757",13,21,8
"IRF8","s954_F_VTA_03_ASEReadCounter.table","NW_015090842.1:8406778",9,14,5
"IRF8","s954_F_VTA_03_ASEReadCounter.table","NW_015090842.1:8406819",9,19,10
"IRF8","s954_F_VTA_03_ASEReadCounter.table","NW_015090842.1:8406941",7,24,17
"IRF8","s954_F_VTA_03_ASEReadCounter.table","NW_015090842.1:8407008",5,17,12
"IRF8","s954_F_VTA_03_ASEReadCounter.table","NW_015090842.1:8407057",5,9,4
"IRF8","s954_F_VTA_03_ASEReadCounter.table","NW_015090842.1:8407064",6,10,4
"IRF8","s954_F_VTA_03_ASEReadCounter.table","NW_015090842.1:8407069",8,12,4
"IRF8","s954_F_VTA_03_ASEReadCounter.table","NW_015090842.1:8407120",9,14,5
"IRF8","s954_F_VTA_03_ASEReadCounter.table","NW_015090842.1:8407157",7,14,7
"IRF8","s954_F_VTA_03_ASEReadCounter.table","NW_015090842.1:8407203",4,12,8
"IRF8","s954_F_VTA_03_ASEReadCounter.table","NW_015090842.1:8407272",10,17,7
"IRF8","s954_F_VTA_03_ASEReadCounter.table","NW_015090842.1:8407276",10,17,7
"IRF8","s954_F_VTA_03_ASEReadCounter.table","NW_015090842.1:8407303",12,21,9
"IRF8","s954_F_VTA_03_ASEReadCounter.table","NW_015090842.1:8407451",11,20,9
"IRF8","s954_F_VTA_03_ASEReadCounter.table","NW_015090842.1:8407456",10,18,8
"IRF8","s954_F_VTA_03_ASEReadCounter.table","NW_015090842.1:8408564",6,13,7
"IRF8","s954_F_VTA_03_ASEReadCounter.table","NW_015090842.1:8408585",17,17,0
"IRF8","s954_F_VTA_03_ASEReadCounter.table","NW_015090842.1:8408973",10,16,6
"IRF8","s954_F_VTA_03_ASEReadCounter.table","NW_015090842.1:8409060",9,12,3
"IRF8","s954_F_VTA_03_ASEReadCounter.table","NW_015090842.1:8409065",11,14,3
"IRF8","s954_F_VTA_03_ASEReadCounter.table","NW_015090842.1:8409254",6,10,4
"IRF8","s954_F_VTA_03_ASEReadCounter.table","NW_015090842.1:8409255",6,9,3
"IRF8","s954_F_VTA_03_ASEReadCounter.table","NW_015090842.1:8409258",5,8,3
"IRF8","s954_F_VTA_03_ASEReadCounter.table","NW_015090842.1:8409312",7,12,5
"IRF8","s954_F_VTA_03_ASEReadCounter.table","NW_015090842.1:8410216",7,16,9
"IRF8","s954_F_VTA_03_ASEReadCounter.table","NW_015090842.1:8410237",8,19,11
"IRF8","s954_F_VTA_03_ASEReadCounter.table","NW_015090842.1:8410276",22,22,0
"IRF8","s954_F_VTA_03_ASEReadCounter.table","NW_015090842.1:8410813",15,21,6
"IRF8","s954_F_VTA_03_ASEReadCounter.table","NW_015090842.1:8410861",14,19,5
"IRF8","s954_F_VTA_03_ASEReadCounter.table","NW_015090842.1:8411940",8,11,3
"IRF8","s954_F_VTA_03_ASEReadCounter.table","NW_015090842.1:8412006",9,15,6
"IRF8","s954_F_VTA_03_ASEReadCounter.table","NW_015090842.1:8412042",8,12,4
"DUSP15","s954_F_VTA_03_ASEReadCounter.table","NW_015090842.1:8422787",2,2,0
"DUSP15","s954_F_VTA_03_ASEReadCounter.table","NW_015090842.1:8422832",3,4,1
"DUSP15","s954_F_VTA_03_ASEReadCounter.table","NW_015090842.1:8422898",3,4,1
"DUSP15","s954_F_VTA_03_ASEReadCounter.table","NW_015090842.1:8422909",4,5,1
"COX4I1","s954_F_VTA_03_ASEReadCounter.table","NW_015090842.1:8442258",1288,2429,1141
"COX4I1","s954_F_VTA_03_ASEReadCounter.table","NW_015090842.1:8442333",1070,2032,962
"EMC8","s954_F_VTA_03_ASEReadCounter.table","NW_015090842.1:8444046",39,95,56
"EMC8","s954_F_VTA_03_ASEReadCounter.table","NW_015090842.1:8444064",35,87,52
"EMC8","s954_F_VTA_03_ASEReadCounter.table","NW_015090842.1:8452029",23,52,29
"EMC8","s954_F_VTA_03_ASEReadCounter.table","NW_015090842.1:8452116",31,54,23
"EMC8","s954_F_VTA_03_ASEReadCounter.table","NW_015090842.1:8452121",28,55,27
"EMC8","s954_F_VTA_03_ASEReadCounter.table","NW_015090842.1:8452222",21,36,15
"EMC8","s954_F_VTA_03_ASEReadCounter.table","NW_015090842.1:8452244",24,48,24
"EMC8","s954_F_VTA_03_ASEReadCounter.table","NW_015090842.1:8452477",10,19,9
"EMC8","s954_F_VTA_03_ASEReadCounter.table","NW_015090842.1:8452498",11,22,11
"EMC8","s954_F_VTA_03_ASEReadCounter.table","NW_015090842.1:8452535",6,12,6
"EMC8","s954_F_VTA_03_ASEReadCounter.table","NW_015090842.1:8452575",3,8,5
"EMC8","s954_F_VTA_03_ASEReadCounter.table","NW_015090842.1:8452600",4,11,7
"EMC8","s954_F_VTA_03_ASEReadCounter.table","NW_015090842.1:8452616",6,11,5
"EMC8","s954_F_VTA_03_ASEReadCounter.table","NW_015090842.1:8452630",6,9,3
"EMC8","s954_F_VTA_03_ASEReadCounter.table","NW_015090842.1:8452650",6,13,7
"EMC8","s954_F_VTA_03_ASEReadCounter.table","NW_015090842.1:8452678",7,19,12
"EMC8","s954_F_VTA_03_ASEReadCounter.table","NW_015090842.1:8452724",3,12,9
"EMC8","s954_F_VTA_03_ASEReadCounter.table","NW_015090842.1:8452731",4,15,11
"EMC8","s954_F_VTA_03_ASEReadCounter.table","NW_015090842.1:8452743",3,12,9
"EMC8","s954_F_VTA_03_ASEReadCounter.table","NW_015090842.1:8452750",2,12,10
"EMC8","s954_F_VTA_03_ASEReadCounter.table","NW_015090842.1:8452778",5,12,7
"EMC8","s954_F_VTA_03_ASEReadCounter.table","NW_015090842.1:8452783",5,14,9
"EMC8","s954_F_VTA_03_ASEReadCounter.table","NW_015090842.1:8452800",5,15,10
"EMC8","s954_F_VTA_03_ASEReadCounter.table","NW_015090842.1:8452804",7,16,9
"EMC8","s954_F_VTA_03_ASEReadCounter.table","NW_015090842.1:8452812",8,15,7
"EMC8","s954_F_VTA_03_ASEReadCounter.table","NW_015090842.1:8452858",12,21,9
"EMC8","s954_F_VTA_03_ASEReadCounter.table","NW_015090842.1:8452906",12,19,7
"EMC8","s954_F_VTA_03_ASEReadCounter.table","NW_015090842.1:8452913",11,18,7
"EMC8","s954_F_VTA_03_ASEReadCounter.table","NW_015090842.1:8453000",7,19,12
"EMC8","s954_F_VTA_03_ASEReadCounter.table","NW_015090842.1:8453007",9,20,11
"EMC8","s954_F_VTA_03_ASEReadCounter.table","NW_015090842.1:8453058",7,18,11
"EMC8","s954_F_VTA_03_ASEReadCounter.table","NW_015090842.1:8453106",3,15,12
"GINS2","s954_F_VTA_03_ASEReadCounter.table","NW_015090842.1:8466420",5,5,0
"GINS2","s954_F_VTA_03_ASEReadCounter.table","NW_015090842.1:8466424",6,6,0
"GINS2","s954_F_VTA_03_ASEReadCounter.table","NW_015090842.1:8466518",10,12,2
"GINS2","s954_F_VTA_03_ASEReadCounter.table","NW_015090842.1:8468482",23,27,4
"GINS2","s954_F_VTA_03_ASEReadCounter.table","NW_015090842.1:8470290",29,31,2
"GINS2","s954_F_VTA_03_ASEReadCounter.table","NW_015090842.1:8470305",28,30,2
"GINS2","s954_F_VTA_03_ASEReadCounter.table","NW_015090842.1:8470381",24,29,5
"GINS2","s954_F_VTA_03_ASEReadCounter.table","NW_015090842.1:8470418",25,28,3
"GINS2","s954_F_VTA_03_ASEReadCounter.table","NW_015090842.1:8470421",24,28,4
"GINS2","s954_F_VTA_03_ASEReadCounter.table","NW_015090842.1:8470430",20,24,4
"GINS2","s954_F_VTA_03_ASEReadCounter.table","NW_015090842.1:8470433",18,22,4
"GINS2","s954_F_VTA_03_ASEReadCounter.table","NW_015090842.1:8470457",11,12,1
"GINS2","s954_F_VTA_03_ASEReadCounter.table","NW_015090842.1:8470491",19,22,3
"GINS2","s954_F_VTA_03_ASEReadCounter.table","NW_015090842.1:8470548",18,21,3
"GINS2","s954_F_VTA_03_ASEReadCounter.table","NW_015090842.1:8470649",24,29,5
"GSE1","s954_F_VTA_03_ASEReadCounter.table","NW_015090842.1:8475362",42,92,50
"GSE1","s954_F_VTA_03_ASEReadCounter.table","NW_015090842.1:8475961",23,36,13
"GSE1","s954_F_VTA_03_ASEReadCounter.table","NW_015090842.1:8476027",28,45,17
"GSE1","s954_F_VTA_03_ASEReadCounter.table","NW_015090842.1:8476159",8,16,8
"GSE1","s954_F_VTA_03_ASEReadCounter.table","NW_015090842.1:8477442",0,24,24
"GSE1","s954_F_VTA_03_ASEReadCounter.table","NW_015090842.1:8477448",0,19,19
"GSE1","s954_F_VTA_03_ASEReadCounter.table","NW_015090842.1:8477662",1,21,20
"GSE1","s954_F_VTA_03_ASEReadCounter.table","NW_015090842.1:8477933",13,32,19
"GSE1","s954_F_VTA_03_ASEReadCounter.table","NW_015090842.1:8477945",13,33,20
"GSE1","s954_F_VTA_03_ASEReadCounter.table","NW_015090842.1:8483272",2,38,36
"GSE1","s954_F_VTA_03_ASEReadCounter.table","NW_015090842.1:8483367",1,12,11
"GSE1","s954_F_VTA_03_ASEReadCounter.table","NW_015090842.1:8483411",0,7,7
"GSE1","s954_F_VTA_03_ASEReadCounter.table","NW_015090842.1:8483756",3,11,8
"GSE1","s954_F_VTA_03_ASEReadCounter.table","NW_015090842.1:8486867",25,49,24
"GSE1","s954_F_VTA_03_ASEReadCounter.table","NW_015090842.1:8486939",35,59,24
"GSE1","s954_F_VTA_03_ASEReadCounter.table","NW_015090842.1:8486945",37,64,27
"GSE1","s954_F_VTA_03_ASEReadCounter.table","NW_015090842.1:8486993",31,46,15
"GSE1","s954_F_VTA_03_ASEReadCounter.table","NW_015090842.1:8487062",23,33,10
"GSE1","s954_F_VTA_03_ASEReadCounter.table","NW_015090842.1:8488065",7,21,14
"GSE1","s954_F_VTA_03_ASEReadCounter.table","NW_015090842.1:8488457",9,23,14
"GSE1","s954_F_VTA_03_ASEReadCounter.table","NW_015090842.1:8488463",10,26,16
"GSE1","s954_F_VTA_03_ASEReadCounter.table","NW_015090842.1:8488490",22,22,0
"GSE1","s954_F_VTA_03_ASEReadCounter.table","NW_015090842.1:8488505",9,22,13
"GSE1","s954_F_VTA_03_ASEReadCounter.table","NW_015090842.1:8490180",1,22,21
"KIAA0513","s954_F_VTA_03_ASEReadCounter.table","NW_015090842.1:8668363",80,187,107
"KIAA0513","s954_F_VTA_03_ASEReadCounter.table","NW_015090842.1:8668387",82,173,91
"KIAA0513","s954_F_VTA_03_ASEReadCounter.table","NW_015090842.1:8668390",84,180,96
"KIAA0513","s954_F_VTA_03_ASEReadCounter.table","NW_015090842.1:8673107",93,185,92
"KIAA0513","s954_F_VTA_03_ASEReadCounter.table","NW_015090842.1:8673147",103,204,101
"KIAA0513","s954_F_VTA_03_ASEReadCounter.table","NW_015090842.1:8674661",62,136,74
"KIAA0513","s954_F_VTA_03_ASEReadCounter.table","NW_015090842.1:8674685",62,132,70
"KIAA0513","s954_F_VTA_03_ASEReadCounter.table","NW_015090842.1:8674730",47,119,72
"KIAA0513","s954_F_VTA_03_ASEReadCounter.table","NW_015090842.1:8675525",60,124,64
"KIAA0513","s954_F_VTA_03_ASEReadCounter.table","NW_015090842.1:8675561",59,114,55
"KIAA0513","s954_F_VTA_03_ASEReadCounter.table","NW_015090842.1:8678608",0,24,24
"KIAA0513","s954_F_VTA_03_ASEReadCounter.table","NW_015090842.1:8686455",0,18,18
"KIAA0513","s954_F_VTA_03_ASEReadCounter.table","NW_015090842.1:8686508",0,21,21
"KIAA0513","s954_F_VTA_03_ASEReadCounter.table","NW_015090842.1:8686521",0,18,18
"KIAA0513","s954_F_VTA_03_ASEReadCounter.table","NW_015090842.1:8693642",3,9,6
"KIAA0513","s954_F_VTA_03_ASEReadCounter.table","NW_015090842.1:8693712",6,9,3
"KIAA0513","s954_F_VTA_03_ASEReadCounter.table","NW_015090842.1:8695794",0,1,1
"FBXO31","s954_F_VTA_03_ASEReadCounter.table","NW_015090842.1:8710240",31,63,32
"FBXO31","s954_F_VTA_03_ASEReadCounter.table","NW_015090842.1:8710372",29,47,18
"FBXO31","s954_F_VTA_03_ASEReadCounter.table","NW_015090842.1:8711239",34,53,19
"FBXO31","s954_F_VTA_03_ASEReadCounter.table","NW_015090842.1:8714565",43,81,38
"FBXO31","s954_F_VTA_03_ASEReadCounter.table","NW_015090842.1:8716001",17,39,22
"ZCCHC14","s954_F_VTA_03_ASEReadCounter.table","NW_015090842.1:8750174",44,54,10
"ZCCHC14","s954_F_VTA_03_ASEReadCounter.table","NW_015090842.1:8750189",53,63,10
"ZCCHC14","s954_F_VTA_03_ASEReadCounter.table","NW_015090842.1:8750365",24,51,27
"ZCCHC14","s954_F_VTA_03_ASEReadCounter.table","NW_015090842.1:8750433",22,44,22
"ZCCHC14","s954_F_VTA_03_ASEReadCounter.table","NW_015090842.1:8750449",23,46,23
"ZCCHC14","s954_F_VTA_03_ASEReadCounter.table","NW_015090842.1:8750456",20,44,24
"ZCCHC14","s954_F_VTA_03_ASEReadCounter.table","NW_015090842.1:8750497",28,50,22
"ZCCHC14","s954_F_VTA_03_ASEReadCounter.table","NW_015090842.1:8750547",31,50,19
"ZCCHC14","s954_F_VTA_03_ASEReadCounter.table","NW_015090842.1:8751100",9,16,7
"ZCCHC14","s954_F_VTA_03_ASEReadCounter.table","NW_015090842.1:8751374",12,29,17
"ZCCHC14","s954_F_VTA_03_ASEReadCounter.table","NW_015090842.1:8751403",14,38,24
"ZCCHC14","s954_F_VTA_03_ASEReadCounter.table","NW_015090842.1:8751517",18,36,18
"ZCCHC14","s954_F_VTA_03_ASEReadCounter.table","NW_015090842.1:8752060",15,23,8
"ZCCHC14","s954_F_VTA_03_ASEReadCounter.table","NW_015090842.1:8752172",20,34,14
"ZCCHC14","s954_F_VTA_03_ASEReadCounter.table","NW_015090842.1:8752183",21,34,13
"ZCCHC14","s954_F_VTA_03_ASEReadCounter.table","NW_015090842.1:8752198",16,32,16
"ZCCHC14","s954_F_VTA_03_ASEReadCounter.table","NW_015090842.1:8752248",21,40,19
"ZCCHC14","s954_F_VTA_03_ASEReadCounter.table","NW_015090842.1:8752326",27,56,29
"ZCCHC14","s954_F_VTA_03_ASEReadCounter.table","NW_015090842.1:8752393",22,46,24
"ZCCHC14","s954_F_VTA_03_ASEReadCounter.table","NW_015090842.1:8752914",21,32,11
"ZCCHC14","s954_F_VTA_03_ASEReadCounter.table","NW_015090842.1:8753528",10,22,12
"ZCCHC14","s954_F_VTA_03_ASEReadCounter.table","NW_015090842.1:8753892",9,15,6
"ZCCHC14","s954_F_VTA_03_ASEReadCounter.table","NW_015090842.1:8753910",8,13,5
"ZCCHC14","s954_F_VTA_03_ASEReadCounter.table","NW_015090842.1:8755096",5,15,10
"ZCCHC14","s954_F_VTA_03_ASEReadCounter.table","NW_015090842.1:8755327",6,15,9
"ZCCHC14","s954_F_VTA_03_ASEReadCounter.table","NW_015090842.1:8755723",7,13,6
"ZCCHC14","s954_F_VTA_03_ASEReadCounter.table","NW_015090842.1:8755739",8,14,6
"ZCCHC14","s954_F_VTA_03_ASEReadCounter.table","NW_015090842.1:8756149",6,10,4
"ZCCHC14","s954_F_VTA_03_ASEReadCounter.table","NW_015090842.1:8756347",7,14,7
"ZCCHC14","s954_F_VTA_03_ASEReadCounter.table","NW_015090842.1:8756361",8,15,7
"ZCCHC14","s954_F_VTA_03_ASEReadCounter.table","NW_015090842.1:8756388",7,13,6
"ZCCHC14","s954_F_VTA_03_ASEReadCounter.table","NW_015090842.1:8756389",7,13,6
"ZCCHC14","s954_F_VTA_03_ASEReadCounter.table","NW_015090842.1:8757160",6,9,3
"ZCCHC14","s954_F_VTA_03_ASEReadCounter.table","NW_015090842.1:8804511",2,5,3
"ZCCHC14","s954_F_VTA_03_ASEReadCounter.table","NW_015090842.1:8804979",1,3,2
"JPH3","s954_F_VTA_03_ASEReadCounter.table","NW_015090842.1:8845375",19,36,17
"JPH3","s954_F_VTA_03_ASEReadCounter.table","NW_015090842.1:8845640",24,50,26
"JPH3","s954_F_VTA_03_ASEReadCounter.table","NW_015090842.1:8845654",19,44,25
"JPH3","s954_F_VTA_03_ASEReadCounter.table","NW_015090842.1:8872283",40,81,41
"JPH3","s954_F_VTA_03_ASEReadCounter.table","NW_015090842.1:8872294",33,76,43
"JPH3","s954_F_VTA_03_ASEReadCounter.table","NW_015090842.1:8872730",56,107,51
"JPH3","s954_F_VTA_03_ASEReadCounter.table","NW_015090842.1:8885260",77,176,99
"JPH3","s954_F_VTA_03_ASEReadCounter.table","NW_015090842.1:8885315",56,150,94
"JPH3","s954_F_VTA_03_ASEReadCounter.table","NW_015090842.1:8885328",48,135,87
"JPH3","s954_F_VTA_03_ASEReadCounter.table","NW_015090842.1:8885438",75,159,84
"JPH3","s954_F_VTA_03_ASEReadCounter.table","NW_015090842.1:8885525",22,78,56
"KLHDC4","s954_F_VTA_03_ASEReadCounter.table","NW_015090842.1:8890729",32,55,23
"KLHDC4","s954_F_VTA_03_ASEReadCounter.table","NW_015090842.1:8890749",36,58,22
"KLHDC4","s954_F_VTA_03_ASEReadCounter.table","NW_015090842.1:8890761",38,61,23
"KLHDC4","s954_F_VTA_03_ASEReadCounter.table","NW_015090842.1:8891123",59,107,48
"KLHDC4","s954_F_VTA_03_ASEReadCounter.table","NW_015090842.1:8893124",35,68,33
"KLHDC4","s954_F_VTA_03_ASEReadCounter.table","NW_015090842.1:8894542",46,72,26
"KLHDC4","s954_F_VTA_03_ASEReadCounter.table","NW_015090842.1:8896726",39,58,19
"KLHDC4","s954_F_VTA_03_ASEReadCounter.table","NW_015090842.1:8896767",37,57,20
"KLHDC4","s954_F_VTA_03_ASEReadCounter.table","NW_015090842.1:8904174",33,53,20
"KLHDC4","s954_F_VTA_03_ASEReadCounter.table","NW_015090842.1:8904231",31,48,17
"KLHDC4","s954_F_VTA_03_ASEReadCounter.table","NW_015090842.1:8905251",21,45,24
"KLHDC4","s954_F_VTA_03_ASEReadCounter.table","NW_015090842.1:8905263",21,47,26
"KLHDC4","s954_F_VTA_03_ASEReadCounter.table","NW_015090842.1:8919626",6,7,1
"SLC7A5","s954_F_VTA_03_ASEReadCounter.table","NW_015090842.1:8938782",209,476,267
"SLC7A5","s954_F_VTA_03_ASEReadCounter.table","NW_015090842.1:8938943",146,391,245
"SLC7A5","s954_F_VTA_03_ASEReadCounter.table","NW_015090842.1:8939611",138,246,108
"SLC7A5","s954_F_VTA_03_ASEReadCounter.table","NW_015090842.1:8939738",144,316,172
"SLC7A5","s954_F_VTA_03_ASEReadCounter.table","NW_015090842.1:8939739",143,314,171
"SLC7A5","s954_F_VTA_03_ASEReadCounter.table","NW_015090842.1:8939740",142,316,174
"SLC7A5","s954_F_VTA_03_ASEReadCounter.table","NW_015090842.1:8939795",150,282,132
"SLC7A5","s954_F_VTA_03_ASEReadCounter.table","NW_015090842.1:8939815",134,290,156
"SLC7A5","s954_F_VTA_03_ASEReadCounter.table","NW_015090842.1:8939816",134,290,156
"SLC7A5","s954_F_VTA_03_ASEReadCounter.table","NW_015090842.1:8939817",132,303,171
"SLC7A5","s954_F_VTA_03_ASEReadCounter.table","NW_015090842.1:8939845",151,336,185
"SLC7A5","s954_F_VTA_03_ASEReadCounter.table","NW_015090842.1:8939894",116,290,174
"SLC7A5","s954_F_VTA_03_ASEReadCounter.table","NW_015090842.1:8939895",115,283,168
"SLC7A5","s954_F_VTA_03_ASEReadCounter.table","NW_015090842.1:8939997",462,462,0
"SLC7A5","s954_F_VTA_03_ASEReadCounter.table","NW_015090842.1:8940172",140,313,173
"SLC7A5","s954_F_VTA_03_ASEReadCounter.table","NW_015090842.1:8940331",54,137,83
"SLC7A5","s954_F_VTA_03_ASEReadCounter.table","NW_015090842.1:8940696",100,184,84
"SLC7A5","s954_F_VTA_03_ASEReadCounter.table","NW_015090842.1:8940719",51,173,122
"SLC7A5","s954_F_VTA_03_ASEReadCounter.table","NW_015090842.1:8940737",61,171,110
"SLC7A5","s954_F_VTA_03_ASEReadCounter.table","NW_015090842.1:8940743",68,174,106
"SLC7A5","s954_F_VTA_03_ASEReadCounter.table","NW_015090842.1:8940766",78,195,117
"SLC7A5","s954_F_VTA_03_ASEReadCounter.table","NW_015090842.1:8940769",83,220,137
"SLC7A5","s954_F_VTA_03_ASEReadCounter.table","NW_015090842.1:8940861",83,196,113
"SLC7A5","s954_F_VTA_03_ASEReadCounter.table","NW_015090842.1:8941068",103,225,122
"SLC7A5","s954_F_VTA_03_ASEReadCounter.table","NW_015090842.1:8941467",54,161,107
"SLC7A5","s954_F_VTA_03_ASEReadCounter.table","NW_015090842.1:8941531",73,176,103
"SLC7A5","s954_F_VTA_03_ASEReadCounter.table","NW_015090842.1:8941588",89,200,111
"SLC7A5","s954_F_VTA_03_ASEReadCounter.table","NW_015090842.1:8941698",62,131,69
"SLC7A5","s954_F_VTA_03_ASEReadCounter.table","NW_015090842.1:8941717",81,151,70
"SLC7A5","s954_F_VTA_03_ASEReadCounter.table","NW_015090842.1:8941745",71,148,77
"SLC7A5","s954_F_VTA_03_ASEReadCounter.table","NW_015090842.1:8941781",81,183,102
"SLC7A5","s954_F_VTA_03_ASEReadCounter.table","NW_015090842.1:8941887",59,128,69
"SLC7A5","s954_F_VTA_03_ASEReadCounter.table","NW_015090842.1:8941968",34,117,83
"SLC7A5","s954_F_VTA_03_ASEReadCounter.table","NW_015090842.1:8942025",54,141,87
"SLC7A5","s954_F_VTA_03_ASEReadCounter.table","NW_015090842.1:8942069",52,142,90
"SLC7A5","s954_F_VTA_03_ASEReadCounter.table","NW_015090842.1:8942170",63,155,92
"SLC7A5","s954_F_VTA_03_ASEReadCounter.table","NW_015090842.1:8942241",69,160,91
"SLC7A5","s954_F_VTA_03_ASEReadCounter.table","NW_015090842.1:8942283",69,167,98
"SLC7A5","s954_F_VTA_03_ASEReadCounter.table","NW_015090842.1:8942717",82,222,140
"SLC7A5","s954_F_VTA_03_ASEReadCounter.table","NW_015090842.1:8942756",91,270,179
"SLC7A5","s954_F_VTA_03_ASEReadCounter.table","NW_015090842.1:8942766",89,270,181
"SLC7A5","s954_F_VTA_03_ASEReadCounter.table","NW_015090842.1:8943271",61,136,75
"SLC7A5","s954_F_VTA_03_ASEReadCounter.table","NW_015090842.1:8943524",55,118,63
"SLC7A5","s954_F_VTA_03_ASEReadCounter.table","NW_015090842.1:8943530",63,126,63
"SLC7A5","s954_F_VTA_03_ASEReadCounter.table","NW_015090842.1:8943602",54,119,65
"SLC7A5","s954_F_VTA_03_ASEReadCounter.table","NW_015090842.1:8943622",54,110,56
"SLC7A5","s954_F_VTA_03_ASEReadCounter.table","NW_015090842.1:8943661",54,114,60
"SLC7A5","s954_F_VTA_03_ASEReadCounter.table","NW_015090842.1:8943686",45,105,60
"SLC7A5","s954_F_VTA_03_ASEReadCounter.table","NW_015090842.1:8943788",47,98,51
"SLC7A5","s954_F_VTA_03_ASEReadCounter.table","NW_015090842.1:8943814",49,101,52
"SLC7A5","s954_F_VTA_03_ASEReadCounter.table","NW_015090842.1:8943876",44,105,61
"SLC7A5","s954_F_VTA_03_ASEReadCounter.table","NW_015090842.1:8943892",47,108,61
"SLC7A5","s954_F_VTA_03_ASEReadCounter.table","NW_015090842.1:8944097",53,126,73
"SLC7A5","s954_F_VTA_03_ASEReadCounter.table","NW_015090842.1:8944104",52,116,64
"SLC7A5","s954_F_VTA_03_ASEReadCounter.table","NW_015090842.1:8944293",23,60,37
"SLC7A5","s954_F_VTA_03_ASEReadCounter.table","NW_015090842.1:8944297",21,60,39
"SLC7A5","s954_F_VTA_03_ASEReadCounter.table","NW_015090842.1:8944397",26,66,40
"SLC7A5","s954_F_VTA_03_ASEReadCounter.table","NW_015090842.1:8944552",36,91,55
"SLC7A5","s954_F_VTA_03_ASEReadCounter.table","NW_015090842.1:8944629",26,85,59
"CA5A","s954_F_VTA_03_ASEReadCounter.table","NW_015090842.1:8989479",83,149,66
"CA5A","s954_F_VTA_03_ASEReadCounter.table","NW_015090842.1:8989562",103,182,79
"CA5A","s954_F_VTA_03_ASEReadCounter.table","NW_015090842.1:8989609",105,198,93
"CA5A","s954_F_VTA_03_ASEReadCounter.table","NW_015090842.1:8989693",138,256,118
"CA5A","s954_F_VTA_03_ASEReadCounter.table","NW_015090842.1:8989702",139,248,109
"CA5A","s954_F_VTA_03_ASEReadCounter.table","NW_015090842.1:8989746",125,232,107
"CA5A","s954_F_VTA_03_ASEReadCounter.table","NW_015090842.1:8989880",111,207,96
"CA5A","s954_F_VTA_03_ASEReadCounter.table","NW_015090842.1:8989885",118,215,97
"CA5A","s954_F_VTA_03_ASEReadCounter.table","NW_015090842.1:8989929",118,210,92
"CA5A","s954_F_VTA_03_ASEReadCounter.table","NW_015090842.1:8990002",90,190,100
"CA5A","s954_F_VTA_03_ASEReadCounter.table","NW_015090842.1:8990004",89,187,98
"CA5A","s954_F_VTA_03_ASEReadCounter.table","NW_015090842.1:8990005",88,188,100
"CA5A","s954_F_VTA_03_ASEReadCounter.table","NW_015090842.1:8990017",91,182,91
"CA5A","s954_F_VTA_03_ASEReadCounter.table","NW_015090842.1:8990043",62,148,86
"CA5A","s954_F_VTA_03_ASEReadCounter.table","NW_015090842.1:8990060",157,157,0
"CA5A","s954_F_VTA_03_ASEReadCounter.table","NW_015090842.1:8990080",60,148,88
"CA5A","s954_F_VTA_03_ASEReadCounter.table","NW_015090842.1:8990084",59,139,80
"CA5A","s954_F_VTA_03_ASEReadCounter.table","NW_015090842.1:8990090",58,144,86
"CA5A","s954_F_VTA_03_ASEReadCounter.table","NW_015090842.1:8990095",61,142,81
"CA5A","s954_F_VTA_03_ASEReadCounter.table","NW_015090842.1:8990111",54,137,83
"CA5A","s954_F_VTA_03_ASEReadCounter.table","NW_015090842.1:8990112",53,129,76
"CA5A","s954_F_VTA_03_ASEReadCounter.table","NW_015090842.1:8990115",65,140,75
"CA5A","s954_F_VTA_03_ASEReadCounter.table","NW_015090842.1:8990166",79,145,66
"CA5A","s954_F_VTA_03_ASEReadCounter.table","NW_015090842.1:8990169",86,148,62
"CA5A","s954_F_VTA_03_ASEReadCounter.table","NW_015090842.1:8990193",150,150,0
"CA5A","s954_F_VTA_03_ASEReadCounter.table","NW_015090842.1:8990222",77,135,58
"CA5A","s954_F_VTA_03_ASEReadCounter.table","NW_015090842.1:8990289",77,139,62
"CA5A","s954_F_VTA_03_ASEReadCounter.table","NW_015090842.1:8990314",87,152,65
"CA5A","s954_F_VTA_03_ASEReadCounter.table","NW_015090842.1:8990361",77,142,65
"CA5A","s954_F_VTA_03_ASEReadCounter.table","NW_015090842.1:8990368",76,141,65
"CA5A","s954_F_VTA_03_ASEReadCounter.table","NW_015090842.1:8990429",76,136,60
"CA5A","s954_F_VTA_03_ASEReadCounter.table","NW_015090842.1:8990466",75,129,54
"CA5A","s954_F_VTA_03_ASEReadCounter.table","NW_015090842.1:8990663",65,118,53
"CA5A","s954_F_VTA_03_ASEReadCounter.table","NW_015090842.1:8990797",58,95,37
"CA5A","s954_F_VTA_03_ASEReadCounter.table","NW_015090842.1:8990836",57,91,34
"CA5A","s954_F_VTA_03_ASEReadCounter.table","NW_015090842.1:8990842",55,93,38
"CA5A","s954_F_VTA_03_ASEReadCounter.table","NW_015090842.1:8990851",57,93,36
"CA5A","s954_F_VTA_03_ASEReadCounter.table","NW_015090842.1:8990918",53,92,39
"CA5A","s954_F_VTA_03_ASEReadCounter.table","NW_015090842.1:8990921",45,89,44
"CA5A","s954_F_VTA_03_ASEReadCounter.table","NW_015090842.1:8990942",58,103,45
"CA5A","s954_F_VTA_03_ASEReadCounter.table","NW_015090842.1:8991001",65,124,59
"CA5A","s954_F_VTA_03_ASEReadCounter.table","NW_015090842.1:8991038",70,118,48
"CA5A","s954_F_VTA_03_ASEReadCounter.table","NW_015090842.1:8991149",70,117,47
"CA5A","s954_F_VTA_03_ASEReadCounter.table","NW_015090842.1:8991176",74,129,55
"CA5A","s954_F_VTA_03_ASEReadCounter.table","NW_015090842.1:8991241",62,118,56
"CA5A","s954_F_VTA_03_ASEReadCounter.table","NW_015090842.1:8991262",56,109,53
"CA5A","s954_F_VTA_03_ASEReadCounter.table","NW_015090842.1:8991316",60,63,3
"CA5A","s954_F_VTA_03_ASEReadCounter.table","NW_015090842.1:8991319",64,67,3
"CA5A","s954_F_VTA_03_ASEReadCounter.table","NW_015090842.1:8991330",61,63,2
"CA5A","s954_F_VTA_03_ASEReadCounter.table","NW_015090842.1:8991334",57,61,4
"CA5A","s954_F_VTA_03_ASEReadCounter.table","NW_015090842.1:8991362",63,91,28
"CA5A","s954_F_VTA_03_ASEReadCounter.table","NW_015090842.1:8991368",63,89,26
"CA5A","s954_F_VTA_03_ASEReadCounter.table","NW_015090842.1:8991390",70,100,30
"CA5A","s954_F_VTA_03_ASEReadCounter.table","NW_015090842.1:8991395",73,110,37
"CA5A","s954_F_VTA_03_ASEReadCounter.table","NW_015090842.1:8991422",72,115,43
"CA5A","s954_F_VTA_03_ASEReadCounter.table","NW_015090842.1:8991467",66,107,41
"CA5A","s954_F_VTA_03_ASEReadCounter.table","NW_015090842.1:8991576",49,85,36
"CA5A","s954_F_VTA_03_ASEReadCounter.table","NW_015090842.1:8991587",64,97,33
"CA5A","s954_F_VTA_03_ASEReadCounter.table","NW_015090842.1:8991655",61,105,44
"CA5A","s954_F_VTA_03_ASEReadCounter.table","NW_015090842.1:8991717",52,97,45
"CA5A","s954_F_VTA_03_ASEReadCounter.table","NW_015090842.1:8991726",53,94,41
"CA5A","s954_F_VTA_03_ASEReadCounter.table","NW_015090842.1:8991799",50,90,40
"CA5A","s954_F_VTA_03_ASEReadCounter.table","NW_015090842.1:8991809",41,77,36
"CA5A","s954_F_VTA_03_ASEReadCounter.table","NW_015090842.1:8991848",35,71,36
"CA5A","s954_F_VTA_03_ASEReadCounter.table","NW_015090842.1:8991849",34,69,35
"CA5A","s954_F_VTA_03_ASEReadCounter.table","NW_015090842.1:8991927",57,91,34
"CA5A","s954_F_VTA_03_ASEReadCounter.table","NW_015090842.1:8991941",59,96,37
"CA5A","s954_F_VTA_03_ASEReadCounter.table","NW_015090842.1:8992121",24,66,42
"CA5A","s954_F_VTA_03_ASEReadCounter.table","NW_015090842.1:8992224",42,75,33
"CA5A","s954_F_VTA_03_ASEReadCounter.table","NW_015090842.1:9002570",20,39,19
"CA5A","s954_F_VTA_03_ASEReadCounter.table","NW_015090842.1:9002600",20,38,18
"CA5A","s954_F_VTA_03_ASEReadCounter.table","NW_015090842.1:9004312",14,29,15
"CA5A","s954_F_VTA_03_ASEReadCounter.table","NW_015090842.1:9004556",1,1,0
"CA5A","s954_F_VTA_03_ASEReadCounter.table","NW_015090842.1:9005116",2,3,1
"CA5A","s954_F_VTA_03_ASEReadCounter.table","NW_015090842.1:9005120",2,3,1
"CA5A","s954_F_VTA_03_ASEReadCounter.table","NW_015090842.1:9005140",2,3,1
"CA5A","s954_F_VTA_03_ASEReadCounter.table","NW_015090842.1:9005152",2,3,1
"BANP","s954_F_VTA_03_ASEReadCounter.table","NW_015090842.1:9033407",5,11,6
"BANP","s954_F_VTA_03_ASEReadCounter.table","NW_015090842.1:9033409",5,11,6
"BANP","s954_F_VTA_03_ASEReadCounter.table","NW_015090842.1:9033420",6,12,6
"BANP","s954_F_VTA_03_ASEReadCounter.table","NW_015090842.1:9067974",0,18,18
"BANP","s954_F_VTA_03_ASEReadCounter.table","NW_015090842.1:9102510",14,30,16
"BANP","s954_F_VTA_03_ASEReadCounter.table","NW_015090842.1:9168534",16,40,24
"BANP","s954_F_VTA_03_ASEReadCounter.table","NW_015090842.1:9168818",20,41,21
"ZNF469","s954_F_VTA_03_ASEReadCounter.table","NW_015090842.1:9424333",0,1,1
"ZNF469","s954_F_VTA_03_ASEReadCounter.table","NW_015090842.1:9425089",1,1,0
"ZNF469","s954_F_VTA_03_ASEReadCounter.table","NW_015090842.1:9425108",1,2,1
"ZNF469","s954_F_VTA_03_ASEReadCounter.table","NW_015090842.1:9425182",1,3,2
"ZNF469","s954_F_VTA_03_ASEReadCounter.table","NW_015090842.1:9427067",0,1,1
"ZNF469","s954_F_VTA_03_ASEReadCounter.table","NW_015090842.1:9428419",2,3,1
"ZNF469","s954_F_VTA_03_ASEReadCounter.table","NW_015090842.1:9429633",0,1,1
"ZNF469","s954_F_VTA_03_ASEReadCounter.table","NW_015090842.1:9429758",0,1,1
"ZNF469","s954_F_VTA_03_ASEReadCounter.table","NW_015090842.1:9429759",0,1,1
"ZNF469","s954_F_VTA_03_ASEReadCounter.table","NW_015090842.1:9429794",0,1,1
"ZNF469","s954_F_VTA_03_ASEReadCounter.table","NW_015090842.1:9430560",0,2,2
"ZNF469","s954_F_VTA_03_ASEReadCounter.table","NW_015090842.1:9431031",0,2,2
"ZNF469","s954_F_VTA_03_ASEReadCounter.table","NW_015090842.1:9431073",0,1,1
"ZNF469","s954_F_VTA_03_ASEReadCounter.table","NW_015090842.1:9431091",0,1,1
"ZNF469","s954_F_VTA_03_ASEReadCounter.table","NW_015090842.1:9431150",0,1,1
"ZNF469","s954_F_VTA_03_ASEReadCounter.table","NW_015090842.1:9431700",1,2,1
"ZNF469","s954_F_VTA_03_ASEReadCounter.table","NW_015090842.1:9432302",0,2,2
"ZNF469","s954_F_VTA_03_ASEReadCounter.table","NW_015090842.1:9432361",0,2,2
"ZNF469","s954_F_VTA_03_ASEReadCounter.table","NW_015090842.1:9432374",0,2,2
"ZNF469","s954_F_VTA_03_ASEReadCounter.table","NW_015090842.1:9432382",0,2,2
"ZNF469","s954_F_VTA_03_ASEReadCounter.table","NW_015090842.1:9432481",0,1,1
"ZNF469","s954_F_VTA_03_ASEReadCounter.table","NW_015090842.1:9432498",0,1,1
"ZNF469","s954_F_VTA_03_ASEReadCounter.table","NW_015090842.1:9433268",0,2,2
"ZNF469","s954_F_VTA_03_ASEReadCounter.table","NW_015090842.1:9433678",0,2,2
"ZNF469","s954_F_VTA_03_ASEReadCounter.table","NW_015090842.1:9433902",0,3,3
"ZNF469","s954_F_VTA_03_ASEReadCounter.table","NW_015090842.1:9433980",1,2,1
"ZNF469","s954_F_VTA_03_ASEReadCounter.table","NW_015090842.1:9434259",0,2,2
"ZNF469","s954_F_VTA_03_ASEReadCounter.table","NW_015090842.1:9435221",1,8,7
"ZFPM1","s954_F_VTA_03_ASEReadCounter.table","NW_015090842.1:9458862",2,3,1
"ZFPM1","s954_F_VTA_03_ASEReadCounter.table","NW_015090842.1:9458888",3,7,4
"ZFPM1","s954_F_VTA_03_ASEReadCounter.table","NW_015090842.1:9458904",4,8,4
"ZFPM1","s954_F_VTA_03_ASEReadCounter.table","NW_015090842.1:9458916",3,7,4
"ZFPM1","s954_F_VTA_03_ASEReadCounter.table","NW_015090842.1:9468568",5,9,4
"ZFPM1","s954_F_VTA_03_ASEReadCounter.table","NW_015090842.1:9468593",5,9,4
"ZFPM1","s954_F_VTA_03_ASEReadCounter.table","NW_015090842.1:9471561",5,7,2
"ZFPM1","s954_F_VTA_03_ASEReadCounter.table","NW_015090842.1:9472557",6,13,7
"ZFPM1","s954_F_VTA_03_ASEReadCounter.table","NW_015090842.1:9472565",6,12,6
"ZFPM1","s954_F_VTA_03_ASEReadCounter.table","NW_015090842.1:9472608",5,13,8
"ZFPM1","s954_F_VTA_03_ASEReadCounter.table","NW_015090842.1:9472627",6,13,7
"ZFPM1","s954_F_VTA_03_ASEReadCounter.table","NW_015090842.1:9472668",8,17,9
"ZFPM1","s954_F_VTA_03_ASEReadCounter.table","NW_015090842.1:9473655",5,9,4
"ZFPM1","s954_F_VTA_03_ASEReadCounter.table","NW_015090842.1:9475827",7,17,10
"ZFPM1","s954_F_VTA_03_ASEReadCounter.table","NW_015090842.1:9475842",7,15,8
"ZFPM1","s954_F_VTA_03_ASEReadCounter.table","NW_015090842.1:9476119",6,14,8
"ZFPM1","s954_F_VTA_03_ASEReadCounter.table","NW_015090842.1:9476161",7,13,6
"ZFPM1","s954_F_VTA_03_ASEReadCounter.table","NW_015090842.1:9476219",6,10,4
"ZFPM1","s954_F_VTA_03_ASEReadCounter.table","NW_015090842.1:9476233",6,11,5
"ZFPM1","s954_F_VTA_03_ASEReadCounter.table","NW_015090842.1:9476305",7,19,12
"ZFPM1","s954_F_VTA_03_ASEReadCounter.table","NW_015090842.1:9476395",11,18,7
"ZFPM1","s954_F_VTA_03_ASEReadCounter.table","NW_015090842.1:9476421",12,23,11
"ZFPM1","s954_F_VTA_03_ASEReadCounter.table","NW_015090842.1:9476539",9,19,10
"ZFPM1","s954_F_VTA_03_ASEReadCounter.table","NW_015090842.1:9476576",7,14,7
"ZFPM1","s954_F_VTA_03_ASEReadCounter.table","NW_015090842.1:9476599",22,22,0
"ZFPM1","s954_F_VTA_03_ASEReadCounter.table","NW_015090842.1:9476792",15,27,12
"ZFPM1","s954_F_VTA_03_ASEReadCounter.table","NW_015090842.1:9476803",16,29,13
"ZFPM1","s954_F_VTA_03_ASEReadCounter.table","NW_015090842.1:9477115",5,16,11
"ZFPM1","s954_F_VTA_03_ASEReadCounter.table","NW_015090842.1:9477299",3,16,13
"ZFPM1","s954_F_VTA_03_ASEReadCounter.table","NW_015090842.1:9477398",21,21,0
"ZFPM1","s954_F_VTA_03_ASEReadCounter.table","NW_015090842.1:9477422",9,17,8
"ZFPM1","s954_F_VTA_03_ASEReadCounter.table","NW_015090842.1:9477554",9,19,10
"ZFPM1","s954_F_VTA_03_ASEReadCounter.table","NW_015090842.1:9477575",21,21,0
"ZFPM1","s954_F_VTA_03_ASEReadCounter.table","NW_015090842.1:9477595",11,22,11
"ZFPM1","s954_F_VTA_03_ASEReadCounter.table","NW_015090842.1:9477611",10,23,13
"ZFPM1","s954_F_VTA_03_ASEReadCounter.table","NW_015090842.1:9477659",10,19,9
"ZFPM1","s954_F_VTA_03_ASEReadCounter.table","NW_015090842.1:9477737",8,16,8
"ZFPM1","s954_F_VTA_03_ASEReadCounter.table","NW_015090842.1:9477791",12,17,5
"ZFPM1","s954_F_VTA_03_ASEReadCounter.table","NW_015090842.1:9477844",12,17,5
"ZFPM1","s954_F_VTA_03_ASEReadCounter.table","NW_015090842.1:9477917",19,28,9
"ZFPM1","s954_F_VTA_03_ASEReadCounter.table","NW_015090842.1:9478295",21,42,21
"ZFPM1","s954_F_VTA_03_ASEReadCounter.table","NW_015090842.1:9478349",22,54,32
"ZFPM1","s954_F_VTA_03_ASEReadCounter.table","NW_015090842.1:9478524",16,40,24
"ZFPM1","s954_F_VTA_03_ASEReadCounter.table","NW_015090842.1:9478546",16,46,30
"ZFPM1","s954_F_VTA_03_ASEReadCounter.table","NW_015090842.1:9478573",13,39,26
"ZFPM1","s954_F_VTA_03_ASEReadCounter.table","NW_015090842.1:9478582",8,31,23
"ZFPM1","s954_F_VTA_03_ASEReadCounter.table","NW_015090842.1:9478684",7,16,9
"ZFPM1","s954_F_VTA_03_ASEReadCounter.table","NW_015090842.1:9478711",6,13,7
"ZFPM1","s954_F_VTA_03_ASEReadCounter.table","NW_015090842.1:9478761",8,18,10
"ZFPM1","s954_F_VTA_03_ASEReadCounter.table","NW_015090842.1:9478829",7,7,0
"ZC3H18","s954_F_VTA_03_ASEReadCounter.table","NW_015090842.1:9494271",6,10,4
"ZC3H18","s954_F_VTA_03_ASEReadCounter.table","NW_015090842.1:9501427",12,27,15
"ZC3H18","s954_F_VTA_03_ASEReadCounter.table","NW_015090842.1:9501442",10,27,17
"ZC3H18","s954_F_VTA_03_ASEReadCounter.table","NW_015090842.1:9505538",14,34,20
"ZC3H18","s954_F_VTA_03_ASEReadCounter.table","NW_015090842.1:9506778",23,42,19
"ZC3H18","s954_F_VTA_03_ASEReadCounter.table","NW_015090842.1:9522538",20,44,24
"ZC3H18","s954_F_VTA_03_ASEReadCounter.table","NW_015090842.1:9524350",25,53,28
"ZC3H18","s954_F_VTA_03_ASEReadCounter.table","NW_015090842.1:9524366",24,58,34
"ZC3H18","s954_F_VTA_03_ASEReadCounter.table","NW_015090842.1:9524424",15,45,30
"ZC3H18","s954_F_VTA_03_ASEReadCounter.table","NW_015090842.1:9529649",23,57,34
"ZC3H18","s954_F_VTA_03_ASEReadCounter.table","NW_015090842.1:9529688",19,46,27
"ZC3H18","s954_F_VTA_03_ASEReadCounter.table","NW_015090842.1:9529691",20,46,26
"ZC3H18","s954_F_VTA_03_ASEReadCounter.table","NW_015090842.1:9530977",41,70,29
"ZC3H18","s954_F_VTA_03_ASEReadCounter.table","NW_015090842.1:9536699",0,45,45
"CYBA","s954_F_VTA_03_ASEReadCounter.table","NW_015090842.1:9547281",14,25,11
"CYBA","s954_F_VTA_03_ASEReadCounter.table","NW_015090842.1:9547402",65,87,22
"CYBA","s954_F_VTA_03_ASEReadCounter.table","NW_015090842.1:9547553",40,70,30
"CYBA","s954_F_VTA_03_ASEReadCounter.table","NW_015090842.1:9548052",42,55,13
"CYBA","s954_F_VTA_03_ASEReadCounter.table","NW_015090842.1:9548436",41,50,9
"CYBA","s954_F_VTA_03_ASEReadCounter.table","NW_015090842.1:9548442",43,51,8
"CYBA","s954_F_VTA_03_ASEReadCounter.table","NW_015090842.1:9548478",51,63,12
"CYBA","s954_F_VTA_03_ASEReadCounter.table","NW_015090842.1:9548487",46,60,14
"CYBA","s954_F_VTA_03_ASEReadCounter.table","NW_015090842.1:9548490",47,59,12
"CYBA","s954_F_VTA_03_ASEReadCounter.table","NW_015090842.1:9548717",42,54,12
"CYBA","s954_F_VTA_03_ASEReadCounter.table","NW_015090842.1:9548750",40,51,11
"CYBA","s954_F_VTA_03_ASEReadCounter.table","NW_015090842.1:9548766",26,33,7
"MVD","s954_F_VTA_03_ASEReadCounter.table","NW_015090842.1:9550678",26,46,20
"MVD","s954_F_VTA_03_ASEReadCounter.table","NW_015090842.1:9550690",25,48,23
"MVD","s954_F_VTA_03_ASEReadCounter.table","NW_015090842.1:9550691",26,49,23
"MVD","s954_F_VTA_03_ASEReadCounter.table","NW_015090842.1:9550699",29,57,28
"MVD","s954_F_VTA_03_ASEReadCounter.table","NW_015090842.1:9550719",21,50,29
"MVD","s954_F_VTA_03_ASEReadCounter.table","NW_015090842.1:9551596",49,93,44
"MVD","s954_F_VTA_03_ASEReadCounter.table","NW_015090842.1:9551638",50,103,53
"MVD","s954_F_VTA_03_ASEReadCounter.table","NW_015090842.1:9551899",0,5,5
"MVD","s954_F_VTA_03_ASEReadCounter.table","NW_015090842.1:9552193",33,82,49
"MVD","s954_F_VTA_03_ASEReadCounter.table","NW_015090842.1:9552202",34,86,52
"MVD","s954_F_VTA_03_ASEReadCounter.table","NW_015090842.1:9552208",32,81,49
"MVD","s954_F_VTA_03_ASEReadCounter.table","NW_015090842.1:9552625",23,56,33
"MVD","s954_F_VTA_03_ASEReadCounter.table","NW_015090842.1:9552629",56,56,0
"MVD","s954_F_VTA_03_ASEReadCounter.table","NW_015090842.1:9552644",20,56,36
"MVD","s954_F_VTA_03_ASEReadCounter.table","NW_015090842.1:9553093",16,40,24
"MVD","s954_F_VTA_03_ASEReadCounter.table","NW_015090842.1:9553114",18,42,24
"RNF166","s954_F_VTA_03_ASEReadCounter.table","NW_015090842.1:9557900",12,32,20
"RNF166","s954_F_VTA_03_ASEReadCounter.table","NW_015090842.1:9558048",17,42,25
"RNF166","s954_F_VTA_03_ASEReadCounter.table","NW_015090842.1:9558116",18,39,21
"RNF166","s954_F_VTA_03_ASEReadCounter.table","NW_015090842.1:9558308",12,32,20
"RNF166","s954_F_VTA_03_ASEReadCounter.table","NW_015090842.1:9558405",21,40,19
"RNF166","s954_F_VTA_03_ASEReadCounter.table","NW_015090842.1:9558549",21,41,20
"RNF166","s954_F_VTA_03_ASEReadCounter.table","NW_015090842.1:9558556",22,42,20
"RNF166","s954_F_VTA_03_ASEReadCounter.table","NW_015090842.1:9558579",23,45,22
"RNF166","s954_F_VTA_03_ASEReadCounter.table","NW_015090842.1:9558599",26,52,26
"RNF166","s954_F_VTA_03_ASEReadCounter.table","NW_015090842.1:9558688",22,49,27
"RNF166","s954_F_VTA_03_ASEReadCounter.table","NW_015090842.1:9558711",14,41,27
"RNF166","s954_F_VTA_03_ASEReadCounter.table","NW_015090842.1:9558733",13,38,25
"RNF166","s954_F_VTA_03_ASEReadCounter.table","NW_015090842.1:9558847",19,38,19
"RNF166","s954_F_VTA_03_ASEReadCounter.table","NW_015090842.1:9559798",18,36,18
"RNF166","s954_F_VTA_03_ASEReadCounter.table","NW_015090842.1:9560575",30,56,26
"RNF166","s954_F_VTA_03_ASEReadCounter.table","NW_015090842.1:9561055",18,46,28
"RNF166","s954_F_VTA_03_ASEReadCounter.table","NW_015090842.1:9562458",14,30,16
"RNF166","s954_F_VTA_03_ASEReadCounter.table","NW_015090842.1:9562497",10,25,15
"RNF166","s954_F_VTA_03_ASEReadCounter.table","NW_015090842.1:9562539",6,17,11
"RNF166","s954_F_VTA_03_ASEReadCounter.table","NW_015090842.1:9564056",5,15,10
"CTU2","s954_F_VTA_03_ASEReadCounter.table","NW_015090842.1:9565149",15,24,9
"CTU2","s954_F_VTA_03_ASEReadCounter.table","NW_015090842.1:9565193",11,25,14
"CTU2","s954_F_VTA_03_ASEReadCounter.table","NW_015090842.1:9565300",10,25,15
"CTU2","s954_F_VTA_03_ASEReadCounter.table","NW_015090842.1:9565321",11,26,15
"CTU2","s954_F_VTA_03_ASEReadCounter.table","NW_015090842.1:9565721",17,33,16
"CTU2","s954_F_VTA_03_ASEReadCounter.table","NW_015090842.1:9565739",15,31,16
"CTU2","s954_F_VTA_03_ASEReadCounter.table","NW_015090842.1:9565905",19,51,32
"CTU2","s954_F_VTA_03_ASEReadCounter.table","NW_015090842.1:9566013",38,38,0
"CTU2","s954_F_VTA_03_ASEReadCounter.table","NW_015090842.1:9566055",29,55,26
"CTU2","s954_F_VTA_03_ASEReadCounter.table","NW_015090842.1:9566056",29,54,25
"CTU2","s954_F_VTA_03_ASEReadCounter.table","NW_015090842.1:9566151",22,43,21
"CTU2","s954_F_VTA_03_ASEReadCounter.table","NW_015090842.1:9566300",22,43,21
"CTU2","s954_F_VTA_03_ASEReadCounter.table","NW_015090842.1:9566342",18,44,26
"CTU2","s954_F_VTA_03_ASEReadCounter.table","NW_015090842.1:9566548",29,51,22
"CTU2","s954_F_VTA_03_ASEReadCounter.table","NW_015090842.1:9566625",26,51,25
"CTU2","s954_F_VTA_03_ASEReadCounter.table","NW_015090842.1:9566633",26,52,26
"CTU2","s954_F_VTA_03_ASEReadCounter.table","NW_015090842.1:9566807",30,56,26
"CTU2","s954_F_VTA_03_ASEReadCounter.table","NW_015090842.1:9567139",30,61,31
"CTU2","s954_F_VTA_03_ASEReadCounter.table","NW_015090842.1:9567156",32,61,29
"CTU2","s954_F_VTA_03_ASEReadCounter.table","NW_015090842.1:9567614",27,59,32
"CTU2","s954_F_VTA_03_ASEReadCounter.table","NW_015090842.1:9567677",22,48,26
"CTU2","s954_F_VTA_03_ASEReadCounter.table","NW_015090842.1:9567747",24,45,21
"CTU2","s954_F_VTA_03_ASEReadCounter.table","NW_015090842.1:9567828",20,38,18
"CTU2","s954_F_VTA_03_ASEReadCounter.table","NW_015090842.1:9567829",20,38,18
"CTU2","s954_F_VTA_03_ASEReadCounter.table","NW_015090842.1:9567885",17,28,11
"PIEZO1","s954_F_VTA_03_ASEReadCounter.table","NW_015090842.1:9568093",22,74,52
"PIEZO1","s954_F_VTA_03_ASEReadCounter.table","NW_015090842.1:9568672",28,83,55
"PIEZO1","s954_F_VTA_03_ASEReadCounter.table","NW_015090842.1:9568948",19,60,41
"PIEZO1","s954_F_VTA_03_ASEReadCounter.table","NW_015090842.1:9568987",47,47,0
"PIEZO1","s954_F_VTA_03_ASEReadCounter.table","NW_015090842.1:9569040",19,53,34
"PIEZO1","s954_F_VTA_03_ASEReadCounter.table","NW_015090842.1:9569180",17,50,33
"PIEZO1","s954_F_VTA_03_ASEReadCounter.table","NW_015090842.1:9569192",25,61,36
"PIEZO1","s954_F_VTA_03_ASEReadCounter.table","NW_015090842.1:9570088",24,56,32
"PIEZO1","s954_F_VTA_03_ASEReadCounter.table","NW_015090842.1:9570480",14,41,27
"PIEZO1","s954_F_VTA_03_ASEReadCounter.table","NW_015090842.1:9570639",19,47,28
"PIEZO1","s954_F_VTA_03_ASEReadCounter.table","NW_015090842.1:9571847",15,47,32
"PIEZO1","s954_F_VTA_03_ASEReadCounter.table","NW_015090842.1:9572371",11,30,19
"PIEZO1","s954_F_VTA_03_ASEReadCounter.table","NW_015090842.1:9572638",11,22,11
"PIEZO1","s954_F_VTA_03_ASEReadCounter.table","NW_015090842.1:9573156",17,40,23
"PIEZO1","s954_F_VTA_03_ASEReadCounter.table","NW_015090842.1:9573280",23,52,29
"PIEZO1","s954_F_VTA_03_ASEReadCounter.table","NW_015090842.1:9573566",14,28,14
"PIEZO1","s954_F_VTA_03_ASEReadCounter.table","NW_015090842.1:9575341",6,22,16
"PIEZO1","s954_F_VTA_03_ASEReadCounter.table","NW_015090842.1:9575367",3,14,11
"PIEZO1","s954_F_VTA_03_ASEReadCounter.table","NW_015090842.1:9575645",8,25,17
"PIEZO1","s954_F_VTA_03_ASEReadCounter.table","NW_015090842.1:9575696",9,24,15
"PIEZO1","s954_F_VTA_03_ASEReadCounter.table","NW_015090842.1:9575897",8,18,10
"PIEZO1","s954_F_VTA_03_ASEReadCounter.table","NW_015090842.1:9576060",7,17,10
"PIEZO1","s954_F_VTA_03_ASEReadCounter.table","NW_015090842.1:9576087",6,16,10
"PIEZO1","s954_F_VTA_03_ASEReadCounter.table","NW_015090842.1:9576093",8,19,11
"PIEZO1","s954_F_VTA_03_ASEReadCounter.table","NW_015090842.1:9576120",9,23,14
"PIEZO1","s954_F_VTA_03_ASEReadCounter.table","NW_015090842.1:9576687",11,23,12
"PIEZO1","s954_F_VTA_03_ASEReadCounter.table","NW_015090842.1:9576710",26,26,0
"PIEZO1","s954_F_VTA_03_ASEReadCounter.table","NW_015090842.1:9576723",9,25,16
"PIEZO1","s954_F_VTA_03_ASEReadCounter.table","NW_015090842.1:9578268",9,24,15
"PIEZO1","s954_F_VTA_03_ASEReadCounter.table","NW_015090842.1:9578770",9,19,10
"PIEZO1","s954_F_VTA_03_ASEReadCounter.table","NW_015090842.1:9578806",7,19,12
"PIEZO1","s954_F_VTA_03_ASEReadCounter.table","NW_015090842.1:9579064",8,14,6
"PIEZO1","s954_F_VTA_03_ASEReadCounter.table","NW_015090842.1:9579065",8,14,6
"PIEZO1","s954_F_VTA_03_ASEReadCounter.table","NW_015090842.1:9579347",7,15,8
"PIEZO1","s954_F_VTA_03_ASEReadCounter.table","NW_015090842.1:9580765",5,18,13
"PIEZO1","s954_F_VTA_03_ASEReadCounter.table","NW_015090842.1:9580996",5,10,5
"PIEZO1","s954_F_VTA_03_ASEReadCounter.table","NW_015090842.1:9581101",7,15,8
"PIEZO1","s954_F_VTA_03_ASEReadCounter.table","NW_015090842.1:9581299",7,13,6
"PIEZO1","s954_F_VTA_03_ASEReadCounter.table","NW_015090842.1:9581875",2,10,8
"PIEZO1","s954_F_VTA_03_ASEReadCounter.table","NW_015090842.1:9582046",2,13,11
"PIEZO1","s954_F_VTA_03_ASEReadCounter.table","NW_015090842.1:9582961",9,19,10
"PIEZO1","s954_F_VTA_03_ASEReadCounter.table","NW_015090842.1:9583298",4,13,9
"PIEZO1","s954_F_VTA_03_ASEReadCounter.table","NW_015090842.1:9584337",3,10,7
"PIEZO1","s954_F_VTA_03_ASEReadCounter.table","NW_015090842.1:9584425",1,9,8
"PIEZO1","s954_F_VTA_03_ASEReadCounter.table","NW_015090842.1:9584435",1,8,7
"PIEZO1","s954_F_VTA_03_ASEReadCounter.table","NW_015090842.1:9584438",1,7,6
"PIEZO1","s954_F_VTA_03_ASEReadCounter.table","NW_015090842.1:9584441",1,6,5
"CDT1","s954_F_VTA_03_ASEReadCounter.table","NW_015090842.1:9596596",1,2,1
"CDT1","s954_F_VTA_03_ASEReadCounter.table","NW_015090842.1:9596766",4,5,1
"CDT1","s954_F_VTA_03_ASEReadCounter.table","NW_015090842.1:9597054",5,8,3
"CDT1","s954_F_VTA_03_ASEReadCounter.table","NW_015090842.1:9597074",3,6,3
"CDT1","s954_F_VTA_03_ASEReadCounter.table","NW_015090842.1:9597137",2,4,2
"CDT1","s954_F_VTA_03_ASEReadCounter.table","NW_015090842.1:9597756",3,3,0
"CDT1","s954_F_VTA_03_ASEReadCounter.table","NW_015090842.1:9597766",4,4,0
"CDT1","s954_F_VTA_03_ASEReadCounter.table","NW_015090842.1:9598496",13,23,10
"CDT1","s954_F_VTA_03_ASEReadCounter.table","NW_015090842.1:9598498",13,23,10
"CDT1","s954_F_VTA_03_ASEReadCounter.table","NW_015090842.1:9598816",8,18,10
"CDT1","s954_F_VTA_03_ASEReadCounter.table","NW_015090842.1:9598879",10,16,6
"CDT1","s954_F_VTA_03_ASEReadCounter.table","NW_015090842.1:9598912",10,16,6
"CDT1","s954_F_VTA_03_ASEReadCounter.table","NW_015090842.1:9598959",9,15,6
"CDT1","s954_F_VTA_03_ASEReadCounter.table","NW_015090842.1:9599807",11,16,5
"CDT1","s954_F_VTA_03_ASEReadCounter.table","NW_015090842.1:9599819",12,17,5
"CDT1","s954_F_VTA_03_ASEReadCounter.table","NW_015090842.1:9599845",10,15,5
"CDT1","s954_F_VTA_03_ASEReadCounter.table","NW_015090842.1:9600148",11,20,9
"CDT1","s954_F_VTA_03_ASEReadCounter.table","NW_015090842.1:9600151",14,23,9
"CDT1","s954_F_VTA_03_ASEReadCounter.table","NW_015090842.1:9600217",14,25,11
"CDT1","s954_F_VTA_03_ASEReadCounter.table","NW_015090842.1:9600226",14,22,8
"CDT1","s954_F_VTA_03_ASEReadCounter.table","NW_015090842.1:9600260",11,21,10
"CDT1","s954_F_VTA_03_ASEReadCounter.table","NW_015090842.1:9600268",10,18,8
"CDT1","s954_F_VTA_03_ASEReadCounter.table","NW_015090842.1:9600305",12,23,11
"CDT1","s954_F_VTA_03_ASEReadCounter.table","NW_015090842.1:9600397",17,23,6
"CDT1","s954_F_VTA_03_ASEReadCounter.table","NW_015090842.1:9600447",9,16,7
"CDT1","s954_F_VTA_03_ASEReadCounter.table","NW_015090842.1:9600450",8,14,6
"CDT1","s954_F_VTA_03_ASEReadCounter.table","NW_015090842.1:9600485",10,18,8
"CDT1","s954_F_VTA_03_ASEReadCounter.table","NW_015090842.1:9600579",8,11,3
"APRT","s954_F_VTA_03_ASEReadCounter.table","NW_015090842.1:9602308",21,52,31
"APRT","s954_F_VTA_03_ASEReadCounter.table","NW_015090842.1:9602440",44,122,78
"APRT","s954_F_VTA_03_ASEReadCounter.table","NW_015090842.1:9602449",42,121,79
"APRT","s954_F_VTA_03_ASEReadCounter.table","NW_015090842.1:9602451",42,125,83
"APRT","s954_F_VTA_03_ASEReadCounter.table","NW_015090842.1:9602455",46,133,87
"APRT","s954_F_VTA_03_ASEReadCounter.table","NW_015090842.1:9602462",45,128,83
"APRT","s954_F_VTA_03_ASEReadCounter.table","NW_015090842.1:9602507",38,120,82
"APRT","s954_F_VTA_03_ASEReadCounter.table","NW_015090842.1:9602514",37,117,80
"APRT","s954_F_VTA_03_ASEReadCounter.table","NW_015090842.1:9602530",35,97,62
"APRT","s954_F_VTA_03_ASEReadCounter.table","NW_015090842.1:9602582",28,86,58
"APRT","s954_F_VTA_03_ASEReadCounter.table","NW_015090842.1:9602583",28,84,56
"APRT","s954_F_VTA_03_ASEReadCounter.table","NW_015090842.1:9602650",44,107,63
"APRT","s954_F_VTA_03_ASEReadCounter.table","NW_015090842.1:9602655",44,106,62
"APRT","s954_F_VTA_03_ASEReadCounter.table","NW_015090842.1:9602712",36,107,71
"APRT","s954_F_VTA_03_ASEReadCounter.table","NW_015090842.1:9602764",46,120,74
"APRT","s954_F_VTA_03_ASEReadCounter.table","NW_015090842.1:9602821",35,95,60
"APRT","s954_F_VTA_03_ASEReadCounter.table","NW_015090842.1:9602867",39,86,47
"APRT","s954_F_VTA_03_ASEReadCounter.table","NW_015090842.1:9602883",43,97,54
"APRT","s954_F_VTA_03_ASEReadCounter.table","NW_015090842.1:9602886",48,103,55
"APRT","s954_F_VTA_03_ASEReadCounter.table","NW_015090842.1:9602948",61,135,74
"APRT","s954_F_VTA_03_ASEReadCounter.table","NW_015090842.1:9602958",57,137,80
"APRT","s954_F_VTA_03_ASEReadCounter.table","NW_015090842.1:9603020",62,148,86
"APRT","s954_F_VTA_03_ASEReadCounter.table","NW_015090842.1:9603025",61,149,88
"APRT","s954_F_VTA_03_ASEReadCounter.table","NW_015090842.1:9603154",39,99,60
"APRT","s954_F_VTA_03_ASEReadCounter.table","NW_015090842.1:9603166",38,110,72
"APRT","s954_F_VTA_03_ASEReadCounter.table","NW_015090842.1:9603326",38,124,86
"APRT","s954_F_VTA_03_ASEReadCounter.table","NW_015090842.1:9603419",36,87,51
"APRT","s954_F_VTA_03_ASEReadCounter.table","NW_015090842.1:9603420",36,87,51
"APRT","s954_F_VTA_03_ASEReadCounter.table","NW_015090842.1:9603464",33,72,39
"APRT","s954_F_VTA_03_ASEReadCounter.table","NW_015090842.1:9603528",36,90,54
"APRT","s954_F_VTA_03_ASEReadCounter.table","NW_015090842.1:9603607",31,84,53
"APRT","s954_F_VTA_03_ASEReadCounter.table","NW_015090842.1:9603622",35,81,46
"APRT","s954_F_VTA_03_ASEReadCounter.table","NW_015090842.1:9604361",21,79,58
"APRT","s954_F_VTA_03_ASEReadCounter.table","NW_015090842.1:9605317",24,51,27
"APRT","s954_F_VTA_03_ASEReadCounter.table","NW_015090842.1:9605336",29,63,34
"GALNS","s954_F_VTA_03_ASEReadCounter.table","NW_015090842.1:9612872",4,4,0
"GALNS","s954_F_VTA_03_ASEReadCounter.table","NW_015090842.1:9612873",4,4,0
"GALNS","s954_F_VTA_03_ASEReadCounter.table","NW_015090842.1:9612877",4,5,1
"GALNS","s954_F_VTA_03_ASEReadCounter.table","NW_015090842.1:9612942",9,19,10
"GALNS","s954_F_VTA_03_ASEReadCounter.table","NW_015090842.1:9612987",26,26,0
"GALNS","s954_F_VTA_03_ASEReadCounter.table","NW_015090842.1:9613064",16,27,11
"GALNS","s954_F_VTA_03_ASEReadCounter.table","NW_015090842.1:9613096",31,46,15
"GALNS","s954_F_VTA_03_ASEReadCounter.table","NW_015090842.1:9613123",29,42,13
"GALNS","s954_F_VTA_03_ASEReadCounter.table","NW_015090842.1:9613125",29,42,13
"GALNS","s954_F_VTA_03_ASEReadCounter.table","NW_015090842.1:9613193",23,35,12
"GALNS","s954_F_VTA_03_ASEReadCounter.table","NW_015090842.1:9613226",21,32,11
"GALNS","s954_F_VTA_03_ASEReadCounter.table","NW_015090842.1:9613249",19,34,15
"GALNS","s954_F_VTA_03_ASEReadCounter.table","NW_015090842.1:9613256",22,38,16
"GALNS","s954_F_VTA_03_ASEReadCounter.table","NW_015090842.1:9613317",23,39,16
"GALNS","s954_F_VTA_03_ASEReadCounter.table","NW_015090842.1:9613343",21,32,11
"GALNS","s954_F_VTA_03_ASEReadCounter.table","NW_015090842.1:9613344",22,33,11
"GALNS","s954_F_VTA_03_ASEReadCounter.table","NW_015090842.1:9613371",19,33,14
"GALNS","s954_F_VTA_03_ASEReadCounter.table","NW_015090842.1:9613378",19,32,13
"GALNS","s954_F_VTA_03_ASEReadCounter.table","NW_015090842.1:9613379",20,33,13
"GALNS","s954_F_VTA_03_ASEReadCounter.table","NW_015090842.1:9613516",25,46,21
"GALNS","s954_F_VTA_03_ASEReadCounter.table","NW_015090842.1:9613572",22,43,21
"GALNS","s954_F_VTA_03_ASEReadCounter.table","NW_015090842.1:9613597",18,37,19
"GALNS","s954_F_VTA_03_ASEReadCounter.table","NW_015090842.1:9613627",16,29,13
"GALNS","s954_F_VTA_03_ASEReadCounter.table","NW_015090842.1:9613640",15,33,18
"GALNS","s954_F_VTA_03_ASEReadCounter.table","NW_015090842.1:9614025",20,38,18
"GALNS","s954_F_VTA_03_ASEReadCounter.table","NW_015090842.1:9614169",33,59,26
"GALNS","s954_F_VTA_03_ASEReadCounter.table","NW_015090842.1:9614232",43,43,0
"GALNS","s954_F_VTA_03_ASEReadCounter.table","NW_015090842.1:9614667",16,31,15
"GALNS","s954_F_VTA_03_ASEReadCounter.table","NW_015090842.1:9614709",13,27,14
"GALNS","s954_F_VTA_03_ASEReadCounter.table","NW_015090842.1:9614880",13,32,19
"GALNS","s954_F_VTA_03_ASEReadCounter.table","NW_015090842.1:9614902",13,29,16
"GALNS","s954_F_VTA_03_ASEReadCounter.table","NW_015090842.1:9614960",9,21,12
"GALNS","s954_F_VTA_03_ASEReadCounter.table","NW_015090842.1:9615114",17,36,19
"GALNS","s954_F_VTA_03_ASEReadCounter.table","NW_015090842.1:9615199",18,30,12
"GALNS","s954_F_VTA_03_ASEReadCounter.table","NW_015090842.1:9615217",16,30,14
"GALNS","s954_F_VTA_03_ASEReadCounter.table","NW_015090842.1:9615277",11,19,8
"GALNS","s954_F_VTA_03_ASEReadCounter.table","NW_015090842.1:9615377",17,35,18
"GALNS","s954_F_VTA_03_ASEReadCounter.table","NW_015090842.1:9647858",6,22,16
"GALNS","s954_F_VTA_03_ASEReadCounter.table","NW_015090842.1:9649186",14,22,8
"GALNS","s954_F_VTA_03_ASEReadCounter.table","NW_015090842.1:9649237",13,25,12
"GALNS","s954_F_VTA_03_ASEReadCounter.table","NW_015090842.1:9661193",1,4,3
"TRAPPC2L","s954_F_VTA_03_ASEReadCounter.table","NW_015090842.1:9662951",135,269,134
"TRAPPC2L","s954_F_VTA_03_ASEReadCounter.table","NW_015090842.1:9663014",145,296,151
"TRAPPC2L","s954_F_VTA_03_ASEReadCounter.table","NW_015090842.1:9664305",251,253,2
"TRAPPC2L","s954_F_VTA_03_ASEReadCounter.table","NW_015090842.1:9665155",122,207,85
"TRAPPC2L","s954_F_VTA_03_ASEReadCounter.table","NW_015090842.1:9665211",24,52,28
"PABPN1L","s954_F_VTA_03_ASEReadCounter.table","NW_015090842.1:9669959",0,1,1
"CBFA2T3","s954_F_VTA_03_ASEReadCounter.table","NW_015090842.1:9709469",1,32,31
"CBFA2T3","s954_F_VTA_03_ASEReadCounter.table","NW_015090842.1:9709475",0,31,31
"CBFA2T3","s954_F_VTA_03_ASEReadCounter.table","NW_015090842.1:9711845",0,17,17
"CBFA2T3","s954_F_VTA_03_ASEReadCounter.table","NW_015090842.1:9712157",0,25,25
"CBFA2T3","s954_F_VTA_03_ASEReadCounter.table","NW_015090842.1:9712160",0,25,25
"CBFA2T3","s954_F_VTA_03_ASEReadCounter.table","NW_015090842.1:9712166",0,26,26
"CBFA2T3","s954_F_VTA_03_ASEReadCounter.table","NW_015090842.1:9712536",3,15,12
"CBFA2T3","s954_F_VTA_03_ASEReadCounter.table","NW_015090842.1:9712673",6,21,15
"CBFA2T3","s954_F_VTA_03_ASEReadCounter.table","NW_015090842.1:9712787",8,24,16
"CBFA2T3","s954_F_VTA_03_ASEReadCounter.table","NW_015090842.1:9712791",10,24,14
"CBFA2T3","s954_F_VTA_03_ASEReadCounter.table","NW_015090842.1:9712805",8,20,12
"CBFA2T3","s954_F_VTA_03_ASEReadCounter.table","NW_015090842.1:9712811",9,22,13
"CBFA2T3","s954_F_VTA_03_ASEReadCounter.table","NW_015090842.1:9712848",18,35,17
"CBFA2T3","s954_F_VTA_03_ASEReadCounter.table","NW_015090842.1:9713088",9,27,18
"CBFA2T3","s954_F_VTA_03_ASEReadCounter.table","NW_015090842.1:9713121",10,29,19
"CBFA2T3","s954_F_VTA_03_ASEReadCounter.table","NW_015090842.1:9717058",18,37,19
"CBFA2T3","s954_F_VTA_03_ASEReadCounter.table","NW_015090842.1:9717093",20,36,16
"CBFA2T3","s954_F_VTA_03_ASEReadCounter.table","NW_015090842.1:9717114",19,33,14
"CBFA2T3","s954_F_VTA_03_ASEReadCounter.table","NW_015090842.1:9717139",16,26,10
"CBFA2T3","s954_F_VTA_03_ASEReadCounter.table","NW_015090842.1:9719788",9,15,6
"CBFA2T3","s954_F_VTA_03_ASEReadCounter.table","NW_015090842.1:9728475",1,5,4
"CBFA2T3","s954_F_VTA_03_ASEReadCounter.table","NW_015090842.1:9728522",2,5,3
"CBFA2T3","s954_F_VTA_03_ASEReadCounter.table","NW_015090842.1:9728525",2,4,2
"CBFA2T3","s954_F_VTA_03_ASEReadCounter.table","NW_015090842.1:9728588",0,3,3
"CBFA2T3","s954_F_VTA_03_ASEReadCounter.table","NW_015090842.1:9728601",0,2,2
"CBFA2T3","s954_F_VTA_03_ASEReadCounter.table","NW_015090842.1:9728611",0,3,3
"CBFA2T3","s954_F_VTA_03_ASEReadCounter.table","NW_015090842.1:9728654",3,7,4
"ACSF3","s954_F_VTA_03_ASEReadCounter.table","NW_015090842.1:9773379",0,1,1
"ACSF3","s954_F_VTA_03_ASEReadCounter.table","NW_015090842.1:9773382",0,1,1
"ACSF3","s954_F_VTA_03_ASEReadCounter.table","NW_015090842.1:9773384",0,1,1
"ACSF3","s954_F_VTA_03_ASEReadCounter.table","NW_015090842.1:9773388",0,4,4
"ACSF3","s954_F_VTA_03_ASEReadCounter.table","NW_015090842.1:9776753",11,16,5
"ACSF3","s954_F_VTA_03_ASEReadCounter.table","NW_015090842.1:9776783",9,15,6
"ACSF3","s954_F_VTA_03_ASEReadCounter.table","NW_015090842.1:9776879",5,11,6
"ACSF3","s954_F_VTA_03_ASEReadCounter.table","NW_015090842.1:9776965",9,12,3
"ACSF3","s954_F_VTA_03_ASEReadCounter.table","NW_015090842.1:9777091",15,23,8
"ACSF3","s954_F_VTA_03_ASEReadCounter.table","NW_015090842.1:9777206",13,17,4
"ACSF3","s954_F_VTA_03_ASEReadCounter.table","NW_015090842.1:9777283",14,29,15
"ACSF3","s954_F_VTA_03_ASEReadCounter.table","NW_015090842.1:9778955",22,54,32
"ACSF3","s954_F_VTA_03_ASEReadCounter.table","NW_015090842.1:9778997",27,59,32
"ACSF3","s954_F_VTA_03_ASEReadCounter.table","NW_015090842.1:9789311",25,46,21
"ACSF3","s954_F_VTA_03_ASEReadCounter.table","NW_015090842.1:9789906",3,28,25
"ACSF3","s954_F_VTA_03_ASEReadCounter.table","NW_015090842.1:9834743",33,78,45
"ACSF3","s954_F_VTA_03_ASEReadCounter.table","NW_015090842.1:9834852",51,87,36
"ACSF3","s954_F_VTA_03_ASEReadCounter.table","NW_015090842.1:9834861",48,79,31
"ACSF3","s954_F_VTA_03_ASEReadCounter.table","NW_015090842.1:9839359",29,66,37
"ACSF3","s954_F_VTA_03_ASEReadCounter.table","NW_015090842.1:9839378",30,62,32
"ACSF3","s954_F_VTA_03_ASEReadCounter.table","NW_015090842.1:9839455",25,52,27
"ACSF3","s954_F_VTA_03_ASEReadCounter.table","NW_015090842.1:9839457",26,52,26
"ACSF3","s954_F_VTA_03_ASEReadCounter.table","NW_015090842.1:9839489",18,41,23
"ACSF3","s954_F_VTA_03_ASEReadCounter.table","NW_015090842.1:9839500",16,37,21
"ACSF3","s954_F_VTA_03_ASEReadCounter.table","NW_015090842.1:9839501",16,36,20
"ACSF3","s954_F_VTA_03_ASEReadCounter.table","NW_015090842.1:9839504",18,38,20
"ACSF3","s954_F_VTA_03_ASEReadCounter.table","NW_015090842.1:9839512",11,29,18
"ACSF3","s954_F_VTA_03_ASEReadCounter.table","NW_015090842.1:9839527",10,26,16
"ACSF3","s954_F_VTA_03_ASEReadCounter.table","NW_015090842.1:9839533",6,20,14
"ACSF3","s954_F_VTA_03_ASEReadCounter.table","NW_015090842.1:9839535",7,19,12
"ACSF3","s954_F_VTA_03_ASEReadCounter.table","NW_015090842.1:9839545",7,19,12
"ACSF3","s954_F_VTA_03_ASEReadCounter.table","NW_015090842.1:9839550",3,15,12
"ACSF3","s954_F_VTA_03_ASEReadCounter.table","NW_015090842.1:9839551",5,17,12
"CDH15","s954_F_VTA_03_ASEReadCounter.table","NW_015090842.1:9848004",0,1,1
"CDH15","s954_F_VTA_03_ASEReadCounter.table","NW_015090842.1:9848220",3,5,2
"CDH15","s954_F_VTA_03_ASEReadCounter.table","NW_015090842.1:9848265",2,5,3
"CDH15","s954_F_VTA_03_ASEReadCounter.table","NW_015090842.1:9848307",3,5,2
"CDH15","s954_F_VTA_03_ASEReadCounter.table","NW_015090842.1:9848310",3,5,2
"CDH15","s954_F_VTA_03_ASEReadCounter.table","NW_015090842.1:9848313",3,5,2
"CDH15","s954_F_VTA_03_ASEReadCounter.table","NW_015090842.1:9848531",1,4,3
"CDH15","s954_F_VTA_03_ASEReadCounter.table","NW_015090842.1:9848552",1,3,2
"CDH15","s954_F_VTA_03_ASEReadCounter.table","NW_015090842.1:9848888",2,4,2
"CDH15","s954_F_VTA_03_ASEReadCounter.table","NW_015090842.1:9848936",2,4,2
"CDH15","s954_F_VTA_03_ASEReadCounter.table","NW_015090842.1:9849473",0,2,2
"CDH15","s954_F_VTA_03_ASEReadCounter.table","NW_015090842.1:9850141",0,1,1
"CDH15","s954_F_VTA_03_ASEReadCounter.table","NW_015090842.1:9850386",0,1,1
"CDH15","s954_F_VTA_03_ASEReadCounter.table","NW_015090842.1:9850609",0,1,1
"SLC22A31","s954_F_VTA_03_ASEReadCounter.table","NW_015090842.1:9850797",0,1,1
"SLC22A31","s954_F_VTA_03_ASEReadCounter.table","NW_015090842.1:9850818",0,1,1
"SLC22A31","s954_F_VTA_03_ASEReadCounter.table","NW_015090842.1:9851117",1,4,3
"SLC22A31","s954_F_VTA_03_ASEReadCounter.table","NW_015090842.1:9851130",1,4,3
"SLC22A31","s954_F_VTA_03_ASEReadCounter.table","NW_015090842.1:9851139",1,4,3
"SLC22A31","s954_F_VTA_03_ASEReadCounter.table","NW_015090842.1:9851265",5,13,8
"SLC22A31","s954_F_VTA_03_ASEReadCounter.table","NW_015090842.1:9851302",7,17,10
"SLC22A31","s954_F_VTA_03_ASEReadCounter.table","NW_015090842.1:9851303",7,16,9
"SLC22A31","s954_F_VTA_03_ASEReadCounter.table","NW_015090842.1:9851305",6,15,9
"SLC22A31","s954_F_VTA_03_ASEReadCounter.table","NW_015090842.1:9851343",5,11,6
"SLC22A31","s954_F_VTA_03_ASEReadCounter.table","NW_015090842.1:9851344",6,12,6
"SLC22A31","s954_F_VTA_03_ASEReadCounter.table","NW_015090842.1:9851361",8,8,0
"SLC22A31","s954_F_VTA_03_ASEReadCounter.table","NW_015090842.1:9851381",4,12,8
"SLC22A31","s954_F_VTA_03_ASEReadCounter.table","NW_015090842.1:9851421",6,14,8
"SLC22A31","s954_F_VTA_03_ASEReadCounter.table","NW_015090842.1:9851501",3,16,13
"SLC22A31","s954_F_VTA_03_ASEReadCounter.table","NW_015090842.1:9851526",1,14,13
"SLC22A31","s954_F_VTA_03_ASEReadCounter.table","NW_015090842.1:9851589",8,17,9
"SLC22A31","s954_F_VTA_03_ASEReadCounter.table","NW_015090842.1:9851712",6,15,9
"SLC22A31","s954_F_VTA_03_ASEReadCounter.table","NW_015090842.1:9851899",6,13,7
"SLC22A31","s954_F_VTA_03_ASEReadCounter.table","NW_015090842.1:9852139",12,22,10
"SLC22A31","s954_F_VTA_03_ASEReadCounter.table","NW_015090842.1:9852380",5,12,7
"SLC22A31","s954_F_VTA_03_ASEReadCounter.table","NW_015090842.1:9852431",5,8,3
"SLC22A31","s954_F_VTA_03_ASEReadCounter.table","NW_015090842.1:9852630",6,14,8
"SLC22A31","s954_F_VTA_03_ASEReadCounter.table","NW_015090842.1:9852711",3,8,5
"SLC22A31","s954_F_VTA_03_ASEReadCounter.table","NW_015090842.1:9853099",7,11,4
"SLC22A31","s954_F_VTA_03_ASEReadCounter.table","NW_015090842.1:9853102",8,12,4
"SLC22A31","s954_F_VTA_03_ASEReadCounter.table","NW_015090842.1:9853421",5,5,0
"SLC22A31","s954_F_VTA_03_ASEReadCounter.table","NW_015090842.1:9853457",6,6,0
"SLC22A31","s954_F_VTA_03_ASEReadCounter.table","NW_015090842.1:9853502",2,2,0
"ANKRD11","s954_F_VTA_03_ASEReadCounter.table","NW_015090842.1:9858863",5,20,15
"ANKRD11","s954_F_VTA_03_ASEReadCounter.table","NW_015090842.1:9859101",100,250,150
"ANKRD11","s954_F_VTA_03_ASEReadCounter.table","NW_015090842.1:9859352",120,290,170
"ANKRD11","s954_F_VTA_03_ASEReadCounter.table","NW_015090842.1:9859381",64,193,129
"ANKRD11","s954_F_VTA_03_ASEReadCounter.table","NW_015090842.1:9859679",117,236,119
"ANKRD11","s954_F_VTA_03_ASEReadCounter.table","NW_015090842.1:9861097",118,234,116
"ANKRD11","s954_F_VTA_03_ASEReadCounter.table","NW_015090842.1:9862571",55,111,56
"ANKRD11","s954_F_VTA_03_ASEReadCounter.table","NW_015090842.1:9862652",56,98,42
"ANKRD11","s954_F_VTA_03_ASEReadCounter.table","NW_015090842.1:9866071",0,83,83
"ANKRD11","s954_F_VTA_03_ASEReadCounter.table","NW_015090842.1:9866200",0,53,53
"ANKRD11","s954_F_VTA_03_ASEReadCounter.table","NW_015090842.1:9867391",23,48,25
"ANKRD11","s954_F_VTA_03_ASEReadCounter.table","NW_015090842.1:9867472",36,73,37
"ANKRD11","s954_F_VTA_03_ASEReadCounter.table","NW_015090842.1:9867559",38,86,48
"ANKRD11","s954_F_VTA_03_ASEReadCounter.table","NW_015090842.1:9867667",41,101,60
"ANKRD11","s954_F_VTA_03_ASEReadCounter.table","NW_015090842.1:9867934",50,85,35
"ANKRD11","s954_F_VTA_03_ASEReadCounter.table","NW_015090842.1:9868064",42,84,42
"ANKRD11","s954_F_VTA_03_ASEReadCounter.table","NW_015090842.1:9868093",36,76,40
"ANKRD11","s954_F_VTA_03_ASEReadCounter.table","NW_015090842.1:9868222",46,93,47
"ANKRD11","s954_F_VTA_03_ASEReadCounter.table","NW_015090842.1:9868327",41,95,54
"ANKRD11","s954_F_VTA_03_ASEReadCounter.table","NW_015090842.1:9868414",55,111,56
"ANKRD11","s954_F_VTA_03_ASEReadCounter.table","NW_015090842.1:9868441",49,109,60
"ANKRD11","s954_F_VTA_03_ASEReadCounter.table","NW_015090842.1:9868444",50,118,68
"ANKRD11","s954_F_VTA_03_ASEReadCounter.table","NW_015090842.1:9868519",64,143,79
"ANKRD11","s954_F_VTA_03_ASEReadCounter.table","NW_015090842.1:9868609",65,156,91
"ANKRD11","s954_F_VTA_03_ASEReadCounter.table","NW_015090842.1:9868666",81,173,92
"ANKRD11","s954_F_VTA_03_ASEReadCounter.table","NW_015090842.1:9868738",188,188,0
"ANKRD11","s954_F_VTA_03_ASEReadCounter.table","NW_015090842.1:9869431",121,256,135
"ANKRD11","s954_F_VTA_03_ASEReadCounter.table","NW_015090842.1:9869578",172,358,186
"ANKRD11","s954_F_VTA_03_ASEReadCounter.table","NW_015090842.1:9869734",201,397,196
"ANKRD11","s954_F_VTA_03_ASEReadCounter.table","NW_015090842.1:9870070",145,301,156
"ANKRD11","s954_F_VTA_03_ASEReadCounter.table","NW_015090842.1:9870349",163,329,166
"ANKRD11","s954_F_VTA_03_ASEReadCounter.table","NW_015090842.1:9870604",175,352,177
"ANKRD11","s954_F_VTA_03_ASEReadCounter.table","NW_015090842.1:9870613",184,370,186
"ANKRD11","s954_F_VTA_03_ASEReadCounter.table","NW_015090842.1:9870685",201,443,242
"ANKRD11","s954_F_VTA_03_ASEReadCounter.table","NW_015090842.1:9870760",179,398,219
"ANKRD11","s954_F_VTA_03_ASEReadCounter.table","NW_015090842.1:9870847",169,371,202
"ANKRD11","s954_F_VTA_03_ASEReadCounter.table","NW_015090842.1:9871103",121,266,145
"ANKRD11","s954_F_VTA_03_ASEReadCounter.table","NW_015090842.1:9871165",138,312,174
"ANKRD11","s954_F_VTA_03_ASEReadCounter.table","NW_015090842.1:9871508",213,213,0
"ANKRD11","s954_F_VTA_03_ASEReadCounter.table","NW_015090842.1:9871820",57,121,64
"ANKRD11","s954_F_VTA_03_ASEReadCounter.table","NW_015090842.1:9872118",50,126,76
"ANKRD11","s954_F_VTA_03_ASEReadCounter.table","NW_015090842.1:9877406",22,52,30
"SPG7","s954_F_VTA_03_ASEReadCounter.table","NW_015090842.1:10051190",74,154,80
"SPG7","s954_F_VTA_03_ASEReadCounter.table","NW_015090842.1:10051218",94,187,93
"SPG7","s954_F_VTA_03_ASEReadCounter.table","NW_015090842.1:10052348",121,213,92
"SPG7","s954_F_VTA_03_ASEReadCounter.table","NW_015090842.1:10052366",116,207,91
"SPG7","s954_F_VTA_03_ASEReadCounter.table","NW_015090842.1:10065173",102,239,137
"SPG7","s954_F_VTA_03_ASEReadCounter.table","NW_015090842.1:10065215",97,221,124
"SPG7","s954_F_VTA_03_ASEReadCounter.table","NW_015090842.1:10066365",84,178,94
"SPG7","s954_F_VTA_03_ASEReadCounter.table","NW_015090842.1:10069752",99,215,116
"SPG7","s954_F_VTA_03_ASEReadCounter.table","NW_015090842.1:10069800",121,264,143
"SPG7","s954_F_VTA_03_ASEReadCounter.table","NW_015090842.1:10071192",141,312,171
"SPG7","s954_F_VTA_03_ASEReadCounter.table","NW_015090842.1:10071219",130,278,148
"SPG7","s954_F_VTA_03_ASEReadCounter.table","NW_015090842.1:10071967",129,258,129
"SPG7","s954_F_VTA_03_ASEReadCounter.table","NW_015090842.1:10075109",229,441,212
"SPG7","s954_F_VTA_03_ASEReadCounter.table","NW_015090842.1:10075114",229,437,208
"SPG7","s954_F_VTA_03_ASEReadCounter.table","NW_015090842.1:10075198",207,370,163
"SPG7","s954_F_VTA_03_ASEReadCounter.table","NW_015090842.1:10075487",152,304,152
"SPG7","s954_F_VTA_03_ASEReadCounter.table","NW_015090842.1:10075488",152,301,149
"SPG7","s954_F_VTA_03_ASEReadCounter.table","NW_015090842.1:10075548",112,223,111
"RPL13","s954_F_VTA_03_ASEReadCounter.table","NW_015090842.1:10077387",440,915,475
"RPL13","s954_F_VTA_03_ASEReadCounter.table","NW_015090842.1:10077978",667,1369,702
"RPL13","s954_F_VTA_03_ASEReadCounter.table","NW_015090842.1:10077992",687,1347,660
"CPNE7","s954_F_VTA_03_ASEReadCounter.table","NW_015090842.1:10084001",5,9,4
"CPNE7","s954_F_VTA_03_ASEReadCounter.table","NW_015090842.1:10084856",5,10,5
"CPNE7","s954_F_VTA_03_ASEReadCounter.table","NW_015090842.1:10084872",7,12,5
"CPNE7","s954_F_VTA_03_ASEReadCounter.table","NW_015090842.1:10084892",5,10,5
"CPNE7","s954_F_VTA_03_ASEReadCounter.table","NW_015090842.1:10084921",5,9,4
"CPNE7","s954_F_VTA_03_ASEReadCounter.table","NW_015090842.1:10084935",5,9,4
"CPNE7","s954_F_VTA_03_ASEReadCounter.table","NW_015090842.1:10085000",4,5,1
"CPNE7","s954_F_VTA_03_ASEReadCounter.table","NW_015090842.1:10085089",0,2,2
"CPNE7","s954_F_VTA_03_ASEReadCounter.table","NW_015090842.1:10085096",0,3,3
"CPNE7","s954_F_VTA_03_ASEReadCounter.table","NW_015090842.1:10085126",0,4,4
"CPNE7","s954_F_VTA_03_ASEReadCounter.table","NW_015090842.1:10085167",7,7,0
"CPNE7","s954_F_VTA_03_ASEReadCounter.table","NW_015090842.1:10085180",2,9,7
"CPNE7","s954_F_VTA_03_ASEReadCounter.table","NW_015090842.1:10085201",3,12,9
"CPNE7","s954_F_VTA_03_ASEReadCounter.table","NW_015090842.1:10088134",3,5,2
"CPNE7","s954_F_VTA_03_ASEReadCounter.table","NW_015090842.1:10088146",4,7,3
"CPNE7","s954_F_VTA_03_ASEReadCounter.table","NW_015090842.1:10088806",9,14,5
"CPNE7","s954_F_VTA_03_ASEReadCounter.table","NW_015090842.1:10088940",18,25,7
"CPNE7","s954_F_VTA_03_ASEReadCounter.table","NW_015090842.1:10088965",20,28,8
"CPNE7","s954_F_VTA_03_ASEReadCounter.table","NW_015090842.1:10088967",20,28,8
"CPNE7","s954_F_VTA_03_ASEReadCounter.table","NW_015090842.1:10088973",21,30,9
"CPNE7","s954_F_VTA_03_ASEReadCounter.table","NW_015090842.1:10090924",15,27,12
"CPNE7","s954_F_VTA_03_ASEReadCounter.table","NW_015090842.1:10090930",17,29,12
"CPNE7","s954_F_VTA_03_ASEReadCounter.table","NW_015090842.1:10091075",19,32,13
"CPNE7","s954_F_VTA_03_ASEReadCounter.table","NW_015090842.1:10091389",15,30,15
"CPNE7","s954_F_VTA_03_ASEReadCounter.table","NW_015090842.1:10091407",18,36,18
"CPNE7","s954_F_VTA_03_ASEReadCounter.table","NW_015090842.1:10091488",30,30,0
"CPNE7","s954_F_VTA_03_ASEReadCounter.table","NW_015090842.1:10091491",32,32,0
"CPNE7","s954_F_VTA_03_ASEReadCounter.table","NW_015090842.1:10091530",19,35,16
"CPNE7","s954_F_VTA_03_ASEReadCounter.table","NW_015090842.1:10091875",35,48,13
"CPNE7","s954_F_VTA_03_ASEReadCounter.table","NW_015090842.1:10091983",21,31,10
"CPNE7","s954_F_VTA_03_ASEReadCounter.table","NW_015090842.1:10091997",25,36,11
"CPNE7","s954_F_VTA_03_ASEReadCounter.table","NW_015090842.1:10092038",12,19,7
"CPNE7","s954_F_VTA_03_ASEReadCounter.table","NW_015090842.1:10092140",14,25,11
"CPNE7","s954_F_VTA_03_ASEReadCounter.table","NW_015090842.1:10092183",15,20,5
"CPNE7","s954_F_VTA_03_ASEReadCounter.table","NW_015090842.1:10092201",15,21,6
"CPNE7","s954_F_VTA_03_ASEReadCounter.table","NW_015090842.1:10092230",10,14,4
"CPNE7","s954_F_VTA_03_ASEReadCounter.table","NW_015090842.1:10092246",7,10,3
"LOC106888185","s954_F_VTA_03_ASEReadCounter.table","NW_015090842.1:10094965",0,3,3
"LOC106888185","s954_F_VTA_03_ASEReadCounter.table","NW_015090842.1:10094966",0,3,3
"LOC106888185","s954_F_VTA_03_ASEReadCounter.table","NW_015090842.1:10094985",0,3,3
"LOC106888185","s954_F_VTA_03_ASEReadCounter.table","NW_015090842.1:10095055",0,4,4
"LOC106888185","s954_F_VTA_03_ASEReadCounter.table","NW_015090842.1:10095062",0,4,4
"LOC106888185","s954_F_VTA_03_ASEReadCounter.table","NW_015090842.1:10095130",0,3,3
"LOC106888185","s954_F_VTA_03_ASEReadCounter.table","NW_015090842.1:10095265",11,17,6
"LOC106888185","s954_F_VTA_03_ASEReadCounter.table","NW_015090842.1:10095586",10,27,17
"LOC106888185","s954_F_VTA_03_ASEReadCounter.table","NW_015090842.1:10095593",11,29,18
"LOC106888185","s954_F_VTA_03_ASEReadCounter.table","NW_015090842.1:10095616",6,20,14
"LOC106888185","s954_F_VTA_03_ASEReadCounter.table","NW_015090842.1:10095662",4,16,12
"LOC106888185","s954_F_VTA_03_ASEReadCounter.table","NW_015090842.1:10095674",4,14,10
"LOC106888185","s954_F_VTA_03_ASEReadCounter.table","NW_015090842.1:10095786",0,10,10
"LOC106888185","s954_F_VTA_03_ASEReadCounter.table","NW_015090842.1:10095831",3,11,8
"LOC106888185","s954_F_VTA_03_ASEReadCounter.table","NW_015090842.1:10096230",8,16,8
"LOC106888185","s954_F_VTA_03_ASEReadCounter.table","NW_015090842.1:10096249",10,17,7
"LOC106888185","s954_F_VTA_03_ASEReadCounter.table","NW_015090842.1:10096272",7,20,13
"LOC106888185","s954_F_VTA_03_ASEReadCounter.table","NW_015090842.1:10096288",7,20,13
"LOC106888185","s954_F_VTA_03_ASEReadCounter.table","NW_015090842.1:10097248",9,21,12
"LOC106888185","s954_F_VTA_03_ASEReadCounter.table","NW_015090842.1:10097265",11,24,13
"LOC106888185","s954_F_VTA_03_ASEReadCounter.table","NW_015090842.1:10097446",1,5,4
"DPEP1","s954_F_VTA_03_ASEReadCounter.table","NW_015090842.1:10100529",0,1,1
"DPEP1","s954_F_VTA_03_ASEReadCounter.table","NW_015090842.1:10100893",0,1,1
"DPEP1","s954_F_VTA_03_ASEReadCounter.table","NW_015090842.1:10100902",0,2,2
"DPEP1","s954_F_VTA_03_ASEReadCounter.table","NW_015090842.1:10101072",0,1,1
"DPEP1","s954_F_VTA_03_ASEReadCounter.table","NW_015090842.1:10101199",0,1,1
"DPEP1","s954_F_VTA_03_ASEReadCounter.table","NW_015090842.1:10101497",0,1,1
"DPEP1","s954_F_VTA_03_ASEReadCounter.table","NW_015090842.1:10101525",0,1,1
"DPEP1","s954_F_VTA_03_ASEReadCounter.table","NW_015090842.1:10101996",0,1,1
"CHMP1A","s954_F_VTA_03_ASEReadCounter.table","NW_015090842.1:10102901",61,135,74
"CHMP1A","s954_F_VTA_03_ASEReadCounter.table","NW_015090842.1:10102961",47,149,102
"CHMP1A","s954_F_VTA_03_ASEReadCounter.table","NW_015090842.1:10102996",38,127,89
"CHMP1A","s954_F_VTA_03_ASEReadCounter.table","NW_015090842.1:10103004",46,139,93
"CHMP1A","s954_F_VTA_03_ASEReadCounter.table","NW_015090842.1:10103006",44,135,91
"CHMP1A","s954_F_VTA_03_ASEReadCounter.table","NW_015090842.1:10103052",84,177,93
"CHMP1A","s954_F_VTA_03_ASEReadCounter.table","NW_015090842.1:10103095",91,195,104
"CHMP1A","s954_F_VTA_03_ASEReadCounter.table","NW_015090842.1:10103096",93,199,106
"CHMP1A","s954_F_VTA_03_ASEReadCounter.table","NW_015090842.1:10103152",78,163,85
"CHMP1A","s954_F_VTA_03_ASEReadCounter.table","NW_015090842.1:10103173",81,177,96
"CHMP1A","s954_F_VTA_03_ASEReadCounter.table","NW_015090842.1:10103334",46,140,94
"CHMP1A","s954_F_VTA_03_ASEReadCounter.table","NW_015090842.1:10103373",32,113,81
"CHMP1A","s954_F_VTA_03_ASEReadCounter.table","NW_015090842.1:10103408",59,148,89
"CHMP1A","s954_F_VTA_03_ASEReadCounter.table","NW_015090842.1:10103412",61,142,81
"CHMP1A","s954_F_VTA_03_ASEReadCounter.table","NW_015090842.1:10103512",86,178,92
"CHMP1A","s954_F_VTA_03_ASEReadCounter.table","NW_015090842.1:10103513",87,180,93
"CHMP1A","s954_F_VTA_03_ASEReadCounter.table","NW_015090842.1:10103583",43,113,70
"CHMP1A","s954_F_VTA_03_ASEReadCounter.table","NW_015090842.1:10103614",45,109,64
"CHMP1A","s954_F_VTA_03_ASEReadCounter.table","NW_015090842.1:10103657",48,122,74
"CHMP1A","s954_F_VTA_03_ASEReadCounter.table","NW_015090842.1:10103669",44,112,68
"CHMP1A","s954_F_VTA_03_ASEReadCounter.table","NW_015090842.1:10103674",48,112,64
"CHMP1A","s954_F_VTA_03_ASEReadCounter.table","NW_015090842.1:10103677",49,106,57
"CHMP1A","s954_F_VTA_03_ASEReadCounter.table","NW_015090842.1:10103729",81,150,69
"CHMP1A","s954_F_VTA_03_ASEReadCounter.table","NW_015090842.1:10103758",83,150,67
"CHMP1A","s954_F_VTA_03_ASEReadCounter.table","NW_015090842.1:10103761",81,148,67
"CHMP1A","s954_F_VTA_03_ASEReadCounter.table","NW_015090842.1:10103788",86,174,88
"CHMP1A","s954_F_VTA_03_ASEReadCounter.table","NW_015090842.1:10103789",88,175,87
"CHMP1A","s954_F_VTA_03_ASEReadCounter.table","NW_015090842.1:10103790",87,173,86
"CHMP1A","s954_F_VTA_03_ASEReadCounter.table","NW_015090842.1:10103950",72,134,62
"CHMP1A","s954_F_VTA_03_ASEReadCounter.table","NW_015090842.1:10104335",48,91,43
"CHMP1A","s954_F_VTA_03_ASEReadCounter.table","NW_015090842.1:10104429",73,133,60
"CHMP1A","s954_F_VTA_03_ASEReadCounter.table","NW_015090842.1:10104532",72,123,51
"CHMP1A","s954_F_VTA_03_ASEReadCounter.table","NW_015090842.1:10104633",43,100,57
"CHMP1A","s954_F_VTA_03_ASEReadCounter.table","NW_015090842.1:10104759",40,86,46
"CHMP1A","s954_F_VTA_03_ASEReadCounter.table","NW_015090842.1:10104794",50,98,48
"CHMP1A","s954_F_VTA_03_ASEReadCounter.table","NW_015090842.1:10104841",83,83,0
"CHMP1A","s954_F_VTA_03_ASEReadCounter.table","NW_015090842.1:10104844",40,85,45
"CHMP1A","s954_F_VTA_03_ASEReadCounter.table","NW_015090842.1:10106242",54,100,46
"CHMP1A","s954_F_VTA_03_ASEReadCounter.table","NW_015090842.1:10106290",45,94,49
"CHMP1A","s954_F_VTA_03_ASEReadCounter.table","NW_015090842.1:10106335",42,97,55
"CHMP1A","s954_F_VTA_03_ASEReadCounter.table","NW_015090842.1:10106383",49,120,71
"CHMP1A","s954_F_VTA_03_ASEReadCounter.table","NW_015090842.1:10106747",41,97,56
"CHMP1A","s954_F_VTA_03_ASEReadCounter.table","NW_015090842.1:10107404",49,118,69
"CHMP1A","s954_F_VTA_03_ASEReadCounter.table","NW_015090842.1:10107876",46,107,61
"CDK10","s954_F_VTA_03_ASEReadCounter.table","NW_015090842.1:10109030",9,10,1
"CDK10","s954_F_VTA_03_ASEReadCounter.table","NW_015090842.1:10109963",38,100,62
"CDK10","s954_F_VTA_03_ASEReadCounter.table","NW_015090842.1:10110887",30,88,58
"CDK10","s954_F_VTA_03_ASEReadCounter.table","NW_015090842.1:10111254",24,66,42
"CDK10","s954_F_VTA_03_ASEReadCounter.table","NW_015090842.1:10111380",21,73,52
"CDK10","s954_F_VTA_03_ASEReadCounter.table","NW_015090842.1:10111395",24,76,52
"CDK10","s954_F_VTA_03_ASEReadCounter.table","NW_015090842.1:10111437",16,68,52
"CDK10","s954_F_VTA_03_ASEReadCounter.table","NW_015090842.1:10111798",36,86,50
"CDK10","s954_F_VTA_03_ASEReadCounter.table","NW_015090842.1:10111840",33,98,65
"CDK10","s954_F_VTA_03_ASEReadCounter.table","NW_015090842.1:10112031",31,135,104
"CDK10","s954_F_VTA_03_ASEReadCounter.table","NW_015090842.1:10112285",33,130,97
"CDK10","s954_F_VTA_03_ASEReadCounter.table","NW_015090842.1:10112398",37,146,109
"CDK10","s954_F_VTA_03_ASEReadCounter.table","NW_015090842.1:10112455",41,141,100
"CDK10","s954_F_VTA_03_ASEReadCounter.table","NW_015090842.1:10112461",41,135,94
"CDK10","s954_F_VTA_03_ASEReadCounter.table","NW_015090842.1:10112497",36,121,85
"CDK10","s954_F_VTA_03_ASEReadCounter.table","NW_015090842.1:10112508",32,118,86
"CDK10","s954_F_VTA_03_ASEReadCounter.table","NW_015090842.1:10112518",28,106,78
"CDK10","s954_F_VTA_03_ASEReadCounter.table","NW_015090842.1:10112540",7,95,88
"CDK10","s954_F_VTA_03_ASEReadCounter.table","NW_015090842.1:10112556",25,121,96
"CDK10","s954_F_VTA_03_ASEReadCounter.table","NW_015090842.1:10112561",26,137,111
"CDK10","s954_F_VTA_03_ASEReadCounter.table","NW_015090842.1:10112596",39,146,107
"CDK10","s954_F_VTA_03_ASEReadCounter.table","NW_015090842.1:10112630",36,124,88
"CDK10","s954_F_VTA_03_ASEReadCounter.table","NW_015090842.1:10112656",35,115,80
"CDK10","s954_F_VTA_03_ASEReadCounter.table","NW_015090842.1:10112665",28,91,63
"CDK10","s954_F_VTA_03_ASEReadCounter.table","NW_015090842.1:10112668",29,91,62
"CDK10","s954_F_VTA_03_ASEReadCounter.table","NW_015090842.1:10112781",14,43,29
"CDK10","s954_F_VTA_03_ASEReadCounter.table","NW_015090842.1:10112782",14,42,28
"CDK10","s954_F_VTA_03_ASEReadCounter.table","NW_015090842.1:10112795",11,31,20
"CDK10","s954_F_VTA_03_ASEReadCounter.table","NW_015090842.1:10112841",5,13,8
"CDK10","s954_F_VTA_03_ASEReadCounter.table","NW_015090842.1:10112861",3,8,5
"SPATA2L","s954_F_VTA_03_ASEReadCounter.table","NW_015090842.1:10113212",16,54,38
"SPATA2L","s954_F_VTA_03_ASEReadCounter.table","NW_015090842.1:10113280",30,79,49
"SPATA2L","s954_F_VTA_03_ASEReadCounter.table","NW_015090842.1:10113296",31,85,54
"SPATA2L","s954_F_VTA_03_ASEReadCounter.table","NW_015090842.1:10113321",33,91,58
"SPATA2L","s954_F_VTA_03_ASEReadCounter.table","NW_015090842.1:10113332",33,99,66
"SPATA2L","s954_F_VTA_03_ASEReadCounter.table","NW_015090842.1:10113380",37,106,69
"SPATA2L","s954_F_VTA_03_ASEReadCounter.table","NW_015090842.1:10113381",37,109,72
"SPATA2L","s954_F_VTA_03_ASEReadCounter.table","NW_015090842.1:10113412",38,114,76
"SPATA2L","s954_F_VTA_03_ASEReadCounter.table","NW_015090842.1:10113421",41,114,73
"SPATA2L","s954_F_VTA_03_ASEReadCounter.table","NW_015090842.1:10113465",37,118,81
"SPATA2L","s954_F_VTA_03_ASEReadCounter.table","NW_015090842.1:10113535",50,114,64
"SPATA2L","s954_F_VTA_03_ASEReadCounter.table","NW_015090842.1:10113645",54,144,90
"SPATA2L","s954_F_VTA_03_ASEReadCounter.table","NW_015090842.1:10113682",61,163,102
"SPATA2L","s954_F_VTA_03_ASEReadCounter.table","NW_015090842.1:10113696",62,154,92
"SPATA2L","s954_F_VTA_03_ASEReadCounter.table","NW_015090842.1:10113727",63,158,95
"SPATA2L","s954_F_VTA_03_ASEReadCounter.table","NW_015090842.1:10113799",64,164,100
"SPATA2L","s954_F_VTA_03_ASEReadCounter.table","NW_015090842.1:10113809",64,171,107
"SPATA2L","s954_F_VTA_03_ASEReadCounter.table","NW_015090842.1:10113827",59,162,103
"SPATA2L","s954_F_VTA_03_ASEReadCounter.table","NW_015090842.1:10113831",61,164,103
"SPATA2L","s954_F_VTA_03_ASEReadCounter.table","NW_015090842.1:10113894",52,142,90
"SPATA2L","s954_F_VTA_03_ASEReadCounter.table","NW_015090842.1:10113905",44,131,87
"SPATA2L","s954_F_VTA_03_ASEReadCounter.table","NW_015090842.1:10113914",44,129,85
"SPATA2L","s954_F_VTA_03_ASEReadCounter.table","NW_015090842.1:10113920",48,133,85
"SPATA2L","s954_F_VTA_03_ASEReadCounter.table","NW_015090842.1:10113937",59,154,95
"SPATA2L","s954_F_VTA_03_ASEReadCounter.table","NW_015090842.1:10113971",42,129,87
"SPATA2L","s954_F_VTA_03_ASEReadCounter.table","NW_015090842.1:10113976",34,133,99
"SPATA2L","s954_F_VTA_03_ASEReadCounter.table","NW_015090842.1:10113985",39,119,80
"SPATA2L","s954_F_VTA_03_ASEReadCounter.table","NW_015090842.1:10113994",44,128,84
"SPATA2L","s954_F_VTA_03_ASEReadCounter.table","NW_015090842.1:10114063",35,103,68
"SPATA2L","s954_F_VTA_03_ASEReadCounter.table","NW_015090842.1:10114066",36,103,67
"SPATA2L","s954_F_VTA_03_ASEReadCounter.table","NW_015090842.1:10114069",36,103,67
"SPATA2L","s954_F_VTA_03_ASEReadCounter.table","NW_015090842.1:10114121",24,72,48
"SPATA2L","s954_F_VTA_03_ASEReadCounter.table","NW_015090842.1:10114159",27,79,52
"SPATA2L","s954_F_VTA_03_ASEReadCounter.table","NW_015090842.1:10114282",105,105,0
"SPATA2L","s954_F_VTA_03_ASEReadCounter.table","NW_015090842.1:10114470",45,100,55
"SPATA2L","s954_F_VTA_03_ASEReadCounter.table","NW_015090842.1:10114524",28,72,44
"VPS9D1","s954_F_VTA_03_ASEReadCounter.table","NW_015090842.1:10116377",30,69,39
"VPS9D1","s954_F_VTA_03_ASEReadCounter.table","NW_015090842.1:10116415",30,71,41
"VPS9D1","s954_F_VTA_03_ASEReadCounter.table","NW_015090842.1:10116607",27,63,36
"VPS9D1","s954_F_VTA_03_ASEReadCounter.table","NW_015090842.1:10116816",66,66,0
"VPS9D1","s954_F_VTA_03_ASEReadCounter.table","NW_015090842.1:10116821",25,71,46
"VPS9D1","s954_F_VTA_03_ASEReadCounter.table","NW_015090842.1:10116825",24,65,41
"VPS9D1","s954_F_VTA_03_ASEReadCounter.table","NW_015090842.1:10116882",33,67,34
"VPS9D1","s954_F_VTA_03_ASEReadCounter.table","NW_015090842.1:10116885",31,67,36
"VPS9D1","s954_F_VTA_03_ASEReadCounter.table","NW_015090842.1:10116933",33,68,35
"VPS9D1","s954_F_VTA_03_ASEReadCounter.table","NW_015090842.1:10116942",31,64,33
"VPS9D1","s954_F_VTA_03_ASEReadCounter.table","NW_015090842.1:10117152",25,60,35
"VPS9D1","s954_F_VTA_03_ASEReadCounter.table","NW_015090842.1:10117396",48,48,0
"VPS9D1","s954_F_VTA_03_ASEReadCounter.table","NW_015090842.1:10117405",35,35,0
"VPS9D1","s954_F_VTA_03_ASEReadCounter.table","NW_015090842.1:10117480",17,55,38
"VPS9D1","s954_F_VTA_03_ASEReadCounter.table","NW_015090842.1:10117497",17,50,33
"VPS9D1","s954_F_VTA_03_ASEReadCounter.table","NW_015090842.1:10117499",14,50,36
"VPS9D1","s954_F_VTA_03_ASEReadCounter.table","NW_015090842.1:10117516",18,60,42
"VPS9D1","s954_F_VTA_03_ASEReadCounter.table","NW_015090842.1:10117525",21,62,41
"VPS9D1","s954_F_VTA_03_ASEReadCounter.table","NW_015090842.1:10117579",13,53,40
"VPS9D1","s954_F_VTA_03_ASEReadCounter.table","NW_015090842.1:10117627",17,58,41
"VPS9D1","s954_F_VTA_03_ASEReadCounter.table","NW_015090842.1:10117678",13,58,45
"VPS9D1","s954_F_VTA_03_ASEReadCounter.table","NW_015090842.1:10117773",25,75,50
"VPS9D1","s954_F_VTA_03_ASEReadCounter.table","NW_015090842.1:10117937",20,66,46
"VPS9D1","s954_F_VTA_03_ASEReadCounter.table","NW_015090842.1:10117961",23,64,41
"VPS9D1","s954_F_VTA_03_ASEReadCounter.table","NW_015090842.1:10118236",30,82,52
"VPS9D1","s954_F_VTA_03_ASEReadCounter.table","NW_015090842.1:10118414",24,78,54
"VPS9D1","s954_F_VTA_03_ASEReadCounter.table","NW_015090842.1:10118973",29,80,51
"VPS9D1","s954_F_VTA_03_ASEReadCounter.table","NW_015090842.1:10119500",22,46,24
"ZNF276","s954_F_VTA_03_ASEReadCounter.table","NW_015090842.1:10121760",8,13,5
"ZNF276","s954_F_VTA_03_ASEReadCounter.table","NW_015090842.1:10121769",8,12,4
"ZNF276","s954_F_VTA_03_ASEReadCounter.table","NW_015090842.1:10121802",13,19,6
"ZNF276","s954_F_VTA_03_ASEReadCounter.table","NW_015090842.1:10121971",10,17,7
"ZNF276","s954_F_VTA_03_ASEReadCounter.table","NW_015090842.1:10122883",15,24,9
"ZNF276","s954_F_VTA_03_ASEReadCounter.table","NW_015090842.1:10123069",12,26,14
"ZNF276","s954_F_VTA_03_ASEReadCounter.table","NW_015090842.1:10123207",21,48,27
"ZNF276","s954_F_VTA_03_ASEReadCounter.table","NW_015090842.1:10125787",26,52,26
"ZNF276","s954_F_VTA_03_ASEReadCounter.table","NW_015090842.1:10126309",29,57,28
"ZNF276","s954_F_VTA_03_ASEReadCounter.table","NW_015090842.1:10126348",22,51,29
"ZNF276","s954_F_VTA_03_ASEReadCounter.table","NW_015090842.1:10126978",32,69,37
"ZNF276","s954_F_VTA_03_ASEReadCounter.table","NW_015090842.1:10126991",31,69,38
"ZNF276","s954_F_VTA_03_ASEReadCounter.table","NW_015090842.1:10127023",29,73,44
"ZNF276","s954_F_VTA_03_ASEReadCounter.table","NW_015090842.1:10127063",35,73,38
"ZNF276","s954_F_VTA_03_ASEReadCounter.table","NW_015090842.1:10127373",32,64,32
"ZNF276","s954_F_VTA_03_ASEReadCounter.table","NW_015090842.1:10127931",35,56,21
"ZNF276","s954_F_VTA_03_ASEReadCounter.table","NW_015090842.1:10128070",43,74,31
"ZNF276","s954_F_VTA_03_ASEReadCounter.table","NW_015090842.1:10128102",45,74,29
"ZNF276","s954_F_VTA_03_ASEReadCounter.table","NW_015090842.1:10128356",26,61,35
"ZNF276","s954_F_VTA_03_ASEReadCounter.table","NW_015090842.1:10128497",20,46,26
"FANCA","s954_F_VTA_03_ASEReadCounter.table","NW_015090842.1:10128743",4,6,2
"FANCA","s954_F_VTA_03_ASEReadCounter.table","NW_015090842.1:10128822",3,4,1
"FANCA","s954_F_VTA_03_ASEReadCounter.table","NW_015090842.1:10129383",2,2,0
"FANCA","s954_F_VTA_03_ASEReadCounter.table","NW_015090842.1:10129390",2,3,1
"FANCA","s954_F_VTA_03_ASEReadCounter.table","NW_015090842.1:10129422",2,3,1
"FANCA","s954_F_VTA_03_ASEReadCounter.table","NW_015090842.1:10129969",1,2,1
"FANCA","s954_F_VTA_03_ASEReadCounter.table","NW_015090842.1:10130399",0,2,2
"FANCA","s954_F_VTA_03_ASEReadCounter.table","NW_015090842.1:10130857",1,1,0
"FANCA","s954_F_VTA_03_ASEReadCounter.table","NW_015090842.1:10130878",1,1,0
"FANCA","s954_F_VTA_03_ASEReadCounter.table","NW_015090842.1:10136957",3,3,0
"FANCA","s954_F_VTA_03_ASEReadCounter.table","NW_015090842.1:10136982",2,2,0
"FANCA","s954_F_VTA_03_ASEReadCounter.table","NW_015090842.1:10136999",2,2,0
"FANCA","s954_F_VTA_03_ASEReadCounter.table","NW_015090842.1:10137019",1,1,0
"FANCA","s954_F_VTA_03_ASEReadCounter.table","NW_015090842.1:10141234",0,2,2
"FANCA","s954_F_VTA_03_ASEReadCounter.table","NW_015090842.1:10145030",0,1,1
"FANCA","s954_F_VTA_03_ASEReadCounter.table","NW_015090842.1:10150518",0,1,1
"FANCA","s954_F_VTA_03_ASEReadCounter.table","NW_015090842.1:10154490",1,2,1
"SPIRE2","s954_F_VTA_03_ASEReadCounter.table","NW_015090842.1:10172284",20,29,9
"SPIRE2","s954_F_VTA_03_ASEReadCounter.table","NW_015090842.1:10175262",33,54,21
"SPIRE2","s954_F_VTA_03_ASEReadCounter.table","NW_015090842.1:10175352",19,28,9
"SPIRE2","s954_F_VTA_03_ASEReadCounter.table","NW_015090842.1:10175400",52,88,36
"SPIRE2","s954_F_VTA_03_ASEReadCounter.table","NW_015090842.1:10175418",59,98,39
"SPIRE2","s954_F_VTA_03_ASEReadCounter.table","NW_015090842.1:10175704",55,99,44
"SPIRE2","s954_F_VTA_03_ASEReadCounter.table","NW_015090842.1:10176115",90,165,75
"SPIRE2","s954_F_VTA_03_ASEReadCounter.table","NW_015090842.1:10176561",100,170,70
"SPIRE2","s954_F_VTA_03_ASEReadCounter.table","NW_015090842.1:10176817",94,181,87
"SPIRE2","s954_F_VTA_03_ASEReadCounter.table","NW_015090842.1:10177084",61,133,72
"SPIRE2","s954_F_VTA_03_ASEReadCounter.table","NW_015090842.1:10177110",53,116,63
"SPIRE2","s954_F_VTA_03_ASEReadCounter.table","NW_015090842.1:10177838",106,197,91
"SPIRE2","s954_F_VTA_03_ASEReadCounter.table","NW_015090842.1:10178000",103,199,96
"SPIRE2","s954_F_VTA_03_ASEReadCounter.table","NW_015090842.1:10178164",117,218,101
"SPIRE2","s954_F_VTA_03_ASEReadCounter.table","NW_015090842.1:10178216",128,229,101
"SPIRE2","s954_F_VTA_03_ASEReadCounter.table","NW_015090842.1:10178403",119,214,95
"SPIRE2","s954_F_VTA_03_ASEReadCounter.table","NW_015090842.1:10178409",118,208,90
"SPIRE2","s954_F_VTA_03_ASEReadCounter.table","NW_015090842.1:10178524",120,202,82
"SPIRE2","s954_F_VTA_03_ASEReadCounter.table","NW_015090842.1:10178526",120,203,83
"SPIRE2","s954_F_VTA_03_ASEReadCounter.table","NW_015090842.1:10178531",121,206,85
"SPIRE2","s954_F_VTA_03_ASEReadCounter.table","NW_015090842.1:10178565",106,197,91
"SPIRE2","s954_F_VTA_03_ASEReadCounter.table","NW_015090842.1:10178587",103,182,79
"SPIRE2","s954_F_VTA_03_ASEReadCounter.table","NW_015090842.1:10178640",59,122,63
"SPIRE2","s954_F_VTA_03_ASEReadCounter.table","NW_015090842.1:10178651",69,134,65
"SPIRE2","s954_F_VTA_03_ASEReadCounter.table","NW_015090842.1:10178682",61,108,47
"TCF25","s954_F_VTA_03_ASEReadCounter.table","NW_015090842.1:10180912",35,59,24
"TCF25","s954_F_VTA_03_ASEReadCounter.table","NW_015090842.1:10180924",33,55,22
"TCF25","s954_F_VTA_03_ASEReadCounter.table","NW_015090842.1:10180931",33,56,23
"TCF25","s954_F_VTA_03_ASEReadCounter.table","NW_015090842.1:10185332",95,187,92
"TCF25","s954_F_VTA_03_ASEReadCounter.table","NW_015090842.1:10188816",83,143,60
"MC1R","s954_F_VTA_03_ASEReadCounter.table","NW_015090842.1:10202160",1,1,0
"MC1R","s954_F_VTA_03_ASEReadCounter.table","NW_015090842.1:10202460",0,1,1
"MC1R","s954_F_VTA_03_ASEReadCounter.table","NW_015090842.1:10202465",0,1,1
"DBNDD1","s954_F_VTA_03_ASEReadCounter.table","NW_015090842.1:10223105",73,158,85
"GAS8","s954_F_VTA_03_ASEReadCounter.table","NW_015090842.1:10228982",20,26,6
"GAS8","s954_F_VTA_03_ASEReadCounter.table","NW_015090842.1:10229832",8,25,17
"GAS8","s954_F_VTA_03_ASEReadCounter.table","NW_015090842.1:10232375",21,37,16
"GAS8","s954_F_VTA_03_ASEReadCounter.table","NW_015090842.1:10232901",27,47,20
"GAS8","s954_F_VTA_03_ASEReadCounter.table","NW_015090842.1:10232928",31,54,23
"GAS8","s954_F_VTA_03_ASEReadCounter.table","NW_015090842.1:10232967",27,47,20
"GAS8","s954_F_VTA_03_ASEReadCounter.table","NW_015090842.1:10233032",27,39,12
"GAS8","s954_F_VTA_03_ASEReadCounter.table","NW_015090842.1:10233057",22,31,9
"GAS8","s954_F_VTA_03_ASEReadCounter.table","NW_015090842.1:10233058",22,31,9
"GAS8","s954_F_VTA_03_ASEReadCounter.table","NW_015090842.1:10233176",15,24,9
"GAS8","s954_F_VTA_03_ASEReadCounter.table","NW_015090842.1:10233196",13,24,11
"GAS8","s954_F_VTA_03_ASEReadCounter.table","NW_015090842.1:10233252",5,12,7
"GAS8","s954_F_VTA_03_ASEReadCounter.table","NW_015090842.1:10233303",4,6,2
"LOC106888094","s954_F_VTA_03_ASEReadCounter.table","NW_015090842.1:10233334",3,8,5
"LOC106888094","s954_F_VTA_03_ASEReadCounter.table","NW_015090842.1:10233362",7,27,20
"LOC106888094","s954_F_VTA_03_ASEReadCounter.table","NW_015090842.1:10233373",7,29,22
"LOC106888094","s954_F_VTA_03_ASEReadCounter.table","NW_015090842.1:10233388",6,28,22
"LOC106888094","s954_F_VTA_03_ASEReadCounter.table","NW_015090842.1:10233402",10,34,24
"LOC106888094","s954_F_VTA_03_ASEReadCounter.table","NW_015090842.1:10233465",11,35,24
"LOC106888094","s954_F_VTA_03_ASEReadCounter.table","NW_015090842.1:10233803",20,48,28
"LOC106888094","s954_F_VTA_03_ASEReadCounter.table","NW_015090842.1:10233815",16,41,25
"LOC106888094","s954_F_VTA_03_ASEReadCounter.table","NW_015090842.1:10235484",1,3,2
"LOC106888094","s954_F_VTA_03_ASEReadCounter.table","NW_015090842.1:10235611",5,6,1
"LOC106888094","s954_F_VTA_03_ASEReadCounter.table","NW_015090842.1:10236098",1,5,4
"LOC106888094","s954_F_VTA_03_ASEReadCounter.table","NW_015090842.1:10236161",1,6,5
"LOC106888094","s954_F_VTA_03_ASEReadCounter.table","NW_015090842.1:10236380",0,3,3
"LOC106888094","s954_F_VTA_03_ASEReadCounter.table","NW_015090842.1:10236388",0,4,4
"LOC106888094","s954_F_VTA_03_ASEReadCounter.table","NW_015090842.1:10236425",0,3,3
"LOC106888094","s954_F_VTA_03_ASEReadCounter.table","NW_015090842.1:10236426",0,3,3
"LOC106888094","s954_F_VTA_03_ASEReadCounter.table","NW_015090842.1:10236603",0,1,1
"LOC106888173","s954_F_VTA_03_ASEReadCounter.table","NW_015090842.1:10239596",2,30,28
"LOC106888173","s954_F_VTA_03_ASEReadCounter.table","NW_015090842.1:10240036",5,53,48
"LOC106888173","s954_F_VTA_03_ASEReadCounter.table","NW_015090842.1:10240095",6,66,60
"LOC106888173","s954_F_VTA_03_ASEReadCounter.table","NW_015090842.1:10240280",6,63,57
"LOC106888173","s954_F_VTA_03_ASEReadCounter.table","NW_015090842.1:10240557",16,78,62
"LOC106888173","s954_F_VTA_03_ASEReadCounter.table","NW_015090842.1:10240603",11,72,61
"LOC106888173","s954_F_VTA_03_ASEReadCounter.table","NW_015090842.1:10240609",11,71,60
"LOC106888173","s954_F_VTA_03_ASEReadCounter.table","NW_015090842.1:10240690",15,91,76
"LOC106888173","s954_F_VTA_03_ASEReadCounter.table","NW_015090842.1:10240924",12,81,69
"LOC106888173","s954_F_VTA_03_ASEReadCounter.table","NW_015090842.1:10241037",7,86,79
"LOC106888173","s954_F_VTA_03_ASEReadCounter.table","NW_015090842.1:10241046",9,90,81
"LOC106888173","s954_F_VTA_03_ASEReadCounter.table","NW_015090842.1:10241058",10,90,80
"LOC106888173","s954_F_VTA_03_ASEReadCounter.table","NW_015090842.1:10241064",11,88,77
"LOC106888173","s954_F_VTA_03_ASEReadCounter.table","NW_015090842.1:10241103",115,115,0
"LOC106888173","s954_F_VTA_03_ASEReadCounter.table","NW_015090842.1:10241163",15,98,83
"LOC106888173","s954_F_VTA_03_ASEReadCounter.table","NW_015090842.1:10241803",17,109,92
"LOC106888173","s954_F_VTA_03_ASEReadCounter.table","NW_015090842.1:10241827",19,112,93
"LOC106888173","s954_F_VTA_03_ASEReadCounter.table","NW_015090842.1:10241869",23,118,95
"LOC106888173","s954_F_VTA_03_ASEReadCounter.table","NW_015090842.1:10242079",8,88,80
"LOC106888173","s954_F_VTA_03_ASEReadCounter.table","NW_015090842.1:10242103",9,87,78
"LOC106888173","s954_F_VTA_03_ASEReadCounter.table","NW_015090842.1:10242157",11,117,106
"LOC106888173","s954_F_VTA_03_ASEReadCounter.table","NW_015090842.1:10242455",16,109,93
"LOC106888173","s954_F_VTA_03_ASEReadCounter.table","NW_015090842.1:10242481",15,112,97
"LOC106888173","s954_F_VTA_03_ASEReadCounter.table","NW_015090842.1:10242590",10,101,91
"LOC106888173","s954_F_VTA_03_ASEReadCounter.table","NW_015090842.1:10242794",16,99,83
"LOC106888173","s954_F_VTA_03_ASEReadCounter.table","NW_015090842.1:10242909",10,101,91
"LOC106888173","s954_F_VTA_03_ASEReadCounter.table","NW_015090842.1:10243094",13,106,93
"LOC106888173","s954_F_VTA_03_ASEReadCounter.table","NW_015090842.1:10243133",8,80,72
"LOC106888173","s954_F_VTA_03_ASEReadCounter.table","NW_015090842.1:10243273",12,108,96
"LOC106888173","s954_F_VTA_03_ASEReadCounter.table","NW_015090842.1:10243278",12,108,96
"LOC106888173","s954_F_VTA_03_ASEReadCounter.table","NW_015090842.1:10243281",12,108,96
"LOC106888173","s954_F_VTA_03_ASEReadCounter.table","NW_015090842.1:10243347",50,50,0
"LOC106888173","s954_F_VTA_03_ASEReadCounter.table","NW_015090842.1:10243353",6,44,38
"LOC106888173","s954_F_VTA_03_ASEReadCounter.table","NW_015090842.1:10243363",6,30,24
"LOC106888173","s954_F_VTA_03_ASEReadCounter.table","NW_015090842.1:10243365",6,29,23
"LOC106888173","s954_F_VTA_03_ASEReadCounter.table","NW_015090842.1:10243566",17,114,97
"LOC106888173","s954_F_VTA_03_ASEReadCounter.table","NW_015090842.1:10243605",18,120,102
"LOC106888173","s954_F_VTA_03_ASEReadCounter.table","NW_015090842.1:10243614",15,112,97
"LOC106888173","s954_F_VTA_03_ASEReadCounter.table","NW_015090842.1:10243615",15,110,95
"LOC106888173","s954_F_VTA_03_ASEReadCounter.table","NW_015090842.1:10243640",12,95,83
"LOC106888173","s954_F_VTA_03_ASEReadCounter.table","NW_015090842.1:10243680",9,84,75
"LOC106888173","s954_F_VTA_03_ASEReadCounter.table","NW_015090842.1:10243742",17,109,92
"LOC106888173","s954_F_VTA_03_ASEReadCounter.table","NW_015090842.1:10243804",15,82,67
"LOC106888173","s954_F_VTA_03_ASEReadCounter.table","NW_015090842.1:10243913",6,30,24
"LOC106888173","s954_F_VTA_03_ASEReadCounter.table","NW_015090842.1:10243921",6,25,19
"LOC106888384","s954_F_VTA_03_ASEReadCounter.table","NW_015090842.1:10250743",1,1,0
"LOC106888384","s954_F_VTA_03_ASEReadCounter.table","NW_015090842.1:10250771",1,1,0
"LOC106888384","s954_F_VTA_03_ASEReadCounter.table","NW_015090842.1:10251354",0,9,9
"LOC106888384","s954_F_VTA_03_ASEReadCounter.table","NW_015090842.1:10251358",0,9,9
"LOC106888384","s954_F_VTA_03_ASEReadCounter.table","NW_015090842.1:10251369",0,8,8
"LOC106888384","s954_F_VTA_03_ASEReadCounter.table","NW_015090842.1:10251370",0,8,8
"LOC106888384","s954_F_VTA_03_ASEReadCounter.table","NW_015090842.1:10251375",0,8,8
"LOC106888384","s954_F_VTA_03_ASEReadCounter.table","NW_015090842.1:10251388",0,5,5
"LOC106888384","s954_F_VTA_03_ASEReadCounter.table","NW_015090842.1:10251390",0,4,4
"LOC106888384","s954_F_VTA_03_ASEReadCounter.table","NW_015090842.1:10251393",0,4,4
"LOC106888384","s954_F_VTA_03_ASEReadCounter.table","NW_015090842.1:10251399",0,3,3
"LOC106888384","s954_F_VTA_03_ASEReadCounter.table","NW_015090842.1:10251492",2,2,0
"LOC106888384","s954_F_VTA_03_ASEReadCounter.table","NW_015090842.1:10253165",0,2,2
"LOC106888384","s954_F_VTA_03_ASEReadCounter.table","NW_015090842.1:10253284",2,5,3
"LOC106888384","s954_F_VTA_03_ASEReadCounter.table","NW_015090842.1:10254028",1,1,0
"LOC106888384","s954_F_VTA_03_ASEReadCounter.table","NW_015090842.1:10254227",1,1,0
"LOC106888384","s954_F_VTA_03_ASEReadCounter.table","NW_015090842.1:10254233",1,1,0
"LOC106888384","s954_F_VTA_03_ASEReadCounter.table","NW_015090842.1:10254263",2,2,0
"LOC106888384","s954_F_VTA_03_ASEReadCounter.table","NW_015090842.1:10254293",3,3,0
"LOC106888384","s954_F_VTA_03_ASEReadCounter.table","NW_015090842.1:10254570",2,2,0
"LOC106888384","s954_F_VTA_03_ASEReadCounter.table","NW_015090842.1:10254605",2,2,0
"LOC106888384","s954_F_VTA_03_ASEReadCounter.table","NW_015090842.1:10254608",2,2,0
"LOC106888384","s954_F_VTA_03_ASEReadCounter.table","NW_015090842.1:10254618",2,2,0
"LOC106888384","s954_F_VTA_03_ASEReadCounter.table","NW_015090842.1:10254620",2,2,0
"LOC106888384","s954_F_VTA_03_ASEReadCounter.table","NW_015090842.1:10254623",1,1,0
"LOC106888384","s954_F_VTA_03_ASEReadCounter.table","NW_015090842.1:10254624",1,1,0
"LOC106888384","s954_F_VTA_03_ASEReadCounter.table","NW_015090842.1:10254627",1,1,0
"LOC106888384","s954_F_VTA_03_ASEReadCounter.table","NW_015090842.1:10254629",1,1,0
"LOC106888384","s954_F_VTA_03_ASEReadCounter.table","NW_015090842.1:10254891",1,1,0
"LOC106888384","s954_F_VTA_03_ASEReadCounter.table","NW_015090842.1:10254900",0,1,1
"LOC106888384","s954_F_VTA_03_ASEReadCounter.table","NW_015090842.1:10254915",0,1,1
"LOC106888384","s954_F_VTA_03_ASEReadCounter.table","NW_015090842.1:10254965",2,2,0
"LOC106888384","s954_F_VTA_03_ASEReadCounter.table","NW_015090842.1:10254975",1,2,1
"LOC106888384","s954_F_VTA_03_ASEReadCounter.table","NW_015090842.1:10255077",1,1,0
"LOC106888384","s954_F_VTA_03_ASEReadCounter.table","NW_015090842.1:10255138",0,1,1
"LOC106888384","s954_F_VTA_03_ASEReadCounter.table","NW_015090842.1:10255139",0,1,1
"LOC106888384","s954_F_VTA_03_ASEReadCounter.table","NW_015090842.1:10255209",3,5,2
"LOC106888384","s954_F_VTA_03_ASEReadCounter.table","NW_015090842.1:10255211",3,5,2
"LOC106888384","s954_F_VTA_03_ASEReadCounter.table","NW_015090842.1:10255236",3,5,2
"LOC106888384","s954_F_VTA_03_ASEReadCounter.table","NW_015090842.1:10255262",1,2,1
"LOC106888384","s954_F_VTA_03_ASEReadCounter.table","NW_015090842.1:10255264",1,2,1
"LOC106888384","s954_F_VTA_03_ASEReadCounter.table","NW_015090842.1:10255306",3,3,0
"LOC106888384","s954_F_VTA_03_ASEReadCounter.table","NW_015090842.1:10255340",4,4,0
"LOC106888384","s954_F_VTA_03_ASEReadCounter.table","NW_015090842.1:10255410",3,4,1
"LOC106888384","s954_F_VTA_03_ASEReadCounter.table","NW_015090842.1:10255449",3,4,1
"LOC106888384","s954_F_VTA_03_ASEReadCounter.table","NW_015090842.1:10255496",2,3,1
"LOC106888384","s954_F_VTA_03_ASEReadCounter.table","NW_015090842.1:10255505",1,1,0
"LOC106888384","s954_F_VTA_03_ASEReadCounter.table","NW_015090842.1:10255531",2,2,0
"LOC106888384","s954_F_VTA_03_ASEReadCounter.table","NW_015090842.1:10255608",1,1,0
"LOC106888384","s954_F_VTA_03_ASEReadCounter.table","NW_015090842.1:10255704",5,5,0
"LOC106888384","s954_F_VTA_03_ASEReadCounter.table","NW_015090842.1:10255731",7,7,0
"LOC106888384","s954_F_VTA_03_ASEReadCounter.table","NW_015090842.1:10255771",5,5,0
"TANGO6","s954_F_VTA_03_ASEReadCounter.table","NW_015090842.1:10257782",8,12,4
"TANGO6","s954_F_VTA_03_ASEReadCounter.table","NW_015090842.1:10258162",7,15,8
"TANGO6","s954_F_VTA_03_ASEReadCounter.table","NW_015090842.1:10258185",7,20,13
"TANGO6","s954_F_VTA_03_ASEReadCounter.table","NW_015090842.1:10259267",9,22,13
"TANGO6","s954_F_VTA_03_ASEReadCounter.table","NW_015090842.1:10260250",34,62,28
"TANGO6","s954_F_VTA_03_ASEReadCounter.table","NW_015090842.1:10260289",31,56,25
"TANGO6","s954_F_VTA_03_ASEReadCounter.table","NW_015090842.1:10260309",21,45,24
"TANGO6","s954_F_VTA_03_ASEReadCounter.table","NW_015090842.1:10260979",27,41,14
"TANGO6","s954_F_VTA_03_ASEReadCounter.table","NW_015090842.1:10261599",21,45,24
"TANGO6","s954_F_VTA_03_ASEReadCounter.table","NW_015090842.1:10268425",35,59,24
"TANGO6","s954_F_VTA_03_ASEReadCounter.table","NW_015090842.1:10269831",28,54,26
"TANGO6","s954_F_VTA_03_ASEReadCounter.table","NW_015090842.1:10270813",25,49,24
"TANGO6","s954_F_VTA_03_ASEReadCounter.table","NW_015090842.1:10274018",26,52,26
"TANGO6","s954_F_VTA_03_ASEReadCounter.table","NW_015090842.1:10275974",30,53,23
"TANGO6","s954_F_VTA_03_ASEReadCounter.table","NW_015090842.1:10275976",30,52,22
"TANGO6","s954_F_VTA_03_ASEReadCounter.table","NW_015090842.1:10276123",34,55,21
"TANGO6","s954_F_VTA_03_ASEReadCounter.table","NW_015090842.1:10276271",24,46,22
"TANGO6","s954_F_VTA_03_ASEReadCounter.table","NW_015090842.1:10276272",24,45,21
"TANGO6","s954_F_VTA_03_ASEReadCounter.table","NW_015090842.1:10276275",24,47,23
"TANGO6","s954_F_VTA_03_ASEReadCounter.table","NW_015090842.1:10276278",24,47,23
"TANGO6","s954_F_VTA_03_ASEReadCounter.table","NW_015090842.1:10276368",22,36,14
"TANGO6","s954_F_VTA_03_ASEReadCounter.table","NW_015090842.1:10276373",18,35,17
"TANGO6","s954_F_VTA_03_ASEReadCounter.table","NW_015090842.1:10276630",24,46,22
"TANGO6","s954_F_VTA_03_ASEReadCounter.table","NW_015090842.1:10281498",26,55,29
"TANGO6","s954_F_VTA_03_ASEReadCounter.table","NW_015090842.1:10281516",28,64,36
"TANGO6","s954_F_VTA_03_ASEReadCounter.table","NW_015090842.1:10282842",40,65,25
"TANGO6","s954_F_VTA_03_ASEReadCounter.table","NW_015090842.1:10282863",35,57,22
"TANGO6","s954_F_VTA_03_ASEReadCounter.table","NW_015090842.1:10282869",39,61,22
"TANGO6","s954_F_VTA_03_ASEReadCounter.table","NW_015090842.1:10282903",41,68,27
"TANGO6","s954_F_VTA_03_ASEReadCounter.table","NW_015090842.1:10283757",45,74,29
"TANGO6","s954_F_VTA_03_ASEReadCounter.table","NW_015090842.1:10283785",51,87,36
"HAS3","s954_F_VTA_03_ASEReadCounter.table","NW_015090842.1:10288093",2,2,0
"HAS3","s954_F_VTA_03_ASEReadCounter.table","NW_015090842.1:10288266",0,2,2
"HAS3","s954_F_VTA_03_ASEReadCounter.table","NW_015090842.1:10288274",0,2,2
"HAS3","s954_F_VTA_03_ASEReadCounter.table","NW_015090842.1:10288364",2,2,0
"HAS3","s954_F_VTA_03_ASEReadCounter.table","NW_015090842.1:10289269",0,2,2
"HAS3","s954_F_VTA_03_ASEReadCounter.table","NW_015090842.1:10289272",0,2,2
"HAS3","s954_F_VTA_03_ASEReadCounter.table","NW_015090842.1:10290375",2,3,1
"HAS3","s954_F_VTA_03_ASEReadCounter.table","NW_015090842.1:10290395",2,3,1
"HAS3","s954_F_VTA_03_ASEReadCounter.table","NW_015090842.1:10290439",3,3,0
"HAS3","s954_F_VTA_03_ASEReadCounter.table","NW_015090842.1:10290609",1,5,4
"HAS3","s954_F_VTA_03_ASEReadCounter.table","NW_015090842.1:10290666",1,6,5
"HAS3","s954_F_VTA_03_ASEReadCounter.table","NW_015090842.1:10290723",2,6,4
"HAS3","s954_F_VTA_03_ASEReadCounter.table","NW_015090842.1:10290927",2,3,1
"HAS3","s954_F_VTA_03_ASEReadCounter.table","NW_015090842.1:10291004",2,3,1
"CHTF8","s954_F_VTA_03_ASEReadCounter.table","NW_015090842.1:10291319",1,6,5
"CHTF8","s954_F_VTA_03_ASEReadCounter.table","NW_015090842.1:10291491",4,7,3
"CHTF8","s954_F_VTA_03_ASEReadCounter.table","NW_015090842.1:10291520",3,11,8
"CHTF8","s954_F_VTA_03_ASEReadCounter.table","NW_015090842.1:10291593",5,14,9
"CHTF8","s954_F_VTA_03_ASEReadCounter.table","NW_015090842.1:10291600",5,12,7
"CHTF8","s954_F_VTA_03_ASEReadCounter.table","NW_015090842.1:10291609",6,15,9
"CHTF8","s954_F_VTA_03_ASEReadCounter.table","NW_015090842.1:10291639",6,11,5
"CHTF8","s954_F_VTA_03_ASEReadCounter.table","NW_015090842.1:10291641",5,10,5
"CHTF8","s954_F_VTA_03_ASEReadCounter.table","NW_015090842.1:10291648",5,12,7
"CHTF8","s954_F_VTA_03_ASEReadCounter.table","NW_015090842.1:10291656",5,12,7
"CHTF8","s954_F_VTA_03_ASEReadCounter.table","NW_015090842.1:10291675",8,14,6
"CHTF8","s954_F_VTA_03_ASEReadCounter.table","NW_015090842.1:10291696",11,19,8
"CHTF8","s954_F_VTA_03_ASEReadCounter.table","NW_015090842.1:10291714",8,14,6
"CHTF8","s954_F_VTA_03_ASEReadCounter.table","NW_015090842.1:10291732",9,13,4
"CHTF8","s954_F_VTA_03_ASEReadCounter.table","NW_015090842.1:10291755",11,15,4
"CHTF8","s954_F_VTA_03_ASEReadCounter.table","NW_015090842.1:10291756",11,14,3
"CHTF8","s954_F_VTA_03_ASEReadCounter.table","NW_015090842.1:10291758",11,14,3
"CHTF8","s954_F_VTA_03_ASEReadCounter.table","NW_015090842.1:10291792",11,15,4
"CHTF8","s954_F_VTA_03_ASEReadCounter.table","NW_015090842.1:10291895",10,14,4
"CHTF8","s954_F_VTA_03_ASEReadCounter.table","NW_015090842.1:10292132",9,16,7
"CHTF8","s954_F_VTA_03_ASEReadCounter.table","NW_015090842.1:10292314",5,9,4
"CHTF8","s954_F_VTA_03_ASEReadCounter.table","NW_015090842.1:10292317",5,9,4
"CHTF8","s954_F_VTA_03_ASEReadCounter.table","NW_015090842.1:10292928",0,1,1
"UTP4","s954_F_VTA_03_ASEReadCounter.table","NW_015090842.1:10293146",14,22,8
"UTP4","s954_F_VTA_03_ASEReadCounter.table","NW_015090842.1:10293151",15,23,8
"UTP4","s954_F_VTA_03_ASEReadCounter.table","NW_015090842.1:10293191",14,21,7
"UTP4","s954_F_VTA_03_ASEReadCounter.table","NW_015090842.1:10293362",23,33,10
"UTP4","s954_F_VTA_03_ASEReadCounter.table","NW_015090842.1:10293430",9,20,11
"UTP4","s954_F_VTA_03_ASEReadCounter.table","NW_015090842.1:10293625",8,23,15
"UTP4","s954_F_VTA_03_ASEReadCounter.table","NW_015090842.1:10293684",7,18,11
"UTP4","s954_F_VTA_03_ASEReadCounter.table","NW_015090842.1:10294093",8,16,8
"UTP4","s954_F_VTA_03_ASEReadCounter.table","NW_015090842.1:10294622",18,29,11
"UTP4","s954_F_VTA_03_ASEReadCounter.table","NW_015090842.1:10294632",15,26,11
"UTP4","s954_F_VTA_03_ASEReadCounter.table","NW_015090842.1:10295238",10,22,12
"UTP4","s954_F_VTA_03_ASEReadCounter.table","NW_015090842.1:10295880",15,27,12
"UTP4","s954_F_VTA_03_ASEReadCounter.table","NW_015090842.1:10295884",13,25,12
"UTP4","s954_F_VTA_03_ASEReadCounter.table","NW_015090842.1:10295903",12,21,9
"UTP4","s954_F_VTA_03_ASEReadCounter.table","NW_015090842.1:10295906",10,19,9
"UTP4","s954_F_VTA_03_ASEReadCounter.table","NW_015090842.1:10295915",8,20,12
"UTP4","s954_F_VTA_03_ASEReadCounter.table","NW_015090842.1:10295938",10,27,17
"UTP4","s954_F_VTA_03_ASEReadCounter.table","NW_015090842.1:10296175",12,22,10
"UTP4","s954_F_VTA_03_ASEReadCounter.table","NW_015090842.1:10296660",19,39,20
"UTP4","s954_F_VTA_03_ASEReadCounter.table","NW_015090842.1:10296679",20,39,19
"UTP4","s954_F_VTA_03_ASEReadCounter.table","NW_015090842.1:10297193",21,39,18
"UTP4","s954_F_VTA_03_ASEReadCounter.table","NW_015090842.1:10297220",23,48,25
"UTP4","s954_F_VTA_03_ASEReadCounter.table","NW_015090842.1:10297307",25,54,29
"UTP4","s954_F_VTA_03_ASEReadCounter.table","NW_015090842.1:10297558",27,62,35
"UTP4","s954_F_VTA_03_ASEReadCounter.table","NW_015090842.1:10297943",21,52,31
"UTP4","s954_F_VTA_03_ASEReadCounter.table","NW_015090842.1:10297979",19,42,23
"UTP4","s954_F_VTA_03_ASEReadCounter.table","NW_015090842.1:10298022",13,31,18
"UTP4","s954_F_VTA_03_ASEReadCounter.table","NW_015090842.1:10298079",2,10,8
"UTP4","s954_F_VTA_03_ASEReadCounter.table","NW_015090842.1:10298081",2,10,8
"UTP4","s954_F_VTA_03_ASEReadCounter.table","NW_015090842.1:10298082",1,10,9
"SNTB2","s954_F_VTA_03_ASEReadCounter.table","NW_015090842.1:10298905",0,1,1
"SNTB2","s954_F_VTA_03_ASEReadCounter.table","NW_015090842.1:10303506",1,3,2
"SNTB2","s954_F_VTA_03_ASEReadCounter.table","NW_015090842.1:10303524",1,2,1
"SNTB2","s954_F_VTA_03_ASEReadCounter.table","NW_015090842.1:10304059",2,3,1
"SNTB2","s954_F_VTA_03_ASEReadCounter.table","NW_015090842.1:10304089",1,2,1
"SNTB2","s954_F_VTA_03_ASEReadCounter.table","NW_015090842.1:10304167",2,4,2
"SNTB2","s954_F_VTA_03_ASEReadCounter.table","NW_015090842.1:10304176",3,5,2
"SNTB2","s954_F_VTA_03_ASEReadCounter.table","NW_015090842.1:10305069",3,5,2
"SNTB2","s954_F_VTA_03_ASEReadCounter.table","NW_015090842.1:10305099",2,5,3
"SNTB2","s954_F_VTA_03_ASEReadCounter.table","NW_015090842.1:10305171",2,4,2
"SNTB2","s954_F_VTA_03_ASEReadCounter.table","NW_015090842.1:10305177",2,4,2
"SNTB2","s954_F_VTA_03_ASEReadCounter.table","NW_015090842.1:10305451",3,6,3
"SNTB2","s954_F_VTA_03_ASEReadCounter.table","NW_015090842.1:10305547",3,4,1
"SNTB2","s954_F_VTA_03_ASEReadCounter.table","NW_015090842.1:10305847",2,4,2
"SNTB2","s954_F_VTA_03_ASEReadCounter.table","NW_015090842.1:10306173",2,4,2
"SNTB2","s954_F_VTA_03_ASEReadCounter.table","NW_015090842.1:10306275",2,3,1
"SNTB2","s954_F_VTA_03_ASEReadCounter.table","NW_015090842.1:10306457",2,6,4
"SNTB2","s954_F_VTA_03_ASEReadCounter.table","NW_015090842.1:10306496",1,5,4
"SNTB2","s954_F_VTA_03_ASEReadCounter.table","NW_015090842.1:10306499",1,4,3
"VPS4A","s954_F_VTA_03_ASEReadCounter.table","NW_015090842.1:10308566",64,140,76
"VPS4A","s954_F_VTA_03_ASEReadCounter.table","NW_015090842.1:10308573",62,140,78
"VPS4A","s954_F_VTA_03_ASEReadCounter.table","NW_015090842.1:10308856",102,233,131
"VPS4A","s954_F_VTA_03_ASEReadCounter.table","NW_015090842.1:10309056",149,295,146
"VPS4A","s954_F_VTA_03_ASEReadCounter.table","NW_015090842.1:10309089",159,322,163
"VPS4A","s954_F_VTA_03_ASEReadCounter.table","NW_015090842.1:10309392",155,287,132
"VPS4A","s954_F_VTA_03_ASEReadCounter.table","NW_015090842.1:10309413",152,299,147
"VPS4A","s954_F_VTA_03_ASEReadCounter.table","NW_015090842.1:10309467",128,317,189
"VPS4A","s954_F_VTA_03_ASEReadCounter.table","NW_015090842.1:10310230",172,372,200
"VPS4A","s954_F_VTA_03_ASEReadCounter.table","NW_015090842.1:10310425",176,334,158
"VPS4A","s954_F_VTA_03_ASEReadCounter.table","NW_015090842.1:10310639",184,346,162
"VPS4A","s954_F_VTA_03_ASEReadCounter.table","NW_015090842.1:10310734",146,304,158
"VPS4A","s954_F_VTA_03_ASEReadCounter.table","NW_015090842.1:10310737",151,316,165
"VPS4A","s954_F_VTA_03_ASEReadCounter.table","NW_015090842.1:10310746",149,317,168
"VPS4A","s954_F_VTA_03_ASEReadCounter.table","NW_015090842.1:10310767",154,326,172
"VPS4A","s954_F_VTA_03_ASEReadCounter.table","NW_015090842.1:10310995",151,327,176
"VPS4A","s954_F_VTA_03_ASEReadCounter.table","NW_015090842.1:10311004",148,318,170
"VPS4A","s954_F_VTA_03_ASEReadCounter.table","NW_015090842.1:10311007",147,323,176
"VPS4A","s954_F_VTA_03_ASEReadCounter.table","NW_015090842.1:10311013",165,337,172
"VPS4A","s954_F_VTA_03_ASEReadCounter.table","NW_015090842.1:10311022",161,331,170
"VPS4A","s954_F_VTA_03_ASEReadCounter.table","NW_015090842.1:10311023",161,326,165
"VPS4A","s954_F_VTA_03_ASEReadCounter.table","NW_015090842.1:10311426",183,377,194
"VPS4A","s954_F_VTA_03_ASEReadCounter.table","NW_015090842.1:10311489",2,8,6
"VPS4A","s954_F_VTA_03_ASEReadCounter.table","NW_015090842.1:10311490",2,7,5
"VPS4A","s954_F_VTA_03_ASEReadCounter.table","NW_015090842.1:10311525",11,22,11
"VPS4A","s954_F_VTA_03_ASEReadCounter.table","NW_015090842.1:10311529",13,32,19
"VPS4A","s954_F_VTA_03_ASEReadCounter.table","NW_015090842.1:10311530",13,35,22
"VPS4A","s954_F_VTA_03_ASEReadCounter.table","NW_015090842.1:10311552",33,66,33
"VPS4A","s954_F_VTA_03_ASEReadCounter.table","NW_015090842.1:10311689",31,83,52
"VPS4A","s954_F_VTA_03_ASEReadCounter.table","NW_015090842.1:10311700",42,87,45
"VPS4A","s954_F_VTA_03_ASEReadCounter.table","NW_015090842.1:10311701",41,90,49
"VPS4A","s954_F_VTA_03_ASEReadCounter.table","NW_015090842.1:10311703",42,90,48
"COG8","s954_F_VTA_03_ASEReadCounter.table","NW_015090842.1:10313487",23,49,26
"COG8","s954_F_VTA_03_ASEReadCounter.table","NW_015090842.1:10313559",33,64,31
"COG8","s954_F_VTA_03_ASEReadCounter.table","NW_015090842.1:10313579",25,55,30
"COG8","s954_F_VTA_03_ASEReadCounter.table","NW_015090842.1:10313665",20,50,30
"COG8","s954_F_VTA_03_ASEReadCounter.table","NW_015090842.1:10313681",23,55,32
"COG8","s954_F_VTA_03_ASEReadCounter.table","NW_015090842.1:10313768",34,60,26
"COG8","s954_F_VTA_03_ASEReadCounter.table","NW_015090842.1:10313775",31,58,27
"COG8","s954_F_VTA_03_ASEReadCounter.table","NW_015090842.1:10313811",22,44,22
"COG8","s954_F_VTA_03_ASEReadCounter.table","NW_015090842.1:10313858",20,42,22
"COG8","s954_F_VTA_03_ASEReadCounter.table","NW_015090842.1:10314100",28,49,21
"COG8","s954_F_VTA_03_ASEReadCounter.table","NW_015090842.1:10314213",22,48,26
"COG8","s954_F_VTA_03_ASEReadCounter.table","NW_015090842.1:10315093",21,42,21
"COG8","s954_F_VTA_03_ASEReadCounter.table","NW_015090842.1:10315162",21,48,27
"COG8","s954_F_VTA_03_ASEReadCounter.table","NW_015090842.1:10315285",25,48,23
"COG8","s954_F_VTA_03_ASEReadCounter.table","NW_015090842.1:10315360",8,21,13
"COG8","s954_F_VTA_03_ASEReadCounter.table","NW_015090842.1:10315369",10,23,13
"COG8","s954_F_VTA_03_ASEReadCounter.table","NW_015090842.1:10315504",10,22,12
"COG8","s954_F_VTA_03_ASEReadCounter.table","NW_015090842.1:10315508",10,22,12
"COG8","s954_F_VTA_03_ASEReadCounter.table","NW_015090842.1:10315624",16,33,17
"COG8","s954_F_VTA_03_ASEReadCounter.table","NW_015090842.1:10315693",13,30,17
"COG8","s954_F_VTA_03_ASEReadCounter.table","NW_015090842.1:10315698",13,30,17
"COG8","s954_F_VTA_03_ASEReadCounter.table","NW_015090842.1:10315768",14,29,15
"COG8","s954_F_VTA_03_ASEReadCounter.table","NW_015090842.1:10315769",14,29,15
"COG8","s954_F_VTA_03_ASEReadCounter.table","NW_015090842.1:10315784",11,22,11
"COG8","s954_F_VTA_03_ASEReadCounter.table","NW_015090842.1:10316093",13,25,12
"COG8","s954_F_VTA_03_ASEReadCounter.table","NW_015090842.1:10316133",13,24,11
"NIP7","s954_F_VTA_03_ASEReadCounter.table","NW_015090842.1:10316759",14,29,15
"NIP7","s954_F_VTA_03_ASEReadCounter.table","NW_015090842.1:10316967",86,167,81
"NIP7","s954_F_VTA_03_ASEReadCounter.table","NW_015090842.1:10316995",107,202,95
"NIP7","s954_F_VTA_03_ASEReadCounter.table","NW_015090842.1:10317240",130,269,139
"NIP7","s954_F_VTA_03_ASEReadCounter.table","NW_015090842.1:10317247",125,257,132
"NIP7","s954_F_VTA_03_ASEReadCounter.table","NW_015090842.1:10317264",122,244,122
"NIP7","s954_F_VTA_03_ASEReadCounter.table","NW_015090842.1:10317433",143,308,165
"NIP7","s954_F_VTA_03_ASEReadCounter.table","NW_015090842.1:10317738",118,267,149
"NIP7","s954_F_VTA_03_ASEReadCounter.table","NW_015090842.1:10317769",127,270,143
"NIP7","s954_F_VTA_03_ASEReadCounter.table","NW_015090842.1:10317808",84,179,95
"NIP7","s954_F_VTA_03_ASEReadCounter.table","NW_015090842.1:10317870",54,142,88
"NIP7","s954_F_VTA_03_ASEReadCounter.table","NW_015090842.1:10317871",55,138,83
"NIP7","s954_F_VTA_03_ASEReadCounter.table","NW_015090842.1:10317898",39,108,69
"NIP7","s954_F_VTA_03_ASEReadCounter.table","NW_015090842.1:10317911",36,97,61
"TMED6","s954_F_VTA_03_ASEReadCounter.table","NW_015090842.1:10318731",1,1,0
"TERF2","s954_F_VTA_03_ASEReadCounter.table","NW_015090842.1:10321665",8,8,0
"TERF2","s954_F_VTA_03_ASEReadCounter.table","NW_015090842.1:10321768",25,52,27
"TERF2","s954_F_VTA_03_ASEReadCounter.table","NW_015090842.1:10321777",23,50,27
"TERF2","s954_F_VTA_03_ASEReadCounter.table","NW_015090842.1:10321805",26,59,33
"TERF2","s954_F_VTA_03_ASEReadCounter.table","NW_015090842.1:10321878",38,85,47
"TERF2","s954_F_VTA_03_ASEReadCounter.table","NW_015090842.1:10321893",3,80,77
"TERF2","s954_F_VTA_03_ASEReadCounter.table","NW_015090842.1:10321897",23,66,43
"TERF2","s954_F_VTA_03_ASEReadCounter.table","NW_015090842.1:10321908",22,62,40
"TERF2","s954_F_VTA_03_ASEReadCounter.table","NW_015090842.1:10322001",33,88,55
"TERF2","s954_F_VTA_03_ASEReadCounter.table","NW_015090842.1:10322035",25,70,45
"TERF2","s954_F_VTA_03_ASEReadCounter.table","NW_015090842.1:10322051",32,91,59
"TERF2","s954_F_VTA_03_ASEReadCounter.table","NW_015090842.1:10322137",35,74,39
"TERF2","s954_F_VTA_03_ASEReadCounter.table","NW_015090842.1:10322144",32,66,34
"TERF2","s954_F_VTA_03_ASEReadCounter.table","NW_015090842.1:10322388",19,76,57
"TERF2","s954_F_VTA_03_ASEReadCounter.table","NW_015090842.1:10322396",20,73,53
"TERF2","s954_F_VTA_03_ASEReadCounter.table","NW_015090842.1:10322502",26,64,38
"TERF2","s954_F_VTA_03_ASEReadCounter.table","NW_015090842.1:10322504",27,65,38
"TERF2","s954_F_VTA_03_ASEReadCounter.table","NW_015090842.1:10322510",27,64,37
"TERF2","s954_F_VTA_03_ASEReadCounter.table","NW_015090842.1:10323580",29,83,54
"TERF2","s954_F_VTA_03_ASEReadCounter.table","NW_015090842.1:10324314",30,79,49
"TERF2","s954_F_VTA_03_ASEReadCounter.table","NW_015090842.1:10326832",21,60,39
"TERF2","s954_F_VTA_03_ASEReadCounter.table","NW_015090842.1:10327787",17,34,17
"TERF2","s954_F_VTA_03_ASEReadCounter.table","NW_015090842.1:10328588",12,38,26
"TERF2","s954_F_VTA_03_ASEReadCounter.table","NW_015090842.1:10328644",8,32,24
"TERF2","s954_F_VTA_03_ASEReadCounter.table","NW_015090842.1:10329813",15,36,21
"TERF2","s954_F_VTA_03_ASEReadCounter.table","NW_015090842.1:10330749",13,31,18
"TERF2","s954_F_VTA_03_ASEReadCounter.table","NW_015090842.1:10330789",11,28,17
"CYB5B","s954_F_VTA_03_ASEReadCounter.table","NW_015090842.1:10336595",4,9,5
"CYB5B","s954_F_VTA_03_ASEReadCounter.table","NW_015090842.1:10336667",46,78,32
"CYB5B","s954_F_VTA_03_ASEReadCounter.table","NW_015090842.1:10336689",68,124,56
"CYB5B","s954_F_VTA_03_ASEReadCounter.table","NW_015090842.1:10336728",91,182,91
"CYB5B","s954_F_VTA_03_ASEReadCounter.table","NW_015090842.1:10345068",77,156,79
"CYB5B","s954_F_VTA_03_ASEReadCounter.table","NW_015090842.1:10348800",143,255,112
"CYB5B","s954_F_VTA_03_ASEReadCounter.table","NW_015090842.1:10348888",109,212,103
"CYB5B","s954_F_VTA_03_ASEReadCounter.table","NW_015090842.1:10349046",118,230,112
"CYB5B","s954_F_VTA_03_ASEReadCounter.table","NW_015090842.1:10349119",75,176,101
"CYB5B","s954_F_VTA_03_ASEReadCounter.table","NW_015090842.1:10349146",58,161,103
"CYB5B","s954_F_VTA_03_ASEReadCounter.table","NW_015090842.1:10349157",88,193,105
