"gene","id","snp","ref_count","total_count","alt_count"
"CENPN","s954_F_NC_02_ASEReadCounter.table","NW_015090842.1:5801623",1,1,0
"CENPN","s954_F_NC_02_ASEReadCounter.table","NW_015090842.1:5801631",1,1,0
"CENPN","s954_F_NC_02_ASEReadCounter.table","NW_015090842.1:5801632",1,1,0
"CENPN","s954_F_NC_02_ASEReadCounter.table","NW_015090842.1:5801655",1,1,0
"CENPN","s954_F_NC_02_ASEReadCounter.table","NW_015090842.1:5801662",1,1,0
"CENPN","s954_F_NC_02_ASEReadCounter.table","NW_015090842.1:5801670",1,1,0
"CENPN","s954_F_NC_02_ASEReadCounter.table","NW_015090842.1:5801674",1,1,0
"CENPN","s954_F_NC_02_ASEReadCounter.table","NW_015090842.1:5801692",1,1,0
"CENPN","s954_F_NC_02_ASEReadCounter.table","NW_015090842.1:5801697",1,1,0
"CENPN","s954_F_NC_02_ASEReadCounter.table","NW_015090842.1:5802008",0,7,7
"CENPN","s954_F_NC_02_ASEReadCounter.table","NW_015090842.1:5802012",0,8,8
"CENPN","s954_F_NC_02_ASEReadCounter.table","NW_015090842.1:5802087",1,6,5
"CENPN","s954_F_NC_02_ASEReadCounter.table","NW_015090842.1:5810113",1,1,0
"CENPN","s954_F_NC_02_ASEReadCounter.table","NW_015090842.1:5810147",1,1,0
"CENPN","s954_F_NC_02_ASEReadCounter.table","NW_015090842.1:5810148",1,1,0
"ATMIN","s954_F_NC_02_ASEReadCounter.table","NW_015090842.1:5818789",0,3,3
"ATMIN","s954_F_NC_02_ASEReadCounter.table","NW_015090842.1:5819958",4,8,4
"ATMIN","s954_F_NC_02_ASEReadCounter.table","NW_015090842.1:5820004",3,6,3
"ATMIN","s954_F_NC_02_ASEReadCounter.table","NW_015090842.1:5820217",4,4,0
"ATMIN","s954_F_NC_02_ASEReadCounter.table","NW_015090842.1:5820250",3,4,1
"ATMIN","s954_F_NC_02_ASEReadCounter.table","NW_015090842.1:5820298",2,4,2
"ATMIN","s954_F_NC_02_ASEReadCounter.table","NW_015090842.1:5820417",2,3,1
"ATMIN","s954_F_NC_02_ASEReadCounter.table","NW_015090842.1:5820421",1,2,1
"ATMIN","s954_F_NC_02_ASEReadCounter.table","NW_015090842.1:5820448",2,3,1
"ATMIN","s954_F_NC_02_ASEReadCounter.table","NW_015090842.1:5820457",3,4,1
"ATMIN","s954_F_NC_02_ASEReadCounter.table","NW_015090842.1:5820510",4,7,3
"ATMIN","s954_F_NC_02_ASEReadCounter.table","NW_015090842.1:5820673",2,5,3
"ATMIN","s954_F_NC_02_ASEReadCounter.table","NW_015090842.1:5820754",5,6,1
"ATMIN","s954_F_NC_02_ASEReadCounter.table","NW_015090842.1:5820820",2,3,1
"ATMIN","s954_F_NC_02_ASEReadCounter.table","NW_015090842.1:5820865",2,4,2
"ATMIN","s954_F_NC_02_ASEReadCounter.table","NW_015090842.1:5820889",3,5,2
"ATMIN","s954_F_NC_02_ASEReadCounter.table","NW_015090842.1:5820891",3,5,2
"ATMIN","s954_F_NC_02_ASEReadCounter.table","NW_015090842.1:5820997",2,4,2
"ATMIN","s954_F_NC_02_ASEReadCounter.table","NW_015090842.1:5821063",3,6,3
"ATMIN","s954_F_NC_02_ASEReadCounter.table","NW_015090842.1:5821132",6,8,2
"ATMIN","s954_F_NC_02_ASEReadCounter.table","NW_015090842.1:5821645",3,6,3
"ATMIN","s954_F_NC_02_ASEReadCounter.table","NW_015090842.1:5825066",14,27,13
"ATMIN","s954_F_NC_02_ASEReadCounter.table","NW_015090842.1:5825106",11,26,15
"ATMIN","s954_F_NC_02_ASEReadCounter.table","NW_015090842.1:5825122",11,28,17
"ATMIN","s954_F_NC_02_ASEReadCounter.table","NW_015090842.1:5825178",12,34,22
"ATMIN","s954_F_NC_02_ASEReadCounter.table","NW_015090842.1:5825194",13,32,19
"ATMIN","s954_F_NC_02_ASEReadCounter.table","NW_015090842.1:5825195",13,30,17
"ATMIN","s954_F_NC_02_ASEReadCounter.table","NW_015090842.1:5825220",11,27,16
"ATMIN","s954_F_NC_02_ASEReadCounter.table","NW_015090842.1:5825240",16,27,11
"ATMIN","s954_F_NC_02_ASEReadCounter.table","NW_015090842.1:5825303",24,40,16
"ATMIN","s954_F_NC_02_ASEReadCounter.table","NW_015090842.1:5825304",24,41,17
"ATMIN","s954_F_NC_02_ASEReadCounter.table","NW_015090842.1:5825310",23,40,17
"ATMIN","s954_F_NC_02_ASEReadCounter.table","NW_015090842.1:5825406",10,29,19
"ATMIN","s954_F_NC_02_ASEReadCounter.table","NW_015090842.1:5825415",10,32,22
"ATMIN","s954_F_NC_02_ASEReadCounter.table","NW_015090842.1:5825438",14,39,25
"ATMIN","s954_F_NC_02_ASEReadCounter.table","NW_015090842.1:5825485",12,40,28
"ATMIN","s954_F_NC_02_ASEReadCounter.table","NW_015090842.1:5825524",23,46,23
"ATMIN","s954_F_NC_02_ASEReadCounter.table","NW_015090842.1:5825557",23,46,23
"ATMIN","s954_F_NC_02_ASEReadCounter.table","NW_015090842.1:5825571",24,47,23
"ATMIN","s954_F_NC_02_ASEReadCounter.table","NW_015090842.1:5825579",24,49,25
"ATMIN","s954_F_NC_02_ASEReadCounter.table","NW_015090842.1:5825590",23,46,23
"ATMIN","s954_F_NC_02_ASEReadCounter.table","NW_015090842.1:5825689",19,47,28
"ATMIN","s954_F_NC_02_ASEReadCounter.table","NW_015090842.1:5825703",25,52,27
"ATMIN","s954_F_NC_02_ASEReadCounter.table","NW_015090842.1:5825787",22,39,17
"ATMIN","s954_F_NC_02_ASEReadCounter.table","NW_015090842.1:5825833",14,34,20
"ATMIN","s954_F_NC_02_ASEReadCounter.table","NW_015090842.1:5825841",13,29,16
"ATMIN","s954_F_NC_02_ASEReadCounter.table","NW_015090842.1:5825895",23,44,21
"ATMIN","s954_F_NC_02_ASEReadCounter.table","NW_015090842.1:5825984",22,55,33
"ATMIN","s954_F_NC_02_ASEReadCounter.table","NW_015090842.1:5826162",28,59,31
"ATMIN","s954_F_NC_02_ASEReadCounter.table","NW_015090842.1:5826194",30,63,33
"ATMIN","s954_F_NC_02_ASEReadCounter.table","NW_015090842.1:5826235",33,66,33
"ATMIN","s954_F_NC_02_ASEReadCounter.table","NW_015090842.1:5826245",27,59,32
"ATMIN","s954_F_NC_02_ASEReadCounter.table","NW_015090842.1:5826335",24,49,25
"ATMIN","s954_F_NC_02_ASEReadCounter.table","NW_015090842.1:5826417",26,56,30
"ATMIN","s954_F_NC_02_ASEReadCounter.table","NW_015090842.1:5826431",24,68,44
"ATMIN","s954_F_NC_02_ASEReadCounter.table","NW_015090842.1:5826438",30,66,36
"ATMIN","s954_F_NC_02_ASEReadCounter.table","NW_015090842.1:5826463",34,82,48
"ATMIN","s954_F_NC_02_ASEReadCounter.table","NW_015090842.1:5826502",37,93,56
"ATMIN","s954_F_NC_02_ASEReadCounter.table","NW_015090842.1:5826511",38,95,57
"ATMIN","s954_F_NC_02_ASEReadCounter.table","NW_015090842.1:5826659",35,77,42
"ATMIN","s954_F_NC_02_ASEReadCounter.table","NW_015090842.1:5826701",35,88,53
"ATMIN","s954_F_NC_02_ASEReadCounter.table","NW_015090842.1:5826702",34,86,52
"ATMIN","s954_F_NC_02_ASEReadCounter.table","NW_015090842.1:5826732",42,104,62
"ATMIN","s954_F_NC_02_ASEReadCounter.table","NW_015090842.1:5826745",40,104,64
"ATMIN","s954_F_NC_02_ASEReadCounter.table","NW_015090842.1:5826835",50,86,36
"ATMIN","s954_F_NC_02_ASEReadCounter.table","NW_015090842.1:5826942",30,80,50
"ATMIN","s954_F_NC_02_ASEReadCounter.table","NW_015090842.1:5827193",51,140,89
"ATMIN","s954_F_NC_02_ASEReadCounter.table","NW_015090842.1:5827196",45,134,89
"ATMIN","s954_F_NC_02_ASEReadCounter.table","NW_015090842.1:5827269",60,135,75
"ATMIN","s954_F_NC_02_ASEReadCounter.table","NW_015090842.1:5827315",41,96,55
"ATMIN","s954_F_NC_02_ASEReadCounter.table","NW_015090842.1:5827316",40,97,57
"ATMIN","s954_F_NC_02_ASEReadCounter.table","NW_015090842.1:5827333",41,93,52
"PPP1R3E","s954_F_NC_02_ASEReadCounter.table","NW_015090842.1:5837733",0,3,3
"PPP1R3E","s954_F_NC_02_ASEReadCounter.table","NW_015090842.1:5837947",2,4,2
"PKD1L2","s954_F_NC_02_ASEReadCounter.table","NW_015090842.1:5867509",1,1,0
"PKD1L2","s954_F_NC_02_ASEReadCounter.table","NW_015090842.1:5867597",2,2,0
"PKD1L2","s954_F_NC_02_ASEReadCounter.table","NW_015090842.1:5867600",2,2,0
"PKD1L2","s954_F_NC_02_ASEReadCounter.table","NW_015090842.1:5867660",1,1,0
"PKD1L2","s954_F_NC_02_ASEReadCounter.table","NW_015090842.1:5867675",1,1,0
"BCO1","s954_F_NC_02_ASEReadCounter.table","NW_015090842.1:5915610",0,1,1
"BCO1","s954_F_NC_02_ASEReadCounter.table","NW_015090842.1:5915646",0,1,1
"BCO1","s954_F_NC_02_ASEReadCounter.table","NW_015090842.1:5917941",1,1,0
"BCO1","s954_F_NC_02_ASEReadCounter.table","NW_015090842.1:5917971",1,1,0
"BCO1","s954_F_NC_02_ASEReadCounter.table","NW_015090842.1:5921679",1,1,0
"BCO1","s954_F_NC_02_ASEReadCounter.table","NW_015090842.1:5921726",2,2,0
"BCO1","s954_F_NC_02_ASEReadCounter.table","NW_015090842.1:5925669",0,1,1
"BCO1","s954_F_NC_02_ASEReadCounter.table","NW_015090842.1:5926937",2,5,3
"BCO1","s954_F_NC_02_ASEReadCounter.table","NW_015090842.1:5927921",0,3,3
"BCO1","s954_F_NC_02_ASEReadCounter.table","NW_015090842.1:5927948",0,3,3
"BCO1","s954_F_NC_02_ASEReadCounter.table","NW_015090842.1:5927968",0,4,4
"BCO1","s954_F_NC_02_ASEReadCounter.table","NW_015090842.1:5928052",1,2,1
"BCO1","s954_F_NC_02_ASEReadCounter.table","NW_015090842.1:5932726",4,5,1
"BCO1","s954_F_NC_02_ASEReadCounter.table","NW_015090842.1:5932801",6,7,1
"BCO1","s954_F_NC_02_ASEReadCounter.table","NW_015090842.1:5934558",9,11,2
"BCO1","s954_F_NC_02_ASEReadCounter.table","NW_015090842.1:5934575",7,9,2
"BCO1","s954_F_NC_02_ASEReadCounter.table","NW_015090842.1:5934608",5,8,3
"BCO1","s954_F_NC_02_ASEReadCounter.table","NW_015090842.1:5934647",10,13,3
"BCO1","s954_F_NC_02_ASEReadCounter.table","NW_015090842.1:5934725",6,7,1
"BCO1","s954_F_NC_02_ASEReadCounter.table","NW_015090842.1:5934726",6,6,0
"BCO1","s954_F_NC_02_ASEReadCounter.table","NW_015090842.1:5934733",5,6,1
"BCO1","s954_F_NC_02_ASEReadCounter.table","NW_015090842.1:5934821",6,9,3
"BCO1","s954_F_NC_02_ASEReadCounter.table","NW_015090842.1:5934826",4,7,3
"BCO1","s954_F_NC_02_ASEReadCounter.table","NW_015090842.1:5934844",2,4,2
"BCO1","s954_F_NC_02_ASEReadCounter.table","NW_015090842.1:5934958",3,7,4
"BCO1","s954_F_NC_02_ASEReadCounter.table","NW_015090842.1:5934976",4,6,2
"GAN","s954_F_NC_02_ASEReadCounter.table","NW_015090842.1:5939249",0,3,3
"GAN","s954_F_NC_02_ASEReadCounter.table","NW_015090842.1:5953759",3,8,5
"GAN","s954_F_NC_02_ASEReadCounter.table","NW_015090842.1:5957502",5,14,9
"GAN","s954_F_NC_02_ASEReadCounter.table","NW_015090842.1:5957578",4,21,17
"GAN","s954_F_NC_02_ASEReadCounter.table","NW_015090842.1:5966047",10,24,14
"GAN","s954_F_NC_02_ASEReadCounter.table","NW_015090842.1:5966126",10,24,14
"GAN","s954_F_NC_02_ASEReadCounter.table","NW_015090842.1:5966127",10,25,15
"GAN","s954_F_NC_02_ASEReadCounter.table","NW_015090842.1:5966162",12,30,18
"GAN","s954_F_NC_02_ASEReadCounter.table","NW_015090842.1:5966483",33,76,43
"CMIP","s954_F_NC_02_ASEReadCounter.table","NW_015090842.1:6109159",9,15,6
"CMIP","s954_F_NC_02_ASEReadCounter.table","NW_015090842.1:6109166",7,13,6
"CMIP","s954_F_NC_02_ASEReadCounter.table","NW_015090842.1:6114641",9,17,8
"CMIP","s954_F_NC_02_ASEReadCounter.table","NW_015090842.1:6114751",15,23,8
"CMIP","s954_F_NC_02_ASEReadCounter.table","NW_015090842.1:6114824",5,11,6
"CMIP","s954_F_NC_02_ASEReadCounter.table","NW_015090842.1:6126295",26,26,0
"CMIP","s954_F_NC_02_ASEReadCounter.table","NW_015090842.1:6128998",15,33,18
"CMIP","s954_F_NC_02_ASEReadCounter.table","NW_015090842.1:6130562",41,74,33
"CMIP","s954_F_NC_02_ASEReadCounter.table","NW_015090842.1:6132522",32,65,33
"CMIP","s954_F_NC_02_ASEReadCounter.table","NW_015090842.1:6138265",88,179,91
"CMIP","s954_F_NC_02_ASEReadCounter.table","NW_015090842.1:6138300",84,176,92
"CMIP","s954_F_NC_02_ASEReadCounter.table","NW_015090842.1:6138342",73,151,78
"CMIP","s954_F_NC_02_ASEReadCounter.table","NW_015090842.1:6138343",71,146,75
"CMIP","s954_F_NC_02_ASEReadCounter.table","NW_015090842.1:6138345",73,152,79
"CMIP","s954_F_NC_02_ASEReadCounter.table","NW_015090842.1:6138647",38,86,48
"CMIP","s954_F_NC_02_ASEReadCounter.table","NW_015090842.1:6138745",51,112,61
"CMIP","s954_F_NC_02_ASEReadCounter.table","NW_015090842.1:6138832",13,48,35
"CMIP","s954_F_NC_02_ASEReadCounter.table","NW_015090842.1:6138967",34,95,61
"CMIP","s954_F_NC_02_ASEReadCounter.table","NW_015090842.1:6139131",19,51,32
"CMIP","s954_F_NC_02_ASEReadCounter.table","NW_015090842.1:6139163",5,39,34
"CMIP","s954_F_NC_02_ASEReadCounter.table","NW_015090842.1:6139212",92,93,1
"CMIP","s954_F_NC_02_ASEReadCounter.table","NW_015090842.1:6139360",20,41,21
"CMIP","s954_F_NC_02_ASEReadCounter.table","NW_015090842.1:6139572",8,15,7
"PLCG2","s954_F_NC_02_ASEReadCounter.table","NW_015090842.1:6179658",1,2,1
"PLCG2","s954_F_NC_02_ASEReadCounter.table","NW_015090842.1:6203775",1,1,0
"PLCG2","s954_F_NC_02_ASEReadCounter.table","NW_015090842.1:6203787",1,1,0
"PLCG2","s954_F_NC_02_ASEReadCounter.table","NW_015090842.1:6209741",0,1,1
"PLCG2","s954_F_NC_02_ASEReadCounter.table","NW_015090842.1:6209798",1,1,0
"PLCG2","s954_F_NC_02_ASEReadCounter.table","NW_015090842.1:6209816",1,1,0
"PLCG2","s954_F_NC_02_ASEReadCounter.table","NW_015090842.1:6217547",1,2,1
"PLCG2","s954_F_NC_02_ASEReadCounter.table","NW_015090842.1:6218641",0,2,2
"PLCG2","s954_F_NC_02_ASEReadCounter.table","NW_015090842.1:6228672",0,2,2
"PLCG2","s954_F_NC_02_ASEReadCounter.table","NW_015090842.1:6228694",0,2,2
"PLCG2","s954_F_NC_02_ASEReadCounter.table","NW_015090842.1:6228722",0,2,2
"PLCG2","s954_F_NC_02_ASEReadCounter.table","NW_015090842.1:6228747",0,2,2
"PLCG2","s954_F_NC_02_ASEReadCounter.table","NW_015090842.1:6228835",2,4,2
"PLCG2","s954_F_NC_02_ASEReadCounter.table","NW_015090842.1:6228841",2,4,2
"PLCG2","s954_F_NC_02_ASEReadCounter.table","NW_015090842.1:6228865",1,2,1
"PLCG2","s954_F_NC_02_ASEReadCounter.table","NW_015090842.1:6228917",1,2,1
"PLCG2","s954_F_NC_02_ASEReadCounter.table","NW_015090842.1:6228926",1,2,1
"PLCG2","s954_F_NC_02_ASEReadCounter.table","NW_015090842.1:6229002",1,1,0
"PLCG2","s954_F_NC_02_ASEReadCounter.table","NW_015090842.1:6229006",1,1,0
"PLCG2","s954_F_NC_02_ASEReadCounter.table","NW_015090842.1:6230349",0,1,1
"PLCG2","s954_F_NC_02_ASEReadCounter.table","NW_015090842.1:6230408",0,1,1
"PLCG2","s954_F_NC_02_ASEReadCounter.table","NW_015090842.1:6230898",3,4,1
"PLCG2","s954_F_NC_02_ASEReadCounter.table","NW_015090842.1:6230976",2,3,1
"PLCG2","s954_F_NC_02_ASEReadCounter.table","NW_015090842.1:6231078",2,3,1
"PLCG2","s954_F_NC_02_ASEReadCounter.table","NW_015090842.1:6231138",1,2,1
"PLCG2","s954_F_NC_02_ASEReadCounter.table","NW_015090842.1:6231177",1,2,1
"PLCG2","s954_F_NC_02_ASEReadCounter.table","NW_015090842.1:6231263",1,1,0
"SDR42E1","s954_F_NC_02_ASEReadCounter.table","NW_015090842.1:6235292",3,4,1
"SDR42E1","s954_F_NC_02_ASEReadCounter.table","NW_015090842.1:6235315",3,7,4
"SDR42E1","s954_F_NC_02_ASEReadCounter.table","NW_015090842.1:6235348",3,9,6
"SDR42E1","s954_F_NC_02_ASEReadCounter.table","NW_015090842.1:6235355",3,9,6
"SDR42E1","s954_F_NC_02_ASEReadCounter.table","NW_015090842.1:6235417",2,6,4
"SDR42E1","s954_F_NC_02_ASEReadCounter.table","NW_015090842.1:6235558",2,6,4
"SDR42E1","s954_F_NC_02_ASEReadCounter.table","NW_015090842.1:6235741",1,4,3
"SDR42E1","s954_F_NC_02_ASEReadCounter.table","NW_015090842.1:6235777",1,4,3
"SDR42E1","s954_F_NC_02_ASEReadCounter.table","NW_015090842.1:6235806",1,4,3
"SDR42E1","s954_F_NC_02_ASEReadCounter.table","NW_015090842.1:6235809",1,4,3
"SDR42E1","s954_F_NC_02_ASEReadCounter.table","NW_015090842.1:6235816",1,4,3
"SDR42E1","s954_F_NC_02_ASEReadCounter.table","NW_015090842.1:6235914",0,3,3
"SDR42E1","s954_F_NC_02_ASEReadCounter.table","NW_015090842.1:6235935",0,1,1
"SDR42E1","s954_F_NC_02_ASEReadCounter.table","NW_015090842.1:6235957",0,1,1
"SDR42E1","s954_F_NC_02_ASEReadCounter.table","NW_015090842.1:6236040",0,2,2
"SDR42E1","s954_F_NC_02_ASEReadCounter.table","NW_015090842.1:6236260",2,4,2
"SDR42E1","s954_F_NC_02_ASEReadCounter.table","NW_015090842.1:6236281",2,5,3
"SDR42E1","s954_F_NC_02_ASEReadCounter.table","NW_015090842.1:6236305",2,7,5
"SDR42E1","s954_F_NC_02_ASEReadCounter.table","NW_015090842.1:6236458",0,3,3
"SDR42E1","s954_F_NC_02_ASEReadCounter.table","NW_015090842.1:6236476",0,3,3
"SDR42E1","s954_F_NC_02_ASEReadCounter.table","NW_015090842.1:6236608",0,1,1
"SDR42E1","s954_F_NC_02_ASEReadCounter.table","NW_015090842.1:6238244",1,1,0
"SDR42E1","s954_F_NC_02_ASEReadCounter.table","NW_015090842.1:6238829",2,2,0
"HSD17B2","s954_F_NC_02_ASEReadCounter.table","NW_015090842.1:6257829",0,1,1
"HSD17B2","s954_F_NC_02_ASEReadCounter.table","NW_015090842.1:6257851",0,1,1
"HSD17B2","s954_F_NC_02_ASEReadCounter.table","NW_015090842.1:6257889",0,1,1
"HSD17B2","s954_F_NC_02_ASEReadCounter.table","NW_015090842.1:6262951",1,2,1
"HSD17B2","s954_F_NC_02_ASEReadCounter.table","NW_015090842.1:6262974",1,3,2
"HSD17B2","s954_F_NC_02_ASEReadCounter.table","NW_015090842.1:6266125",0,1,1
"HSD17B2","s954_F_NC_02_ASEReadCounter.table","NW_015090842.1:6266795",0,3,3
"HSD17B2","s954_F_NC_02_ASEReadCounter.table","NW_015090842.1:6266944",0,4,4
"HSD17B2","s954_F_NC_02_ASEReadCounter.table","NW_015090842.1:6267053",1,1,0
"HSD17B2","s954_F_NC_02_ASEReadCounter.table","NW_015090842.1:6267196",0,1,1
"HSD17B2","s954_F_NC_02_ASEReadCounter.table","NW_015090842.1:6267273",0,3,3
"HSD17B2","s954_F_NC_02_ASEReadCounter.table","NW_015090842.1:6267674",0,4,4
"HSD17B2","s954_F_NC_02_ASEReadCounter.table","NW_015090842.1:6267913",0,1,1
"HSD17B2","s954_F_NC_02_ASEReadCounter.table","NW_015090842.1:6268203",0,3,3
"ARY2","s954_F_NC_02_ASEReadCounter.table","NW_015090842.1:6303922",7,10,3
"ARY2","s954_F_NC_02_ASEReadCounter.table","NW_015090842.1:6303954",4,8,4
"ARY2","s954_F_NC_02_ASEReadCounter.table","NW_015090842.1:6303979",3,7,4
"ARY2","s954_F_NC_02_ASEReadCounter.table","NW_015090842.1:6305848",3,7,4
"ARY2","s954_F_NC_02_ASEReadCounter.table","NW_015090842.1:6305856",4,7,3
"ARY2","s954_F_NC_02_ASEReadCounter.table","NW_015090842.1:6305857",4,7,3
"ARY2","s954_F_NC_02_ASEReadCounter.table","NW_015090842.1:6306017",3,6,3
"ARY2","s954_F_NC_02_ASEReadCounter.table","NW_015090842.1:6306052",4,8,4
"ARY2","s954_F_NC_02_ASEReadCounter.table","NW_015090842.1:6306094",6,10,4
"ARY2","s954_F_NC_02_ASEReadCounter.table","NW_015090842.1:6306100",5,10,5
"ARY2","s954_F_NC_02_ASEReadCounter.table","NW_015090842.1:6306146",7,9,2
"ARY2","s954_F_NC_02_ASEReadCounter.table","NW_015090842.1:6306147",7,9,2
"ARY2","s954_F_NC_02_ASEReadCounter.table","NW_015090842.1:6306390",5,10,5
"ARY2","s954_F_NC_02_ASEReadCounter.table","NW_015090842.1:6306567",4,8,4
"ARY2","s954_F_NC_02_ASEReadCounter.table","NW_015090842.1:6306705",4,5,1
"ARY2","s954_F_NC_02_ASEReadCounter.table","NW_015090842.1:6306773",2,2,0
"ARY2","s954_F_NC_02_ASEReadCounter.table","NW_015090842.1:6307039",4,4,0
"ARY2","s954_F_NC_02_ASEReadCounter.table","NW_015090842.1:6307043",4,4,0
"ARY2","s954_F_NC_02_ASEReadCounter.table","NW_015090842.1:6307093",5,6,1
"ARY2","s954_F_NC_02_ASEReadCounter.table","NW_015090842.1:6307138",2,4,2
"ARY2","s954_F_NC_02_ASEReadCounter.table","NW_015090842.1:6307157",2,4,2
"ARY2","s954_F_NC_02_ASEReadCounter.table","NW_015090842.1:6307187",5,6,1
"ARY2","s954_F_NC_02_ASEReadCounter.table","NW_015090842.1:6307204",6,7,1
"ARY2","s954_F_NC_02_ASEReadCounter.table","NW_015090842.1:6307278",2,3,1
"ARY2","s954_F_NC_02_ASEReadCounter.table","NW_015090842.1:6307305",4,4,0
"ARY2","s954_F_NC_02_ASEReadCounter.table","NW_015090842.1:6307318",4,4,0
"ARY2","s954_F_NC_02_ASEReadCounter.table","NW_015090842.1:6307429",6,7,1
"ARY2","s954_F_NC_02_ASEReadCounter.table","NW_015090842.1:6307487",7,8,1
"ARY2","s954_F_NC_02_ASEReadCounter.table","NW_015090842.1:6307670",4,5,1
"ARYL","s954_F_NC_02_ASEReadCounter.table","NW_015090842.1:6313767",1,2,1
"ARY1","s954_F_NC_02_ASEReadCounter.table","NW_015090842.1:6314296",3,4,1
"ARY1","s954_F_NC_02_ASEReadCounter.table","NW_015090842.1:6314541",2,3,1
"ARY1","s954_F_NC_02_ASEReadCounter.table","NW_015090842.1:6314597",1,2,1
"ARY1","s954_F_NC_02_ASEReadCounter.table","NW_015090842.1:6314794",3,4,1
"ARY1","s954_F_NC_02_ASEReadCounter.table","NW_015090842.1:6314827",3,4,1
"ARY1","s954_F_NC_02_ASEReadCounter.table","NW_015090842.1:6314859",3,4,1
"ARY1","s954_F_NC_02_ASEReadCounter.table","NW_015090842.1:6314886",2,4,2
"ARY1","s954_F_NC_02_ASEReadCounter.table","NW_015090842.1:6315022",3,5,2
"ARY1","s954_F_NC_02_ASEReadCounter.table","NW_015090842.1:6315026",3,5,2
"ARY1","s954_F_NC_02_ASEReadCounter.table","NW_015090842.1:6315043",2,3,1
"ARY1","s954_F_NC_02_ASEReadCounter.table","NW_015090842.1:6315065",4,5,1
"ARY1","s954_F_NC_02_ASEReadCounter.table","NW_015090842.1:6315409",6,7,1
"ARY1","s954_F_NC_02_ASEReadCounter.table","NW_015090842.1:6315479",3,4,1
"ARY1","s954_F_NC_02_ASEReadCounter.table","NW_015090842.1:6318342",4,8,4
"ARY1","s954_F_NC_02_ASEReadCounter.table","NW_015090842.1:6318427",10,16,6
"ARY1","s954_F_NC_02_ASEReadCounter.table","NW_015090842.1:6318603",9,12,3
"ARY1","s954_F_NC_02_ASEReadCounter.table","NW_015090842.1:6318708",4,9,5
"ARY1","s954_F_NC_02_ASEReadCounter.table","NW_015090842.1:6318858",7,12,5
"ARY1","s954_F_NC_02_ASEReadCounter.table","NW_015090842.1:6318952",9,10,1
"MPHOSPH6","s954_F_NC_02_ASEReadCounter.table","NW_015090842.1:6324063",34,70,36
"MPHOSPH6","s954_F_NC_02_ASEReadCounter.table","NW_015090842.1:6324174",78,153,75
"MPHOSPH6","s954_F_NC_02_ASEReadCounter.table","NW_015090842.1:6324270",90,185,95
"MPHOSPH6","s954_F_NC_02_ASEReadCounter.table","NW_015090842.1:6324762",59,114,55
"MPHOSPH6","s954_F_NC_02_ASEReadCounter.table","NW_015090842.1:6324780",58,113,55
"MPHOSPH6","s954_F_NC_02_ASEReadCounter.table","NW_015090842.1:6324902",76,132,56
"MPHOSPH6","s954_F_NC_02_ASEReadCounter.table","NW_015090842.1:6325066",82,152,70
"MPHOSPH6","s954_F_NC_02_ASEReadCounter.table","NW_015090842.1:6325089",85,166,81
"MPHOSPH6","s954_F_NC_02_ASEReadCounter.table","NW_015090842.1:6325877",52,122,70
"MPHOSPH6","s954_F_NC_02_ASEReadCounter.table","NW_015090842.1:6326976",37,88,51
"CDH13","s954_F_NC_02_ASEReadCounter.table","NW_015090842.1:6662283",1,5,4
"CDH13","s954_F_NC_02_ASEReadCounter.table","NW_015090842.1:6693665",4,9,5
"CDH13","s954_F_NC_02_ASEReadCounter.table","NW_015090842.1:6693697",4,11,7
"CDH13","s954_F_NC_02_ASEReadCounter.table","NW_015090842.1:6693712",3,8,5
"CDH13","s954_F_NC_02_ASEReadCounter.table","NW_015090842.1:6693723",3,8,5
"CDH13","s954_F_NC_02_ASEReadCounter.table","NW_015090842.1:6693738",4,8,4
"CDH13","s954_F_NC_02_ASEReadCounter.table","NW_015090842.1:6823730",5,12,7
"CDH13","s954_F_NC_02_ASEReadCounter.table","NW_015090842.1:6889713",6,10,4
"CDH13","s954_F_NC_02_ASEReadCounter.table","NW_015090842.1:6955167",6,15,9
"MLYCD","s954_F_NC_02_ASEReadCounter.table","NW_015090842.1:7150054",45,84,39
"MLYCD","s954_F_NC_02_ASEReadCounter.table","NW_015090842.1:7150131",72,144,72
"MLYCD","s954_F_NC_02_ASEReadCounter.table","NW_015090842.1:7150585",39,73,34
"MLYCD","s954_F_NC_02_ASEReadCounter.table","NW_015090842.1:7150686",36,65,29
"MLYCD","s954_F_NC_02_ASEReadCounter.table","NW_015090842.1:7150696",41,68,27
"MLYCD","s954_F_NC_02_ASEReadCounter.table","NW_015090842.1:7150869",33,52,19
"MLYCD","s954_F_NC_02_ASEReadCounter.table","NW_015090842.1:7151100",43,81,38
"MLYCD","s954_F_NC_02_ASEReadCounter.table","NW_015090842.1:7151127",45,80,35
"MLYCD","s954_F_NC_02_ASEReadCounter.table","NW_015090842.1:7157538",15,29,14
"MLYCD","s954_F_NC_02_ASEReadCounter.table","NW_015090842.1:7167662",13,26,13
"MLYCD","s954_F_NC_02_ASEReadCounter.table","NW_015090842.1:7167675",14,24,10
"MLYCD","s954_F_NC_02_ASEReadCounter.table","NW_015090842.1:7167710",10,22,12
"MLYCD","s954_F_NC_02_ASEReadCounter.table","NW_015090842.1:7167781",11,23,12
"MLYCD","s954_F_NC_02_ASEReadCounter.table","NW_015090842.1:7167803",11,21,10
"MLYCD","s954_F_NC_02_ASEReadCounter.table","NW_015090842.1:7167812",8,18,10
"MLYCD","s954_F_NC_02_ASEReadCounter.table","NW_015090842.1:7167845",11,23,12
"MLYCD","s954_F_NC_02_ASEReadCounter.table","NW_015090842.1:7167862",11,22,11
"MLYCD","s954_F_NC_02_ASEReadCounter.table","NW_015090842.1:7167929",11,15,4
"MLYCD","s954_F_NC_02_ASEReadCounter.table","NW_015090842.1:7167995",3,6,3
"MLYCD","s954_F_NC_02_ASEReadCounter.table","NW_015090842.1:7168005",3,6,3
"MLYCD","s954_F_NC_02_ASEReadCounter.table","NW_015090842.1:7168037",5,10,5
"HSBP1","s954_F_NC_02_ASEReadCounter.table","NW_015090842.1:7245192",412,714,302
"HSBP1","s954_F_NC_02_ASEReadCounter.table","NW_015090842.1:7245226",454,789,335
"HSBP1","s954_F_NC_02_ASEReadCounter.table","NW_015090842.1:7245257",377,687,310
"HSBP1","s954_F_NC_02_ASEReadCounter.table","NW_015090842.1:7245296",336,685,349
"HSBP1","s954_F_NC_02_ASEReadCounter.table","NW_015090842.1:7245389",451,847,396
"HSBP1","s954_F_NC_02_ASEReadCounter.table","NW_015090842.1:7245400",460,815,355
"HSBP1","s954_F_NC_02_ASEReadCounter.table","NW_015090842.1:7245445",437,799,362
"HSBP1","s954_F_NC_02_ASEReadCounter.table","NW_015090842.1:7245495",446,768,322
"HSBP1","s954_F_NC_02_ASEReadCounter.table","NW_015090842.1:7245733",264,532,268
"HSBP1","s954_F_NC_02_ASEReadCounter.table","NW_015090842.1:7245771",303,528,225
"HSBP1","s954_F_NC_02_ASEReadCounter.table","NW_015090842.1:7245813",278,470,192
"HSBP1","s954_F_NC_02_ASEReadCounter.table","NW_015090842.1:7245926",308,579,271
"HSBP1","s954_F_NC_02_ASEReadCounter.table","NW_015090842.1:7245927",312,580,268
"HSBP1","s954_F_NC_02_ASEReadCounter.table","NW_015090842.1:7245933",308,573,265
"HSBP1","s954_F_NC_02_ASEReadCounter.table","NW_015090842.1:7246002",214,448,234
"HSBP1","s954_F_NC_02_ASEReadCounter.table","NW_015090842.1:7246094",270,509,239
"HSBP1","s954_F_NC_02_ASEReadCounter.table","NW_015090842.1:7246167",260,499,239
"HSBP1","s954_F_NC_02_ASEReadCounter.table","NW_015090842.1:7246183",240,484,244
"HSBP1","s954_F_NC_02_ASEReadCounter.table","NW_015090842.1:7247285",19,31,12
"HSBP1","s954_F_NC_02_ASEReadCounter.table","NW_015090842.1:7247651",294,596,302
"HSBP1","s954_F_NC_02_ASEReadCounter.table","NW_015090842.1:7247657",290,593,303
"HSBP1","s954_F_NC_02_ASEReadCounter.table","NW_015090842.1:7248520",212,416,204
"HSBP1","s954_F_NC_02_ASEReadCounter.table","NW_015090842.1:7248535",187,352,165
"KCNG4","s954_F_NC_02_ASEReadCounter.table","NW_015090842.1:7282500",1,1,0
"KCNG4","s954_F_NC_02_ASEReadCounter.table","NW_015090842.1:7282542",1,1,0
"KCNG4","s954_F_NC_02_ASEReadCounter.table","NW_015090842.1:7282579",1,3,2
"KCNG4","s954_F_NC_02_ASEReadCounter.table","NW_015090842.1:7282630",0,3,3
"KCNG4","s954_F_NC_02_ASEReadCounter.table","NW_015090842.1:7283056",0,1,1
"KCNG4","s954_F_NC_02_ASEReadCounter.table","NW_015090842.1:7283245",1,2,1
"WFDC1","s954_F_NC_02_ASEReadCounter.table","NW_015090842.1:7378036",2,2,0
"WFDC1","s954_F_NC_02_ASEReadCounter.table","NW_015090842.1:7379451",1,2,1
"WFDC1","s954_F_NC_02_ASEReadCounter.table","NW_015090842.1:7379471",0,1,1
"WFDC1","s954_F_NC_02_ASEReadCounter.table","NW_015090842.1:7379576",0,1,1
"WFDC1","s954_F_NC_02_ASEReadCounter.table","NW_015090842.1:7379605",0,1,1
"WFDC1","s954_F_NC_02_ASEReadCounter.table","NW_015090842.1:7379626",0,1,1
"WFDC1","s954_F_NC_02_ASEReadCounter.table","NW_015090842.1:7379821",0,1,1
"WFDC1","s954_F_NC_02_ASEReadCounter.table","NW_015090842.1:7379840",0,1,1
"WFDC1","s954_F_NC_02_ASEReadCounter.table","NW_015090842.1:7380237",0,1,1
"WFDC1","s954_F_NC_02_ASEReadCounter.table","NW_015090842.1:7380261",0,1,1
"WFDC1","s954_F_NC_02_ASEReadCounter.table","NW_015090842.1:7380322",0,1,1
"WFDC1","s954_F_NC_02_ASEReadCounter.table","NW_015090842.1:7380491",1,4,3
"WFDC1","s954_F_NC_02_ASEReadCounter.table","NW_015090842.1:7380567",1,3,2
"WFDC1","s954_F_NC_02_ASEReadCounter.table","NW_015090842.1:7380672",1,3,2
"WFDC1","s954_F_NC_02_ASEReadCounter.table","NW_015090842.1:7380721",1,4,3
"WFDC1","s954_F_NC_02_ASEReadCounter.table","NW_015090842.1:7380743",0,2,2
"WFDC1","s954_F_NC_02_ASEReadCounter.table","NW_015090842.1:7380852",1,3,2
"WFDC1","s954_F_NC_02_ASEReadCounter.table","NW_015090842.1:7380878",1,2,1
"WFDC1","s954_F_NC_02_ASEReadCounter.table","NW_015090842.1:7381081",1,3,2
"WFDC1","s954_F_NC_02_ASEReadCounter.table","NW_015090842.1:7381127",0,2,2
"WFDC1","s954_F_NC_02_ASEReadCounter.table","NW_015090842.1:7381195",0,4,4
"WFDC1","s954_F_NC_02_ASEReadCounter.table","NW_015090842.1:7381253",1,3,2
"WFDC1","s954_F_NC_02_ASEReadCounter.table","NW_015090842.1:7381378",0,3,3
"WFDC1","s954_F_NC_02_ASEReadCounter.table","NW_015090842.1:7381433",0,5,5
"WFDC1","s954_F_NC_02_ASEReadCounter.table","NW_015090842.1:7381434",0,5,5
"WFDC1","s954_F_NC_02_ASEReadCounter.table","NW_015090842.1:7381442",0,5,5
"WFDC1","s954_F_NC_02_ASEReadCounter.table","NW_015090842.1:7381517",0,3,3
"WFDC1","s954_F_NC_02_ASEReadCounter.table","NW_015090842.1:7381520",0,3,3
"WFDC1","s954_F_NC_02_ASEReadCounter.table","NW_015090842.1:7381677",0,2,2
"WFDC1","s954_F_NC_02_ASEReadCounter.table","NW_015090842.1:7381709",0,2,2
"ATP2C2","s954_F_NC_02_ASEReadCounter.table","NW_015090842.1:7395230",1,1,0
"ATP2C2","s954_F_NC_02_ASEReadCounter.table","NW_015090842.1:7395366",1,1,0
"ATP2C2","s954_F_NC_02_ASEReadCounter.table","NW_015090842.1:7397049",0,2,2
"ATP2C2","s954_F_NC_02_ASEReadCounter.table","NW_015090842.1:7398395",0,2,2
"ATP2C2","s954_F_NC_02_ASEReadCounter.table","NW_015090842.1:7399774",0,1,1
"ATP2C2","s954_F_NC_02_ASEReadCounter.table","NW_015090842.1:7402554",0,1,1
"ATP2C2","s954_F_NC_02_ASEReadCounter.table","NW_015090842.1:7402578",0,1,1
"ATP2C2","s954_F_NC_02_ASEReadCounter.table","NW_015090842.1:7405621",0,2,2
"ATP2C2","s954_F_NC_02_ASEReadCounter.table","NW_015090842.1:7413855",17,28,11
"ATP2C2","s954_F_NC_02_ASEReadCounter.table","NW_015090842.1:7413869",3,13,10
"ATP2C2","s954_F_NC_02_ASEReadCounter.table","NW_015090842.1:7413875",4,16,12
"TLDC1","s954_F_NC_02_ASEReadCounter.table","NW_015090842.1:7421137",29,67,38
"TLDC1","s954_F_NC_02_ASEReadCounter.table","NW_015090842.1:7421155",26,58,32
"TLDC1","s954_F_NC_02_ASEReadCounter.table","NW_015090842.1:7421218",32,56,24
"TLDC1","s954_F_NC_02_ASEReadCounter.table","NW_015090842.1:7421399",20,42,22
"TLDC1","s954_F_NC_02_ASEReadCounter.table","NW_015090842.1:7421402",20,41,21
"TLDC1","s954_F_NC_02_ASEReadCounter.table","NW_015090842.1:7421528",28,50,22
"TLDC1","s954_F_NC_02_ASEReadCounter.table","NW_015090842.1:7421532",28,51,23
"TLDC1","s954_F_NC_02_ASEReadCounter.table","NW_015090842.1:7421621",17,42,25
"TLDC1","s954_F_NC_02_ASEReadCounter.table","NW_015090842.1:7421647",16,41,25
"TLDC1","s954_F_NC_02_ASEReadCounter.table","NW_015090842.1:7421657",13,34,21
"TLDC1","s954_F_NC_02_ASEReadCounter.table","NW_015090842.1:7421693",14,38,24
"TLDC1","s954_F_NC_02_ASEReadCounter.table","NW_015090842.1:7421796",19,33,14
"TLDC1","s954_F_NC_02_ASEReadCounter.table","NW_015090842.1:7421810",26,38,12
"TLDC1","s954_F_NC_02_ASEReadCounter.table","NW_015090842.1:7421833",23,37,14
"TLDC1","s954_F_NC_02_ASEReadCounter.table","NW_015090842.1:7421879",27,42,15
"TLDC1","s954_F_NC_02_ASEReadCounter.table","NW_015090842.1:7421914",29,45,16
"TLDC1","s954_F_NC_02_ASEReadCounter.table","NW_015090842.1:7421969",17,27,10
"TLDC1","s954_F_NC_02_ASEReadCounter.table","NW_015090842.1:7422015",11,24,13
"TLDC1","s954_F_NC_02_ASEReadCounter.table","NW_015090842.1:7422042",15,32,17
"TLDC1","s954_F_NC_02_ASEReadCounter.table","NW_015090842.1:7422230",16,39,23
"TLDC1","s954_F_NC_02_ASEReadCounter.table","NW_015090842.1:7423349",18,35,17
"TLDC1","s954_F_NC_02_ASEReadCounter.table","NW_015090842.1:7423362",16,31,15
"TLDC1","s954_F_NC_02_ASEReadCounter.table","NW_015090842.1:7426091",10,26,16
"TLDC1","s954_F_NC_02_ASEReadCounter.table","NW_015090842.1:7426485",18,31,13
"TLDC1","s954_F_NC_02_ASEReadCounter.table","NW_015090842.1:7427211",12,26,14
"TLDC1","s954_F_NC_02_ASEReadCounter.table","NW_015090842.1:7428179",8,15,7
"COTL1","s954_F_NC_02_ASEReadCounter.table","NW_015090842.1:7490744",335,759,424
"COTL1","s954_F_NC_02_ASEReadCounter.table","NW_015090842.1:7491051",250,571,321
"COTL1","s954_F_NC_02_ASEReadCounter.table","NW_015090842.1:7491124",272,559,287
"COTL1","s954_F_NC_02_ASEReadCounter.table","NW_015090842.1:7491418",139,292,153
"COTL1","s954_F_NC_02_ASEReadCounter.table","NW_015090842.1:7491539",103,231,128
"COTL1","s954_F_NC_02_ASEReadCounter.table","NW_015090842.1:7491585",164,338,174
"COTL1","s954_F_NC_02_ASEReadCounter.table","NW_015090842.1:7491586",157,350,193
"COTL1","s954_F_NC_02_ASEReadCounter.table","NW_015090842.1:7491646",190,433,243
"COTL1","s954_F_NC_02_ASEReadCounter.table","NW_015090842.1:7491747",164,357,193
"COTL1","s954_F_NC_02_ASEReadCounter.table","NW_015090842.1:7491803",147,323,176
"KLHL36","s954_F_NC_02_ASEReadCounter.table","NW_015090842.1:7514700",17,26,9
"KLHL36","s954_F_NC_02_ASEReadCounter.table","NW_015090842.1:7519691",1,3,2
"KLHL36","s954_F_NC_02_ASEReadCounter.table","NW_015090842.1:7519696",1,3,2
"KLHL36","s954_F_NC_02_ASEReadCounter.table","NW_015090842.1:7526160",17,45,28
"KLHL36","s954_F_NC_02_ASEReadCounter.table","NW_015090842.1:7526469",7,28,21
"KLHL36","s954_F_NC_02_ASEReadCounter.table","NW_015090842.1:7526587",12,37,25
"KLHL36","s954_F_NC_02_ASEReadCounter.table","NW_015090842.1:7526997",20,31,11
"KLHL36","s954_F_NC_02_ASEReadCounter.table","NW_015090842.1:7527142",14,32,18
"KLHL36","s954_F_NC_02_ASEReadCounter.table","NW_015090842.1:7535174",21,59,38
"KLHL36","s954_F_NC_02_ASEReadCounter.table","NW_015090842.1:7535384",21,44,23
"KLHL36","s954_F_NC_02_ASEReadCounter.table","NW_015090842.1:7535420",25,52,27
"KLHL36","s954_F_NC_02_ASEReadCounter.table","NW_015090842.1:7535545",19,34,15
"KLHL36","s954_F_NC_02_ASEReadCounter.table","NW_015090842.1:7535829",20,51,31
"KLHL36","s954_F_NC_02_ASEReadCounter.table","NW_015090842.1:7535977",21,47,26
"KLHL36","s954_F_NC_02_ASEReadCounter.table","NW_015090842.1:7536010",22,46,24
"KLHL36","s954_F_NC_02_ASEReadCounter.table","NW_015090842.1:7536051",23,47,24
"KLHL36","s954_F_NC_02_ASEReadCounter.table","NW_015090842.1:7536096",29,60,31
"KLHL36","s954_F_NC_02_ASEReadCounter.table","NW_015090842.1:7536135",23,58,35
"KLHL36","s954_F_NC_02_ASEReadCounter.table","NW_015090842.1:7536136",23,58,35
"KLHL36","s954_F_NC_02_ASEReadCounter.table","NW_015090842.1:7536160",23,56,33
"KLHL36","s954_F_NC_02_ASEReadCounter.table","NW_015090842.1:7536336",26,64,38
"KLHL36","s954_F_NC_02_ASEReadCounter.table","NW_015090842.1:7536352",24,64,40
"KLHL36","s954_F_NC_02_ASEReadCounter.table","NW_015090842.1:7536412",17,51,34
"KLHL36","s954_F_NC_02_ASEReadCounter.table","NW_015090842.1:7536418",14,47,33
"KLHL36","s954_F_NC_02_ASEReadCounter.table","NW_015090842.1:7536465",16,45,29
"KLHL36","s954_F_NC_02_ASEReadCounter.table","NW_015090842.1:7536466",16,45,29
"KLHL36","s954_F_NC_02_ASEReadCounter.table","NW_015090842.1:7536553",35,62,27
"KLHL36","s954_F_NC_02_ASEReadCounter.table","NW_015090842.1:7536698",33,69,36
"KLHL36","s954_F_NC_02_ASEReadCounter.table","NW_015090842.1:7536713",18,61,43
"KLHL36","s954_F_NC_02_ASEReadCounter.table","NW_015090842.1:7536720",29,65,36
"KLHL36","s954_F_NC_02_ASEReadCounter.table","NW_015090842.1:7536791",43,74,31
"KLHL36","s954_F_NC_02_ASEReadCounter.table","NW_015090842.1:7536849",36,70,34
"KLHL36","s954_F_NC_02_ASEReadCounter.table","NW_015090842.1:7536872",34,73,39
"KLHL36","s954_F_NC_02_ASEReadCounter.table","NW_015090842.1:7536878",40,75,35
"KLHL36","s954_F_NC_02_ASEReadCounter.table","NW_015090842.1:7536916",41,72,31
"KLHL36","s954_F_NC_02_ASEReadCounter.table","NW_015090842.1:7536927",41,90,49
"KLHL36","s954_F_NC_02_ASEReadCounter.table","NW_015090842.1:7537315",41,84,43
"KLHL36","s954_F_NC_02_ASEReadCounter.table","NW_015090842.1:7537352",35,78,43
"KLHL36","s954_F_NC_02_ASEReadCounter.table","NW_015090842.1:7537631",59,124,65
"KLHL36","s954_F_NC_02_ASEReadCounter.table","NW_015090842.1:7537830",95,166,71
"KLHL36","s954_F_NC_02_ASEReadCounter.table","NW_015090842.1:7537838",88,161,73
"KLHL36","s954_F_NC_02_ASEReadCounter.table","NW_015090842.1:7538153",51,123,72
"KLHL36","s954_F_NC_02_ASEReadCounter.table","NW_015090842.1:7538256",35,109,74
"KLHL36","s954_F_NC_02_ASEReadCounter.table","NW_015090842.1:7538265",35,105,70
"KLHL36","s954_F_NC_02_ASEReadCounter.table","NW_015090842.1:7538300",45,111,66
"USP10","s954_F_NC_02_ASEReadCounter.table","NW_015090842.1:7563972",5,9,4
"USP10","s954_F_NC_02_ASEReadCounter.table","NW_015090842.1:7571816",18,28,10
"USP10","s954_F_NC_02_ASEReadCounter.table","NW_015090842.1:7571993",22,40,18
"USP10","s954_F_NC_02_ASEReadCounter.table","NW_015090842.1:7572580",27,55,28
"USP10","s954_F_NC_02_ASEReadCounter.table","NW_015090842.1:7587372",69,148,79
"CRISPLD2","s954_F_NC_02_ASEReadCounter.table","NW_015090842.1:7617757",1,1,0
"CRISPLD2","s954_F_NC_02_ASEReadCounter.table","NW_015090842.1:7617781",1,1,0
"CRISPLD2","s954_F_NC_02_ASEReadCounter.table","NW_015090842.1:7617790",1,1,0
"CRISPLD2","s954_F_NC_02_ASEReadCounter.table","NW_015090842.1:7625451",4,4,0
"CRISPLD2","s954_F_NC_02_ASEReadCounter.table","NW_015090842.1:7626214",4,4,0
"CRISPLD2","s954_F_NC_02_ASEReadCounter.table","NW_015090842.1:7630784",3,3,0
"CRISPLD2","s954_F_NC_02_ASEReadCounter.table","NW_015090842.1:7630823",1,1,0
"CRISPLD2","s954_F_NC_02_ASEReadCounter.table","NW_015090842.1:7633172",3,4,1
"CRISPLD2","s954_F_NC_02_ASEReadCounter.table","NW_015090842.1:7633326",2,2,0
"CRISPLD2","s954_F_NC_02_ASEReadCounter.table","NW_015090842.1:7633336",3,3,0
"CRISPLD2","s954_F_NC_02_ASEReadCounter.table","NW_015090842.1:7633381",3,4,1
"CRISPLD2","s954_F_NC_02_ASEReadCounter.table","NW_015090842.1:7633388",2,3,1
"CRISPLD2","s954_F_NC_02_ASEReadCounter.table","NW_015090842.1:7633400",1,3,2
"CRISPLD2","s954_F_NC_02_ASEReadCounter.table","NW_015090842.1:7633486",3,5,2
"CRISPLD2","s954_F_NC_02_ASEReadCounter.table","NW_015090842.1:7633503",3,4,1
"CRISPLD2","s954_F_NC_02_ASEReadCounter.table","NW_015090842.1:7633504",3,4,1
"CRISPLD2","s954_F_NC_02_ASEReadCounter.table","NW_015090842.1:7633557",2,3,1
"CRISPLD2","s954_F_NC_02_ASEReadCounter.table","NW_015090842.1:7633571",0,1,1
"CRISPLD2","s954_F_NC_02_ASEReadCounter.table","NW_015090842.1:7633588",0,1,1
"CRISPLD2","s954_F_NC_02_ASEReadCounter.table","NW_015090842.1:7633617",1,2,1
"CRISPLD2","s954_F_NC_02_ASEReadCounter.table","NW_015090842.1:7633695",4,4,0
"CRISPLD2","s954_F_NC_02_ASEReadCounter.table","NW_015090842.1:7633721",6,6,0
"CRISPLD2","s954_F_NC_02_ASEReadCounter.table","NW_015090842.1:7633888",3,3,0
"CRISPLD2","s954_F_NC_02_ASEReadCounter.table","NW_015090842.1:7633910",4,5,1
"CRISPLD2","s954_F_NC_02_ASEReadCounter.table","NW_015090842.1:7634142",4,4,0
"CRISPLD2","s954_F_NC_02_ASEReadCounter.table","NW_015090842.1:7634825",1,1,0
"CRISPLD2","s954_F_NC_02_ASEReadCounter.table","NW_015090842.1:7635009",3,3,0
"CRISPLD2","s954_F_NC_02_ASEReadCounter.table","NW_015090842.1:7635208",4,4,0
"CRISPLD2","s954_F_NC_02_ASEReadCounter.table","NW_015090842.1:7635373",5,5,0
"CRISPLD2","s954_F_NC_02_ASEReadCounter.table","NW_015090842.1:7635525",3,3,0
"CRISPLD2","s954_F_NC_02_ASEReadCounter.table","NW_015090842.1:7635583",2,3,1
"CRISPLD2","s954_F_NC_02_ASEReadCounter.table","NW_015090842.1:7635924",2,3,1
"LOC106888312","s954_F_NC_02_ASEReadCounter.table","NW_015090842.1:7727001",1,1,0
"LOC106888312","s954_F_NC_02_ASEReadCounter.table","NW_015090842.1:7732443",1,1,0
"LOC106888312","s954_F_NC_02_ASEReadCounter.table","NW_015090842.1:7732444",1,1,0
"LOC106888312","s954_F_NC_02_ASEReadCounter.table","NW_015090842.1:7732538",1,1,0
"LOC106888312","s954_F_NC_02_ASEReadCounter.table","NW_015090842.1:7732548",1,1,0
"LOC106888312","s954_F_NC_02_ASEReadCounter.table","NW_015090842.1:7732860",1,1,0
"LOC106888312","s954_F_NC_02_ASEReadCounter.table","NW_015090842.1:7732861",1,1,0
"LOC106888312","s954_F_NC_02_ASEReadCounter.table","NW_015090842.1:7732918",1,1,0
"LOC106888312","s954_F_NC_02_ASEReadCounter.table","NW_015090842.1:7733096",1,1,0
"LOC106888312","s954_F_NC_02_ASEReadCounter.table","NW_015090842.1:7733142",1,1,0
"LOC106888312","s954_F_NC_02_ASEReadCounter.table","NW_015090842.1:7733196",1,1,0
"LOC106888312","s954_F_NC_02_ASEReadCounter.table","NW_015090842.1:7733299",1,1,0
"LOC106888312","s954_F_NC_02_ASEReadCounter.table","NW_015090842.1:7733609",1,1,0
"LOC106888312","s954_F_NC_02_ASEReadCounter.table","NW_015090842.1:7733631",1,1,0
"ZDHHC7","s954_F_NC_02_ASEReadCounter.table","NW_015090842.1:7737199",26,49,23
"ZDHHC7","s954_F_NC_02_ASEReadCounter.table","NW_015090842.1:7737332",19,39,20
"ZDHHC7","s954_F_NC_02_ASEReadCounter.table","NW_015090842.1:7737553",26,53,27
"ZDHHC7","s954_F_NC_02_ASEReadCounter.table","NW_015090842.1:7737920",11,31,20
"ZDHHC7","s954_F_NC_02_ASEReadCounter.table","NW_015090842.1:7737953",10,33,23
"ZDHHC7","s954_F_NC_02_ASEReadCounter.table","NW_015090842.1:7737987",9,32,23
"ZDHHC7","s954_F_NC_02_ASEReadCounter.table","NW_015090842.1:7738068",9,26,17
"ZDHHC7","s954_F_NC_02_ASEReadCounter.table","NW_015090842.1:7738204",14,28,14
"LOC106888097","s954_F_NC_02_ASEReadCounter.table","NW_015090842.1:7767178",2,4,2
"LOC106888097","s954_F_NC_02_ASEReadCounter.table","NW_015090842.1:7767187",2,4,2
"LOC106888097","s954_F_NC_02_ASEReadCounter.table","NW_015090842.1:7768144",3,7,4
"LOC106888097","s954_F_NC_02_ASEReadCounter.table","NW_015090842.1:7768196",5,6,1
"LOC106888097","s954_F_NC_02_ASEReadCounter.table","NW_015090842.1:7769884",6,9,3
"LOC106888097","s954_F_NC_02_ASEReadCounter.table","NW_015090842.1:7769893",5,8,3
"LOC106888097","s954_F_NC_02_ASEReadCounter.table","NW_015090842.1:7770245",5,11,6
"LOC106888097","s954_F_NC_02_ASEReadCounter.table","NW_015090842.1:7772402",3,10,7
"LOC106888097","s954_F_NC_02_ASEReadCounter.table","NW_015090842.1:7772483",3,17,14
"LOC106888097","s954_F_NC_02_ASEReadCounter.table","NW_015090842.1:7772490",3,16,13
"LOC106888097","s954_F_NC_02_ASEReadCounter.table","NW_015090842.1:7774281",10,24,14
"LOC106888097","s954_F_NC_02_ASEReadCounter.table","NW_015090842.1:7774552",11,34,23
"LOC106888097","s954_F_NC_02_ASEReadCounter.table","NW_015090842.1:7774564",11,35,24
"LOC106888097","s954_F_NC_02_ASEReadCounter.table","NW_015090842.1:7774611",12,38,26
"LOC106888097","s954_F_NC_02_ASEReadCounter.table","NW_015090842.1:7774681",12,34,22
"LOC106888097","s954_F_NC_02_ASEReadCounter.table","NW_015090842.1:7774698",9,26,17
"LOC106888097","s954_F_NC_02_ASEReadCounter.table","NW_015090842.1:7774730",4,14,10
"LOC106888097","s954_F_NC_02_ASEReadCounter.table","NW_015090842.1:7774778",1,1,0
"FOXC2","s954_F_NC_02_ASEReadCounter.table","NW_015090842.1:8129599",2,3,1
"FOXC2","s954_F_NC_02_ASEReadCounter.table","NW_015090842.1:8129616",3,5,2
"FOXC2","s954_F_NC_02_ASEReadCounter.table","NW_015090842.1:8129715",2,4,2
"FOXC2","s954_F_NC_02_ASEReadCounter.table","NW_015090842.1:8129719",2,4,2
"FOXC2","s954_F_NC_02_ASEReadCounter.table","NW_015090842.1:8130244",3,5,2
"FOXC2","s954_F_NC_02_ASEReadCounter.table","NW_015090842.1:8130472",2,3,1
"FOXC2","s954_F_NC_02_ASEReadCounter.table","NW_015090842.1:8130490",1,3,2
"FOXC2","s954_F_NC_02_ASEReadCounter.table","NW_015090842.1:8130547",2,4,2
"FOXC2","s954_F_NC_02_ASEReadCounter.table","NW_015090842.1:8130550",2,4,2
"FOXC2","s954_F_NC_02_ASEReadCounter.table","NW_015090842.1:8130573",2,3,1
"FOXC2","s954_F_NC_02_ASEReadCounter.table","NW_015090842.1:8130575",2,3,1
"MTHFSD","s954_F_NC_02_ASEReadCounter.table","NW_015090842.1:8140051",3,13,10
"MTHFSD","s954_F_NC_02_ASEReadCounter.table","NW_015090842.1:8142923",8,43,35
"MTHFSD","s954_F_NC_02_ASEReadCounter.table","NW_015090842.1:8143029",5,33,28
"MTHFSD","s954_F_NC_02_ASEReadCounter.table","NW_015090842.1:8152035",5,20,15
"MTHFSD","s954_F_NC_02_ASEReadCounter.table","NW_015090842.1:8152315",10,21,11
"MTHFSD","s954_F_NC_02_ASEReadCounter.table","NW_015090842.1:8152511",7,14,7
"MTHFSD","s954_F_NC_02_ASEReadCounter.table","NW_015090842.1:8152518",7,13,6
"MTHFSD","s954_F_NC_02_ASEReadCounter.table","NW_015090842.1:8152553",4,12,8
"MTHFSD","s954_F_NC_02_ASEReadCounter.table","NW_015090842.1:8152773",10,25,15
"MTHFSD","s954_F_NC_02_ASEReadCounter.table","NW_015090842.1:8152805",11,27,16
"IRF8","s954_F_NC_02_ASEReadCounter.table","NW_015090842.1:8406652",2,8,6
"IRF8","s954_F_NC_02_ASEReadCounter.table","NW_015090842.1:8406703",6,10,4
"IRF8","s954_F_NC_02_ASEReadCounter.table","NW_015090842.1:8406704",6,10,4
"IRF8","s954_F_NC_02_ASEReadCounter.table","NW_015090842.1:8406757",8,13,5
"IRF8","s954_F_NC_02_ASEReadCounter.table","NW_015090842.1:8406778",5,8,3
"IRF8","s954_F_NC_02_ASEReadCounter.table","NW_015090842.1:8406819",2,4,2
"IRF8","s954_F_NC_02_ASEReadCounter.table","NW_015090842.1:8406941",3,11,8
"IRF8","s954_F_NC_02_ASEReadCounter.table","NW_015090842.1:8407008",2,8,6
"IRF8","s954_F_NC_02_ASEReadCounter.table","NW_015090842.1:8407057",3,7,4
"IRF8","s954_F_NC_02_ASEReadCounter.table","NW_015090842.1:8407064",3,7,4
"IRF8","s954_F_NC_02_ASEReadCounter.table","NW_015090842.1:8407069",4,8,4
"IRF8","s954_F_NC_02_ASEReadCounter.table","NW_015090842.1:8407120",3,6,3
"IRF8","s954_F_NC_02_ASEReadCounter.table","NW_015090842.1:8407157",4,6,2
"IRF8","s954_F_NC_02_ASEReadCounter.table","NW_015090842.1:8407203",4,9,5
"IRF8","s954_F_NC_02_ASEReadCounter.table","NW_015090842.1:8407272",4,12,8
"IRF8","s954_F_NC_02_ASEReadCounter.table","NW_015090842.1:8407276",3,11,8
"IRF8","s954_F_NC_02_ASEReadCounter.table","NW_015090842.1:8407303",3,11,8
"IRF8","s954_F_NC_02_ASEReadCounter.table","NW_015090842.1:8407451",3,5,2
"IRF8","s954_F_NC_02_ASEReadCounter.table","NW_015090842.1:8407456",2,3,1
"IRF8","s954_F_NC_02_ASEReadCounter.table","NW_015090842.1:8408564",5,8,3
"IRF8","s954_F_NC_02_ASEReadCounter.table","NW_015090842.1:8408585",8,8,0
"IRF8","s954_F_NC_02_ASEReadCounter.table","NW_015090842.1:8408973",3,4,1
"IRF8","s954_F_NC_02_ASEReadCounter.table","NW_015090842.1:8409060",3,5,2
"IRF8","s954_F_NC_02_ASEReadCounter.table","NW_015090842.1:8409065",3,5,2
"IRF8","s954_F_NC_02_ASEReadCounter.table","NW_015090842.1:8409254",1,3,2
"IRF8","s954_F_NC_02_ASEReadCounter.table","NW_015090842.1:8409255",1,3,2
"IRF8","s954_F_NC_02_ASEReadCounter.table","NW_015090842.1:8409258",1,3,2
"IRF8","s954_F_NC_02_ASEReadCounter.table","NW_015090842.1:8409312",0,4,4
"IRF8","s954_F_NC_02_ASEReadCounter.table","NW_015090842.1:8410216",2,9,7
"IRF8","s954_F_NC_02_ASEReadCounter.table","NW_015090842.1:8410237",2,9,7
"IRF8","s954_F_NC_02_ASEReadCounter.table","NW_015090842.1:8410276",4,4,0
"IRF8","s954_F_NC_02_ASEReadCounter.table","NW_015090842.1:8410813",1,4,3
"IRF8","s954_F_NC_02_ASEReadCounter.table","NW_015090842.1:8410861",1,8,7
"IRF8","s954_F_NC_02_ASEReadCounter.table","NW_015090842.1:8411940",0,6,6
"IRF8","s954_F_NC_02_ASEReadCounter.table","NW_015090842.1:8412006",3,8,5
"IRF8","s954_F_NC_02_ASEReadCounter.table","NW_015090842.1:8412042",2,7,5
"DUSP15","s954_F_NC_02_ASEReadCounter.table","NW_015090842.1:8422787",2,2,0
"DUSP15","s954_F_NC_02_ASEReadCounter.table","NW_015090842.1:8422832",2,2,0
"COX4I1","s954_F_NC_02_ASEReadCounter.table","NW_015090842.1:8442258",955,1842,887
"COX4I1","s954_F_NC_02_ASEReadCounter.table","NW_015090842.1:8442333",800,1561,761
"EMC8","s954_F_NC_02_ASEReadCounter.table","NW_015090842.1:8444046",56,114,58
"EMC8","s954_F_NC_02_ASEReadCounter.table","NW_015090842.1:8444064",49,99,50
"EMC8","s954_F_NC_02_ASEReadCounter.table","NW_015090842.1:8452029",27,79,52
"EMC8","s954_F_NC_02_ASEReadCounter.table","NW_015090842.1:8452116",40,93,53
"EMC8","s954_F_NC_02_ASEReadCounter.table","NW_015090842.1:8452121",45,104,59
"EMC8","s954_F_NC_02_ASEReadCounter.table","NW_015090842.1:8452222",44,82,38
"EMC8","s954_F_NC_02_ASEReadCounter.table","NW_015090842.1:8452244",47,96,49
"EMC8","s954_F_NC_02_ASEReadCounter.table","NW_015090842.1:8452477",17,26,9
"EMC8","s954_F_NC_02_ASEReadCounter.table","NW_015090842.1:8452498",12,22,10
"EMC8","s954_F_NC_02_ASEReadCounter.table","NW_015090842.1:8452535",6,17,11
"EMC8","s954_F_NC_02_ASEReadCounter.table","NW_015090842.1:8452575",4,14,10
"EMC8","s954_F_NC_02_ASEReadCounter.table","NW_015090842.1:8452600",6,18,12
"EMC8","s954_F_NC_02_ASEReadCounter.table","NW_015090842.1:8452616",6,20,14
"EMC8","s954_F_NC_02_ASEReadCounter.table","NW_015090842.1:8452630",8,19,11
"EMC8","s954_F_NC_02_ASEReadCounter.table","NW_015090842.1:8452650",6,18,12
"EMC8","s954_F_NC_02_ASEReadCounter.table","NW_015090842.1:8452678",10,31,21
"EMC8","s954_F_NC_02_ASEReadCounter.table","NW_015090842.1:8452724",9,26,17
"EMC8","s954_F_NC_02_ASEReadCounter.table","NW_015090842.1:8452731",7,23,16
"EMC8","s954_F_NC_02_ASEReadCounter.table","NW_015090842.1:8452743",8,28,20
"EMC8","s954_F_NC_02_ASEReadCounter.table","NW_015090842.1:8452750",7,27,20
"EMC8","s954_F_NC_02_ASEReadCounter.table","NW_015090842.1:8452778",7,22,15
"EMC8","s954_F_NC_02_ASEReadCounter.table","NW_015090842.1:8452783",6,26,20
"EMC8","s954_F_NC_02_ASEReadCounter.table","NW_015090842.1:8452800",9,31,22
"EMC8","s954_F_NC_02_ASEReadCounter.table","NW_015090842.1:8452804",10,33,23
"EMC8","s954_F_NC_02_ASEReadCounter.table","NW_015090842.1:8452812",10,34,24
"EMC8","s954_F_NC_02_ASEReadCounter.table","NW_015090842.1:8452858",19,51,32
"EMC8","s954_F_NC_02_ASEReadCounter.table","NW_015090842.1:8452906",29,56,27
"EMC8","s954_F_NC_02_ASEReadCounter.table","NW_015090842.1:8452913",31,56,25
"EMC8","s954_F_NC_02_ASEReadCounter.table","NW_015090842.1:8453000",24,55,31
"EMC8","s954_F_NC_02_ASEReadCounter.table","NW_015090842.1:8453007",23,57,34
"EMC8","s954_F_NC_02_ASEReadCounter.table","NW_015090842.1:8453058",23,53,30
"EMC8","s954_F_NC_02_ASEReadCounter.table","NW_015090842.1:8453106",21,46,25
"GINS2","s954_F_NC_02_ASEReadCounter.table","NW_015090842.1:8466420",3,6,3
"GINS2","s954_F_NC_02_ASEReadCounter.table","NW_015090842.1:8466424",3,6,3
"GINS2","s954_F_NC_02_ASEReadCounter.table","NW_015090842.1:8466518",5,7,2
"GINS2","s954_F_NC_02_ASEReadCounter.table","NW_015090842.1:8468482",10,11,1
"GINS2","s954_F_NC_02_ASEReadCounter.table","NW_015090842.1:8470290",10,13,3
"GINS2","s954_F_NC_02_ASEReadCounter.table","NW_015090842.1:8470305",14,18,4
"GINS2","s954_F_NC_02_ASEReadCounter.table","NW_015090842.1:8470381",16,22,6
"GINS2","s954_F_NC_02_ASEReadCounter.table","NW_015090842.1:8470418",9,15,6
"GINS2","s954_F_NC_02_ASEReadCounter.table","NW_015090842.1:8470421",9,14,5
"GINS2","s954_F_NC_02_ASEReadCounter.table","NW_015090842.1:8470430",4,8,4
"GINS2","s954_F_NC_02_ASEReadCounter.table","NW_015090842.1:8470433",4,8,4
"GINS2","s954_F_NC_02_ASEReadCounter.table","NW_015090842.1:8470457",3,5,2
"GINS2","s954_F_NC_02_ASEReadCounter.table","NW_015090842.1:8470491",12,16,4
"GINS2","s954_F_NC_02_ASEReadCounter.table","NW_015090842.1:8470548",10,13,3
"GINS2","s954_F_NC_02_ASEReadCounter.table","NW_015090842.1:8470649",5,9,4
"GSE1","s954_F_NC_02_ASEReadCounter.table","NW_015090842.1:8475362",41,86,45
"GSE1","s954_F_NC_02_ASEReadCounter.table","NW_015090842.1:8475961",24,34,10
"GSE1","s954_F_NC_02_ASEReadCounter.table","NW_015090842.1:8476027",17,26,9
"GSE1","s954_F_NC_02_ASEReadCounter.table","NW_015090842.1:8476159",5,9,4
"GSE1","s954_F_NC_02_ASEReadCounter.table","NW_015090842.1:8477442",0,20,20
"GSE1","s954_F_NC_02_ASEReadCounter.table","NW_015090842.1:8477448",0,19,19
"GSE1","s954_F_NC_02_ASEReadCounter.table","NW_015090842.1:8477662",0,10,10
"GSE1","s954_F_NC_02_ASEReadCounter.table","NW_015090842.1:8477933",7,27,20
"GSE1","s954_F_NC_02_ASEReadCounter.table","NW_015090842.1:8477945",8,24,16
"GSE1","s954_F_NC_02_ASEReadCounter.table","NW_015090842.1:8483272",2,18,16
"GSE1","s954_F_NC_02_ASEReadCounter.table","NW_015090842.1:8483367",0,3,3
"GSE1","s954_F_NC_02_ASEReadCounter.table","NW_015090842.1:8483411",0,4,4
"GSE1","s954_F_NC_02_ASEReadCounter.table","NW_015090842.1:8483756",3,14,11
"GSE1","s954_F_NC_02_ASEReadCounter.table","NW_015090842.1:8486867",17,27,10
"GSE1","s954_F_NC_02_ASEReadCounter.table","NW_015090842.1:8486939",19,33,14
"GSE1","s954_F_NC_02_ASEReadCounter.table","NW_015090842.1:8486945",19,35,16
"GSE1","s954_F_NC_02_ASEReadCounter.table","NW_015090842.1:8486993",17,23,6
"GSE1","s954_F_NC_02_ASEReadCounter.table","NW_015090842.1:8487062",8,22,14
"GSE1","s954_F_NC_02_ASEReadCounter.table","NW_015090842.1:8488065",8,12,4
"GSE1","s954_F_NC_02_ASEReadCounter.table","NW_015090842.1:8488457",2,7,5
"GSE1","s954_F_NC_02_ASEReadCounter.table","NW_015090842.1:8488463",2,8,6
"GSE1","s954_F_NC_02_ASEReadCounter.table","NW_015090842.1:8488490",8,8,0
"GSE1","s954_F_NC_02_ASEReadCounter.table","NW_015090842.1:8488505",4,11,7
"GSE1","s954_F_NC_02_ASEReadCounter.table","NW_015090842.1:8490180",0,11,11
"KIAA0513","s954_F_NC_02_ASEReadCounter.table","NW_015090842.1:8668363",45,114,69
"KIAA0513","s954_F_NC_02_ASEReadCounter.table","NW_015090842.1:8668387",51,112,61
"KIAA0513","s954_F_NC_02_ASEReadCounter.table","NW_015090842.1:8668390",53,115,62
"KIAA0513","s954_F_NC_02_ASEReadCounter.table","NW_015090842.1:8673107",51,124,73
"KIAA0513","s954_F_NC_02_ASEReadCounter.table","NW_015090842.1:8673147",52,121,69
"KIAA0513","s954_F_NC_02_ASEReadCounter.table","NW_015090842.1:8674661",36,71,35
"KIAA0513","s954_F_NC_02_ASEReadCounter.table","NW_015090842.1:8674685",34,77,43
"KIAA0513","s954_F_NC_02_ASEReadCounter.table","NW_015090842.1:8674730",31,77,46
"KIAA0513","s954_F_NC_02_ASEReadCounter.table","NW_015090842.1:8675525",26,69,43
"KIAA0513","s954_F_NC_02_ASEReadCounter.table","NW_015090842.1:8675561",23,66,43
"KIAA0513","s954_F_NC_02_ASEReadCounter.table","NW_015090842.1:8678608",1,16,15
"KIAA0513","s954_F_NC_02_ASEReadCounter.table","NW_015090842.1:8686455",0,12,12
"KIAA0513","s954_F_NC_02_ASEReadCounter.table","NW_015090842.1:8686508",0,22,22
"KIAA0513","s954_F_NC_02_ASEReadCounter.table","NW_015090842.1:8686521",0,23,23
"KIAA0513","s954_F_NC_02_ASEReadCounter.table","NW_015090842.1:8693642",1,3,2
"KIAA0513","s954_F_NC_02_ASEReadCounter.table","NW_015090842.1:8693712",1,2,1
"FBXO31","s954_F_NC_02_ASEReadCounter.table","NW_015090842.1:8710240",19,32,13
"FBXO31","s954_F_NC_02_ASEReadCounter.table","NW_015090842.1:8710372",14,39,25
"FBXO31","s954_F_NC_02_ASEReadCounter.table","NW_015090842.1:8711239",17,40,23
"FBXO31","s954_F_NC_02_ASEReadCounter.table","NW_015090842.1:8714565",32,55,23
"FBXO31","s954_F_NC_02_ASEReadCounter.table","NW_015090842.1:8716001",12,25,13
"ZCCHC14","s954_F_NC_02_ASEReadCounter.table","NW_015090842.1:8750174",47,64,17
"ZCCHC14","s954_F_NC_02_ASEReadCounter.table","NW_015090842.1:8750189",55,66,11
"ZCCHC14","s954_F_NC_02_ASEReadCounter.table","NW_015090842.1:8750365",26,51,25
"ZCCHC14","s954_F_NC_02_ASEReadCounter.table","NW_015090842.1:8750433",32,50,18
"ZCCHC14","s954_F_NC_02_ASEReadCounter.table","NW_015090842.1:8750449",37,61,24
"ZCCHC14","s954_F_NC_02_ASEReadCounter.table","NW_015090842.1:8750456",33,58,25
"ZCCHC14","s954_F_NC_02_ASEReadCounter.table","NW_015090842.1:8750497",37,67,30
"ZCCHC14","s954_F_NC_02_ASEReadCounter.table","NW_015090842.1:8750547",31,58,27
"ZCCHC14","s954_F_NC_02_ASEReadCounter.table","NW_015090842.1:8751100",7,13,6
"ZCCHC14","s954_F_NC_02_ASEReadCounter.table","NW_015090842.1:8751374",8,19,11
"ZCCHC14","s954_F_NC_02_ASEReadCounter.table","NW_015090842.1:8751403",16,29,13
"ZCCHC14","s954_F_NC_02_ASEReadCounter.table","NW_015090842.1:8751517",12,24,12
"ZCCHC14","s954_F_NC_02_ASEReadCounter.table","NW_015090842.1:8752060",12,22,10
"ZCCHC14","s954_F_NC_02_ASEReadCounter.table","NW_015090842.1:8752172",17,27,10
"ZCCHC14","s954_F_NC_02_ASEReadCounter.table","NW_015090842.1:8752183",18,32,14
"ZCCHC14","s954_F_NC_02_ASEReadCounter.table","NW_015090842.1:8752198",18,36,18
"ZCCHC14","s954_F_NC_02_ASEReadCounter.table","NW_015090842.1:8752248",21,40,19
"ZCCHC14","s954_F_NC_02_ASEReadCounter.table","NW_015090842.1:8752326",27,55,28
"ZCCHC14","s954_F_NC_02_ASEReadCounter.table","NW_015090842.1:8752393",15,41,26
"ZCCHC14","s954_F_NC_02_ASEReadCounter.table","NW_015090842.1:8752914",12,35,23
"ZCCHC14","s954_F_NC_02_ASEReadCounter.table","NW_015090842.1:8753528",6,12,6
"ZCCHC14","s954_F_NC_02_ASEReadCounter.table","NW_015090842.1:8753892",7,10,3
"ZCCHC14","s954_F_NC_02_ASEReadCounter.table","NW_015090842.1:8753910",6,12,6
"ZCCHC14","s954_F_NC_02_ASEReadCounter.table","NW_015090842.1:8755096",8,13,5
"ZCCHC14","s954_F_NC_02_ASEReadCounter.table","NW_015090842.1:8755327",7,7,0
"ZCCHC14","s954_F_NC_02_ASEReadCounter.table","NW_015090842.1:8755723",1,5,4
"ZCCHC14","s954_F_NC_02_ASEReadCounter.table","NW_015090842.1:8755739",1,5,4
"ZCCHC14","s954_F_NC_02_ASEReadCounter.table","NW_015090842.1:8756149",4,4,0
"ZCCHC14","s954_F_NC_02_ASEReadCounter.table","NW_015090842.1:8756347",4,7,3
"ZCCHC14","s954_F_NC_02_ASEReadCounter.table","NW_015090842.1:8756361",5,8,3
"ZCCHC14","s954_F_NC_02_ASEReadCounter.table","NW_015090842.1:8756388",4,7,3
"ZCCHC14","s954_F_NC_02_ASEReadCounter.table","NW_015090842.1:8756389",4,7,3
"ZCCHC14","s954_F_NC_02_ASEReadCounter.table","NW_015090842.1:8757160",2,4,2
"ZCCHC14","s954_F_NC_02_ASEReadCounter.table","NW_015090842.1:8804511",0,3,3
"ZCCHC14","s954_F_NC_02_ASEReadCounter.table","NW_015090842.1:8804979",0,1,1
"JPH3","s954_F_NC_02_ASEReadCounter.table","NW_015090842.1:8845375",32,65,33
"JPH3","s954_F_NC_02_ASEReadCounter.table","NW_015090842.1:8845640",63,117,54
"JPH3","s954_F_NC_02_ASEReadCounter.table","NW_015090842.1:8845654",59,119,60
"JPH3","s954_F_NC_02_ASEReadCounter.table","NW_015090842.1:8872283",91,169,78
"JPH3","s954_F_NC_02_ASEReadCounter.table","NW_015090842.1:8872294",91,178,87
"JPH3","s954_F_NC_02_ASEReadCounter.table","NW_015090842.1:8872730",104,193,89
"JPH3","s954_F_NC_02_ASEReadCounter.table","NW_015090842.1:8885260",184,376,192
"JPH3","s954_F_NC_02_ASEReadCounter.table","NW_015090842.1:8885315",155,325,170
"JPH3","s954_F_NC_02_ASEReadCounter.table","NW_015090842.1:8885328",137,300,163
"JPH3","s954_F_NC_02_ASEReadCounter.table","NW_015090842.1:8885438",142,317,175
"JPH3","s954_F_NC_02_ASEReadCounter.table","NW_015090842.1:8885525",54,188,134
"KLHDC4","s954_F_NC_02_ASEReadCounter.table","NW_015090842.1:8890729",44,79,35
"KLHDC4","s954_F_NC_02_ASEReadCounter.table","NW_015090842.1:8890749",45,79,34
"KLHDC4","s954_F_NC_02_ASEReadCounter.table","NW_015090842.1:8890761",44,82,38
"KLHDC4","s954_F_NC_02_ASEReadCounter.table","NW_015090842.1:8891123",65,106,41
"KLHDC4","s954_F_NC_02_ASEReadCounter.table","NW_015090842.1:8893124",52,78,26
"KLHDC4","s954_F_NC_02_ASEReadCounter.table","NW_015090842.1:8894542",29,57,28
"KLHDC4","s954_F_NC_02_ASEReadCounter.table","NW_015090842.1:8896726",18,31,13
"KLHDC4","s954_F_NC_02_ASEReadCounter.table","NW_015090842.1:8896767",20,36,16
"KLHDC4","s954_F_NC_02_ASEReadCounter.table","NW_015090842.1:8904174",20,28,8
"KLHDC4","s954_F_NC_02_ASEReadCounter.table","NW_015090842.1:8904231",12,22,10
"KLHDC4","s954_F_NC_02_ASEReadCounter.table","NW_015090842.1:8905251",15,28,13
"KLHDC4","s954_F_NC_02_ASEReadCounter.table","NW_015090842.1:8905263",16,31,15
"KLHDC4","s954_F_NC_02_ASEReadCounter.table","NW_015090842.1:8919626",2,3,1
"SLC7A5","s954_F_NC_02_ASEReadCounter.table","NW_015090842.1:8938782",175,447,272
"SLC7A5","s954_F_NC_02_ASEReadCounter.table","NW_015090842.1:8938943",140,333,193
"SLC7A5","s954_F_NC_02_ASEReadCounter.table","NW_015090842.1:8939611",87,144,57
"SLC7A5","s954_F_NC_02_ASEReadCounter.table","NW_015090842.1:8939738",98,204,106
"SLC7A5","s954_F_NC_02_ASEReadCounter.table","NW_015090842.1:8939739",99,202,103
"SLC7A5","s954_F_NC_02_ASEReadCounter.table","NW_015090842.1:8939740",96,204,108
"SLC7A5","s954_F_NC_02_ASEReadCounter.table","NW_015090842.1:8939795",110,203,93
"SLC7A5","s954_F_NC_02_ASEReadCounter.table","NW_015090842.1:8939815",83,186,103
"SLC7A5","s954_F_NC_02_ASEReadCounter.table","NW_015090842.1:8939816",83,190,107
"SLC7A5","s954_F_NC_02_ASEReadCounter.table","NW_015090842.1:8939817",84,198,114
"SLC7A5","s954_F_NC_02_ASEReadCounter.table","NW_015090842.1:8939845",88,210,122
"SLC7A5","s954_F_NC_02_ASEReadCounter.table","NW_015090842.1:8939894",65,191,126
"SLC7A5","s954_F_NC_02_ASEReadCounter.table","NW_015090842.1:8939895",66,184,118
"SLC7A5","s954_F_NC_02_ASEReadCounter.table","NW_015090842.1:8939997",305,305,0
"SLC7A5","s954_F_NC_02_ASEReadCounter.table","NW_015090842.1:8940172",78,193,115
"SLC7A5","s954_F_NC_02_ASEReadCounter.table","NW_015090842.1:8940331",47,108,61
"SLC7A5","s954_F_NC_02_ASEReadCounter.table","NW_015090842.1:8940696",61,120,59
"SLC7A5","s954_F_NC_02_ASEReadCounter.table","NW_015090842.1:8940719",21,93,72
"SLC7A5","s954_F_NC_02_ASEReadCounter.table","NW_015090842.1:8940737",25,88,63
"SLC7A5","s954_F_NC_02_ASEReadCounter.table","NW_015090842.1:8940743",32,96,64
"SLC7A5","s954_F_NC_02_ASEReadCounter.table","NW_015090842.1:8940766",46,115,69
"SLC7A5","s954_F_NC_02_ASEReadCounter.table","NW_015090842.1:8940769",51,131,80
"SLC7A5","s954_F_NC_02_ASEReadCounter.table","NW_015090842.1:8940861",53,113,60
"SLC7A5","s954_F_NC_02_ASEReadCounter.table","NW_015090842.1:8941068",69,154,85
"SLC7A5","s954_F_NC_02_ASEReadCounter.table","NW_015090842.1:8941467",31,98,67
"SLC7A5","s954_F_NC_02_ASEReadCounter.table","NW_015090842.1:8941531",28,95,67
"SLC7A5","s954_F_NC_02_ASEReadCounter.table","NW_015090842.1:8941588",35,115,80
"SLC7A5","s954_F_NC_02_ASEReadCounter.table","NW_015090842.1:8941698",17,55,38
"SLC7A5","s954_F_NC_02_ASEReadCounter.table","NW_015090842.1:8941717",23,65,42
"SLC7A5","s954_F_NC_02_ASEReadCounter.table","NW_015090842.1:8941745",22,68,46
"SLC7A5","s954_F_NC_02_ASEReadCounter.table","NW_015090842.1:8941781",23,85,62
"SLC7A5","s954_F_NC_02_ASEReadCounter.table","NW_015090842.1:8941887",23,63,40
"SLC7A5","s954_F_NC_02_ASEReadCounter.table","NW_015090842.1:8941968",24,65,41
"SLC7A5","s954_F_NC_02_ASEReadCounter.table","NW_015090842.1:8942025",37,73,36
"SLC7A5","s954_F_NC_02_ASEReadCounter.table","NW_015090842.1:8942069",38,86,48
"SLC7A5","s954_F_NC_02_ASEReadCounter.table","NW_015090842.1:8942170",32,85,53
"SLC7A5","s954_F_NC_02_ASEReadCounter.table","NW_015090842.1:8942241",43,111,68
"SLC7A5","s954_F_NC_02_ASEReadCounter.table","NW_015090842.1:8942283",44,114,70
"SLC7A5","s954_F_NC_02_ASEReadCounter.table","NW_015090842.1:8942717",71,160,89
"SLC7A5","s954_F_NC_02_ASEReadCounter.table","NW_015090842.1:8942756",80,209,129
"SLC7A5","s954_F_NC_02_ASEReadCounter.table","NW_015090842.1:8942766",78,206,128
"SLC7A5","s954_F_NC_02_ASEReadCounter.table","NW_015090842.1:8943271",37,102,65
"SLC7A5","s954_F_NC_02_ASEReadCounter.table","NW_015090842.1:8943524",35,76,41
"SLC7A5","s954_F_NC_02_ASEReadCounter.table","NW_015090842.1:8943530",40,81,41
"SLC7A5","s954_F_NC_02_ASEReadCounter.table","NW_015090842.1:8943602",36,70,34
"SLC7A5","s954_F_NC_02_ASEReadCounter.table","NW_015090842.1:8943622",30,60,30
"SLC7A5","s954_F_NC_02_ASEReadCounter.table","NW_015090842.1:8943661",31,73,42
"SLC7A5","s954_F_NC_02_ASEReadCounter.table","NW_015090842.1:8943686",33,75,42
"SLC7A5","s954_F_NC_02_ASEReadCounter.table","NW_015090842.1:8943788",22,46,24
"SLC7A5","s954_F_NC_02_ASEReadCounter.table","NW_015090842.1:8943814",26,53,27
"SLC7A5","s954_F_NC_02_ASEReadCounter.table","NW_015090842.1:8943876",25,55,30
"SLC7A5","s954_F_NC_02_ASEReadCounter.table","NW_015090842.1:8943892",28,61,33
"SLC7A5","s954_F_NC_02_ASEReadCounter.table","NW_015090842.1:8944097",20,43,23
"SLC7A5","s954_F_NC_02_ASEReadCounter.table","NW_015090842.1:8944104",20,38,18
"SLC7A5","s954_F_NC_02_ASEReadCounter.table","NW_015090842.1:8944293",9,25,16
"SLC7A5","s954_F_NC_02_ASEReadCounter.table","NW_015090842.1:8944297",7,23,16
"SLC7A5","s954_F_NC_02_ASEReadCounter.table","NW_015090842.1:8944397",10,26,16
"SLC7A5","s954_F_NC_02_ASEReadCounter.table","NW_015090842.1:8944552",12,34,22
"SLC7A5","s954_F_NC_02_ASEReadCounter.table","NW_015090842.1:8944629",16,44,28
"CA5A","s954_F_NC_02_ASEReadCounter.table","NW_015090842.1:8989479",39,60,21
"CA5A","s954_F_NC_02_ASEReadCounter.table","NW_015090842.1:8989562",72,95,23
"CA5A","s954_F_NC_02_ASEReadCounter.table","NW_015090842.1:8989609",72,99,27
"CA5A","s954_F_NC_02_ASEReadCounter.table","NW_015090842.1:8989693",71,112,41
"CA5A","s954_F_NC_02_ASEReadCounter.table","NW_015090842.1:8989702",66,101,35
"CA5A","s954_F_NC_02_ASEReadCounter.table","NW_015090842.1:8989746",61,101,40
"CA5A","s954_F_NC_02_ASEReadCounter.table","NW_015090842.1:8989880",46,94,48
"CA5A","s954_F_NC_02_ASEReadCounter.table","NW_015090842.1:8989885",47,93,46
"CA5A","s954_F_NC_02_ASEReadCounter.table","NW_015090842.1:8989929",54,99,45
"CA5A","s954_F_NC_02_ASEReadCounter.table","NW_015090842.1:8990002",48,86,38
"CA5A","s954_F_NC_02_ASEReadCounter.table","NW_015090842.1:8990004",49,89,40
"CA5A","s954_F_NC_02_ASEReadCounter.table","NW_015090842.1:8990005",49,90,41
"CA5A","s954_F_NC_02_ASEReadCounter.table","NW_015090842.1:8990017",40,78,38
"CA5A","s954_F_NC_02_ASEReadCounter.table","NW_015090842.1:8990043",35,71,36
"CA5A","s954_F_NC_02_ASEReadCounter.table","NW_015090842.1:8990060",80,80,0
"CA5A","s954_F_NC_02_ASEReadCounter.table","NW_015090842.1:8990080",31,71,40
"CA5A","s954_F_NC_02_ASEReadCounter.table","NW_015090842.1:8990084",32,72,40
"CA5A","s954_F_NC_02_ASEReadCounter.table","NW_015090842.1:8990090",31,72,41
"CA5A","s954_F_NC_02_ASEReadCounter.table","NW_015090842.1:8990095",36,75,39
"CA5A","s954_F_NC_02_ASEReadCounter.table","NW_015090842.1:8990111",27,66,39
"CA5A","s954_F_NC_02_ASEReadCounter.table","NW_015090842.1:8990112",28,67,39
"CA5A","s954_F_NC_02_ASEReadCounter.table","NW_015090842.1:8990115",29,66,37
"CA5A","s954_F_NC_02_ASEReadCounter.table","NW_015090842.1:8990166",28,57,29
"CA5A","s954_F_NC_02_ASEReadCounter.table","NW_015090842.1:8990169",33,59,26
"CA5A","s954_F_NC_02_ASEReadCounter.table","NW_015090842.1:8990193",62,62,0
"CA5A","s954_F_NC_02_ASEReadCounter.table","NW_015090842.1:8990222",33,58,25
"CA5A","s954_F_NC_02_ASEReadCounter.table","NW_015090842.1:8990289",32,62,30
"CA5A","s954_F_NC_02_ASEReadCounter.table","NW_015090842.1:8990314",39,66,27
"CA5A","s954_F_NC_02_ASEReadCounter.table","NW_015090842.1:8990361",34,62,28
"CA5A","s954_F_NC_02_ASEReadCounter.table","NW_015090842.1:8990368",35,64,29
"CA5A","s954_F_NC_02_ASEReadCounter.table","NW_015090842.1:8990429",25,49,24
"CA5A","s954_F_NC_02_ASEReadCounter.table","NW_015090842.1:8990466",22,41,19
"CA5A","s954_F_NC_02_ASEReadCounter.table","NW_015090842.1:8990663",31,48,17
"CA5A","s954_F_NC_02_ASEReadCounter.table","NW_015090842.1:8990797",16,33,17
"CA5A","s954_F_NC_02_ASEReadCounter.table","NW_015090842.1:8990836",20,37,17
"CA5A","s954_F_NC_02_ASEReadCounter.table","NW_015090842.1:8990842",20,38,18
"CA5A","s954_F_NC_02_ASEReadCounter.table","NW_015090842.1:8990851",19,35,16
"CA5A","s954_F_NC_02_ASEReadCounter.table","NW_015090842.1:8990918",16,27,11
"CA5A","s954_F_NC_02_ASEReadCounter.table","NW_015090842.1:8990921",15,27,12
"CA5A","s954_F_NC_02_ASEReadCounter.table","NW_015090842.1:8990942",20,32,12
"CA5A","s954_F_NC_02_ASEReadCounter.table","NW_015090842.1:8991001",23,37,14
"CA5A","s954_F_NC_02_ASEReadCounter.table","NW_015090842.1:8991038",16,26,10
"CA5A","s954_F_NC_02_ASEReadCounter.table","NW_015090842.1:8991149",23,35,12
"CA5A","s954_F_NC_02_ASEReadCounter.table","NW_015090842.1:8991176",24,36,12
"CA5A","s954_F_NC_02_ASEReadCounter.table","NW_015090842.1:8991241",20,34,14
"CA5A","s954_F_NC_02_ASEReadCounter.table","NW_015090842.1:8991262",18,32,14
"CA5A","s954_F_NC_02_ASEReadCounter.table","NW_015090842.1:8991316",20,21,1
"CA5A","s954_F_NC_02_ASEReadCounter.table","NW_015090842.1:8991319",22,22,0
"CA5A","s954_F_NC_02_ASEReadCounter.table","NW_015090842.1:8991330",20,20,0
"CA5A","s954_F_NC_02_ASEReadCounter.table","NW_015090842.1:8991334",22,22,0
"CA5A","s954_F_NC_02_ASEReadCounter.table","NW_015090842.1:8991362",23,30,7
"CA5A","s954_F_NC_02_ASEReadCounter.table","NW_015090842.1:8991368",23,30,7
"CA5A","s954_F_NC_02_ASEReadCounter.table","NW_015090842.1:8991390",21,28,7
"CA5A","s954_F_NC_02_ASEReadCounter.table","NW_015090842.1:8991395",19,26,7
"CA5A","s954_F_NC_02_ASEReadCounter.table","NW_015090842.1:8991422",18,29,11
"CA5A","s954_F_NC_02_ASEReadCounter.table","NW_015090842.1:8991467",18,30,12
"CA5A","s954_F_NC_02_ASEReadCounter.table","NW_015090842.1:8991576",8,12,4
"CA5A","s954_F_NC_02_ASEReadCounter.table","NW_015090842.1:8991587",13,18,5
"CA5A","s954_F_NC_02_ASEReadCounter.table","NW_015090842.1:8991655",17,25,8
"CA5A","s954_F_NC_02_ASEReadCounter.table","NW_015090842.1:8991717",16,23,7
"CA5A","s954_F_NC_02_ASEReadCounter.table","NW_015090842.1:8991726",16,23,7
"CA5A","s954_F_NC_02_ASEReadCounter.table","NW_015090842.1:8991799",17,26,9
"CA5A","s954_F_NC_02_ASEReadCounter.table","NW_015090842.1:8991809",15,24,9
"CA5A","s954_F_NC_02_ASEReadCounter.table","NW_015090842.1:8991848",11,27,16
"CA5A","s954_F_NC_02_ASEReadCounter.table","NW_015090842.1:8991849",11,27,16
"CA5A","s954_F_NC_02_ASEReadCounter.table","NW_015090842.1:8991927",9,21,12
"CA5A","s954_F_NC_02_ASEReadCounter.table","NW_015090842.1:8991941",8,21,13
"CA5A","s954_F_NC_02_ASEReadCounter.table","NW_015090842.1:8992121",5,17,12
"CA5A","s954_F_NC_02_ASEReadCounter.table","NW_015090842.1:8992224",13,23,10
"CA5A","s954_F_NC_02_ASEReadCounter.table","NW_015090842.1:9002570",4,12,8
"CA5A","s954_F_NC_02_ASEReadCounter.table","NW_015090842.1:9002600",5,13,8
"CA5A","s954_F_NC_02_ASEReadCounter.table","NW_015090842.1:9004312",5,9,4
"CA5A","s954_F_NC_02_ASEReadCounter.table","NW_015090842.1:9005116",2,2,0
"CA5A","s954_F_NC_02_ASEReadCounter.table","NW_015090842.1:9005120",2,2,0
"CA5A","s954_F_NC_02_ASEReadCounter.table","NW_015090842.1:9005140",2,3,1
"CA5A","s954_F_NC_02_ASEReadCounter.table","NW_015090842.1:9005152",3,4,1
"BANP","s954_F_NC_02_ASEReadCounter.table","NW_015090842.1:9033407",4,8,4
"BANP","s954_F_NC_02_ASEReadCounter.table","NW_015090842.1:9033409",4,9,5
"BANP","s954_F_NC_02_ASEReadCounter.table","NW_015090842.1:9033420",5,10,5
"BANP","s954_F_NC_02_ASEReadCounter.table","NW_015090842.1:9067974",0,8,8
"BANP","s954_F_NC_02_ASEReadCounter.table","NW_015090842.1:9102510",6,21,15
"BANP","s954_F_NC_02_ASEReadCounter.table","NW_015090842.1:9168534",20,33,13
"BANP","s954_F_NC_02_ASEReadCounter.table","NW_015090842.1:9168818",20,42,22
"ZNF469","s954_F_NC_02_ASEReadCounter.table","NW_015090842.1:9429794",1,1,0
"ZNF469","s954_F_NC_02_ASEReadCounter.table","NW_015090842.1:9432361",1,1,0
"ZNF469","s954_F_NC_02_ASEReadCounter.table","NW_015090842.1:9432374",1,1,0
"ZNF469","s954_F_NC_02_ASEReadCounter.table","NW_015090842.1:9432382",1,1,0
"ZNF469","s954_F_NC_02_ASEReadCounter.table","NW_015090842.1:9432481",0,1,1
"ZNF469","s954_F_NC_02_ASEReadCounter.table","NW_015090842.1:9432498",0,1,1
"ZNF469","s954_F_NC_02_ASEReadCounter.table","NW_015090842.1:9433678",0,1,1
"ZNF469","s954_F_NC_02_ASEReadCounter.table","NW_015090842.1:9435221",1,4,3
"ZFPM1","s954_F_NC_02_ASEReadCounter.table","NW_015090842.1:9458862",3,4,1
"ZFPM1","s954_F_NC_02_ASEReadCounter.table","NW_015090842.1:9458888",1,3,2
"ZFPM1","s954_F_NC_02_ASEReadCounter.table","NW_015090842.1:9458904",1,4,3
"ZFPM1","s954_F_NC_02_ASEReadCounter.table","NW_015090842.1:9458916",1,4,3
"ZFPM1","s954_F_NC_02_ASEReadCounter.table","NW_015090842.1:9468568",1,3,2
"ZFPM1","s954_F_NC_02_ASEReadCounter.table","NW_015090842.1:9468593",1,2,1
"ZFPM1","s954_F_NC_02_ASEReadCounter.table","NW_015090842.1:9471561",2,2,0
"ZFPM1","s954_F_NC_02_ASEReadCounter.table","NW_015090842.1:9472557",2,5,3
"ZFPM1","s954_F_NC_02_ASEReadCounter.table","NW_015090842.1:9472565",2,5,3
"ZFPM1","s954_F_NC_02_ASEReadCounter.table","NW_015090842.1:9472608",2,5,3
"ZFPM1","s954_F_NC_02_ASEReadCounter.table","NW_015090842.1:9472627",1,2,1
"ZFPM1","s954_F_NC_02_ASEReadCounter.table","NW_015090842.1:9472668",0,2,2
"ZFPM1","s954_F_NC_02_ASEReadCounter.table","NW_015090842.1:9473655",6,7,1
"ZFPM1","s954_F_NC_02_ASEReadCounter.table","NW_015090842.1:9475827",3,4,1
"ZFPM1","s954_F_NC_02_ASEReadCounter.table","NW_015090842.1:9475842",3,3,0
"ZFPM1","s954_F_NC_02_ASEReadCounter.table","NW_015090842.1:9476119",6,11,5
"ZFPM1","s954_F_NC_02_ASEReadCounter.table","NW_015090842.1:9476161",5,9,4
"ZFPM1","s954_F_NC_02_ASEReadCounter.table","NW_015090842.1:9476219",5,6,1
"ZFPM1","s954_F_NC_02_ASEReadCounter.table","NW_015090842.1:9476233",7,8,1
"ZFPM1","s954_F_NC_02_ASEReadCounter.table","NW_015090842.1:9476305",8,13,5
"ZFPM1","s954_F_NC_02_ASEReadCounter.table","NW_015090842.1:9476395",3,7,4
"ZFPM1","s954_F_NC_02_ASEReadCounter.table","NW_015090842.1:9476421",3,8,5
"ZFPM1","s954_F_NC_02_ASEReadCounter.table","NW_015090842.1:9476539",4,7,3
"ZFPM1","s954_F_NC_02_ASEReadCounter.table","NW_015090842.1:9476576",1,3,2
"ZFPM1","s954_F_NC_02_ASEReadCounter.table","NW_015090842.1:9476599",4,4,0
"ZFPM1","s954_F_NC_02_ASEReadCounter.table","NW_015090842.1:9476792",6,9,3
"ZFPM1","s954_F_NC_02_ASEReadCounter.table","NW_015090842.1:9476803",5,9,4
"ZFPM1","s954_F_NC_02_ASEReadCounter.table","NW_015090842.1:9477115",3,4,1
"ZFPM1","s954_F_NC_02_ASEReadCounter.table","NW_015090842.1:9477299",3,5,2
"ZFPM1","s954_F_NC_02_ASEReadCounter.table","NW_015090842.1:9477398",7,7,0
"ZFPM1","s954_F_NC_02_ASEReadCounter.table","NW_015090842.1:9477422",4,5,1
"ZFPM1","s954_F_NC_02_ASEReadCounter.table","NW_015090842.1:9477554",5,8,3
"ZFPM1","s954_F_NC_02_ASEReadCounter.table","NW_015090842.1:9477575",8,8,0
"ZFPM1","s954_F_NC_02_ASEReadCounter.table","NW_015090842.1:9477595",6,8,2
"ZFPM1","s954_F_NC_02_ASEReadCounter.table","NW_015090842.1:9477611",7,9,2
"ZFPM1","s954_F_NC_02_ASEReadCounter.table","NW_015090842.1:9477659",7,12,5
"ZFPM1","s954_F_NC_02_ASEReadCounter.table","NW_015090842.1:9477737",5,6,1
"ZFPM1","s954_F_NC_02_ASEReadCounter.table","NW_015090842.1:9477791",6,13,7
"ZFPM1","s954_F_NC_02_ASEReadCounter.table","NW_015090842.1:9477844",6,14,8
"ZFPM1","s954_F_NC_02_ASEReadCounter.table","NW_015090842.1:9477917",4,11,7
"ZFPM1","s954_F_NC_02_ASEReadCounter.table","NW_015090842.1:9478295",12,22,10
"ZFPM1","s954_F_NC_02_ASEReadCounter.table","NW_015090842.1:9478349",15,32,17
"ZFPM1","s954_F_NC_02_ASEReadCounter.table","NW_015090842.1:9478524",10,19,9
"ZFPM1","s954_F_NC_02_ASEReadCounter.table","NW_015090842.1:9478546",11,23,12
"ZFPM1","s954_F_NC_02_ASEReadCounter.table","NW_015090842.1:9478573",12,21,9
"ZFPM1","s954_F_NC_02_ASEReadCounter.table","NW_015090842.1:9478582",9,16,7
"ZFPM1","s954_F_NC_02_ASEReadCounter.table","NW_015090842.1:9478684",3,5,2
"ZFPM1","s954_F_NC_02_ASEReadCounter.table","NW_015090842.1:9478711",3,6,3
"ZFPM1","s954_F_NC_02_ASEReadCounter.table","NW_015090842.1:9478761",2,6,4
"ZFPM1","s954_F_NC_02_ASEReadCounter.table","NW_015090842.1:9478829",3,3,0
"ZC3H18","s954_F_NC_02_ASEReadCounter.table","NW_015090842.1:9494271",6,11,5
"ZC3H18","s954_F_NC_02_ASEReadCounter.table","NW_015090842.1:9501427",9,17,8
"ZC3H18","s954_F_NC_02_ASEReadCounter.table","NW_015090842.1:9501442",10,17,7
"ZC3H18","s954_F_NC_02_ASEReadCounter.table","NW_015090842.1:9505538",6,19,13
"ZC3H18","s954_F_NC_02_ASEReadCounter.table","NW_015090842.1:9506778",12,24,12
"ZC3H18","s954_F_NC_02_ASEReadCounter.table","NW_015090842.1:9522538",20,32,12
"ZC3H18","s954_F_NC_02_ASEReadCounter.table","NW_015090842.1:9524350",10,24,14
"ZC3H18","s954_F_NC_02_ASEReadCounter.table","NW_015090842.1:9524366",8,23,15
"ZC3H18","s954_F_NC_02_ASEReadCounter.table","NW_015090842.1:9524424",10,24,14
"ZC3H18","s954_F_NC_02_ASEReadCounter.table","NW_015090842.1:9529649",18,42,24
"ZC3H18","s954_F_NC_02_ASEReadCounter.table","NW_015090842.1:9529688",17,35,18
"ZC3H18","s954_F_NC_02_ASEReadCounter.table","NW_015090842.1:9529691",18,33,15
"ZC3H18","s954_F_NC_02_ASEReadCounter.table","NW_015090842.1:9530977",28,50,22
"ZC3H18","s954_F_NC_02_ASEReadCounter.table","NW_015090842.1:9536699",0,31,31
"CYBA","s954_F_NC_02_ASEReadCounter.table","NW_015090842.1:9547281",21,26,5
"CYBA","s954_F_NC_02_ASEReadCounter.table","NW_015090842.1:9547402",53,75,22
"CYBA","s954_F_NC_02_ASEReadCounter.table","NW_015090842.1:9547553",32,61,29
"CYBA","s954_F_NC_02_ASEReadCounter.table","NW_015090842.1:9548052",23,33,10
"CYBA","s954_F_NC_02_ASEReadCounter.table","NW_015090842.1:9548436",37,43,6
"CYBA","s954_F_NC_02_ASEReadCounter.table","NW_015090842.1:9548442",32,39,7
"CYBA","s954_F_NC_02_ASEReadCounter.table","NW_015090842.1:9548478",40,49,9
"CYBA","s954_F_NC_02_ASEReadCounter.table","NW_015090842.1:9548487",37,44,7
"CYBA","s954_F_NC_02_ASEReadCounter.table","NW_015090842.1:9548490",38,45,7
"CYBA","s954_F_NC_02_ASEReadCounter.table","NW_015090842.1:9548717",36,43,7
"CYBA","s954_F_NC_02_ASEReadCounter.table","NW_015090842.1:9548750",30,35,5
"CYBA","s954_F_NC_02_ASEReadCounter.table","NW_015090842.1:9548766",23,27,4
"MVD","s954_F_NC_02_ASEReadCounter.table","NW_015090842.1:9550678",20,33,13
"MVD","s954_F_NC_02_ASEReadCounter.table","NW_015090842.1:9550690",19,33,14
"MVD","s954_F_NC_02_ASEReadCounter.table","NW_015090842.1:9550691",20,34,14
"MVD","s954_F_NC_02_ASEReadCounter.table","NW_015090842.1:9550699",25,41,16
"MVD","s954_F_NC_02_ASEReadCounter.table","NW_015090842.1:9550719",25,42,17
"MVD","s954_F_NC_02_ASEReadCounter.table","NW_015090842.1:9551596",50,95,45
"MVD","s954_F_NC_02_ASEReadCounter.table","NW_015090842.1:9551638",55,102,47
"MVD","s954_F_NC_02_ASEReadCounter.table","NW_015090842.1:9551899",0,4,4
"MVD","s954_F_NC_02_ASEReadCounter.table","NW_015090842.1:9552193",41,70,29
"MVD","s954_F_NC_02_ASEReadCounter.table","NW_015090842.1:9552202",36,64,28
"MVD","s954_F_NC_02_ASEReadCounter.table","NW_015090842.1:9552208",37,62,25
"MVD","s954_F_NC_02_ASEReadCounter.table","NW_015090842.1:9552625",20,40,20
"MVD","s954_F_NC_02_ASEReadCounter.table","NW_015090842.1:9552629",44,44,0
"MVD","s954_F_NC_02_ASEReadCounter.table","NW_015090842.1:9552644",22,46,24
"MVD","s954_F_NC_02_ASEReadCounter.table","NW_015090842.1:9553093",21,42,21
"MVD","s954_F_NC_02_ASEReadCounter.table","NW_015090842.1:9553114",24,45,21
"RNF166","s954_F_NC_02_ASEReadCounter.table","NW_015090842.1:9557900",16,58,42
"RNF166","s954_F_NC_02_ASEReadCounter.table","NW_015090842.1:9558048",16,37,21
"RNF166","s954_F_NC_02_ASEReadCounter.table","NW_015090842.1:9558116",18,45,27
"RNF166","s954_F_NC_02_ASEReadCounter.table","NW_015090842.1:9558308",19,41,22
"RNF166","s954_F_NC_02_ASEReadCounter.table","NW_015090842.1:9558405",23,44,21
"RNF166","s954_F_NC_02_ASEReadCounter.table","NW_015090842.1:9558549",29,44,15
"RNF166","s954_F_NC_02_ASEReadCounter.table","NW_015090842.1:9558556",29,43,14
"RNF166","s954_F_NC_02_ASEReadCounter.table","NW_015090842.1:9558579",24,39,15
"RNF166","s954_F_NC_02_ASEReadCounter.table","NW_015090842.1:9558599",17,31,14
"RNF166","s954_F_NC_02_ASEReadCounter.table","NW_015090842.1:9558688",15,33,18
"RNF166","s954_F_NC_02_ASEReadCounter.table","NW_015090842.1:9558711",18,41,23
"RNF166","s954_F_NC_02_ASEReadCounter.table","NW_015090842.1:9558733",16,37,21
"RNF166","s954_F_NC_02_ASEReadCounter.table","NW_015090842.1:9558847",15,32,17
"RNF166","s954_F_NC_02_ASEReadCounter.table","NW_015090842.1:9559798",18,37,19
"RNF166","s954_F_NC_02_ASEReadCounter.table","NW_015090842.1:9560575",25,51,26
"RNF166","s954_F_NC_02_ASEReadCounter.table","NW_015090842.1:9561055",9,32,23
"RNF166","s954_F_NC_02_ASEReadCounter.table","NW_015090842.1:9562458",18,33,15
"RNF166","s954_F_NC_02_ASEReadCounter.table","NW_015090842.1:9562497",14,24,10
"RNF166","s954_F_NC_02_ASEReadCounter.table","NW_015090842.1:9562539",10,18,8
"RNF166","s954_F_NC_02_ASEReadCounter.table","NW_015090842.1:9564056",9,17,8
"CTU2","s954_F_NC_02_ASEReadCounter.table","NW_015090842.1:9565149",14,24,10
"CTU2","s954_F_NC_02_ASEReadCounter.table","NW_015090842.1:9565193",12,25,13
"CTU2","s954_F_NC_02_ASEReadCounter.table","NW_015090842.1:9565300",15,28,13
"CTU2","s954_F_NC_02_ASEReadCounter.table","NW_015090842.1:9565321",12,25,13
"CTU2","s954_F_NC_02_ASEReadCounter.table","NW_015090842.1:9565721",13,22,9
"CTU2","s954_F_NC_02_ASEReadCounter.table","NW_015090842.1:9565739",13,21,8
"CTU2","s954_F_NC_02_ASEReadCounter.table","NW_015090842.1:9565905",11,22,11
"CTU2","s954_F_NC_02_ASEReadCounter.table","NW_015090842.1:9566013",23,23,0
"CTU2","s954_F_NC_02_ASEReadCounter.table","NW_015090842.1:9566055",19,35,16
"CTU2","s954_F_NC_02_ASEReadCounter.table","NW_015090842.1:9566056",19,36,17
"CTU2","s954_F_NC_02_ASEReadCounter.table","NW_015090842.1:9566151",9,33,24
"CTU2","s954_F_NC_02_ASEReadCounter.table","NW_015090842.1:9566300",10,23,13
"CTU2","s954_F_NC_02_ASEReadCounter.table","NW_015090842.1:9566342",10,25,15
"CTU2","s954_F_NC_02_ASEReadCounter.table","NW_015090842.1:9566548",11,31,20
"CTU2","s954_F_NC_02_ASEReadCounter.table","NW_015090842.1:9566625",16,37,21
"CTU2","s954_F_NC_02_ASEReadCounter.table","NW_015090842.1:9566633",18,40,22
"CTU2","s954_F_NC_02_ASEReadCounter.table","NW_015090842.1:9566807",18,42,24
"CTU2","s954_F_NC_02_ASEReadCounter.table","NW_015090842.1:9567139",19,37,18
"CTU2","s954_F_NC_02_ASEReadCounter.table","NW_015090842.1:9567156",17,32,15
"CTU2","s954_F_NC_02_ASEReadCounter.table","NW_015090842.1:9567614",28,56,28
"CTU2","s954_F_NC_02_ASEReadCounter.table","NW_015090842.1:9567677",25,51,26
"CTU2","s954_F_NC_02_ASEReadCounter.table","NW_015090842.1:9567747",26,53,27
"CTU2","s954_F_NC_02_ASEReadCounter.table","NW_015090842.1:9567828",20,37,17
"CTU2","s954_F_NC_02_ASEReadCounter.table","NW_015090842.1:9567829",20,36,16
"CTU2","s954_F_NC_02_ASEReadCounter.table","NW_015090842.1:9567885",16,27,11
"PIEZO1","s954_F_NC_02_ASEReadCounter.table","NW_015090842.1:9568093",12,31,19
"PIEZO1","s954_F_NC_02_ASEReadCounter.table","NW_015090842.1:9568672",9,30,21
"PIEZO1","s954_F_NC_02_ASEReadCounter.table","NW_015090842.1:9568948",14,26,12
"PIEZO1","s954_F_NC_02_ASEReadCounter.table","NW_015090842.1:9568987",22,22,0
"PIEZO1","s954_F_NC_02_ASEReadCounter.table","NW_015090842.1:9569040",6,16,10
"PIEZO1","s954_F_NC_02_ASEReadCounter.table","NW_015090842.1:9569180",5,13,8
"PIEZO1","s954_F_NC_02_ASEReadCounter.table","NW_015090842.1:9569192",8,18,10
"PIEZO1","s954_F_NC_02_ASEReadCounter.table","NW_015090842.1:9570088",15,26,11
"PIEZO1","s954_F_NC_02_ASEReadCounter.table","NW_015090842.1:9570480",6,13,7
"PIEZO1","s954_F_NC_02_ASEReadCounter.table","NW_015090842.1:9570639",6,13,7
"PIEZO1","s954_F_NC_02_ASEReadCounter.table","NW_015090842.1:9571847",9,17,8
"PIEZO1","s954_F_NC_02_ASEReadCounter.table","NW_015090842.1:9572371",5,11,6
"PIEZO1","s954_F_NC_02_ASEReadCounter.table","NW_015090842.1:9572638",3,9,6
"PIEZO1","s954_F_NC_02_ASEReadCounter.table","NW_015090842.1:9573156",5,14,9
"PIEZO1","s954_F_NC_02_ASEReadCounter.table","NW_015090842.1:9573280",7,16,9
"PIEZO1","s954_F_NC_02_ASEReadCounter.table","NW_015090842.1:9573566",9,13,4
"PIEZO1","s954_F_NC_02_ASEReadCounter.table","NW_015090842.1:9575341",3,8,5
"PIEZO1","s954_F_NC_02_ASEReadCounter.table","NW_015090842.1:9575367",2,6,4
"PIEZO1","s954_F_NC_02_ASEReadCounter.table","NW_015090842.1:9575645",6,11,5
"PIEZO1","s954_F_NC_02_ASEReadCounter.table","NW_015090842.1:9575696",4,9,5
"PIEZO1","s954_F_NC_02_ASEReadCounter.table","NW_015090842.1:9575897",4,6,2
"PIEZO1","s954_F_NC_02_ASEReadCounter.table","NW_015090842.1:9576060",5,6,1
"PIEZO1","s954_F_NC_02_ASEReadCounter.table","NW_015090842.1:9576087",3,7,4
"PIEZO1","s954_F_NC_02_ASEReadCounter.table","NW_015090842.1:9576093",5,9,4
"PIEZO1","s954_F_NC_02_ASEReadCounter.table","NW_015090842.1:9576120",5,9,4
"PIEZO1","s954_F_NC_02_ASEReadCounter.table","NW_015090842.1:9576687",3,3,0
"PIEZO1","s954_F_NC_02_ASEReadCounter.table","NW_015090842.1:9576710",5,5,0
"PIEZO1","s954_F_NC_02_ASEReadCounter.table","NW_015090842.1:9576723",4,5,1
"PIEZO1","s954_F_NC_02_ASEReadCounter.table","NW_015090842.1:9578268",3,6,3
"PIEZO1","s954_F_NC_02_ASEReadCounter.table","NW_015090842.1:9578770",3,3,0
"PIEZO1","s954_F_NC_02_ASEReadCounter.table","NW_015090842.1:9578806",5,5,0
"PIEZO1","s954_F_NC_02_ASEReadCounter.table","NW_015090842.1:9579064",4,5,1
"PIEZO1","s954_F_NC_02_ASEReadCounter.table","NW_015090842.1:9579065",4,5,1
"PIEZO1","s954_F_NC_02_ASEReadCounter.table","NW_015090842.1:9579347",0,3,3
"PIEZO1","s954_F_NC_02_ASEReadCounter.table","NW_015090842.1:9580765",1,1,0
"PIEZO1","s954_F_NC_02_ASEReadCounter.table","NW_015090842.1:9580996",1,3,2
"PIEZO1","s954_F_NC_02_ASEReadCounter.table","NW_015090842.1:9581101",0,1,1
"PIEZO1","s954_F_NC_02_ASEReadCounter.table","NW_015090842.1:9581299",0,1,1
"PIEZO1","s954_F_NC_02_ASEReadCounter.table","NW_015090842.1:9581875",1,3,2
"PIEZO1","s954_F_NC_02_ASEReadCounter.table","NW_015090842.1:9582046",3,5,2
"PIEZO1","s954_F_NC_02_ASEReadCounter.table","NW_015090842.1:9582961",0,3,3
"PIEZO1","s954_F_NC_02_ASEReadCounter.table","NW_015090842.1:9583298",3,6,3
"PIEZO1","s954_F_NC_02_ASEReadCounter.table","NW_015090842.1:9584337",0,3,3
"PIEZO1","s954_F_NC_02_ASEReadCounter.table","NW_015090842.1:9584425",0,3,3
"PIEZO1","s954_F_NC_02_ASEReadCounter.table","NW_015090842.1:9584435",0,3,3
"PIEZO1","s954_F_NC_02_ASEReadCounter.table","NW_015090842.1:9584438",0,3,3
"PIEZO1","s954_F_NC_02_ASEReadCounter.table","NW_015090842.1:9584441",0,3,3
"CDT1","s954_F_NC_02_ASEReadCounter.table","NW_015090842.1:9596596",3,3,0
"CDT1","s954_F_NC_02_ASEReadCounter.table","NW_015090842.1:9596766",4,4,0
"CDT1","s954_F_NC_02_ASEReadCounter.table","NW_015090842.1:9597054",4,5,1
"CDT1","s954_F_NC_02_ASEReadCounter.table","NW_015090842.1:9597074",3,4,1
"CDT1","s954_F_NC_02_ASEReadCounter.table","NW_015090842.1:9597137",5,8,3
"CDT1","s954_F_NC_02_ASEReadCounter.table","NW_015090842.1:9597756",5,11,6
"CDT1","s954_F_NC_02_ASEReadCounter.table","NW_015090842.1:9597766",7,13,6
"CDT1","s954_F_NC_02_ASEReadCounter.table","NW_015090842.1:9598496",13,15,2
"CDT1","s954_F_NC_02_ASEReadCounter.table","NW_015090842.1:9598498",13,15,2
"CDT1","s954_F_NC_02_ASEReadCounter.table","NW_015090842.1:9598816",6,6,0
"CDT1","s954_F_NC_02_ASEReadCounter.table","NW_015090842.1:9598879",5,7,2
"CDT1","s954_F_NC_02_ASEReadCounter.table","NW_015090842.1:9598912",8,11,3
"CDT1","s954_F_NC_02_ASEReadCounter.table","NW_015090842.1:9598959",6,11,5
"CDT1","s954_F_NC_02_ASEReadCounter.table","NW_015090842.1:9599807",13,17,4
"CDT1","s954_F_NC_02_ASEReadCounter.table","NW_015090842.1:9599819",13,17,4
"CDT1","s954_F_NC_02_ASEReadCounter.table","NW_015090842.1:9599845",12,23,11
"CDT1","s954_F_NC_02_ASEReadCounter.table","NW_015090842.1:9600148",14,20,6
"CDT1","s954_F_NC_02_ASEReadCounter.table","NW_015090842.1:9600151",14,20,6
"CDT1","s954_F_NC_02_ASEReadCounter.table","NW_015090842.1:9600217",10,12,2
"CDT1","s954_F_NC_02_ASEReadCounter.table","NW_015090842.1:9600226",11,14,3
"CDT1","s954_F_NC_02_ASEReadCounter.table","NW_015090842.1:9600260",8,12,4
"CDT1","s954_F_NC_02_ASEReadCounter.table","NW_015090842.1:9600268",8,12,4
"CDT1","s954_F_NC_02_ASEReadCounter.table","NW_015090842.1:9600305",5,10,5
"CDT1","s954_F_NC_02_ASEReadCounter.table","NW_015090842.1:9600397",6,7,1
"CDT1","s954_F_NC_02_ASEReadCounter.table","NW_015090842.1:9600447",5,6,1
"CDT1","s954_F_NC_02_ASEReadCounter.table","NW_015090842.1:9600450",5,6,1
"CDT1","s954_F_NC_02_ASEReadCounter.table","NW_015090842.1:9600485",7,8,1
"CDT1","s954_F_NC_02_ASEReadCounter.table","NW_015090842.1:9600579",6,7,1
"APRT","s954_F_NC_02_ASEReadCounter.table","NW_015090842.1:9602308",15,44,29
"APRT","s954_F_NC_02_ASEReadCounter.table","NW_015090842.1:9602440",32,109,77
"APRT","s954_F_NC_02_ASEReadCounter.table","NW_015090842.1:9602449",33,113,80
"APRT","s954_F_NC_02_ASEReadCounter.table","NW_015090842.1:9602451",33,112,79
"APRT","s954_F_NC_02_ASEReadCounter.table","NW_015090842.1:9602455",32,113,81
"APRT","s954_F_NC_02_ASEReadCounter.table","NW_015090842.1:9602462",31,108,77
"APRT","s954_F_NC_02_ASEReadCounter.table","NW_015090842.1:9602507",28,99,71
"APRT","s954_F_NC_02_ASEReadCounter.table","NW_015090842.1:9602514",33,106,73
"APRT","s954_F_NC_02_ASEReadCounter.table","NW_015090842.1:9602530",30,97,67
"APRT","s954_F_NC_02_ASEReadCounter.table","NW_015090842.1:9602582",37,100,63
"APRT","s954_F_NC_02_ASEReadCounter.table","NW_015090842.1:9602583",37,97,60
"APRT","s954_F_NC_02_ASEReadCounter.table","NW_015090842.1:9602650",42,107,65
"APRT","s954_F_NC_02_ASEReadCounter.table","NW_015090842.1:9602655",41,105,64
"APRT","s954_F_NC_02_ASEReadCounter.table","NW_015090842.1:9602712",44,117,73
"APRT","s954_F_NC_02_ASEReadCounter.table","NW_015090842.1:9602764",35,100,65
"APRT","s954_F_NC_02_ASEReadCounter.table","NW_015090842.1:9602821",32,70,38
"APRT","s954_F_NC_02_ASEReadCounter.table","NW_015090842.1:9602867",29,59,30
"APRT","s954_F_NC_02_ASEReadCounter.table","NW_015090842.1:9602883",28,66,38
"APRT","s954_F_NC_02_ASEReadCounter.table","NW_015090842.1:9602886",30,68,38
"APRT","s954_F_NC_02_ASEReadCounter.table","NW_015090842.1:9602948",25,78,53
"APRT","s954_F_NC_02_ASEReadCounter.table","NW_015090842.1:9602958",24,81,57
"APRT","s954_F_NC_02_ASEReadCounter.table","NW_015090842.1:9603020",34,88,54
"APRT","s954_F_NC_02_ASEReadCounter.table","NW_015090842.1:9603025",35,89,54
"APRT","s954_F_NC_02_ASEReadCounter.table","NW_015090842.1:9603154",35,87,52
"APRT","s954_F_NC_02_ASEReadCounter.table","NW_015090842.1:9603166",40,96,56
"APRT","s954_F_NC_02_ASEReadCounter.table","NW_015090842.1:9603326",32,70,38
"APRT","s954_F_NC_02_ASEReadCounter.table","NW_015090842.1:9603419",27,71,44
"APRT","s954_F_NC_02_ASEReadCounter.table","NW_015090842.1:9603420",27,68,41
"APRT","s954_F_NC_02_ASEReadCounter.table","NW_015090842.1:9603464",22,53,31
"APRT","s954_F_NC_02_ASEReadCounter.table","NW_015090842.1:9603528",26,64,38
"APRT","s954_F_NC_02_ASEReadCounter.table","NW_015090842.1:9603607",23,62,39
"APRT","s954_F_NC_02_ASEReadCounter.table","NW_015090842.1:9603622",20,54,34
"APRT","s954_F_NC_02_ASEReadCounter.table","NW_015090842.1:9604361",16,60,44
"APRT","s954_F_NC_02_ASEReadCounter.table","NW_015090842.1:9605317",14,41,27
"APRT","s954_F_NC_02_ASEReadCounter.table","NW_015090842.1:9605336",15,49,34
"GALNS","s954_F_NC_02_ASEReadCounter.table","NW_015090842.1:9612872",3,4,1
"GALNS","s954_F_NC_02_ASEReadCounter.table","NW_015090842.1:9612873",2,3,1
"GALNS","s954_F_NC_02_ASEReadCounter.table","NW_015090842.1:9612877",2,3,1
"GALNS","s954_F_NC_02_ASEReadCounter.table","NW_015090842.1:9612942",8,13,5
"GALNS","s954_F_NC_02_ASEReadCounter.table","NW_015090842.1:9612987",15,15,0
"GALNS","s954_F_NC_02_ASEReadCounter.table","NW_015090842.1:9613064",6,11,5
"GALNS","s954_F_NC_02_ASEReadCounter.table","NW_015090842.1:9613096",14,19,5
"GALNS","s954_F_NC_02_ASEReadCounter.table","NW_015090842.1:9613123",12,17,5
"GALNS","s954_F_NC_02_ASEReadCounter.table","NW_015090842.1:9613125",13,18,5
"GALNS","s954_F_NC_02_ASEReadCounter.table","NW_015090842.1:9613193",12,19,7
"GALNS","s954_F_NC_02_ASEReadCounter.table","NW_015090842.1:9613226",15,26,11
"GALNS","s954_F_NC_02_ASEReadCounter.table","NW_015090842.1:9613249",21,33,12
"GALNS","s954_F_NC_02_ASEReadCounter.table","NW_015090842.1:9613256",23,33,10
"GALNS","s954_F_NC_02_ASEReadCounter.table","NW_015090842.1:9613317",13,22,9
"GALNS","s954_F_NC_02_ASEReadCounter.table","NW_015090842.1:9613343",10,19,9
"GALNS","s954_F_NC_02_ASEReadCounter.table","NW_015090842.1:9613344",10,19,9
"GALNS","s954_F_NC_02_ASEReadCounter.table","NW_015090842.1:9613371",11,24,13
"GALNS","s954_F_NC_02_ASEReadCounter.table","NW_015090842.1:9613378",11,24,13
"GALNS","s954_F_NC_02_ASEReadCounter.table","NW_015090842.1:9613379",11,24,13
"GALNS","s954_F_NC_02_ASEReadCounter.table","NW_015090842.1:9613516",13,29,16
"GALNS","s954_F_NC_02_ASEReadCounter.table","NW_015090842.1:9613572",9,23,14
"GALNS","s954_F_NC_02_ASEReadCounter.table","NW_015090842.1:9613597",4,14,10
"GALNS","s954_F_NC_02_ASEReadCounter.table","NW_015090842.1:9613627",2,12,10
"GALNS","s954_F_NC_02_ASEReadCounter.table","NW_015090842.1:9613640",2,9,7
"GALNS","s954_F_NC_02_ASEReadCounter.table","NW_015090842.1:9614025",9,18,9
"GALNS","s954_F_NC_02_ASEReadCounter.table","NW_015090842.1:9614169",7,14,7
"GALNS","s954_F_NC_02_ASEReadCounter.table","NW_015090842.1:9614232",15,15,0
"GALNS","s954_F_NC_02_ASEReadCounter.table","NW_015090842.1:9614667",7,14,7
"GALNS","s954_F_NC_02_ASEReadCounter.table","NW_015090842.1:9614709",9,13,4
"GALNS","s954_F_NC_02_ASEReadCounter.table","NW_015090842.1:9614880",9,15,6
"GALNS","s954_F_NC_02_ASEReadCounter.table","NW_015090842.1:9614902",6,12,6
"GALNS","s954_F_NC_02_ASEReadCounter.table","NW_015090842.1:9614960",3,4,1
"GALNS","s954_F_NC_02_ASEReadCounter.table","NW_015090842.1:9615114",10,16,6
"GALNS","s954_F_NC_02_ASEReadCounter.table","NW_015090842.1:9615199",12,17,5
"GALNS","s954_F_NC_02_ASEReadCounter.table","NW_015090842.1:9615217",10,15,5
"GALNS","s954_F_NC_02_ASEReadCounter.table","NW_015090842.1:9615277",6,12,6
"GALNS","s954_F_NC_02_ASEReadCounter.table","NW_015090842.1:9615377",9,15,6
"GALNS","s954_F_NC_02_ASEReadCounter.table","NW_015090842.1:9647858",5,6,1
"GALNS","s954_F_NC_02_ASEReadCounter.table","NW_015090842.1:9649186",2,6,4
"GALNS","s954_F_NC_02_ASEReadCounter.table","NW_015090842.1:9649237",1,3,2
"GALNS","s954_F_NC_02_ASEReadCounter.table","NW_015090842.1:9661193",2,5,3
"TRAPPC2L","s954_F_NC_02_ASEReadCounter.table","NW_015090842.1:9662951",88,168,80
"TRAPPC2L","s954_F_NC_02_ASEReadCounter.table","NW_015090842.1:9663014",100,190,90
"TRAPPC2L","s954_F_NC_02_ASEReadCounter.table","NW_015090842.1:9664305",173,175,2
"TRAPPC2L","s954_F_NC_02_ASEReadCounter.table","NW_015090842.1:9665155",86,160,74
"TRAPPC2L","s954_F_NC_02_ASEReadCounter.table","NW_015090842.1:9665211",29,54,25
"CBFA2T3","s954_F_NC_02_ASEReadCounter.table","NW_015090842.1:9709469",0,24,24
"CBFA2T3","s954_F_NC_02_ASEReadCounter.table","NW_015090842.1:9709475",0,26,26
"CBFA2T3","s954_F_NC_02_ASEReadCounter.table","NW_015090842.1:9711845",0,8,8
"CBFA2T3","s954_F_NC_02_ASEReadCounter.table","NW_015090842.1:9712157",0,13,13
"CBFA2T3","s954_F_NC_02_ASEReadCounter.table","NW_015090842.1:9712160",0,13,13
"CBFA2T3","s954_F_NC_02_ASEReadCounter.table","NW_015090842.1:9712166",0,12,12
"CBFA2T3","s954_F_NC_02_ASEReadCounter.table","NW_015090842.1:9712536",2,6,4
"CBFA2T3","s954_F_NC_02_ASEReadCounter.table","NW_015090842.1:9712673",4,11,7
"CBFA2T3","s954_F_NC_02_ASEReadCounter.table","NW_015090842.1:9712787",5,22,17
"CBFA2T3","s954_F_NC_02_ASEReadCounter.table","NW_015090842.1:9712791",5,21,16
"CBFA2T3","s954_F_NC_02_ASEReadCounter.table","NW_015090842.1:9712805",3,15,12
"CBFA2T3","s954_F_NC_02_ASEReadCounter.table","NW_015090842.1:9712811",4,18,14
"CBFA2T3","s954_F_NC_02_ASEReadCounter.table","NW_015090842.1:9712848",3,23,20
"CBFA2T3","s954_F_NC_02_ASEReadCounter.table","NW_015090842.1:9713088",13,26,13
"CBFA2T3","s954_F_NC_02_ASEReadCounter.table","NW_015090842.1:9713121",13,22,9
"CBFA2T3","s954_F_NC_02_ASEReadCounter.table","NW_015090842.1:9717058",8,21,13
"CBFA2T3","s954_F_NC_02_ASEReadCounter.table","NW_015090842.1:9717093",11,22,11
"CBFA2T3","s954_F_NC_02_ASEReadCounter.table","NW_015090842.1:9717114",11,23,12
"CBFA2T3","s954_F_NC_02_ASEReadCounter.table","NW_015090842.1:9717139",10,24,14
"CBFA2T3","s954_F_NC_02_ASEReadCounter.table","NW_015090842.1:9719788",5,11,6
"CBFA2T3","s954_F_NC_02_ASEReadCounter.table","NW_015090842.1:9728475",0,1,1
"CBFA2T3","s954_F_NC_02_ASEReadCounter.table","NW_015090842.1:9728522",0,1,1
"CBFA2T3","s954_F_NC_02_ASEReadCounter.table","NW_015090842.1:9728525",0,1,1
"CBFA2T3","s954_F_NC_02_ASEReadCounter.table","NW_015090842.1:9728588",0,1,1
"CBFA2T3","s954_F_NC_02_ASEReadCounter.table","NW_015090842.1:9728601",0,1,1
"CBFA2T3","s954_F_NC_02_ASEReadCounter.table","NW_015090842.1:9728611",0,1,1
"CBFA2T3","s954_F_NC_02_ASEReadCounter.table","NW_015090842.1:9728654",1,3,2
"ACSF3","s954_F_NC_02_ASEReadCounter.table","NW_015090842.1:9773388",0,3,3
"ACSF3","s954_F_NC_02_ASEReadCounter.table","NW_015090842.1:9776753",3,6,3
"ACSF3","s954_F_NC_02_ASEReadCounter.table","NW_015090842.1:9776783",3,7,4
"ACSF3","s954_F_NC_02_ASEReadCounter.table","NW_015090842.1:9776879",4,5,1
"ACSF3","s954_F_NC_02_ASEReadCounter.table","NW_015090842.1:9776965",7,11,4
"ACSF3","s954_F_NC_02_ASEReadCounter.table","NW_015090842.1:9777091",14,18,4
"ACSF3","s954_F_NC_02_ASEReadCounter.table","NW_015090842.1:9777206",12,18,6
"ACSF3","s954_F_NC_02_ASEReadCounter.table","NW_015090842.1:9777283",18,20,2
"ACSF3","s954_F_NC_02_ASEReadCounter.table","NW_015090842.1:9778955",15,36,21
"ACSF3","s954_F_NC_02_ASEReadCounter.table","NW_015090842.1:9778997",18,50,32
"ACSF3","s954_F_NC_02_ASEReadCounter.table","NW_015090842.1:9789311",8,31,23
"ACSF3","s954_F_NC_02_ASEReadCounter.table","NW_015090842.1:9789906",1,19,18
"ACSF3","s954_F_NC_02_ASEReadCounter.table","NW_015090842.1:9834743",33,65,32
"ACSF3","s954_F_NC_02_ASEReadCounter.table","NW_015090842.1:9834852",25,68,43
"ACSF3","s954_F_NC_02_ASEReadCounter.table","NW_015090842.1:9834861",19,57,38
"ACSF3","s954_F_NC_02_ASEReadCounter.table","NW_015090842.1:9839359",23,60,37
"ACSF3","s954_F_NC_02_ASEReadCounter.table","NW_015090842.1:9839378",27,66,39
"ACSF3","s954_F_NC_02_ASEReadCounter.table","NW_015090842.1:9839455",26,61,35
"ACSF3","s954_F_NC_02_ASEReadCounter.table","NW_015090842.1:9839457",27,58,31
"ACSF3","s954_F_NC_02_ASEReadCounter.table","NW_015090842.1:9839489",20,47,27
"ACSF3","s954_F_NC_02_ASEReadCounter.table","NW_015090842.1:9839500",17,43,26
"ACSF3","s954_F_NC_02_ASEReadCounter.table","NW_015090842.1:9839501",17,42,25
"ACSF3","s954_F_NC_02_ASEReadCounter.table","NW_015090842.1:9839504",16,38,22
"ACSF3","s954_F_NC_02_ASEReadCounter.table","NW_015090842.1:9839512",13,30,17
"ACSF3","s954_F_NC_02_ASEReadCounter.table","NW_015090842.1:9839527",8,23,15
"ACSF3","s954_F_NC_02_ASEReadCounter.table","NW_015090842.1:9839533",3,18,15
"ACSF3","s954_F_NC_02_ASEReadCounter.table","NW_015090842.1:9839535",3,17,14
"ACSF3","s954_F_NC_02_ASEReadCounter.table","NW_015090842.1:9839545",2,13,11
"ACSF3","s954_F_NC_02_ASEReadCounter.table","NW_015090842.1:9839550",2,12,10
"ACSF3","s954_F_NC_02_ASEReadCounter.table","NW_015090842.1:9839551",2,12,10
"CDH15","s954_F_NC_02_ASEReadCounter.table","NW_015090842.1:9848307",0,1,1
"CDH15","s954_F_NC_02_ASEReadCounter.table","NW_015090842.1:9848310",0,1,1
"CDH15","s954_F_NC_02_ASEReadCounter.table","NW_015090842.1:9848313",0,1,1
"CDH15","s954_F_NC_02_ASEReadCounter.table","NW_015090842.1:9848888",0,1,1
"CDH15","s954_F_NC_02_ASEReadCounter.table","NW_015090842.1:9848936",0,1,1
"CDH15","s954_F_NC_02_ASEReadCounter.table","NW_015090842.1:9849086",0,1,1
"CDH15","s954_F_NC_02_ASEReadCounter.table","NW_015090842.1:9849119",0,1,1
"CDH15","s954_F_NC_02_ASEReadCounter.table","NW_015090842.1:9849473",2,2,0
"CDH15","s954_F_NC_02_ASEReadCounter.table","NW_015090842.1:9850141",1,1,0
"CDH15","s954_F_NC_02_ASEReadCounter.table","NW_015090842.1:9850432",1,1,0
"CDH15","s954_F_NC_02_ASEReadCounter.table","NW_015090842.1:9850609",1,1,0
"SLC22A31","s954_F_NC_02_ASEReadCounter.table","NW_015090842.1:9851117",3,5,2
"SLC22A31","s954_F_NC_02_ASEReadCounter.table","NW_015090842.1:9851130",3,6,3
"SLC22A31","s954_F_NC_02_ASEReadCounter.table","NW_015090842.1:9851139",3,6,3
"SLC22A31","s954_F_NC_02_ASEReadCounter.table","NW_015090842.1:9851265",6,14,8
"SLC22A31","s954_F_NC_02_ASEReadCounter.table","NW_015090842.1:9851302",7,13,6
"SLC22A31","s954_F_NC_02_ASEReadCounter.table","NW_015090842.1:9851303",7,13,6
"SLC22A31","s954_F_NC_02_ASEReadCounter.table","NW_015090842.1:9851305",7,13,6
"SLC22A31","s954_F_NC_02_ASEReadCounter.table","NW_015090842.1:9851343",4,8,4
"SLC22A31","s954_F_NC_02_ASEReadCounter.table","NW_015090842.1:9851344",4,8,4
"SLC22A31","s954_F_NC_02_ASEReadCounter.table","NW_015090842.1:9851361",8,8,0
"SLC22A31","s954_F_NC_02_ASEReadCounter.table","NW_015090842.1:9851381",2,11,9
"SLC22A31","s954_F_NC_02_ASEReadCounter.table","NW_015090842.1:9851421",5,15,10
"SLC22A31","s954_F_NC_02_ASEReadCounter.table","NW_015090842.1:9851501",2,8,6
"SLC22A31","s954_F_NC_02_ASEReadCounter.table","NW_015090842.1:9851526",5,14,9
"SLC22A31","s954_F_NC_02_ASEReadCounter.table","NW_015090842.1:9851589",6,19,13
"SLC22A31","s954_F_NC_02_ASEReadCounter.table","NW_015090842.1:9851712",8,21,13
"SLC22A31","s954_F_NC_02_ASEReadCounter.table","NW_015090842.1:9851899",3,11,8
"SLC22A31","s954_F_NC_02_ASEReadCounter.table","NW_015090842.1:9852139",6,16,10
"SLC22A31","s954_F_NC_02_ASEReadCounter.table","NW_015090842.1:9852380",5,21,16
"SLC22A31","s954_F_NC_02_ASEReadCounter.table","NW_015090842.1:9852431",2,12,10
"SLC22A31","s954_F_NC_02_ASEReadCounter.table","NW_015090842.1:9852630",2,11,9
"SLC22A31","s954_F_NC_02_ASEReadCounter.table","NW_015090842.1:9852711",4,11,7
"SLC22A31","s954_F_NC_02_ASEReadCounter.table","NW_015090842.1:9853099",5,9,4
"SLC22A31","s954_F_NC_02_ASEReadCounter.table","NW_015090842.1:9853102",5,9,4
"SLC22A31","s954_F_NC_02_ASEReadCounter.table","NW_015090842.1:9853421",1,2,1
"SLC22A31","s954_F_NC_02_ASEReadCounter.table","NW_015090842.1:9853457",3,4,1
"SLC22A31","s954_F_NC_02_ASEReadCounter.table","NW_015090842.1:9853502",3,3,0
"ANKRD11","s954_F_NC_02_ASEReadCounter.table","NW_015090842.1:9858863",8,19,11
"ANKRD11","s954_F_NC_02_ASEReadCounter.table","NW_015090842.1:9859101",147,336,189
"ANKRD11","s954_F_NC_02_ASEReadCounter.table","NW_015090842.1:9859352",202,426,224
"ANKRD11","s954_F_NC_02_ASEReadCounter.table","NW_015090842.1:9859381",106,275,169
"ANKRD11","s954_F_NC_02_ASEReadCounter.table","NW_015090842.1:9859679",163,337,174
"ANKRD11","s954_F_NC_02_ASEReadCounter.table","NW_015090842.1:9861097",121,252,131
"ANKRD11","s954_F_NC_02_ASEReadCounter.table","NW_015090842.1:9862571",76,164,88
"ANKRD11","s954_F_NC_02_ASEReadCounter.table","NW_015090842.1:9862652",74,118,44
"ANKRD11","s954_F_NC_02_ASEReadCounter.table","NW_015090842.1:9866071",0,89,89
"ANKRD11","s954_F_NC_02_ASEReadCounter.table","NW_015090842.1:9866200",0,84,84
"ANKRD11","s954_F_NC_02_ASEReadCounter.table","NW_015090842.1:9867391",30,52,22
"ANKRD11","s954_F_NC_02_ASEReadCounter.table","NW_015090842.1:9867472",31,63,32
"ANKRD11","s954_F_NC_02_ASEReadCounter.table","NW_015090842.1:9867559",39,79,40
"ANKRD11","s954_F_NC_02_ASEReadCounter.table","NW_015090842.1:9867667",49,84,35
"ANKRD11","s954_F_NC_02_ASEReadCounter.table","NW_015090842.1:9867934",38,70,32
"ANKRD11","s954_F_NC_02_ASEReadCounter.table","NW_015090842.1:9868064",49,83,34
"ANKRD11","s954_F_NC_02_ASEReadCounter.table","NW_015090842.1:9868093",39,65,26
"ANKRD11","s954_F_NC_02_ASEReadCounter.table","NW_015090842.1:9868222",38,88,50
"ANKRD11","s954_F_NC_02_ASEReadCounter.table","NW_015090842.1:9868327",46,100,54
"ANKRD11","s954_F_NC_02_ASEReadCounter.table","NW_015090842.1:9868414",63,119,56
"ANKRD11","s954_F_NC_02_ASEReadCounter.table","NW_015090842.1:9868441",60,108,48
"ANKRD11","s954_F_NC_02_ASEReadCounter.table","NW_015090842.1:9868444",62,115,53
"ANKRD11","s954_F_NC_02_ASEReadCounter.table","NW_015090842.1:9868519",67,142,75
"ANKRD11","s954_F_NC_02_ASEReadCounter.table","NW_015090842.1:9868609",75,147,72
"ANKRD11","s954_F_NC_02_ASEReadCounter.table","NW_015090842.1:9868666",77,149,72
"ANKRD11","s954_F_NC_02_ASEReadCounter.table","NW_015090842.1:9868738",189,189,0
"ANKRD11","s954_F_NC_02_ASEReadCounter.table","NW_015090842.1:9869431",137,272,135
"ANKRD11","s954_F_NC_02_ASEReadCounter.table","NW_015090842.1:9869578",227,397,170
"ANKRD11","s954_F_NC_02_ASEReadCounter.table","NW_015090842.1:9869734",231,465,234
"ANKRD11","s954_F_NC_02_ASEReadCounter.table","NW_015090842.1:9870070",197,404,207
"ANKRD11","s954_F_NC_02_ASEReadCounter.table","NW_015090842.1:9870349",221,464,243
"ANKRD11","s954_F_NC_02_ASEReadCounter.table","NW_015090842.1:9870604",219,475,256
"ANKRD11","s954_F_NC_02_ASEReadCounter.table","NW_015090842.1:9870613",237,502,265
"ANKRD11","s954_F_NC_02_ASEReadCounter.table","NW_015090842.1:9870685",321,638,317
"ANKRD11","s954_F_NC_02_ASEReadCounter.table","NW_015090842.1:9870760",264,562,298
"ANKRD11","s954_F_NC_02_ASEReadCounter.table","NW_015090842.1:9870847",231,498,267
"ANKRD11","s954_F_NC_02_ASEReadCounter.table","NW_015090842.1:9871103",178,362,184
"ANKRD11","s954_F_NC_02_ASEReadCounter.table","NW_015090842.1:9871165",184,406,222
"ANKRD11","s954_F_NC_02_ASEReadCounter.table","NW_015090842.1:9871508",268,269,1
"ANKRD11","s954_F_NC_02_ASEReadCounter.table","NW_015090842.1:9871820",54,132,78
"ANKRD11","s954_F_NC_02_ASEReadCounter.table","NW_015090842.1:9872118",50,112,62
"ANKRD11","s954_F_NC_02_ASEReadCounter.table","NW_015090842.1:9877406",27,50,23
"SPG7","s954_F_NC_02_ASEReadCounter.table","NW_015090842.1:10051190",62,117,55
"SPG7","s954_F_NC_02_ASEReadCounter.table","NW_015090842.1:10051218",59,131,72
"SPG7","s954_F_NC_02_ASEReadCounter.table","NW_015090842.1:10052348",80,148,68
"SPG7","s954_F_NC_02_ASEReadCounter.table","NW_015090842.1:10052366",81,154,73
"SPG7","s954_F_NC_02_ASEReadCounter.table","NW_015090842.1:10065173",112,196,84
"SPG7","s954_F_NC_02_ASEReadCounter.table","NW_015090842.1:10065215",105,190,85
"SPG7","s954_F_NC_02_ASEReadCounter.table","NW_015090842.1:10066365",96,170,74
"SPG7","s954_F_NC_02_ASEReadCounter.table","NW_015090842.1:10069752",107,210,103
"SPG7","s954_F_NC_02_ASEReadCounter.table","NW_015090842.1:10069800",125,258,133
"SPG7","s954_F_NC_02_ASEReadCounter.table","NW_015090842.1:10071192",165,316,151
"SPG7","s954_F_NC_02_ASEReadCounter.table","NW_015090842.1:10071219",156,287,131
"SPG7","s954_F_NC_02_ASEReadCounter.table","NW_015090842.1:10071967",124,248,124
"SPG7","s954_F_NC_02_ASEReadCounter.table","NW_015090842.1:10075109",240,454,214
"SPG7","s954_F_NC_02_ASEReadCounter.table","NW_015090842.1:10075114",238,447,209
"SPG7","s954_F_NC_02_ASEReadCounter.table","NW_015090842.1:10075198",174,340,166
"SPG7","s954_F_NC_02_ASEReadCounter.table","NW_015090842.1:10075487",161,304,143
"SPG7","s954_F_NC_02_ASEReadCounter.table","NW_015090842.1:10075488",161,304,143
"SPG7","s954_F_NC_02_ASEReadCounter.table","NW_015090842.1:10075548",111,211,100
"RPL13","s954_F_NC_02_ASEReadCounter.table","NW_015090842.1:10077387",397,752,355
"RPL13","s954_F_NC_02_ASEReadCounter.table","NW_015090842.1:10077978",592,1235,643
"RPL13","s954_F_NC_02_ASEReadCounter.table","NW_015090842.1:10077992",584,1202,618
"CPNE7","s954_F_NC_02_ASEReadCounter.table","NW_015090842.1:10084001",22,38,16
"CPNE7","s954_F_NC_02_ASEReadCounter.table","NW_015090842.1:10084856",13,27,14
"CPNE7","s954_F_NC_02_ASEReadCounter.table","NW_015090842.1:10084872",14,30,16
"CPNE7","s954_F_NC_02_ASEReadCounter.table","NW_015090842.1:10084892",23,38,15
"CPNE7","s954_F_NC_02_ASEReadCounter.table","NW_015090842.1:10084921",24,39,15
"CPNE7","s954_F_NC_02_ASEReadCounter.table","NW_015090842.1:10084935",29,44,15
"CPNE7","s954_F_NC_02_ASEReadCounter.table","NW_015090842.1:10085000",33,55,22
"CPNE7","s954_F_NC_02_ASEReadCounter.table","NW_015090842.1:10085089",26,45,19
"CPNE7","s954_F_NC_02_ASEReadCounter.table","NW_015090842.1:10085096",27,47,20
"CPNE7","s954_F_NC_02_ASEReadCounter.table","NW_015090842.1:10085126",31,47,16
"CPNE7","s954_F_NC_02_ASEReadCounter.table","NW_015090842.1:10085167",46,46,0
"CPNE7","s954_F_NC_02_ASEReadCounter.table","NW_015090842.1:10085180",27,40,13
"CPNE7","s954_F_NC_02_ASEReadCounter.table","NW_015090842.1:10085201",22,31,9
"CPNE7","s954_F_NC_02_ASEReadCounter.table","NW_015090842.1:10088134",42,80,38
"CPNE7","s954_F_NC_02_ASEReadCounter.table","NW_015090842.1:10088146",40,77,37
"CPNE7","s954_F_NC_02_ASEReadCounter.table","NW_015090842.1:10088806",61,99,38
"CPNE7","s954_F_NC_02_ASEReadCounter.table","NW_015090842.1:10088940",70,107,37
"CPNE7","s954_F_NC_02_ASEReadCounter.table","NW_015090842.1:10088965",61,94,33
"CPNE7","s954_F_NC_02_ASEReadCounter.table","NW_015090842.1:10088967",60,95,35
"CPNE7","s954_F_NC_02_ASEReadCounter.table","NW_015090842.1:10088973",58,94,36
"CPNE7","s954_F_NC_02_ASEReadCounter.table","NW_015090842.1:10090924",90,169,79
"CPNE7","s954_F_NC_02_ASEReadCounter.table","NW_015090842.1:10090930",94,171,77
"CPNE7","s954_F_NC_02_ASEReadCounter.table","NW_015090842.1:10091075",100,187,87
"CPNE7","s954_F_NC_02_ASEReadCounter.table","NW_015090842.1:10091389",119,212,93
"CPNE7","s954_F_NC_02_ASEReadCounter.table","NW_015090842.1:10091407",134,241,107
"CPNE7","s954_F_NC_02_ASEReadCounter.table","NW_015090842.1:10091488",196,196,0
"CPNE7","s954_F_NC_02_ASEReadCounter.table","NW_015090842.1:10091491",205,205,0
"CPNE7","s954_F_NC_02_ASEReadCounter.table","NW_015090842.1:10091530",113,208,95
"CPNE7","s954_F_NC_02_ASEReadCounter.table","NW_015090842.1:10091875",144,262,118
"CPNE7","s954_F_NC_02_ASEReadCounter.table","NW_015090842.1:10091983",136,219,83
"CPNE7","s954_F_NC_02_ASEReadCounter.table","NW_015090842.1:10091997",139,240,101
"CPNE7","s954_F_NC_02_ASEReadCounter.table","NW_015090842.1:10092038",73,140,67
"CPNE7","s954_F_NC_02_ASEReadCounter.table","NW_015090842.1:10092140",92,181,89
"CPNE7","s954_F_NC_02_ASEReadCounter.table","NW_015090842.1:10092183",73,126,53
"CPNE7","s954_F_NC_02_ASEReadCounter.table","NW_015090842.1:10092201",66,111,45
"CPNE7","s954_F_NC_02_ASEReadCounter.table","NW_015090842.1:10092230",48,76,28
"CPNE7","s954_F_NC_02_ASEReadCounter.table","NW_015090842.1:10092246",31,52,21
"LOC106888185","s954_F_NC_02_ASEReadCounter.table","NW_015090842.1:10094965",0,2,2
"LOC106888185","s954_F_NC_02_ASEReadCounter.table","NW_015090842.1:10094966",1,3,2
"LOC106888185","s954_F_NC_02_ASEReadCounter.table","NW_015090842.1:10094985",1,3,2
"LOC106888185","s954_F_NC_02_ASEReadCounter.table","NW_015090842.1:10095055",1,2,1
"LOC106888185","s954_F_NC_02_ASEReadCounter.table","NW_015090842.1:10095062",1,2,1
"LOC106888185","s954_F_NC_02_ASEReadCounter.table","NW_015090842.1:10095130",0,1,1
"LOC106888185","s954_F_NC_02_ASEReadCounter.table","NW_015090842.1:10095265",2,4,2
"LOC106888185","s954_F_NC_02_ASEReadCounter.table","NW_015090842.1:10095586",3,9,6
"LOC106888185","s954_F_NC_02_ASEReadCounter.table","NW_015090842.1:10095593",3,9,6
"LOC106888185","s954_F_NC_02_ASEReadCounter.table","NW_015090842.1:10095616",2,8,6
"LOC106888185","s954_F_NC_02_ASEReadCounter.table","NW_015090842.1:10095662",1,2,1
"LOC106888185","s954_F_NC_02_ASEReadCounter.table","NW_015090842.1:10095674",1,2,1
"LOC106888185","s954_F_NC_02_ASEReadCounter.table","NW_015090842.1:10095786",3,5,2
"LOC106888185","s954_F_NC_02_ASEReadCounter.table","NW_015090842.1:10095831",2,4,2
"LOC106888185","s954_F_NC_02_ASEReadCounter.table","NW_015090842.1:10096230",0,1,1
"LOC106888185","s954_F_NC_02_ASEReadCounter.table","NW_015090842.1:10096249",2,4,2
"LOC106888185","s954_F_NC_02_ASEReadCounter.table","NW_015090842.1:10096272",3,4,1
"LOC106888185","s954_F_NC_02_ASEReadCounter.table","NW_015090842.1:10096288",3,4,1
"LOC106888185","s954_F_NC_02_ASEReadCounter.table","NW_015090842.1:10097248",1,4,3
"LOC106888185","s954_F_NC_02_ASEReadCounter.table","NW_015090842.1:10097265",0,3,3
"LOC106888185","s954_F_NC_02_ASEReadCounter.table","NW_015090842.1:10097446",0,1,1
"DPEP1","s954_F_NC_02_ASEReadCounter.table","NW_015090842.1:10101072",0,2,2
"DPEP1","s954_F_NC_02_ASEReadCounter.table","NW_015090842.1:10101199",0,2,2
"DPEP1","s954_F_NC_02_ASEReadCounter.table","NW_015090842.1:10101875",0,1,1
"CHMP1A","s954_F_NC_02_ASEReadCounter.table","NW_015090842.1:10102901",63,162,99
"CHMP1A","s954_F_NC_02_ASEReadCounter.table","NW_015090842.1:10102961",55,170,115
"CHMP1A","s954_F_NC_02_ASEReadCounter.table","NW_015090842.1:10102996",40,140,100
"CHMP1A","s954_F_NC_02_ASEReadCounter.table","NW_015090842.1:10103004",45,138,93
"CHMP1A","s954_F_NC_02_ASEReadCounter.table","NW_015090842.1:10103006",46,140,94
"CHMP1A","s954_F_NC_02_ASEReadCounter.table","NW_015090842.1:10103052",81,189,108
"CHMP1A","s954_F_NC_02_ASEReadCounter.table","NW_015090842.1:10103095",84,196,112
"CHMP1A","s954_F_NC_02_ASEReadCounter.table","NW_015090842.1:10103096",86,197,111
"CHMP1A","s954_F_NC_02_ASEReadCounter.table","NW_015090842.1:10103152",62,140,78
"CHMP1A","s954_F_NC_02_ASEReadCounter.table","NW_015090842.1:10103173",66,148,82
"CHMP1A","s954_F_NC_02_ASEReadCounter.table","NW_015090842.1:10103334",40,103,63
"CHMP1A","s954_F_NC_02_ASEReadCounter.table","NW_015090842.1:10103373",24,93,69
"CHMP1A","s954_F_NC_02_ASEReadCounter.table","NW_015090842.1:10103408",40,115,75
"CHMP1A","s954_F_NC_02_ASEReadCounter.table","NW_015090842.1:10103412",48,121,73
"CHMP1A","s954_F_NC_02_ASEReadCounter.table","NW_015090842.1:10103512",47,125,78
"CHMP1A","s954_F_NC_02_ASEReadCounter.table","NW_015090842.1:10103513",50,131,81
"CHMP1A","s954_F_NC_02_ASEReadCounter.table","NW_015090842.1:10103583",41,94,53
"CHMP1A","s954_F_NC_02_ASEReadCounter.table","NW_015090842.1:10103614",48,96,48
"CHMP1A","s954_F_NC_02_ASEReadCounter.table","NW_015090842.1:10103657",44,88,44
"CHMP1A","s954_F_NC_02_ASEReadCounter.table","NW_015090842.1:10103669",37,81,44
"CHMP1A","s954_F_NC_02_ASEReadCounter.table","NW_015090842.1:10103674",35,76,41
"CHMP1A","s954_F_NC_02_ASEReadCounter.table","NW_015090842.1:10103677",35,77,42
"CHMP1A","s954_F_NC_02_ASEReadCounter.table","NW_015090842.1:10103729",52,103,51
"CHMP1A","s954_F_NC_02_ASEReadCounter.table","NW_015090842.1:10103758",57,109,52
"CHMP1A","s954_F_NC_02_ASEReadCounter.table","NW_015090842.1:10103761",55,104,49
"CHMP1A","s954_F_NC_02_ASEReadCounter.table","NW_015090842.1:10103788",57,124,67
"CHMP1A","s954_F_NC_02_ASEReadCounter.table","NW_015090842.1:10103789",57,121,64
"CHMP1A","s954_F_NC_02_ASEReadCounter.table","NW_015090842.1:10103790",56,122,66
"CHMP1A","s954_F_NC_02_ASEReadCounter.table","NW_015090842.1:10103950",66,113,47
"CHMP1A","s954_F_NC_02_ASEReadCounter.table","NW_015090842.1:10104335",29,66,37
"CHMP1A","s954_F_NC_02_ASEReadCounter.table","NW_015090842.1:10104429",42,89,47
"CHMP1A","s954_F_NC_02_ASEReadCounter.table","NW_015090842.1:10104532",42,89,47
"CHMP1A","s954_F_NC_02_ASEReadCounter.table","NW_015090842.1:10104633",39,77,38
"CHMP1A","s954_F_NC_02_ASEReadCounter.table","NW_015090842.1:10104759",42,86,44
"CHMP1A","s954_F_NC_02_ASEReadCounter.table","NW_015090842.1:10104794",41,84,43
"CHMP1A","s954_F_NC_02_ASEReadCounter.table","NW_015090842.1:10104841",57,57,0
"CHMP1A","s954_F_NC_02_ASEReadCounter.table","NW_015090842.1:10104844",30,58,28
"CHMP1A","s954_F_NC_02_ASEReadCounter.table","NW_015090842.1:10106242",33,73,40
"CHMP1A","s954_F_NC_02_ASEReadCounter.table","NW_015090842.1:10106290",29,64,35
"CHMP1A","s954_F_NC_02_ASEReadCounter.table","NW_015090842.1:10106335",26,59,33
"CHMP1A","s954_F_NC_02_ASEReadCounter.table","NW_015090842.1:10106383",30,75,45
"CHMP1A","s954_F_NC_02_ASEReadCounter.table","NW_015090842.1:10106747",36,68,32
"CHMP1A","s954_F_NC_02_ASEReadCounter.table","NW_015090842.1:10107404",30,78,48
"CHMP1A","s954_F_NC_02_ASEReadCounter.table","NW_015090842.1:10107876",27,57,30
"CDK10","s954_F_NC_02_ASEReadCounter.table","NW_015090842.1:10109030",8,9,1
"CDK10","s954_F_NC_02_ASEReadCounter.table","NW_015090842.1:10109963",35,85,50
"CDK10","s954_F_NC_02_ASEReadCounter.table","NW_015090842.1:10110887",20,57,37
"CDK10","s954_F_NC_02_ASEReadCounter.table","NW_015090842.1:10111254",19,60,41
"CDK10","s954_F_NC_02_ASEReadCounter.table","NW_015090842.1:10111380",25,82,57
"CDK10","s954_F_NC_02_ASEReadCounter.table","NW_015090842.1:10111395",26,75,49
"CDK10","s954_F_NC_02_ASEReadCounter.table","NW_015090842.1:10111437",17,70,53
"CDK10","s954_F_NC_02_ASEReadCounter.table","NW_015090842.1:10111798",33,101,68
"CDK10","s954_F_NC_02_ASEReadCounter.table","NW_015090842.1:10111840",29,95,66
"CDK10","s954_F_NC_02_ASEReadCounter.table","NW_015090842.1:10112031",33,114,81
"CDK10","s954_F_NC_02_ASEReadCounter.table","NW_015090842.1:10112285",39,123,84
"CDK10","s954_F_NC_02_ASEReadCounter.table","NW_015090842.1:10112398",41,113,72
"CDK10","s954_F_NC_02_ASEReadCounter.table","NW_015090842.1:10112455",43,106,63
"CDK10","s954_F_NC_02_ASEReadCounter.table","NW_015090842.1:10112461",39,95,56
"CDK10","s954_F_NC_02_ASEReadCounter.table","NW_015090842.1:10112497",35,102,67
"CDK10","s954_F_NC_02_ASEReadCounter.table","NW_015090842.1:10112508",31,106,75
"CDK10","s954_F_NC_02_ASEReadCounter.table","NW_015090842.1:10112518",22,94,72
"CDK10","s954_F_NC_02_ASEReadCounter.table","NW_015090842.1:10112540",10,92,82
"CDK10","s954_F_NC_02_ASEReadCounter.table","NW_015090842.1:10112556",21,94,73
"CDK10","s954_F_NC_02_ASEReadCounter.table","NW_015090842.1:10112561",25,121,96
"CDK10","s954_F_NC_02_ASEReadCounter.table","NW_015090842.1:10112596",35,123,88
"CDK10","s954_F_NC_02_ASEReadCounter.table","NW_015090842.1:10112630",32,108,76
"CDK10","s954_F_NC_02_ASEReadCounter.table","NW_015090842.1:10112656",38,120,82
"CDK10","s954_F_NC_02_ASEReadCounter.table","NW_015090842.1:10112665",24,83,59
"CDK10","s954_F_NC_02_ASEReadCounter.table","NW_015090842.1:10112668",25,84,59
"CDK10","s954_F_NC_02_ASEReadCounter.table","NW_015090842.1:10112781",20,48,28
"CDK10","s954_F_NC_02_ASEReadCounter.table","NW_015090842.1:10112782",20,48,28
"CDK10","s954_F_NC_02_ASEReadCounter.table","NW_015090842.1:10112795",18,44,26
"CDK10","s954_F_NC_02_ASEReadCounter.table","NW_015090842.1:10112841",7,18,11
"CDK10","s954_F_NC_02_ASEReadCounter.table","NW_015090842.1:10112861",7,15,8
"SPATA2L","s954_F_NC_02_ASEReadCounter.table","NW_015090842.1:10113212",31,68,37
"SPATA2L","s954_F_NC_02_ASEReadCounter.table","NW_015090842.1:10113280",45,115,70
"SPATA2L","s954_F_NC_02_ASEReadCounter.table","NW_015090842.1:10113296",46,116,70
"SPATA2L","s954_F_NC_02_ASEReadCounter.table","NW_015090842.1:10113321",51,133,82
"SPATA2L","s954_F_NC_02_ASEReadCounter.table","NW_015090842.1:10113332",51,138,87
"SPATA2L","s954_F_NC_02_ASEReadCounter.table","NW_015090842.1:10113380",47,127,80
"SPATA2L","s954_F_NC_02_ASEReadCounter.table","NW_015090842.1:10113381",46,131,85
"SPATA2L","s954_F_NC_02_ASEReadCounter.table","NW_015090842.1:10113412",56,156,100
"SPATA2L","s954_F_NC_02_ASEReadCounter.table","NW_015090842.1:10113421",59,156,97
"SPATA2L","s954_F_NC_02_ASEReadCounter.table","NW_015090842.1:10113465",66,152,86
"SPATA2L","s954_F_NC_02_ASEReadCounter.table","NW_015090842.1:10113535",89,176,87
"SPATA2L","s954_F_NC_02_ASEReadCounter.table","NW_015090842.1:10113645",74,201,127
"SPATA2L","s954_F_NC_02_ASEReadCounter.table","NW_015090842.1:10113682",103,244,141
"SPATA2L","s954_F_NC_02_ASEReadCounter.table","NW_015090842.1:10113696",86,206,120
"SPATA2L","s954_F_NC_02_ASEReadCounter.table","NW_015090842.1:10113727",91,224,133
"SPATA2L","s954_F_NC_02_ASEReadCounter.table","NW_015090842.1:10113799",94,214,120
"SPATA2L","s954_F_NC_02_ASEReadCounter.table","NW_015090842.1:10113809",103,223,120
"SPATA2L","s954_F_NC_02_ASEReadCounter.table","NW_015090842.1:10113827",104,216,112
"SPATA2L","s954_F_NC_02_ASEReadCounter.table","NW_015090842.1:10113831",99,212,113
"SPATA2L","s954_F_NC_02_ASEReadCounter.table","NW_015090842.1:10113894",87,181,94
"SPATA2L","s954_F_NC_02_ASEReadCounter.table","NW_015090842.1:10113905",64,154,90
"SPATA2L","s954_F_NC_02_ASEReadCounter.table","NW_015090842.1:10113914",60,145,85
"SPATA2L","s954_F_NC_02_ASEReadCounter.table","NW_015090842.1:10113920",65,156,91
"SPATA2L","s954_F_NC_02_ASEReadCounter.table","NW_015090842.1:10113937",83,189,106
"SPATA2L","s954_F_NC_02_ASEReadCounter.table","NW_015090842.1:10113971",73,173,100
"SPATA2L","s954_F_NC_02_ASEReadCounter.table","NW_015090842.1:10113976",62,175,113
"SPATA2L","s954_F_NC_02_ASEReadCounter.table","NW_015090842.1:10113985",70,162,92
"SPATA2L","s954_F_NC_02_ASEReadCounter.table","NW_015090842.1:10113994",84,180,96
"SPATA2L","s954_F_NC_02_ASEReadCounter.table","NW_015090842.1:10114063",63,134,71
"SPATA2L","s954_F_NC_02_ASEReadCounter.table","NW_015090842.1:10114066",61,132,71
"SPATA2L","s954_F_NC_02_ASEReadCounter.table","NW_015090842.1:10114069",64,135,71
"SPATA2L","s954_F_NC_02_ASEReadCounter.table","NW_015090842.1:10114121",41,100,59
"SPATA2L","s954_F_NC_02_ASEReadCounter.table","NW_015090842.1:10114159",38,106,68
"SPATA2L","s954_F_NC_02_ASEReadCounter.table","NW_015090842.1:10114282",134,134,0
"SPATA2L","s954_F_NC_02_ASEReadCounter.table","NW_015090842.1:10114470",47,128,81
"SPATA2L","s954_F_NC_02_ASEReadCounter.table","NW_015090842.1:10114524",37,110,73
"VPS9D1","s954_F_NC_02_ASEReadCounter.table","NW_015090842.1:10116377",39,96,57
"VPS9D1","s954_F_NC_02_ASEReadCounter.table","NW_015090842.1:10116415",31,99,68
"VPS9D1","s954_F_NC_02_ASEReadCounter.table","NW_015090842.1:10116607",35,103,68
"VPS9D1","s954_F_NC_02_ASEReadCounter.table","NW_015090842.1:10116816",87,87,0
"VPS9D1","s954_F_NC_02_ASEReadCounter.table","NW_015090842.1:10116821",34,88,54
"VPS9D1","s954_F_NC_02_ASEReadCounter.table","NW_015090842.1:10116825",33,80,47
"VPS9D1","s954_F_NC_02_ASEReadCounter.table","NW_015090842.1:10116882",40,87,47
"VPS9D1","s954_F_NC_02_ASEReadCounter.table","NW_015090842.1:10116885",41,88,47
"VPS9D1","s954_F_NC_02_ASEReadCounter.table","NW_015090842.1:10116933",36,91,55
"VPS9D1","s954_F_NC_02_ASEReadCounter.table","NW_015090842.1:10116942",38,93,55
"VPS9D1","s954_F_NC_02_ASEReadCounter.table","NW_015090842.1:10117152",25,72,47
"VPS9D1","s954_F_NC_02_ASEReadCounter.table","NW_015090842.1:10117396",51,51,0
"VPS9D1","s954_F_NC_02_ASEReadCounter.table","NW_015090842.1:10117405",36,36,0
"VPS9D1","s954_F_NC_02_ASEReadCounter.table","NW_015090842.1:10117480",17,52,35
"VPS9D1","s954_F_NC_02_ASEReadCounter.table","NW_015090842.1:10117497",12,38,26
"VPS9D1","s954_F_NC_02_ASEReadCounter.table","NW_015090842.1:10117499",13,43,30
"VPS9D1","s954_F_NC_02_ASEReadCounter.table","NW_015090842.1:10117516",22,56,34
"VPS9D1","s954_F_NC_02_ASEReadCounter.table","NW_015090842.1:10117525",22,59,37
"VPS9D1","s954_F_NC_02_ASEReadCounter.table","NW_015090842.1:10117579",30,70,40
"VPS9D1","s954_F_NC_02_ASEReadCounter.table","NW_015090842.1:10117627",27,65,38
"VPS9D1","s954_F_NC_02_ASEReadCounter.table","NW_015090842.1:10117678",11,50,39
"VPS9D1","s954_F_NC_02_ASEReadCounter.table","NW_015090842.1:10117773",29,76,47
"VPS9D1","s954_F_NC_02_ASEReadCounter.table","NW_015090842.1:10117937",36,96,60
"VPS9D1","s954_F_NC_02_ASEReadCounter.table","NW_015090842.1:10117961",30,82,52
"VPS9D1","s954_F_NC_02_ASEReadCounter.table","NW_015090842.1:10118236",35,94,59
"VPS9D1","s954_F_NC_02_ASEReadCounter.table","NW_015090842.1:10118414",29,87,58
"VPS9D1","s954_F_NC_02_ASEReadCounter.table","NW_015090842.1:10118973",27,79,52
"VPS9D1","s954_F_NC_02_ASEReadCounter.table","NW_015090842.1:10119500",18,44,26
"ZNF276","s954_F_NC_02_ASEReadCounter.table","NW_015090842.1:10121760",1,6,5
"ZNF276","s954_F_NC_02_ASEReadCounter.table","NW_015090842.1:10121769",1,5,4
"ZNF276","s954_F_NC_02_ASEReadCounter.table","NW_015090842.1:10121802",3,8,5
"ZNF276","s954_F_NC_02_ASEReadCounter.table","NW_015090842.1:10121971",9,13,4
"ZNF276","s954_F_NC_02_ASEReadCounter.table","NW_015090842.1:10122883",4,9,5
"ZNF276","s954_F_NC_02_ASEReadCounter.table","NW_015090842.1:10123069",12,20,8
"ZNF276","s954_F_NC_02_ASEReadCounter.table","NW_015090842.1:10123207",24,39,15
"ZNF276","s954_F_NC_02_ASEReadCounter.table","NW_015090842.1:10125787",21,35,14
"ZNF276","s954_F_NC_02_ASEReadCounter.table","NW_015090842.1:10126309",16,38,22
"ZNF276","s954_F_NC_02_ASEReadCounter.table","NW_015090842.1:10126348",19,45,26
"ZNF276","s954_F_NC_02_ASEReadCounter.table","NW_015090842.1:10126978",19,49,30
"ZNF276","s954_F_NC_02_ASEReadCounter.table","NW_015090842.1:10126991",18,45,27
"ZNF276","s954_F_NC_02_ASEReadCounter.table","NW_015090842.1:10127023",22,51,29
"ZNF276","s954_F_NC_02_ASEReadCounter.table","NW_015090842.1:10127063",18,47,29
"ZNF276","s954_F_NC_02_ASEReadCounter.table","NW_015090842.1:10127373",16,43,27
"ZNF276","s954_F_NC_02_ASEReadCounter.table","NW_015090842.1:10127931",24,45,21
"ZNF276","s954_F_NC_02_ASEReadCounter.table","NW_015090842.1:10128070",26,56,30
"ZNF276","s954_F_NC_02_ASEReadCounter.table","NW_015090842.1:10128102",30,57,27
"ZNF276","s954_F_NC_02_ASEReadCounter.table","NW_015090842.1:10128356",20,53,33
"ZNF276","s954_F_NC_02_ASEReadCounter.table","NW_015090842.1:10128497",15,31,16
"FANCA","s954_F_NC_02_ASEReadCounter.table","NW_015090842.1:10128822",0,1,1
"FANCA","s954_F_NC_02_ASEReadCounter.table","NW_015090842.1:10129383",0,1,1
"FANCA","s954_F_NC_02_ASEReadCounter.table","NW_015090842.1:10129390",0,1,1
"FANCA","s954_F_NC_02_ASEReadCounter.table","NW_015090842.1:10129422",0,1,1
"FANCA","s954_F_NC_02_ASEReadCounter.table","NW_015090842.1:10129969",2,3,1
"FANCA","s954_F_NC_02_ASEReadCounter.table","NW_015090842.1:10130399",2,4,2
"FANCA","s954_F_NC_02_ASEReadCounter.table","NW_015090842.1:10133530",0,1,1
"FANCA","s954_F_NC_02_ASEReadCounter.table","NW_015090842.1:10133533",0,1,1
"FANCA","s954_F_NC_02_ASEReadCounter.table","NW_015090842.1:10133536",0,1,1
"FANCA","s954_F_NC_02_ASEReadCounter.table","NW_015090842.1:10133601",1,4,3
"FANCA","s954_F_NC_02_ASEReadCounter.table","NW_015090842.1:10134492",1,5,4
"FANCA","s954_F_NC_02_ASEReadCounter.table","NW_015090842.1:10134531",0,3,3
"FANCA","s954_F_NC_02_ASEReadCounter.table","NW_015090842.1:10136957",0,2,2
"FANCA","s954_F_NC_02_ASEReadCounter.table","NW_015090842.1:10136982",0,1,1
"FANCA","s954_F_NC_02_ASEReadCounter.table","NW_015090842.1:10140699",1,1,0
"FANCA","s954_F_NC_02_ASEReadCounter.table","NW_015090842.1:10141234",1,4,3
"FANCA","s954_F_NC_02_ASEReadCounter.table","NW_015090842.1:10154490",0,2,2
"SPIRE2","s954_F_NC_02_ASEReadCounter.table","NW_015090842.1:10172284",19,34,15
"SPIRE2","s954_F_NC_02_ASEReadCounter.table","NW_015090842.1:10175262",43,65,22
"SPIRE2","s954_F_NC_02_ASEReadCounter.table","NW_015090842.1:10175352",24,36,12
"SPIRE2","s954_F_NC_02_ASEReadCounter.table","NW_015090842.1:10175400",69,122,53
"SPIRE2","s954_F_NC_02_ASEReadCounter.table","NW_015090842.1:10175418",80,136,56
"SPIRE2","s954_F_NC_02_ASEReadCounter.table","NW_015090842.1:10175704",98,160,62
"SPIRE2","s954_F_NC_02_ASEReadCounter.table","NW_015090842.1:10176115",107,186,79
"SPIRE2","s954_F_NC_02_ASEReadCounter.table","NW_015090842.1:10176561",108,203,95
"SPIRE2","s954_F_NC_02_ASEReadCounter.table","NW_015090842.1:10176817",128,234,106
"SPIRE2","s954_F_NC_02_ASEReadCounter.table","NW_015090842.1:10177084",83,142,59
"SPIRE2","s954_F_NC_02_ASEReadCounter.table","NW_015090842.1:10177110",90,150,60
"SPIRE2","s954_F_NC_02_ASEReadCounter.table","NW_015090842.1:10177838",128,235,107
"SPIRE2","s954_F_NC_02_ASEReadCounter.table","NW_015090842.1:10178000",136,266,130
"SPIRE2","s954_F_NC_02_ASEReadCounter.table","NW_015090842.1:10178164",165,311,146
"SPIRE2","s954_F_NC_02_ASEReadCounter.table","NW_015090842.1:10178216",157,317,160
"SPIRE2","s954_F_NC_02_ASEReadCounter.table","NW_015090842.1:10178403",155,307,152
"SPIRE2","s954_F_NC_02_ASEReadCounter.table","NW_015090842.1:10178409",151,300,149
"SPIRE2","s954_F_NC_02_ASEReadCounter.table","NW_015090842.1:10178524",147,260,113
"SPIRE2","s954_F_NC_02_ASEReadCounter.table","NW_015090842.1:10178526",148,262,114
"SPIRE2","s954_F_NC_02_ASEReadCounter.table","NW_015090842.1:10178531",152,267,115
"SPIRE2","s954_F_NC_02_ASEReadCounter.table","NW_015090842.1:10178565",131,243,112
"SPIRE2","s954_F_NC_02_ASEReadCounter.table","NW_015090842.1:10178587",119,210,91
"SPIRE2","s954_F_NC_02_ASEReadCounter.table","NW_015090842.1:10178640",83,159,76
"SPIRE2","s954_F_NC_02_ASEReadCounter.table","NW_015090842.1:10178651",91,175,84
"SPIRE2","s954_F_NC_02_ASEReadCounter.table","NW_015090842.1:10178682",83,153,70
"TCF25","s954_F_NC_02_ASEReadCounter.table","NW_015090842.1:10180912",35,54,19
"TCF25","s954_F_NC_02_ASEReadCounter.table","NW_015090842.1:10180924",37,54,17
"TCF25","s954_F_NC_02_ASEReadCounter.table","NW_015090842.1:10180931",38,57,19
"TCF25","s954_F_NC_02_ASEReadCounter.table","NW_015090842.1:10185332",86,155,69
"TCF25","s954_F_NC_02_ASEReadCounter.table","NW_015090842.1:10188816",58,104,46
"MC1R","s954_F_NC_02_ASEReadCounter.table","NW_015090842.1:10202460",0,1,1
"MC1R","s954_F_NC_02_ASEReadCounter.table","NW_015090842.1:10202465",0,1,1
"DBNDD1","s954_F_NC_02_ASEReadCounter.table","NW_015090842.1:10223105",35,70,35
"GAS8","s954_F_NC_02_ASEReadCounter.table","NW_015090842.1:10228982",17,33,16
"GAS8","s954_F_NC_02_ASEReadCounter.table","NW_015090842.1:10229832",8,21,13
"GAS8","s954_F_NC_02_ASEReadCounter.table","NW_015090842.1:10232375",18,34,16
"GAS8","s954_F_NC_02_ASEReadCounter.table","NW_015090842.1:10232901",15,29,14
"GAS8","s954_F_NC_02_ASEReadCounter.table","NW_015090842.1:10232928",19,32,13
"GAS8","s954_F_NC_02_ASEReadCounter.table","NW_015090842.1:10232967",16,32,16
"GAS8","s954_F_NC_02_ASEReadCounter.table","NW_015090842.1:10233032",9,21,12
"GAS8","s954_F_NC_02_ASEReadCounter.table","NW_015090842.1:10233057",11,20,9
"GAS8","s954_F_NC_02_ASEReadCounter.table","NW_015090842.1:10233058",11,20,9
"GAS8","s954_F_NC_02_ASEReadCounter.table","NW_015090842.1:10233176",9,19,10
"GAS8","s954_F_NC_02_ASEReadCounter.table","NW_015090842.1:10233196",11,18,7
"GAS8","s954_F_NC_02_ASEReadCounter.table","NW_015090842.1:10233252",8,14,6
"GAS8","s954_F_NC_02_ASEReadCounter.table","NW_015090842.1:10233303",3,7,4
"LOC106888094","s954_F_NC_02_ASEReadCounter.table","NW_015090842.1:10233334",4,6,2
"LOC106888094","s954_F_NC_02_ASEReadCounter.table","NW_015090842.1:10233362",5,15,10
"LOC106888094","s954_F_NC_02_ASEReadCounter.table","NW_015090842.1:10233373",5,15,10
"LOC106888094","s954_F_NC_02_ASEReadCounter.table","NW_015090842.1:10233388",4,16,12
"LOC106888094","s954_F_NC_02_ASEReadCounter.table","NW_015090842.1:10233402",3,14,11
"LOC106888094","s954_F_NC_02_ASEReadCounter.table","NW_015090842.1:10233465",8,21,13
"LOC106888094","s954_F_NC_02_ASEReadCounter.table","NW_015090842.1:10233803",9,22,13
"LOC106888094","s954_F_NC_02_ASEReadCounter.table","NW_015090842.1:10233815",6,16,10
"LOC106888094","s954_F_NC_02_ASEReadCounter.table","NW_015090842.1:10236098",0,2,2
"LOC106888094","s954_F_NC_02_ASEReadCounter.table","NW_015090842.1:10236161",0,1,1
"LOC106888094","s954_F_NC_02_ASEReadCounter.table","NW_015090842.1:10236425",0,1,1
"LOC106888094","s954_F_NC_02_ASEReadCounter.table","NW_015090842.1:10236426",0,1,1
"LOC106888094","s954_F_NC_02_ASEReadCounter.table","NW_015090842.1:10236603",0,1,1
"LOC106888173","s954_F_NC_02_ASEReadCounter.table","NW_015090842.1:10239596",0,6,6
"LOC106888173","s954_F_NC_02_ASEReadCounter.table","NW_015090842.1:10240036",0,10,10
"LOC106888173","s954_F_NC_02_ASEReadCounter.table","NW_015090842.1:10240095",0,9,9
"LOC106888173","s954_F_NC_02_ASEReadCounter.table","NW_015090842.1:10240280",0,9,9
"LOC106888173","s954_F_NC_02_ASEReadCounter.table","NW_015090842.1:10240557",1,13,12
"LOC106888173","s954_F_NC_02_ASEReadCounter.table","NW_015090842.1:10240603",2,11,9
"LOC106888173","s954_F_NC_02_ASEReadCounter.table","NW_015090842.1:10240609",1,9,8
"LOC106888173","s954_F_NC_02_ASEReadCounter.table","NW_015090842.1:10240690",0,4,4
"LOC106888173","s954_F_NC_02_ASEReadCounter.table","NW_015090842.1:10240924",0,6,6
"LOC106888173","s954_F_NC_02_ASEReadCounter.table","NW_015090842.1:10241037",0,8,8
"LOC106888173","s954_F_NC_02_ASEReadCounter.table","NW_015090842.1:10241046",0,8,8
"LOC106888173","s954_F_NC_02_ASEReadCounter.table","NW_015090842.1:10241058",0,10,10
"LOC106888173","s954_F_NC_02_ASEReadCounter.table","NW_015090842.1:10241064",1,13,12
"LOC106888173","s954_F_NC_02_ASEReadCounter.table","NW_015090842.1:10241103",14,14,0
"LOC106888173","s954_F_NC_02_ASEReadCounter.table","NW_015090842.1:10241163",0,6,6
"LOC106888173","s954_F_NC_02_ASEReadCounter.table","NW_015090842.1:10241803",3,12,9
"LOC106888173","s954_F_NC_02_ASEReadCounter.table","NW_015090842.1:10241827",3,15,12
"LOC106888173","s954_F_NC_02_ASEReadCounter.table","NW_015090842.1:10241869",2,16,14
"LOC106888173","s954_F_NC_02_ASEReadCounter.table","NW_015090842.1:10242079",1,13,12
"LOC106888173","s954_F_NC_02_ASEReadCounter.table","NW_015090842.1:10242103",1,13,12
"LOC106888173","s954_F_NC_02_ASEReadCounter.table","NW_015090842.1:10242157",1,16,15
"LOC106888173","s954_F_NC_02_ASEReadCounter.table","NW_015090842.1:10242455",4,16,12
"LOC106888173","s954_F_NC_02_ASEReadCounter.table","NW_015090842.1:10242481",2,12,10
"LOC106888173","s954_F_NC_02_ASEReadCounter.table","NW_015090842.1:10242590",4,23,19
"LOC106888173","s954_F_NC_02_ASEReadCounter.table","NW_015090842.1:10242794",1,17,16
"LOC106888173","s954_F_NC_02_ASEReadCounter.table","NW_015090842.1:10242909",3,19,16
"LOC106888173","s954_F_NC_02_ASEReadCounter.table","NW_015090842.1:10243094",1,22,21
"LOC106888173","s954_F_NC_02_ASEReadCounter.table","NW_015090842.1:10243133",0,17,17
"LOC106888173","s954_F_NC_02_ASEReadCounter.table","NW_015090842.1:10243273",1,30,29
"LOC106888173","s954_F_NC_02_ASEReadCounter.table","NW_015090842.1:10243278",1,30,29
"LOC106888173","s954_F_NC_02_ASEReadCounter.table","NW_015090842.1:10243281",1,31,30
"LOC106888173","s954_F_NC_02_ASEReadCounter.table","NW_015090842.1:10243347",14,14,0
"LOC106888173","s954_F_NC_02_ASEReadCounter.table","NW_015090842.1:10243353",1,14,13
"LOC106888173","s954_F_NC_02_ASEReadCounter.table","NW_015090842.1:10243363",1,10,9
"LOC106888173","s954_F_NC_02_ASEReadCounter.table","NW_015090842.1:10243365",1,11,10
"LOC106888173","s954_F_NC_02_ASEReadCounter.table","NW_015090842.1:10243566",2,22,20
"LOC106888173","s954_F_NC_02_ASEReadCounter.table","NW_015090842.1:10243605",1,23,22
"LOC106888173","s954_F_NC_02_ASEReadCounter.table","NW_015090842.1:10243614",1,23,22
"LOC106888173","s954_F_NC_02_ASEReadCounter.table","NW_015090842.1:10243615",1,23,22
"LOC106888173","s954_F_NC_02_ASEReadCounter.table","NW_015090842.1:10243640",1,20,19
"LOC106888173","s954_F_NC_02_ASEReadCounter.table","NW_015090842.1:10243680",2,14,12
"LOC106888173","s954_F_NC_02_ASEReadCounter.table","NW_015090842.1:10243742",3,22,19
"LOC106888173","s954_F_NC_02_ASEReadCounter.table","NW_015090842.1:10243804",2,18,16
"LOC106888173","s954_F_NC_02_ASEReadCounter.table","NW_015090842.1:10243913",2,11,9
"LOC106888173","s954_F_NC_02_ASEReadCounter.table","NW_015090842.1:10243921",2,10,8
"LOC106888384","s954_F_NC_02_ASEReadCounter.table","NW_015090842.1:10251354",0,1,1
"LOC106888384","s954_F_NC_02_ASEReadCounter.table","NW_015090842.1:10251358",0,1,1
"LOC106888384","s954_F_NC_02_ASEReadCounter.table","NW_015090842.1:10251369",0,1,1
"LOC106888384","s954_F_NC_02_ASEReadCounter.table","NW_015090842.1:10251370",0,1,1
"LOC106888384","s954_F_NC_02_ASEReadCounter.table","NW_015090842.1:10251375",0,1,1
"LOC106888384","s954_F_NC_02_ASEReadCounter.table","NW_015090842.1:10251388",0,1,1
"LOC106888384","s954_F_NC_02_ASEReadCounter.table","NW_015090842.1:10251390",0,1,1
"LOC106888384","s954_F_NC_02_ASEReadCounter.table","NW_015090842.1:10251393",0,1,1
"LOC106888384","s954_F_NC_02_ASEReadCounter.table","NW_015090842.1:10253165",0,1,1
"LOC106888384","s954_F_NC_02_ASEReadCounter.table","NW_015090842.1:10254605",0,1,1
"LOC106888384","s954_F_NC_02_ASEReadCounter.table","NW_015090842.1:10254608",0,1,1
"LOC106888384","s954_F_NC_02_ASEReadCounter.table","NW_015090842.1:10254620",0,1,1
"LOC106888384","s954_F_NC_02_ASEReadCounter.table","NW_015090842.1:10254624",0,1,1
"LOC106888384","s954_F_NC_02_ASEReadCounter.table","NW_015090842.1:10254647",1,1,0
"LOC106888384","s954_F_NC_02_ASEReadCounter.table","NW_015090842.1:10254891",0,1,1
"LOC106888384","s954_F_NC_02_ASEReadCounter.table","NW_015090842.1:10254900",1,1,0
"LOC106888384","s954_F_NC_02_ASEReadCounter.table","NW_015090842.1:10254915",1,1,0
"LOC106888384","s954_F_NC_02_ASEReadCounter.table","NW_015090842.1:10255531",0,1,1
"LOC106888384","s954_F_NC_02_ASEReadCounter.table","NW_015090842.1:10255608",1,1,0
"LOC106888384","s954_F_NC_02_ASEReadCounter.table","NW_015090842.1:10255704",2,3,1
"LOC106888384","s954_F_NC_02_ASEReadCounter.table","NW_015090842.1:10255731",2,4,2
"LOC106888384","s954_F_NC_02_ASEReadCounter.table","NW_015090842.1:10255771",2,4,2
"TANGO6","s954_F_NC_02_ASEReadCounter.table","NW_015090842.1:10257782",5,7,2
"TANGO6","s954_F_NC_02_ASEReadCounter.table","NW_015090842.1:10258162",6,9,3
"TANGO6","s954_F_NC_02_ASEReadCounter.table","NW_015090842.1:10258185",9,15,6
"TANGO6","s954_F_NC_02_ASEReadCounter.table","NW_015090842.1:10259267",11,18,7
"TANGO6","s954_F_NC_02_ASEReadCounter.table","NW_015090842.1:10260250",11,23,12
"TANGO6","s954_F_NC_02_ASEReadCounter.table","NW_015090842.1:10260289",15,28,13
"TANGO6","s954_F_NC_02_ASEReadCounter.table","NW_015090842.1:10260309",15,29,14
"TANGO6","s954_F_NC_02_ASEReadCounter.table","NW_015090842.1:10260979",14,24,10
"TANGO6","s954_F_NC_02_ASEReadCounter.table","NW_015090842.1:10261599",16,29,13
"TANGO6","s954_F_NC_02_ASEReadCounter.table","NW_015090842.1:10268425",15,34,19
"TANGO6","s954_F_NC_02_ASEReadCounter.table","NW_015090842.1:10269831",20,33,13
"TANGO6","s954_F_NC_02_ASEReadCounter.table","NW_015090842.1:10270813",16,39,23
"TANGO6","s954_F_NC_02_ASEReadCounter.table","NW_015090842.1:10274018",21,32,11
"TANGO6","s954_F_NC_02_ASEReadCounter.table","NW_015090842.1:10275974",16,36,20
"TANGO6","s954_F_NC_02_ASEReadCounter.table","NW_015090842.1:10275976",15,36,21
"TANGO6","s954_F_NC_02_ASEReadCounter.table","NW_015090842.1:10276123",22,38,16
"TANGO6","s954_F_NC_02_ASEReadCounter.table","NW_015090842.1:10276271",23,31,8
"TANGO6","s954_F_NC_02_ASEReadCounter.table","NW_015090842.1:10276272",22,29,7
"TANGO6","s954_F_NC_02_ASEReadCounter.table","NW_015090842.1:10276275",24,33,9
"TANGO6","s954_F_NC_02_ASEReadCounter.table","NW_015090842.1:10276278",23,33,10
"TANGO6","s954_F_NC_02_ASEReadCounter.table","NW_015090842.1:10276368",16,26,10
"TANGO6","s954_F_NC_02_ASEReadCounter.table","NW_015090842.1:10276373",14,23,9
"TANGO6","s954_F_NC_02_ASEReadCounter.table","NW_015090842.1:10276630",23,33,10
"TANGO6","s954_F_NC_02_ASEReadCounter.table","NW_015090842.1:10281498",30,48,18
"TANGO6","s954_F_NC_02_ASEReadCounter.table","NW_015090842.1:10281516",30,50,20
"TANGO6","s954_F_NC_02_ASEReadCounter.table","NW_015090842.1:10282842",26,43,17
"TANGO6","s954_F_NC_02_ASEReadCounter.table","NW_015090842.1:10282863",21,35,14
"TANGO6","s954_F_NC_02_ASEReadCounter.table","NW_015090842.1:10282869",22,38,16
"TANGO6","s954_F_NC_02_ASEReadCounter.table","NW_015090842.1:10282903",19,48,29
"TANGO6","s954_F_NC_02_ASEReadCounter.table","NW_015090842.1:10283757",33,58,25
"TANGO6","s954_F_NC_02_ASEReadCounter.table","NW_015090842.1:10283785",30,60,30
"HAS3","s954_F_NC_02_ASEReadCounter.table","NW_015090842.1:10288093",1,1,0
"HAS3","s954_F_NC_02_ASEReadCounter.table","NW_015090842.1:10288266",0,1,1
"HAS3","s954_F_NC_02_ASEReadCounter.table","NW_015090842.1:10288274",1,2,1
"HAS3","s954_F_NC_02_ASEReadCounter.table","NW_015090842.1:10288364",1,1,0
"HAS3","s954_F_NC_02_ASEReadCounter.table","NW_015090842.1:10289269",1,1,0
"HAS3","s954_F_NC_02_ASEReadCounter.table","NW_015090842.1:10289272",1,1,0
"HAS3","s954_F_NC_02_ASEReadCounter.table","NW_015090842.1:10289469",0,2,2
"HAS3","s954_F_NC_02_ASEReadCounter.table","NW_015090842.1:10290375",2,6,4
"HAS3","s954_F_NC_02_ASEReadCounter.table","NW_015090842.1:10290395",2,4,2
"HAS3","s954_F_NC_02_ASEReadCounter.table","NW_015090842.1:10290439",5,5,0
"HAS3","s954_F_NC_02_ASEReadCounter.table","NW_015090842.1:10290561",0,2,2
"HAS3","s954_F_NC_02_ASEReadCounter.table","NW_015090842.1:10290609",0,2,2
"HAS3","s954_F_NC_02_ASEReadCounter.table","NW_015090842.1:10290927",2,4,2
"HAS3","s954_F_NC_02_ASEReadCounter.table","NW_015090842.1:10291004",4,6,2
"CHTF8","s954_F_NC_02_ASEReadCounter.table","NW_015090842.1:10291319",3,6,3
"CHTF8","s954_F_NC_02_ASEReadCounter.table","NW_015090842.1:10291491",5,11,6
"CHTF8","s954_F_NC_02_ASEReadCounter.table","NW_015090842.1:10291520",4,6,2
"CHTF8","s954_F_NC_02_ASEReadCounter.table","NW_015090842.1:10291593",4,9,5
"CHTF8","s954_F_NC_02_ASEReadCounter.table","NW_015090842.1:10291600",4,9,5
"CHTF8","s954_F_NC_02_ASEReadCounter.table","NW_015090842.1:10291609",3,8,5
"CHTF8","s954_F_NC_02_ASEReadCounter.table","NW_015090842.1:10291639",6,10,4
"CHTF8","s954_F_NC_02_ASEReadCounter.table","NW_015090842.1:10291641",6,10,4
"CHTF8","s954_F_NC_02_ASEReadCounter.table","NW_015090842.1:10291648",5,9,4
"CHTF8","s954_F_NC_02_ASEReadCounter.table","NW_015090842.1:10291656",4,8,4
"CHTF8","s954_F_NC_02_ASEReadCounter.table","NW_015090842.1:10291675",5,7,2
"CHTF8","s954_F_NC_02_ASEReadCounter.table","NW_015090842.1:10291696",5,6,1
"CHTF8","s954_F_NC_02_ASEReadCounter.table","NW_015090842.1:10291714",6,7,1
"CHTF8","s954_F_NC_02_ASEReadCounter.table","NW_015090842.1:10291732",4,5,1
"CHTF8","s954_F_NC_02_ASEReadCounter.table","NW_015090842.1:10291755",2,4,2
"CHTF8","s954_F_NC_02_ASEReadCounter.table","NW_015090842.1:10291756",2,4,2
"CHTF8","s954_F_NC_02_ASEReadCounter.table","NW_015090842.1:10291758",2,4,2
"CHTF8","s954_F_NC_02_ASEReadCounter.table","NW_015090842.1:10291792",4,6,2
"CHTF8","s954_F_NC_02_ASEReadCounter.table","NW_015090842.1:10291895",3,7,4
"CHTF8","s954_F_NC_02_ASEReadCounter.table","NW_015090842.1:10292132",2,3,1
"CHTF8","s954_F_NC_02_ASEReadCounter.table","NW_015090842.1:10292314",2,5,3
"CHTF8","s954_F_NC_02_ASEReadCounter.table","NW_015090842.1:10292317",2,5,3
"CHTF8","s954_F_NC_02_ASEReadCounter.table","NW_015090842.1:10292928",1,3,2
"UTP4","s954_F_NC_02_ASEReadCounter.table","NW_015090842.1:10293146",2,11,9
"UTP4","s954_F_NC_02_ASEReadCounter.table","NW_015090842.1:10293151",4,13,9
"UTP4","s954_F_NC_02_ASEReadCounter.table","NW_015090842.1:10293191",3,10,7
"UTP4","s954_F_NC_02_ASEReadCounter.table","NW_015090842.1:10293362",4,12,8
"UTP4","s954_F_NC_02_ASEReadCounter.table","NW_015090842.1:10293430",7,21,14
"UTP4","s954_F_NC_02_ASEReadCounter.table","NW_015090842.1:10293625",7,15,8
"UTP4","s954_F_NC_02_ASEReadCounter.table","NW_015090842.1:10293684",9,21,12
"UTP4","s954_F_NC_02_ASEReadCounter.table","NW_015090842.1:10294093",9,17,8
"UTP4","s954_F_NC_02_ASEReadCounter.table","NW_015090842.1:10294622",6,18,12
"UTP4","s954_F_NC_02_ASEReadCounter.table","NW_015090842.1:10294632",8,22,14
"UTP4","s954_F_NC_02_ASEReadCounter.table","NW_015090842.1:10295238",9,17,8
"UTP4","s954_F_NC_02_ASEReadCounter.table","NW_015090842.1:10295880",9,21,12
"UTP4","s954_F_NC_02_ASEReadCounter.table","NW_015090842.1:10295884",9,20,11
"UTP4","s954_F_NC_02_ASEReadCounter.table","NW_015090842.1:10295903",6,19,13
"UTP4","s954_F_NC_02_ASEReadCounter.table","NW_015090842.1:10295906",4,16,12
"UTP4","s954_F_NC_02_ASEReadCounter.table","NW_015090842.1:10295915",4,18,14
"UTP4","s954_F_NC_02_ASEReadCounter.table","NW_015090842.1:10295938",5,21,16
"UTP4","s954_F_NC_02_ASEReadCounter.table","NW_015090842.1:10296175",7,18,11
"UTP4","s954_F_NC_02_ASEReadCounter.table","NW_015090842.1:10296660",12,31,19
"UTP4","s954_F_NC_02_ASEReadCounter.table","NW_015090842.1:10296679",13,36,23
"UTP4","s954_F_NC_02_ASEReadCounter.table","NW_015090842.1:10297193",23,46,23
"UTP4","s954_F_NC_02_ASEReadCounter.table","NW_015090842.1:10297220",23,47,24
"UTP4","s954_F_NC_02_ASEReadCounter.table","NW_015090842.1:10297307",29,64,35
"UTP4","s954_F_NC_02_ASEReadCounter.table","NW_015090842.1:10297558",34,75,41
"UTP4","s954_F_NC_02_ASEReadCounter.table","NW_015090842.1:10297943",24,56,32
"UTP4","s954_F_NC_02_ASEReadCounter.table","NW_015090842.1:10297979",23,61,38
"UTP4","s954_F_NC_02_ASEReadCounter.table","NW_015090842.1:10298022",18,42,24
"UTP4","s954_F_NC_02_ASEReadCounter.table","NW_015090842.1:10298079",1,8,7
"UTP4","s954_F_NC_02_ASEReadCounter.table","NW_015090842.1:10298081",1,9,8
"UTP4","s954_F_NC_02_ASEReadCounter.table","NW_015090842.1:10298082",1,10,9
"SNTB2","s954_F_NC_02_ASEReadCounter.table","NW_015090842.1:10298905",0,1,1
"SNTB2","s954_F_NC_02_ASEReadCounter.table","NW_015090842.1:10298928",1,2,1
"SNTB2","s954_F_NC_02_ASEReadCounter.table","NW_015090842.1:10303506",2,5,3
"SNTB2","s954_F_NC_02_ASEReadCounter.table","NW_015090842.1:10303524",3,6,3
"SNTB2","s954_F_NC_02_ASEReadCounter.table","NW_015090842.1:10304059",3,4,1
"SNTB2","s954_F_NC_02_ASEReadCounter.table","NW_015090842.1:10304089",3,5,2
"SNTB2","s954_F_NC_02_ASEReadCounter.table","NW_015090842.1:10304167",1,2,1
"SNTB2","s954_F_NC_02_ASEReadCounter.table","NW_015090842.1:10304176",2,3,1
"SNTB2","s954_F_NC_02_ASEReadCounter.table","NW_015090842.1:10305069",2,3,1
"SNTB2","s954_F_NC_02_ASEReadCounter.table","NW_015090842.1:10305099",0,3,3
"SNTB2","s954_F_NC_02_ASEReadCounter.table","NW_015090842.1:10305171",0,7,7
"SNTB2","s954_F_NC_02_ASEReadCounter.table","NW_015090842.1:10305177",0,7,7
"SNTB2","s954_F_NC_02_ASEReadCounter.table","NW_015090842.1:10305451",3,6,3
"SNTB2","s954_F_NC_02_ASEReadCounter.table","NW_015090842.1:10305547",1,4,3
"SNTB2","s954_F_NC_02_ASEReadCounter.table","NW_015090842.1:10305847",5,8,3
"SNTB2","s954_F_NC_02_ASEReadCounter.table","NW_015090842.1:10306173",3,9,6
"SNTB2","s954_F_NC_02_ASEReadCounter.table","NW_015090842.1:10306275",6,8,2
"SNTB2","s954_F_NC_02_ASEReadCounter.table","NW_015090842.1:10306457",4,12,8
"SNTB2","s954_F_NC_02_ASEReadCounter.table","NW_015090842.1:10306496",4,10,6
"SNTB2","s954_F_NC_02_ASEReadCounter.table","NW_015090842.1:10306499",4,8,4
"VPS4A","s954_F_NC_02_ASEReadCounter.table","NW_015090842.1:10308566",55,117,62
"VPS4A","s954_F_NC_02_ASEReadCounter.table","NW_015090842.1:10308573",58,126,68
"VPS4A","s954_F_NC_02_ASEReadCounter.table","NW_015090842.1:10308856",85,186,101
"VPS4A","s954_F_NC_02_ASEReadCounter.table","NW_015090842.1:10309056",116,249,133
"VPS4A","s954_F_NC_02_ASEReadCounter.table","NW_015090842.1:10309089",131,277,146
"VPS4A","s954_F_NC_02_ASEReadCounter.table","NW_015090842.1:10309392",130,278,148
"VPS4A","s954_F_NC_02_ASEReadCounter.table","NW_015090842.1:10309413",137,293,156
"VPS4A","s954_F_NC_02_ASEReadCounter.table","NW_015090842.1:10309467",159,336,177
"VPS4A","s954_F_NC_02_ASEReadCounter.table","NW_015090842.1:10310230",177,403,226
"VPS4A","s954_F_NC_02_ASEReadCounter.table","NW_015090842.1:10310425",164,357,193
"VPS4A","s954_F_NC_02_ASEReadCounter.table","NW_015090842.1:10310639",171,365,194
"VPS4A","s954_F_NC_02_ASEReadCounter.table","NW_015090842.1:10310734",166,336,170
"VPS4A","s954_F_NC_02_ASEReadCounter.table","NW_015090842.1:10310737",165,341,176
"VPS4A","s954_F_NC_02_ASEReadCounter.table","NW_015090842.1:10310746",162,341,179
"VPS4A","s954_F_NC_02_ASEReadCounter.table","NW_015090842.1:10310767",174,351,177
"VPS4A","s954_F_NC_02_ASEReadCounter.table","NW_015090842.1:10310995",192,371,179
"VPS4A","s954_F_NC_02_ASEReadCounter.table","NW_015090842.1:10311004",185,362,177
"VPS4A","s954_F_NC_02_ASEReadCounter.table","NW_015090842.1:10311007",192,380,188
"VPS4A","s954_F_NC_02_ASEReadCounter.table","NW_015090842.1:10311013",200,386,186
"VPS4A","s954_F_NC_02_ASEReadCounter.table","NW_015090842.1:10311022",185,366,181
"VPS4A","s954_F_NC_02_ASEReadCounter.table","NW_015090842.1:10311023",184,370,186
"VPS4A","s954_F_NC_02_ASEReadCounter.table","NW_015090842.1:10311426",199,423,224
"VPS4A","s954_F_NC_02_ASEReadCounter.table","NW_015090842.1:10311489",2,10,8
"VPS4A","s954_F_NC_02_ASEReadCounter.table","NW_015090842.1:10311490",2,7,5
"VPS4A","s954_F_NC_02_ASEReadCounter.table","NW_015090842.1:10311525",4,13,9
"VPS4A","s954_F_NC_02_ASEReadCounter.table","NW_015090842.1:10311529",6,22,16
"VPS4A","s954_F_NC_02_ASEReadCounter.table","NW_015090842.1:10311530",6,24,18
"VPS4A","s954_F_NC_02_ASEReadCounter.table","NW_015090842.1:10311552",33,60,27
"VPS4A","s954_F_NC_02_ASEReadCounter.table","NW_015090842.1:10311689",36,79,43
"VPS4A","s954_F_NC_02_ASEReadCounter.table","NW_015090842.1:10311700",49,96,47
"VPS4A","s954_F_NC_02_ASEReadCounter.table","NW_015090842.1:10311701",48,93,45
"VPS4A","s954_F_NC_02_ASEReadCounter.table","NW_015090842.1:10311703",47,92,45
"COG8","s954_F_NC_02_ASEReadCounter.table","NW_015090842.1:10313487",30,61,31
"COG8","s954_F_NC_02_ASEReadCounter.table","NW_015090842.1:10313559",36,68,32
"COG8","s954_F_NC_02_ASEReadCounter.table","NW_015090842.1:10313579",27,59,32
"COG8","s954_F_NC_02_ASEReadCounter.table","NW_015090842.1:10313665",22,46,24
"COG8","s954_F_NC_02_ASEReadCounter.table","NW_015090842.1:10313681",18,47,29
"COG8","s954_F_NC_02_ASEReadCounter.table","NW_015090842.1:10313768",30,58,28
"COG8","s954_F_NC_02_ASEReadCounter.table","NW_015090842.1:10313775",29,55,26
"COG8","s954_F_NC_02_ASEReadCounter.table","NW_015090842.1:10313811",17,34,17
"COG8","s954_F_NC_02_ASEReadCounter.table","NW_015090842.1:10313858",17,33,16
"COG8","s954_F_NC_02_ASEReadCounter.table","NW_015090842.1:10314100",24,45,21
"COG8","s954_F_NC_02_ASEReadCounter.table","NW_015090842.1:10314213",22,38,16
"COG8","s954_F_NC_02_ASEReadCounter.table","NW_015090842.1:10315093",17,29,12
"COG8","s954_F_NC_02_ASEReadCounter.table","NW_015090842.1:10315162",23,40,17
"COG8","s954_F_NC_02_ASEReadCounter.table","NW_015090842.1:10315285",16,39,23
"COG8","s954_F_NC_02_ASEReadCounter.table","NW_015090842.1:10315360",19,39,20
"COG8","s954_F_NC_02_ASEReadCounter.table","NW_015090842.1:10315369",21,46,25
"COG8","s954_F_NC_02_ASEReadCounter.table","NW_015090842.1:10315504",10,22,12
"COG8","s954_F_NC_02_ASEReadCounter.table","NW_015090842.1:10315508",10,23,13
"COG8","s954_F_NC_02_ASEReadCounter.table","NW_015090842.1:10315624",20,34,14
"COG8","s954_F_NC_02_ASEReadCounter.table","NW_015090842.1:10315693",12,25,13
"COG8","s954_F_NC_02_ASEReadCounter.table","NW_015090842.1:10315698",14,29,15
"COG8","s954_F_NC_02_ASEReadCounter.table","NW_015090842.1:10315768",10,21,11
"COG8","s954_F_NC_02_ASEReadCounter.table","NW_015090842.1:10315769",10,21,11
"COG8","s954_F_NC_02_ASEReadCounter.table","NW_015090842.1:10315784",13,24,11
"COG8","s954_F_NC_02_ASEReadCounter.table","NW_015090842.1:10316093",8,19,11
"COG8","s954_F_NC_02_ASEReadCounter.table","NW_015090842.1:10316133",8,13,5
"NIP7","s954_F_NC_02_ASEReadCounter.table","NW_015090842.1:10316759",16,29,13
"NIP7","s954_F_NC_02_ASEReadCounter.table","NW_015090842.1:10316967",91,174,83
"NIP7","s954_F_NC_02_ASEReadCounter.table","NW_015090842.1:10316995",112,205,93
"NIP7","s954_F_NC_02_ASEReadCounter.table","NW_015090842.1:10317240",170,323,153
"NIP7","s954_F_NC_02_ASEReadCounter.table","NW_015090842.1:10317247",163,314,151
"NIP7","s954_F_NC_02_ASEReadCounter.table","NW_015090842.1:10317264",146,291,145
"NIP7","s954_F_NC_02_ASEReadCounter.table","NW_015090842.1:10317433",181,359,178
"NIP7","s954_F_NC_02_ASEReadCounter.table","NW_015090842.1:10317738",149,324,175
"NIP7","s954_F_NC_02_ASEReadCounter.table","NW_015090842.1:10317769",162,345,183
"NIP7","s954_F_NC_02_ASEReadCounter.table","NW_015090842.1:10317808",107,221,114
"NIP7","s954_F_NC_02_ASEReadCounter.table","NW_015090842.1:10317870",66,160,94
"NIP7","s954_F_NC_02_ASEReadCounter.table","NW_015090842.1:10317871",67,156,89
"NIP7","s954_F_NC_02_ASEReadCounter.table","NW_015090842.1:10317898",47,113,66
"NIP7","s954_F_NC_02_ASEReadCounter.table","NW_015090842.1:10317911",46,99,53
"TERF2","s954_F_NC_02_ASEReadCounter.table","NW_015090842.1:10321665",7,7,0
"TERF2","s954_F_NC_02_ASEReadCounter.table","NW_015090842.1:10321768",24,47,23
"TERF2","s954_F_NC_02_ASEReadCounter.table","NW_015090842.1:10321777",25,47,22
"TERF2","s954_F_NC_02_ASEReadCounter.table","NW_015090842.1:10321805",26,57,31
"TERF2","s954_F_NC_02_ASEReadCounter.table","NW_015090842.1:10321878",39,83,44
"TERF2","s954_F_NC_02_ASEReadCounter.table","NW_015090842.1:10321893",4,74,70
"TERF2","s954_F_NC_02_ASEReadCounter.table","NW_015090842.1:10321897",30,66,36
"TERF2","s954_F_NC_02_ASEReadCounter.table","NW_015090842.1:10321908",31,60,29
"TERF2","s954_F_NC_02_ASEReadCounter.table","NW_015090842.1:10322001",34,73,39
"TERF2","s954_F_NC_02_ASEReadCounter.table","NW_015090842.1:10322035",27,68,41
"TERF2","s954_F_NC_02_ASEReadCounter.table","NW_015090842.1:10322051",32,77,45
"TERF2","s954_F_NC_02_ASEReadCounter.table","NW_015090842.1:10322137",26,61,35
"TERF2","s954_F_NC_02_ASEReadCounter.table","NW_015090842.1:10322144",32,65,33
"TERF2","s954_F_NC_02_ASEReadCounter.table","NW_015090842.1:10322388",22,69,47
"TERF2","s954_F_NC_02_ASEReadCounter.table","NW_015090842.1:10322396",24,74,50
"TERF2","s954_F_NC_02_ASEReadCounter.table","NW_015090842.1:10322502",38,76,38
"TERF2","s954_F_NC_02_ASEReadCounter.table","NW_015090842.1:10322504",39,78,39
"TERF2","s954_F_NC_02_ASEReadCounter.table","NW_015090842.1:10322510",36,78,42
"TERF2","s954_F_NC_02_ASEReadCounter.table","NW_015090842.1:10323580",35,78,43
"TERF2","s954_F_NC_02_ASEReadCounter.table","NW_015090842.1:10324314",30,67,37
"TERF2","s954_F_NC_02_ASEReadCounter.table","NW_015090842.1:10326832",29,46,17
"TERF2","s954_F_NC_02_ASEReadCounter.table","NW_015090842.1:10327787",11,23,12
"TERF2","s954_F_NC_02_ASEReadCounter.table","NW_015090842.1:10328588",16,32,16
"TERF2","s954_F_NC_02_ASEReadCounter.table","NW_015090842.1:10328644",13,27,14
"TERF2","s954_F_NC_02_ASEReadCounter.table","NW_015090842.1:10329813",6,15,9
"TERF2","s954_F_NC_02_ASEReadCounter.table","NW_015090842.1:10330749",3,12,9
"TERF2","s954_F_NC_02_ASEReadCounter.table","NW_015090842.1:10330789",5,17,12
"CYB5B","s954_F_NC_02_ASEReadCounter.table","NW_015090842.1:10336595",2,4,2
"CYB5B","s954_F_NC_02_ASEReadCounter.table","NW_015090842.1:10336667",32,61,29
"CYB5B","s954_F_NC_02_ASEReadCounter.table","NW_015090842.1:10336689",48,92,44
"CYB5B","s954_F_NC_02_ASEReadCounter.table","NW_015090842.1:10336728",76,147,71
"CYB5B","s954_F_NC_02_ASEReadCounter.table","NW_015090842.1:10345068",56,111,55
"CYB5B","s954_F_NC_02_ASEReadCounter.table","NW_015090842.1:10348800",101,182,81
"CYB5B","s954_F_NC_02_ASEReadCounter.table","NW_015090842.1:10348888",74,146,72
"CYB5B","s954_F_NC_02_ASEReadCounter.table","NW_015090842.1:10349046",65,140,75
"CYB5B","s954_F_NC_02_ASEReadCounter.table","NW_015090842.1:10349119",45,128,83
"CYB5B","s954_F_NC_02_ASEReadCounter.table","NW_015090842.1:10349146",34,118,84
"CYB5B","s954_F_NC_02_ASEReadCounter.table","NW_015090842.1:10349157",51,135,84
