"gene","id","snp","ref_count","total_count","alt_count"
"CENPN","s1324_SAT_M_BLOOD_ASEReadCounter.table","NW_015090842.1:5801612",0,1,1
"CENPN","s1324_SAT_M_BLOOD_ASEReadCounter.table","NW_015090842.1:5801618",0,1,1
"CENPN","s1324_SAT_M_BLOOD_ASEReadCounter.table","NW_015090842.1:5801623",0,1,1
"CENPN","s1324_SAT_M_BLOOD_ASEReadCounter.table","NW_015090842.1:5801631",0,1,1
"CENPN","s1324_SAT_M_BLOOD_ASEReadCounter.table","NW_015090842.1:5801632",0,2,2
"CENPN","s1324_SAT_M_BLOOD_ASEReadCounter.table","NW_015090842.1:5801655",1,3,2
"CENPN","s1324_SAT_M_BLOOD_ASEReadCounter.table","NW_015090842.1:5801670",1,3,2
"CENPN","s1324_SAT_M_BLOOD_ASEReadCounter.table","NW_015090842.1:5801674",1,3,2
"CENPN","s1324_SAT_M_BLOOD_ASEReadCounter.table","NW_015090842.1:5801692",1,3,2
"CENPN","s1324_SAT_M_BLOOD_ASEReadCounter.table","NW_015090842.1:5802008",3,10,7
"CENPN","s1324_SAT_M_BLOOD_ASEReadCounter.table","NW_015090842.1:5802012",3,10,7
"CENPN","s1324_SAT_M_BLOOD_ASEReadCounter.table","NW_015090842.1:5802087",2,10,8
"CENPN","s1324_SAT_M_BLOOD_ASEReadCounter.table","NW_015090842.1:5810113",1,1,0
"CENPN","s1324_SAT_M_BLOOD_ASEReadCounter.table","NW_015090842.1:5810147",1,1,0
"CENPN","s1324_SAT_M_BLOOD_ASEReadCounter.table","NW_015090842.1:5810148",1,1,0
"ATMIN","s1324_SAT_M_BLOOD_ASEReadCounter.table","NW_015090842.1:5818789",25,50,25
"ATMIN","s1324_SAT_M_BLOOD_ASEReadCounter.table","NW_015090842.1:5819958",24,47,23
"ATMIN","s1324_SAT_M_BLOOD_ASEReadCounter.table","NW_015090842.1:5820004",24,56,32
"ATMIN","s1324_SAT_M_BLOOD_ASEReadCounter.table","NW_015090842.1:5820217",18,47,29
"ATMIN","s1324_SAT_M_BLOOD_ASEReadCounter.table","NW_015090842.1:5820250",28,52,24
"ATMIN","s1324_SAT_M_BLOOD_ASEReadCounter.table","NW_015090842.1:5820298",26,43,17
"ATMIN","s1324_SAT_M_BLOOD_ASEReadCounter.table","NW_015090842.1:5820417",16,31,15
"ATMIN","s1324_SAT_M_BLOOD_ASEReadCounter.table","NW_015090842.1:5820421",13,28,15
"ATMIN","s1324_SAT_M_BLOOD_ASEReadCounter.table","NW_015090842.1:5820448",16,27,11
"ATMIN","s1324_SAT_M_BLOOD_ASEReadCounter.table","NW_015090842.1:5820457",13,25,12
"ATMIN","s1324_SAT_M_BLOOD_ASEReadCounter.table","NW_015090842.1:5820510",25,44,19
"ATMIN","s1324_SAT_M_BLOOD_ASEReadCounter.table","NW_015090842.1:5820673",21,41,20
"ATMIN","s1324_SAT_M_BLOOD_ASEReadCounter.table","NW_015090842.1:5820754",17,41,24
"ATMIN","s1324_SAT_M_BLOOD_ASEReadCounter.table","NW_015090842.1:5820820",27,48,21
"ATMIN","s1324_SAT_M_BLOOD_ASEReadCounter.table","NW_015090842.1:5820865",32,57,25
"ATMIN","s1324_SAT_M_BLOOD_ASEReadCounter.table","NW_015090842.1:5820889",31,55,24
"ATMIN","s1324_SAT_M_BLOOD_ASEReadCounter.table","NW_015090842.1:5820891",32,56,24
"ATMIN","s1324_SAT_M_BLOOD_ASEReadCounter.table","NW_015090842.1:5820997",29,61,32
"ATMIN","s1324_SAT_M_BLOOD_ASEReadCounter.table","NW_015090842.1:5821063",27,57,30
"ATMIN","s1324_SAT_M_BLOOD_ASEReadCounter.table","NW_015090842.1:5821132",24,60,36
"ATMIN","s1324_SAT_M_BLOOD_ASEReadCounter.table","NW_015090842.1:5821645",28,56,28
"ATMIN","s1324_SAT_M_BLOOD_ASEReadCounter.table","NW_015090842.1:5825066",18,38,20
"ATMIN","s1324_SAT_M_BLOOD_ASEReadCounter.table","NW_015090842.1:5825106",19,44,25
"ATMIN","s1324_SAT_M_BLOOD_ASEReadCounter.table","NW_015090842.1:5825122",19,42,23
"ATMIN","s1324_SAT_M_BLOOD_ASEReadCounter.table","NW_015090842.1:5825178",15,39,24
"ATMIN","s1324_SAT_M_BLOOD_ASEReadCounter.table","NW_015090842.1:5825194",20,43,23
"ATMIN","s1324_SAT_M_BLOOD_ASEReadCounter.table","NW_015090842.1:5825195",20,43,23
"ATMIN","s1324_SAT_M_BLOOD_ASEReadCounter.table","NW_015090842.1:5825220",17,38,21
"ATMIN","s1324_SAT_M_BLOOD_ASEReadCounter.table","NW_015090842.1:5825240",20,39,19
"ATMIN","s1324_SAT_M_BLOOD_ASEReadCounter.table","NW_015090842.1:5825303",19,47,28
"ATMIN","s1324_SAT_M_BLOOD_ASEReadCounter.table","NW_015090842.1:5825304",21,49,28
"ATMIN","s1324_SAT_M_BLOOD_ASEReadCounter.table","NW_015090842.1:5825310",21,50,29
"ATMIN","s1324_SAT_M_BLOOD_ASEReadCounter.table","NW_015090842.1:5825406",15,31,16
"ATMIN","s1324_SAT_M_BLOOD_ASEReadCounter.table","NW_015090842.1:5825415",13,29,16
"ATMIN","s1324_SAT_M_BLOOD_ASEReadCounter.table","NW_015090842.1:5825438",8,25,17
"ATMIN","s1324_SAT_M_BLOOD_ASEReadCounter.table","NW_015090842.1:5825485",18,39,21
"ATMIN","s1324_SAT_M_BLOOD_ASEReadCounter.table","NW_015090842.1:5825524",21,40,19
"ATMIN","s1324_SAT_M_BLOOD_ASEReadCounter.table","NW_015090842.1:5825557",14,37,23
"ATMIN","s1324_SAT_M_BLOOD_ASEReadCounter.table","NW_015090842.1:5825571",15,37,22
"ATMIN","s1324_SAT_M_BLOOD_ASEReadCounter.table","NW_015090842.1:5825579",17,41,24
"ATMIN","s1324_SAT_M_BLOOD_ASEReadCounter.table","NW_015090842.1:5825590",15,35,20
"ATMIN","s1324_SAT_M_BLOOD_ASEReadCounter.table","NW_015090842.1:5825689",26,47,21
"ATMIN","s1324_SAT_M_BLOOD_ASEReadCounter.table","NW_015090842.1:5825703",34,54,20
"ATMIN","s1324_SAT_M_BLOOD_ASEReadCounter.table","NW_015090842.1:5825787",25,51,26
"ATMIN","s1324_SAT_M_BLOOD_ASEReadCounter.table","NW_015090842.1:5825833",22,51,29
"ATMIN","s1324_SAT_M_BLOOD_ASEReadCounter.table","NW_015090842.1:5825841",22,51,29
"ATMIN","s1324_SAT_M_BLOOD_ASEReadCounter.table","NW_015090842.1:5825895",19,38,19
"ATMIN","s1324_SAT_M_BLOOD_ASEReadCounter.table","NW_015090842.1:5825984",26,52,26
"ATMIN","s1324_SAT_M_BLOOD_ASEReadCounter.table","NW_015090842.1:5826162",26,50,24
"ATMIN","s1324_SAT_M_BLOOD_ASEReadCounter.table","NW_015090842.1:5826194",29,52,23
"ATMIN","s1324_SAT_M_BLOOD_ASEReadCounter.table","NW_015090842.1:5826235",33,62,29
"ATMIN","s1324_SAT_M_BLOOD_ASEReadCounter.table","NW_015090842.1:5826245",32,60,28
"ATMIN","s1324_SAT_M_BLOOD_ASEReadCounter.table","NW_015090842.1:5826335",16,23,7
"ATMIN","s1324_SAT_M_BLOOD_ASEReadCounter.table","NW_015090842.1:5826417",16,31,15
"ATMIN","s1324_SAT_M_BLOOD_ASEReadCounter.table","NW_015090842.1:5826431",18,33,15
"ATMIN","s1324_SAT_M_BLOOD_ASEReadCounter.table","NW_015090842.1:5826438",18,33,15
"ATMIN","s1324_SAT_M_BLOOD_ASEReadCounter.table","NW_015090842.1:5826463",25,55,30
"ATMIN","s1324_SAT_M_BLOOD_ASEReadCounter.table","NW_015090842.1:5826502",17,49,32
"ATMIN","s1324_SAT_M_BLOOD_ASEReadCounter.table","NW_015090842.1:5826511",17,48,31
"ATMIN","s1324_SAT_M_BLOOD_ASEReadCounter.table","NW_015090842.1:5826659",16,31,15
"ATMIN","s1324_SAT_M_BLOOD_ASEReadCounter.table","NW_015090842.1:5826701",12,36,24
"ATMIN","s1324_SAT_M_BLOOD_ASEReadCounter.table","NW_015090842.1:5826702",12,39,27
"ATMIN","s1324_SAT_M_BLOOD_ASEReadCounter.table","NW_015090842.1:5826732",17,45,28
"ATMIN","s1324_SAT_M_BLOOD_ASEReadCounter.table","NW_015090842.1:5826745",19,48,29
"ATMIN","s1324_SAT_M_BLOOD_ASEReadCounter.table","NW_015090842.1:5826835",20,34,14
"ATMIN","s1324_SAT_M_BLOOD_ASEReadCounter.table","NW_015090842.1:5826910",20,26,6
"ATMIN","s1324_SAT_M_BLOOD_ASEReadCounter.table","NW_015090842.1:5826942",27,45,18
"ATMIN","s1324_SAT_M_BLOOD_ASEReadCounter.table","NW_015090842.1:5827193",30,53,23
"ATMIN","s1324_SAT_M_BLOOD_ASEReadCounter.table","NW_015090842.1:5827196",30,52,22
"ATMIN","s1324_SAT_M_BLOOD_ASEReadCounter.table","NW_015090842.1:5827269",23,42,19
"ATMIN","s1324_SAT_M_BLOOD_ASEReadCounter.table","NW_015090842.1:5827315",17,35,18
"ATMIN","s1324_SAT_M_BLOOD_ASEReadCounter.table","NW_015090842.1:5827316",17,36,19
"ATMIN","s1324_SAT_M_BLOOD_ASEReadCounter.table","NW_015090842.1:5827333",16,35,19
"PKD1L2","s1324_SAT_M_BLOOD_ASEReadCounter.table","NW_015090842.1:5867660",1,1,0
"PKD1L2","s1324_SAT_M_BLOOD_ASEReadCounter.table","NW_015090842.1:5867675",1,1,0
"PKD1L2","s1324_SAT_M_BLOOD_ASEReadCounter.table","NW_015090842.1:5867788",1,1,0
"PKD1L2","s1324_SAT_M_BLOOD_ASEReadCounter.table","NW_015090842.1:5867843",2,2,0
"BCO1","s1324_SAT_M_BLOOD_ASEReadCounter.table","NW_015090842.1:5917941",1,1,0
"BCO1","s1324_SAT_M_BLOOD_ASEReadCounter.table","NW_015090842.1:5917971",1,1,0
"BCO1","s1324_SAT_M_BLOOD_ASEReadCounter.table","NW_015090842.1:5921679",3,3,0
"BCO1","s1324_SAT_M_BLOOD_ASEReadCounter.table","NW_015090842.1:5921726",2,2,0
"BCO1","s1324_SAT_M_BLOOD_ASEReadCounter.table","NW_015090842.1:5925669",1,1,0
"BCO1","s1324_SAT_M_BLOOD_ASEReadCounter.table","NW_015090842.1:5925753",1,1,0
"BCO1","s1324_SAT_M_BLOOD_ASEReadCounter.table","NW_015090842.1:5926937",1,1,0
"BCO1","s1324_SAT_M_BLOOD_ASEReadCounter.table","NW_015090842.1:5932726",2,3,1
"BCO1","s1324_SAT_M_BLOOD_ASEReadCounter.table","NW_015090842.1:5932801",1,1,0
"BCO1","s1324_SAT_M_BLOOD_ASEReadCounter.table","NW_015090842.1:5934558",1,1,0
"BCO1","s1324_SAT_M_BLOOD_ASEReadCounter.table","NW_015090842.1:5934575",1,1,0
"BCO1","s1324_SAT_M_BLOOD_ASEReadCounter.table","NW_015090842.1:5934608",1,1,0
"BCO1","s1324_SAT_M_BLOOD_ASEReadCounter.table","NW_015090842.1:5934958",1,1,0
"BCO1","s1324_SAT_M_BLOOD_ASEReadCounter.table","NW_015090842.1:5934976",1,1,0
"GAN","s1324_SAT_M_BLOOD_ASEReadCounter.table","NW_015090842.1:5966047",1,1,0
"CMIP","s1324_SAT_M_BLOOD_ASEReadCounter.table","NW_015090842.1:6109159",22,35,13
"CMIP","s1324_SAT_M_BLOOD_ASEReadCounter.table","NW_015090842.1:6109166",20,34,14
"CMIP","s1324_SAT_M_BLOOD_ASEReadCounter.table","NW_015090842.1:6114641",17,43,26
"CMIP","s1324_SAT_M_BLOOD_ASEReadCounter.table","NW_015090842.1:6114751",14,33,19
"CMIP","s1324_SAT_M_BLOOD_ASEReadCounter.table","NW_015090842.1:6114824",12,33,21
"CMIP","s1324_SAT_M_BLOOD_ASEReadCounter.table","NW_015090842.1:6128998",25,41,16
"CMIP","s1324_SAT_M_BLOOD_ASEReadCounter.table","NW_015090842.1:6130562",34,71,37
"CMIP","s1324_SAT_M_BLOOD_ASEReadCounter.table","NW_015090842.1:6132522",14,26,12
"CMIP","s1324_SAT_M_BLOOD_ASEReadCounter.table","NW_015090842.1:6134088",18,32,14
"CMIP","s1324_SAT_M_BLOOD_ASEReadCounter.table","NW_015090842.1:6138265",13,32,19
"CMIP","s1324_SAT_M_BLOOD_ASEReadCounter.table","NW_015090842.1:6138300",16,38,22
"CMIP","s1324_SAT_M_BLOOD_ASEReadCounter.table","NW_015090842.1:6138342",16,42,26
"CMIP","s1324_SAT_M_BLOOD_ASEReadCounter.table","NW_015090842.1:6138343",16,43,27
"CMIP","s1324_SAT_M_BLOOD_ASEReadCounter.table","NW_015090842.1:6138345",16,42,26
"CMIP","s1324_SAT_M_BLOOD_ASEReadCounter.table","NW_015090842.1:6138647",19,40,21
"CMIP","s1324_SAT_M_BLOOD_ASEReadCounter.table","NW_015090842.1:6138745",30,53,23
"CMIP","s1324_SAT_M_BLOOD_ASEReadCounter.table","NW_015090842.1:6138832",1,10,9
"CMIP","s1324_SAT_M_BLOOD_ASEReadCounter.table","NW_015090842.1:6138967",17,33,16
"CMIP","s1324_SAT_M_BLOOD_ASEReadCounter.table","NW_015090842.1:6139131",12,25,13
"CMIP","s1324_SAT_M_BLOOD_ASEReadCounter.table","NW_015090842.1:6139163",17,28,11
"CMIP","s1324_SAT_M_BLOOD_ASEReadCounter.table","NW_015090842.1:6139360",5,10,5
"CMIP","s1324_SAT_M_BLOOD_ASEReadCounter.table","NW_015090842.1:6139572",2,4,2
"CMIP","s1324_SAT_M_BLOOD_ASEReadCounter.table","NW_015090842.1:6139773",3,3,0
"PLCG2","s1324_SAT_M_BLOOD_ASEReadCounter.table","NW_015090842.1:6179613",2,12,10
"PLCG2","s1324_SAT_M_BLOOD_ASEReadCounter.table","NW_015090842.1:6179658",8,25,17
"PLCG2","s1324_SAT_M_BLOOD_ASEReadCounter.table","NW_015090842.1:6203766",9,105,96
"PLCG2","s1324_SAT_M_BLOOD_ASEReadCounter.table","NW_015090842.1:6203775",8,98,90
"PLCG2","s1324_SAT_M_BLOOD_ASEReadCounter.table","NW_015090842.1:6203787",7,96,89
"PLCG2","s1324_SAT_M_BLOOD_ASEReadCounter.table","NW_015090842.1:6205047",8,103,95
"PLCG2","s1324_SAT_M_BLOOD_ASEReadCounter.table","NW_015090842.1:6208541",0,98,98
"PLCG2","s1324_SAT_M_BLOOD_ASEReadCounter.table","NW_015090842.1:6209741",10,78,68
"PLCG2","s1324_SAT_M_BLOOD_ASEReadCounter.table","NW_015090842.1:6209798",8,96,88
"PLCG2","s1324_SAT_M_BLOOD_ASEReadCounter.table","NW_015090842.1:6209816",7,111,104
"PLCG2","s1324_SAT_M_BLOOD_ASEReadCounter.table","NW_015090842.1:6217547",13,153,140
"PLCG2","s1324_SAT_M_BLOOD_ASEReadCounter.table","NW_015090842.1:6218641",10,119,109
"PLCG2","s1324_SAT_M_BLOOD_ASEReadCounter.table","NW_015090842.1:6220552",3,113,110
"PLCG2","s1324_SAT_M_BLOOD_ASEReadCounter.table","NW_015090842.1:6221969",8,125,117
"PLCG2","s1324_SAT_M_BLOOD_ASEReadCounter.table","NW_015090842.1:6228672",10,106,96
"PLCG2","s1324_SAT_M_BLOOD_ASEReadCounter.table","NW_015090842.1:6228694",8,95,87
"PLCG2","s1324_SAT_M_BLOOD_ASEReadCounter.table","NW_015090842.1:6228722",11,114,103
"PLCG2","s1324_SAT_M_BLOOD_ASEReadCounter.table","NW_015090842.1:6228747",9,132,123
"PLCG2","s1324_SAT_M_BLOOD_ASEReadCounter.table","NW_015090842.1:6228835",9,136,127
"PLCG2","s1324_SAT_M_BLOOD_ASEReadCounter.table","NW_015090842.1:6228841",9,139,130
"PLCG2","s1324_SAT_M_BLOOD_ASEReadCounter.table","NW_015090842.1:6228865",8,127,119
"PLCG2","s1324_SAT_M_BLOOD_ASEReadCounter.table","NW_015090842.1:6228917",10,151,141
"PLCG2","s1324_SAT_M_BLOOD_ASEReadCounter.table","NW_015090842.1:6228926",10,144,134
"PLCG2","s1324_SAT_M_BLOOD_ASEReadCounter.table","NW_015090842.1:6228954",7,105,98
"PLCG2","s1324_SAT_M_BLOOD_ASEReadCounter.table","NW_015090842.1:6229002",9,113,104
"PLCG2","s1324_SAT_M_BLOOD_ASEReadCounter.table","NW_015090842.1:6229006",9,108,99
"PLCG2","s1324_SAT_M_BLOOD_ASEReadCounter.table","NW_015090842.1:6229081",7,82,75
"PLCG2","s1324_SAT_M_BLOOD_ASEReadCounter.table","NW_015090842.1:6229097",6,56,50
"PLCG2","s1324_SAT_M_BLOOD_ASEReadCounter.table","NW_015090842.1:6229160",7,54,47
"PLCG2","s1324_SAT_M_BLOOD_ASEReadCounter.table","NW_015090842.1:6229213",8,51,43
"PLCG2","s1324_SAT_M_BLOOD_ASEReadCounter.table","NW_015090842.1:6229231",9,65,56
"PLCG2","s1324_SAT_M_BLOOD_ASEReadCounter.table","NW_015090842.1:6229663",19,69,50
"PLCG2","s1324_SAT_M_BLOOD_ASEReadCounter.table","NW_015090842.1:6229748",15,72,57
"PLCG2","s1324_SAT_M_BLOOD_ASEReadCounter.table","NW_015090842.1:6229892",15,62,47
"PLCG2","s1324_SAT_M_BLOOD_ASEReadCounter.table","NW_015090842.1:6230248",15,55,40
"PLCG2","s1324_SAT_M_BLOOD_ASEReadCounter.table","NW_015090842.1:6230255",13,55,42
"PLCG2","s1324_SAT_M_BLOOD_ASEReadCounter.table","NW_015090842.1:6230296",8,50,42
"PLCG2","s1324_SAT_M_BLOOD_ASEReadCounter.table","NW_015090842.1:6230349",12,59,47
"PLCG2","s1324_SAT_M_BLOOD_ASEReadCounter.table","NW_015090842.1:6230381",13,46,33
"PLCG2","s1324_SAT_M_BLOOD_ASEReadCounter.table","NW_015090842.1:6230408",10,45,35
"PLCG2","s1324_SAT_M_BLOOD_ASEReadCounter.table","NW_015090842.1:6230439",9,36,27
"PLCG2","s1324_SAT_M_BLOOD_ASEReadCounter.table","NW_015090842.1:6230757",9,37,28
"PLCG2","s1324_SAT_M_BLOOD_ASEReadCounter.table","NW_015090842.1:6230758",9,36,27
"PLCG2","s1324_SAT_M_BLOOD_ASEReadCounter.table","NW_015090842.1:6230898",5,30,25
"PLCG2","s1324_SAT_M_BLOOD_ASEReadCounter.table","NW_015090842.1:6230976",4,34,30
"PLCG2","s1324_SAT_M_BLOOD_ASEReadCounter.table","NW_015090842.1:6231078",6,33,27
"PLCG2","s1324_SAT_M_BLOOD_ASEReadCounter.table","NW_015090842.1:6231138",7,37,30
"PLCG2","s1324_SAT_M_BLOOD_ASEReadCounter.table","NW_015090842.1:6231177",7,36,29
"PLCG2","s1324_SAT_M_BLOOD_ASEReadCounter.table","NW_015090842.1:6231263",6,35,29
"PLCG2","s1324_SAT_M_BLOOD_ASEReadCounter.table","NW_015090842.1:6231309",2,18,16
"SDR42E1","s1324_SAT_M_BLOOD_ASEReadCounter.table","NW_015090842.1:6235292",0,2,2
"SDR42E1","s1324_SAT_M_BLOOD_ASEReadCounter.table","NW_015090842.1:6235315",0,3,3
"SDR42E1","s1324_SAT_M_BLOOD_ASEReadCounter.table","NW_015090842.1:6235348",0,8,8
"SDR42E1","s1324_SAT_M_BLOOD_ASEReadCounter.table","NW_015090842.1:6235355",0,8,8
"SDR42E1","s1324_SAT_M_BLOOD_ASEReadCounter.table","NW_015090842.1:6235417",0,7,7
"SDR42E1","s1324_SAT_M_BLOOD_ASEReadCounter.table","NW_015090842.1:6235526",4,4,0
"SDR42E1","s1324_SAT_M_BLOOD_ASEReadCounter.table","NW_015090842.1:6235558",1,2,1
"SDR42E1","s1324_SAT_M_BLOOD_ASEReadCounter.table","NW_015090842.1:6235603",6,6,0
"SDR42E1","s1324_SAT_M_BLOOD_ASEReadCounter.table","NW_015090842.1:6235741",0,7,7
"SDR42E1","s1324_SAT_M_BLOOD_ASEReadCounter.table","NW_015090842.1:6235777",1,8,7
"SDR42E1","s1324_SAT_M_BLOOD_ASEReadCounter.table","NW_015090842.1:6235806",1,36,35
"SDR42E1","s1324_SAT_M_BLOOD_ASEReadCounter.table","NW_015090842.1:6235809",1,37,36
"SDR42E1","s1324_SAT_M_BLOOD_ASEReadCounter.table","NW_015090842.1:6235816",1,38,37
"SDR42E1","s1324_SAT_M_BLOOD_ASEReadCounter.table","NW_015090842.1:6235914",0,32,32
"SDR42E1","s1324_SAT_M_BLOOD_ASEReadCounter.table","NW_015090842.1:6235935",0,37,37
"SDR42E1","s1324_SAT_M_BLOOD_ASEReadCounter.table","NW_015090842.1:6235957",0,44,44
"SDR42E1","s1324_SAT_M_BLOOD_ASEReadCounter.table","NW_015090842.1:6236040",0,40,40
"SDR42E1","s1324_SAT_M_BLOOD_ASEReadCounter.table","NW_015090842.1:6236260",1,26,25
"SDR42E1","s1324_SAT_M_BLOOD_ASEReadCounter.table","NW_015090842.1:6236281",0,24,24
"SDR42E1","s1324_SAT_M_BLOOD_ASEReadCounter.table","NW_015090842.1:6236305",0,26,26
"SDR42E1","s1324_SAT_M_BLOOD_ASEReadCounter.table","NW_015090842.1:6236458",0,35,35
"SDR42E1","s1324_SAT_M_BLOOD_ASEReadCounter.table","NW_015090842.1:6236476",0,37,37
"SDR42E1","s1324_SAT_M_BLOOD_ASEReadCounter.table","NW_015090842.1:6236608",1,33,32
"SDR42E1","s1324_SAT_M_BLOOD_ASEReadCounter.table","NW_015090842.1:6238244",1,8,7
"SDR42E1","s1324_SAT_M_BLOOD_ASEReadCounter.table","NW_015090842.1:6238829",1,6,5
"HSD17B2","s1324_SAT_M_BLOOD_ASEReadCounter.table","NW_015090842.1:6257616",0,35,35
"HSD17B2","s1324_SAT_M_BLOOD_ASEReadCounter.table","NW_015090842.1:6257670",0,34,34
"HSD17B2","s1324_SAT_M_BLOOD_ASEReadCounter.table","NW_015090842.1:6257684",0,35,35
"HSD17B2","s1324_SAT_M_BLOOD_ASEReadCounter.table","NW_015090842.1:6257829",0,53,53
"HSD17B2","s1324_SAT_M_BLOOD_ASEReadCounter.table","NW_015090842.1:6262951",0,52,52
"HSD17B2","s1324_SAT_M_BLOOD_ASEReadCounter.table","NW_015090842.1:6262974",0,51,51
"HSD17B2","s1324_SAT_M_BLOOD_ASEReadCounter.table","NW_015090842.1:6266125",0,31,31
"HSD17B2","s1324_SAT_M_BLOOD_ASEReadCounter.table","NW_015090842.1:6266135",0,32,32
"HSD17B2","s1324_SAT_M_BLOOD_ASEReadCounter.table","NW_015090842.1:6266795",0,54,54
"HSD17B2","s1324_SAT_M_BLOOD_ASEReadCounter.table","NW_015090842.1:6266918",0,45,45
"HSD17B2","s1324_SAT_M_BLOOD_ASEReadCounter.table","NW_015090842.1:6266944",0,52,52
"HSD17B2","s1324_SAT_M_BLOOD_ASEReadCounter.table","NW_015090842.1:6266997",0,46,46
"HSD17B2","s1324_SAT_M_BLOOD_ASEReadCounter.table","NW_015090842.1:6267053",0,39,39
"HSD17B2","s1324_SAT_M_BLOOD_ASEReadCounter.table","NW_015090842.1:6267196",0,23,23
"HSD17B2","s1324_SAT_M_BLOOD_ASEReadCounter.table","NW_015090842.1:6267273",0,36,36
"HSD17B2","s1324_SAT_M_BLOOD_ASEReadCounter.table","NW_015090842.1:6267358",0,46,46
"HSD17B2","s1324_SAT_M_BLOOD_ASEReadCounter.table","NW_015090842.1:6267674",0,23,23
"HSD17B2","s1324_SAT_M_BLOOD_ASEReadCounter.table","NW_015090842.1:6267913",0,43,43
"HSD17B2","s1324_SAT_M_BLOOD_ASEReadCounter.table","NW_015090842.1:6268098",0,32,32
"HSD17B2","s1324_SAT_M_BLOOD_ASEReadCounter.table","NW_015090842.1:6268180",0,34,34
"HSD17B2","s1324_SAT_M_BLOOD_ASEReadCounter.table","NW_015090842.1:6268203",0,44,44
"ARY2","s1324_SAT_M_BLOOD_ASEReadCounter.table","NW_015090842.1:6303922",0,1,1
"ARY2","s1324_SAT_M_BLOOD_ASEReadCounter.table","NW_015090842.1:6303954",0,5,5
"ARY2","s1324_SAT_M_BLOOD_ASEReadCounter.table","NW_015090842.1:6303979",0,6,6
"ARY2","s1324_SAT_M_BLOOD_ASEReadCounter.table","NW_015090842.1:6305848",5,19,14
"ARY2","s1324_SAT_M_BLOOD_ASEReadCounter.table","NW_015090842.1:6305856",5,21,16
"ARY2","s1324_SAT_M_BLOOD_ASEReadCounter.table","NW_015090842.1:6305857",5,21,16
"ARY2","s1324_SAT_M_BLOOD_ASEReadCounter.table","NW_015090842.1:6306017",1,11,10
"ARY2","s1324_SAT_M_BLOOD_ASEReadCounter.table","NW_015090842.1:6306052",2,11,9
"ARY2","s1324_SAT_M_BLOOD_ASEReadCounter.table","NW_015090842.1:6306094",3,11,8
"ARY2","s1324_SAT_M_BLOOD_ASEReadCounter.table","NW_015090842.1:6306100",3,10,7
"ARY2","s1324_SAT_M_BLOOD_ASEReadCounter.table","NW_015090842.1:6306146",1,10,9
"ARY2","s1324_SAT_M_BLOOD_ASEReadCounter.table","NW_015090842.1:6306147",1,10,9
"ARY2","s1324_SAT_M_BLOOD_ASEReadCounter.table","NW_015090842.1:6306390",0,6,6
"ARY2","s1324_SAT_M_BLOOD_ASEReadCounter.table","NW_015090842.1:6306567",0,8,8
"ARY2","s1324_SAT_M_BLOOD_ASEReadCounter.table","NW_015090842.1:6306705",1,4,3
"ARY2","s1324_SAT_M_BLOOD_ASEReadCounter.table","NW_015090842.1:6306713",6,6,0
"ARY2","s1324_SAT_M_BLOOD_ASEReadCounter.table","NW_015090842.1:6306773",1,5,4
"ARY2","s1324_SAT_M_BLOOD_ASEReadCounter.table","NW_015090842.1:6307039",0,3,3
"ARY2","s1324_SAT_M_BLOOD_ASEReadCounter.table","NW_015090842.1:6307043",0,4,4
"ARY2","s1324_SAT_M_BLOOD_ASEReadCounter.table","NW_015090842.1:6307093",0,5,5
"ARY2","s1324_SAT_M_BLOOD_ASEReadCounter.table","NW_015090842.1:6307138",0,5,5
"ARY2","s1324_SAT_M_BLOOD_ASEReadCounter.table","NW_015090842.1:6307157",0,3,3
"ARY2","s1324_SAT_M_BLOOD_ASEReadCounter.table","NW_015090842.1:6307187",0,3,3
"ARY2","s1324_SAT_M_BLOOD_ASEReadCounter.table","NW_015090842.1:6307278",4,8,4
"ARY2","s1324_SAT_M_BLOOD_ASEReadCounter.table","NW_015090842.1:6307305",3,6,3
"ARY2","s1324_SAT_M_BLOOD_ASEReadCounter.table","NW_015090842.1:6307318",4,8,4
"ARY2","s1324_SAT_M_BLOOD_ASEReadCounter.table","NW_015090842.1:6307429",3,9,6
"ARY2","s1324_SAT_M_BLOOD_ASEReadCounter.table","NW_015090842.1:6307487",0,1,1
"ARY2","s1324_SAT_M_BLOOD_ASEReadCounter.table","NW_015090842.1:6307670",2,2,0
"ARYL","s1324_SAT_M_BLOOD_ASEReadCounter.table","NW_015090842.1:6313360",2,4,2
"ARYL","s1324_SAT_M_BLOOD_ASEReadCounter.table","NW_015090842.1:6313377",2,4,2
"ARYL","s1324_SAT_M_BLOOD_ASEReadCounter.table","NW_015090842.1:6313767",1,3,2
"ARY1","s1324_SAT_M_BLOOD_ASEReadCounter.table","NW_015090842.1:6313909",3,3,0
"ARY1","s1324_SAT_M_BLOOD_ASEReadCounter.table","NW_015090842.1:6314296",2,4,2
"ARY1","s1324_SAT_M_BLOOD_ASEReadCounter.table","NW_015090842.1:6314541",3,10,7
"ARY1","s1324_SAT_M_BLOOD_ASEReadCounter.table","NW_015090842.1:6314597",2,8,6
"ARY1","s1324_SAT_M_BLOOD_ASEReadCounter.table","NW_015090842.1:6314750",1,1,0
"ARY1","s1324_SAT_M_BLOOD_ASEReadCounter.table","NW_015090842.1:6314794",1,1,0
"ARY1","s1324_SAT_M_BLOOD_ASEReadCounter.table","NW_015090842.1:6314827",1,8,7
"ARY1","s1324_SAT_M_BLOOD_ASEReadCounter.table","NW_015090842.1:6314843",1,8,7
"ARY1","s1324_SAT_M_BLOOD_ASEReadCounter.table","NW_015090842.1:6314859",1,8,7
"ARY1","s1324_SAT_M_BLOOD_ASEReadCounter.table","NW_015090842.1:6314886",1,8,7
"ARY1","s1324_SAT_M_BLOOD_ASEReadCounter.table","NW_015090842.1:6314943",4,4,0
"ARY1","s1324_SAT_M_BLOOD_ASEReadCounter.table","NW_015090842.1:6314949",4,4,0
"ARY1","s1324_SAT_M_BLOOD_ASEReadCounter.table","NW_015090842.1:6315022",0,7,7
"ARY1","s1324_SAT_M_BLOOD_ASEReadCounter.table","NW_015090842.1:6315026",0,6,6
"ARY1","s1324_SAT_M_BLOOD_ASEReadCounter.table","NW_015090842.1:6315043",0,5,5
"ARY1","s1324_SAT_M_BLOOD_ASEReadCounter.table","NW_015090842.1:6315065",1,6,5
"ARY1","s1324_SAT_M_BLOOD_ASEReadCounter.table","NW_015090842.1:6315409",1,4,3
"ARY1","s1324_SAT_M_BLOOD_ASEReadCounter.table","NW_015090842.1:6315479",1,2,1
"ARY1","s1324_SAT_M_BLOOD_ASEReadCounter.table","NW_015090842.1:6318342",3,12,9
"ARY1","s1324_SAT_M_BLOOD_ASEReadCounter.table","NW_015090842.1:6318427",4,10,6
"ARY1","s1324_SAT_M_BLOOD_ASEReadCounter.table","NW_015090842.1:6318603",3,8,5
"ARY1","s1324_SAT_M_BLOOD_ASEReadCounter.table","NW_015090842.1:6318708",4,12,8
"ARY1","s1324_SAT_M_BLOOD_ASEReadCounter.table","NW_015090842.1:6318858",3,11,8
"ARY1","s1324_SAT_M_BLOOD_ASEReadCounter.table","NW_015090842.1:6318952",0,11,11
"MPHOSPH6","s1324_SAT_M_BLOOD_ASEReadCounter.table","NW_015090842.1:6324063",27,93,66
"MPHOSPH6","s1324_SAT_M_BLOOD_ASEReadCounter.table","NW_015090842.1:6324174",46,157,111
"MPHOSPH6","s1324_SAT_M_BLOOD_ASEReadCounter.table","NW_015090842.1:6324270",60,208,148
"MPHOSPH6","s1324_SAT_M_BLOOD_ASEReadCounter.table","NW_015090842.1:6324762",128,343,215
"MPHOSPH6","s1324_SAT_M_BLOOD_ASEReadCounter.table","NW_015090842.1:6324772",133,304,171
"MPHOSPH6","s1324_SAT_M_BLOOD_ASEReadCounter.table","NW_015090842.1:6324780",119,295,176
"MPHOSPH6","s1324_SAT_M_BLOOD_ASEReadCounter.table","NW_015090842.1:6324902",148,408,260
"MPHOSPH6","s1324_SAT_M_BLOOD_ASEReadCounter.table","NW_015090842.1:6324910",419,419,0
"MPHOSPH6","s1324_SAT_M_BLOOD_ASEReadCounter.table","NW_015090842.1:6325066",137,397,260
"MPHOSPH6","s1324_SAT_M_BLOOD_ASEReadCounter.table","NW_015090842.1:6325089",150,426,276
"MPHOSPH6","s1324_SAT_M_BLOOD_ASEReadCounter.table","NW_015090842.1:6325298",192,535,343
"MPHOSPH6","s1324_SAT_M_BLOOD_ASEReadCounter.table","NW_015090842.1:6325877",184,556,372
"MPHOSPH6","s1324_SAT_M_BLOOD_ASEReadCounter.table","NW_015090842.1:6326976",118,347,229
"MLYCD","s1324_SAT_M_BLOOD_ASEReadCounter.table","NW_015090842.1:7150054",23,59,36
"MLYCD","s1324_SAT_M_BLOOD_ASEReadCounter.table","NW_015090842.1:7150131",58,117,59
"MLYCD","s1324_SAT_M_BLOOD_ASEReadCounter.table","NW_015090842.1:7150585",72,128,56
"MLYCD","s1324_SAT_M_BLOOD_ASEReadCounter.table","NW_015090842.1:7150686",50,85,35
"MLYCD","s1324_SAT_M_BLOOD_ASEReadCounter.table","NW_015090842.1:7150696",56,94,38
"MLYCD","s1324_SAT_M_BLOOD_ASEReadCounter.table","NW_015090842.1:7150698",95,95,0
"MLYCD","s1324_SAT_M_BLOOD_ASEReadCounter.table","NW_015090842.1:7150869",53,100,47
"MLYCD","s1324_SAT_M_BLOOD_ASEReadCounter.table","NW_015090842.1:7151100",65,120,55
"MLYCD","s1324_SAT_M_BLOOD_ASEReadCounter.table","NW_015090842.1:7151127",68,122,54
"MLYCD","s1324_SAT_M_BLOOD_ASEReadCounter.table","NW_015090842.1:7157538",64,141,77
"MLYCD","s1324_SAT_M_BLOOD_ASEReadCounter.table","NW_015090842.1:7167662",34,60,26
"MLYCD","s1324_SAT_M_BLOOD_ASEReadCounter.table","NW_015090842.1:7167675",36,62,26
"MLYCD","s1324_SAT_M_BLOOD_ASEReadCounter.table","NW_015090842.1:7167710",26,45,19
"MLYCD","s1324_SAT_M_BLOOD_ASEReadCounter.table","NW_015090842.1:7167781",19,39,20
"MLYCD","s1324_SAT_M_BLOOD_ASEReadCounter.table","NW_015090842.1:7167803",17,31,14
"MLYCD","s1324_SAT_M_BLOOD_ASEReadCounter.table","NW_015090842.1:7167812",16,29,13
"MLYCD","s1324_SAT_M_BLOOD_ASEReadCounter.table","NW_015090842.1:7167845",22,44,22
"MLYCD","s1324_SAT_M_BLOOD_ASEReadCounter.table","NW_015090842.1:7167862",16,38,22
"MLYCD","s1324_SAT_M_BLOOD_ASEReadCounter.table","NW_015090842.1:7167929",19,43,24
"MLYCD","s1324_SAT_M_BLOOD_ASEReadCounter.table","NW_015090842.1:7167995",12,31,19
"MLYCD","s1324_SAT_M_BLOOD_ASEReadCounter.table","NW_015090842.1:7168005",11,28,17
"MLYCD","s1324_SAT_M_BLOOD_ASEReadCounter.table","NW_015090842.1:7168037",13,22,9
"HSBP1","s1324_SAT_M_BLOOD_ASEReadCounter.table","NW_015090842.1:7245192",43,67,24
"HSBP1","s1324_SAT_M_BLOOD_ASEReadCounter.table","NW_015090842.1:7245226",53,83,30
"HSBP1","s1324_SAT_M_BLOOD_ASEReadCounter.table","NW_015090842.1:7245257",40,64,24
"HSBP1","s1324_SAT_M_BLOOD_ASEReadCounter.table","NW_015090842.1:7245296",39,60,21
"HSBP1","s1324_SAT_M_BLOOD_ASEReadCounter.table","NW_015090842.1:7245389",45,67,22
"HSBP1","s1324_SAT_M_BLOOD_ASEReadCounter.table","NW_015090842.1:7245400",53,79,26
"HSBP1","s1324_SAT_M_BLOOD_ASEReadCounter.table","NW_015090842.1:7245445",45,79,34
"HSBP1","s1324_SAT_M_BLOOD_ASEReadCounter.table","NW_015090842.1:7245495",44,78,34
"HSBP1","s1324_SAT_M_BLOOD_ASEReadCounter.table","NW_015090842.1:7245515",50,81,31
"HSBP1","s1324_SAT_M_BLOOD_ASEReadCounter.table","NW_015090842.1:7245733",50,74,24
"HSBP1","s1324_SAT_M_BLOOD_ASEReadCounter.table","NW_015090842.1:7245771",52,74,22
"HSBP1","s1324_SAT_M_BLOOD_ASEReadCounter.table","NW_015090842.1:7245813",57,85,28
"HSBP1","s1324_SAT_M_BLOOD_ASEReadCounter.table","NW_015090842.1:7245926",48,74,26
"HSBP1","s1324_SAT_M_BLOOD_ASEReadCounter.table","NW_015090842.1:7245927",49,75,26
"HSBP1","s1324_SAT_M_BLOOD_ASEReadCounter.table","NW_015090842.1:7245933",48,74,26
"HSBP1","s1324_SAT_M_BLOOD_ASEReadCounter.table","NW_015090842.1:7246002",49,77,28
"HSBP1","s1324_SAT_M_BLOOD_ASEReadCounter.table","NW_015090842.1:7246094",70,108,38
"HSBP1","s1324_SAT_M_BLOOD_ASEReadCounter.table","NW_015090842.1:7246167",56,96,40
"HSBP1","s1324_SAT_M_BLOOD_ASEReadCounter.table","NW_015090842.1:7246183",51,89,38
"HSBP1","s1324_SAT_M_BLOOD_ASEReadCounter.table","NW_015090842.1:7247285",25,31,6
"HSBP1","s1324_SAT_M_BLOOD_ASEReadCounter.table","NW_015090842.1:7247651",191,381,190
"HSBP1","s1324_SAT_M_BLOOD_ASEReadCounter.table","NW_015090842.1:7247657",186,375,189
"HSBP1","s1324_SAT_M_BLOOD_ASEReadCounter.table","NW_015090842.1:7248520",131,258,127
"HSBP1","s1324_SAT_M_BLOOD_ASEReadCounter.table","NW_015090842.1:7248535",116,226,110
"TLDC1","s1324_SAT_M_BLOOD_ASEReadCounter.table","NW_015090842.1:7421997",11,14,3
"COTL1","s1324_SAT_M_BLOOD_ASEReadCounter.table","NW_015090842.1:7490707",20,42,22
"COTL1","s1324_SAT_M_BLOOD_ASEReadCounter.table","NW_015090842.1:7490708",21,43,22
"COTL1","s1324_SAT_M_BLOOD_ASEReadCounter.table","NW_015090842.1:7490711",21,43,22
"COTL1","s1324_SAT_M_BLOOD_ASEReadCounter.table","NW_015090842.1:7490739",23,45,22
"COTL1","s1324_SAT_M_BLOOD_ASEReadCounter.table","NW_015090842.1:7490785",27,54,27
"COTL1","s1324_SAT_M_BLOOD_ASEReadCounter.table","NW_015090842.1:7490820",38,44,6
"COTL1","s1324_SAT_M_BLOOD_ASEReadCounter.table","NW_015090842.1:7490846",30,53,23
"USP10","s1324_SAT_M_BLOOD_ASEReadCounter.table","NW_015090842.1:7572213",57,114,57
"USP10","s1324_SAT_M_BLOOD_ASEReadCounter.table","NW_015090842.1:7572358",64,64,0
"CRISPLD2","s1324_SAT_M_BLOOD_ASEReadCounter.table","NW_015090842.1:7619796",4,4,0
"CRISPLD2","s1324_SAT_M_BLOOD_ASEReadCounter.table","NW_015090842.1:7630779",4,4,0
"CRISPLD2","s1324_SAT_M_BLOOD_ASEReadCounter.table","NW_015090842.1:7633611",2,2,0
"CRISPLD2","s1324_SAT_M_BLOOD_ASEReadCounter.table","NW_015090842.1:7633787",0,3,3
"CRISPLD2","s1324_SAT_M_BLOOD_ASEReadCounter.table","NW_015090842.1:7634023",1,1,0
"CRISPLD2","s1324_SAT_M_BLOOD_ASEReadCounter.table","NW_015090842.1:7634620",7,7,0
"MTHFSD","s1324_SAT_M_BLOOD_ASEReadCounter.table","NW_015090842.1:8152578",1,1,0
"EMC8","s1324_SAT_M_BLOOD_ASEReadCounter.table","NW_015090842.1:8452385",4,15,11
"GINS2","s1324_SAT_M_BLOOD_ASEReadCounter.table","NW_015090842.1:8467469",14,14,0
"GINS2","s1324_SAT_M_BLOOD_ASEReadCounter.table","NW_015090842.1:8470290",13,27,14
"GINS2","s1324_SAT_M_BLOOD_ASEReadCounter.table","NW_015090842.1:8470305",14,28,14
"GINS2","s1324_SAT_M_BLOOD_ASEReadCounter.table","NW_015090842.1:8470376",12,25,13
"GINS2","s1324_SAT_M_BLOOD_ASEReadCounter.table","NW_015090842.1:8471057",2,2,0
"GSE1","s1324_SAT_M_BLOOD_ASEReadCounter.table","NW_015090842.1:8483570",3,3,0
"KIAA0513","s1324_SAT_M_BLOOD_ASEReadCounter.table","NW_015090842.1:8674736",1,1,0
"ZCCHC14","s1324_SAT_M_BLOOD_ASEReadCounter.table","NW_015090842.1:8750189",9,9,0
"KLHDC4","s1324_SAT_M_BLOOD_ASEReadCounter.table","NW_015090842.1:8891175",28,52,24
"KLHDC4","s1324_SAT_M_BLOOD_ASEReadCounter.table","NW_015090842.1:8905251",17,32,15
"KLHDC4","s1324_SAT_M_BLOOD_ASEReadCounter.table","NW_015090842.1:8919630",2,4,2
"SLC7A5","s1324_SAT_M_BLOOD_ASEReadCounter.table","NW_015090842.1:8940382",1,1,0
"SLC7A5","s1324_SAT_M_BLOOD_ASEReadCounter.table","NW_015090842.1:8941818",7,7,0
"SLC7A5","s1324_SAT_M_BLOOD_ASEReadCounter.table","NW_015090842.1:8944655",9,9,0
"CA5A","s1324_SAT_M_BLOOD_ASEReadCounter.table","NW_015090842.1:8989479",5,8,3
"CA5A","s1324_SAT_M_BLOOD_ASEReadCounter.table","NW_015090842.1:8989562",11,15,4
"CA5A","s1324_SAT_M_BLOOD_ASEReadCounter.table","NW_015090842.1:8989609",12,18,6
"CA5A","s1324_SAT_M_BLOOD_ASEReadCounter.table","NW_015090842.1:8989693",8,12,4
"CA5A","s1324_SAT_M_BLOOD_ASEReadCounter.table","NW_015090842.1:8989702",11,13,2
"CA5A","s1324_SAT_M_BLOOD_ASEReadCounter.table","NW_015090842.1:8989746",15,20,5
"CA5A","s1324_SAT_M_BLOOD_ASEReadCounter.table","NW_015090842.1:8989880",9,19,10
"CA5A","s1324_SAT_M_BLOOD_ASEReadCounter.table","NW_015090842.1:8989885",9,18,9
"CA5A","s1324_SAT_M_BLOOD_ASEReadCounter.table","NW_015090842.1:8989929",5,15,10
"CA5A","s1324_SAT_M_BLOOD_ASEReadCounter.table","NW_015090842.1:8990002",3,11,8
"CA5A","s1324_SAT_M_BLOOD_ASEReadCounter.table","NW_015090842.1:8990004",3,11,8
"CA5A","s1324_SAT_M_BLOOD_ASEReadCounter.table","NW_015090842.1:8990005",3,11,8
"CA5A","s1324_SAT_M_BLOOD_ASEReadCounter.table","NW_015090842.1:8990017",6,15,9
"CA5A","s1324_SAT_M_BLOOD_ASEReadCounter.table","NW_015090842.1:8990043",7,13,6
"CA5A","s1324_SAT_M_BLOOD_ASEReadCounter.table","NW_015090842.1:8990080",7,16,9
"CA5A","s1324_SAT_M_BLOOD_ASEReadCounter.table","NW_015090842.1:8990084",8,17,9
"CA5A","s1324_SAT_M_BLOOD_ASEReadCounter.table","NW_015090842.1:8990090",8,18,10
"CA5A","s1324_SAT_M_BLOOD_ASEReadCounter.table","NW_015090842.1:8990095",10,20,10
"CA5A","s1324_SAT_M_BLOOD_ASEReadCounter.table","NW_015090842.1:8990111",7,14,7
"CA5A","s1324_SAT_M_BLOOD_ASEReadCounter.table","NW_015090842.1:8990112",7,13,6
"CA5A","s1324_SAT_M_BLOOD_ASEReadCounter.table","NW_015090842.1:8990115",7,13,6
"CA5A","s1324_SAT_M_BLOOD_ASEReadCounter.table","NW_015090842.1:8990166",8,16,8
"CA5A","s1324_SAT_M_BLOOD_ASEReadCounter.table","NW_015090842.1:8990169",8,16,8
"CA5A","s1324_SAT_M_BLOOD_ASEReadCounter.table","NW_015090842.1:8990222",6,12,6
"CA5A","s1324_SAT_M_BLOOD_ASEReadCounter.table","NW_015090842.1:8990289",7,16,9
"CA5A","s1324_SAT_M_BLOOD_ASEReadCounter.table","NW_015090842.1:8990314",6,15,9
"CA5A","s1324_SAT_M_BLOOD_ASEReadCounter.table","NW_015090842.1:8990361",6,14,8
"CA5A","s1324_SAT_M_BLOOD_ASEReadCounter.table","NW_015090842.1:8990368",6,14,8
"CA5A","s1324_SAT_M_BLOOD_ASEReadCounter.table","NW_015090842.1:8990429",7,12,5
"CA5A","s1324_SAT_M_BLOOD_ASEReadCounter.table","NW_015090842.1:8990466",6,12,6
"CA5A","s1324_SAT_M_BLOOD_ASEReadCounter.table","NW_015090842.1:8990663",9,12,3
"CA5A","s1324_SAT_M_BLOOD_ASEReadCounter.table","NW_015090842.1:8990797",9,13,4
"CA5A","s1324_SAT_M_BLOOD_ASEReadCounter.table","NW_015090842.1:8990836",13,15,2
"CA5A","s1324_SAT_M_BLOOD_ASEReadCounter.table","NW_015090842.1:8990842",11,13,2
"CA5A","s1324_SAT_M_BLOOD_ASEReadCounter.table","NW_015090842.1:8990851",13,15,2
"CA5A","s1324_SAT_M_BLOOD_ASEReadCounter.table","NW_015090842.1:8990918",8,12,4
"CA5A","s1324_SAT_M_BLOOD_ASEReadCounter.table","NW_015090842.1:8990921",7,11,4
"CA5A","s1324_SAT_M_BLOOD_ASEReadCounter.table","NW_015090842.1:8990942",8,13,5
"CA5A","s1324_SAT_M_BLOOD_ASEReadCounter.table","NW_015090842.1:8991001",7,12,5
"CA5A","s1324_SAT_M_BLOOD_ASEReadCounter.table","NW_015090842.1:8991038",8,15,7
"CA5A","s1324_SAT_M_BLOOD_ASEReadCounter.table","NW_015090842.1:8991149",12,13,1
"CA5A","s1324_SAT_M_BLOOD_ASEReadCounter.table","NW_015090842.1:8991176",9,12,3
"CA5A","s1324_SAT_M_BLOOD_ASEReadCounter.table","NW_015090842.1:8991241",4,9,5
"CA5A","s1324_SAT_M_BLOOD_ASEReadCounter.table","NW_015090842.1:8991262",4,9,5
"CA5A","s1324_SAT_M_BLOOD_ASEReadCounter.table","NW_015090842.1:8991316",5,5,0
"CA5A","s1324_SAT_M_BLOOD_ASEReadCounter.table","NW_015090842.1:8991319",4,4,0
"CA5A","s1324_SAT_M_BLOOD_ASEReadCounter.table","NW_015090842.1:8991330",6,6,0
"CA5A","s1324_SAT_M_BLOOD_ASEReadCounter.table","NW_015090842.1:8991334",6,6,0
"CA5A","s1324_SAT_M_BLOOD_ASEReadCounter.table","NW_015090842.1:8991362",8,11,3
"CA5A","s1324_SAT_M_BLOOD_ASEReadCounter.table","NW_015090842.1:8991368",8,11,3
"CA5A","s1324_SAT_M_BLOOD_ASEReadCounter.table","NW_015090842.1:8991390",5,8,3
"CA5A","s1324_SAT_M_BLOOD_ASEReadCounter.table","NW_015090842.1:8991395",6,9,3
"CA5A","s1324_SAT_M_BLOOD_ASEReadCounter.table","NW_015090842.1:8991422",7,13,6
"CA5A","s1324_SAT_M_BLOOD_ASEReadCounter.table","NW_015090842.1:8991467",5,9,4
"CA5A","s1324_SAT_M_BLOOD_ASEReadCounter.table","NW_015090842.1:8991576",4,10,6
"CA5A","s1324_SAT_M_BLOOD_ASEReadCounter.table","NW_015090842.1:8991587",7,14,7
"CA5A","s1324_SAT_M_BLOOD_ASEReadCounter.table","NW_015090842.1:8991655",8,12,4
"CA5A","s1324_SAT_M_BLOOD_ASEReadCounter.table","NW_015090842.1:8991717",7,10,3
"CA5A","s1324_SAT_M_BLOOD_ASEReadCounter.table","NW_015090842.1:8991726",6,9,3
"CA5A","s1324_SAT_M_BLOOD_ASEReadCounter.table","NW_015090842.1:8991799",7,9,2
"CA5A","s1324_SAT_M_BLOOD_ASEReadCounter.table","NW_015090842.1:8991809",6,9,3
"CA5A","s1324_SAT_M_BLOOD_ASEReadCounter.table","NW_015090842.1:8991848",4,10,6
"CA5A","s1324_SAT_M_BLOOD_ASEReadCounter.table","NW_015090842.1:8991849",4,10,6
"CA5A","s1324_SAT_M_BLOOD_ASEReadCounter.table","NW_015090842.1:8991927",5,9,4
"CA5A","s1324_SAT_M_BLOOD_ASEReadCounter.table","NW_015090842.1:8991941",6,10,4
"CA5A","s1324_SAT_M_BLOOD_ASEReadCounter.table","NW_015090842.1:8992121",5,12,7
"CA5A","s1324_SAT_M_BLOOD_ASEReadCounter.table","NW_015090842.1:8992224",1,7,6
"CA5A","s1324_SAT_M_BLOOD_ASEReadCounter.table","NW_015090842.1:9002570",5,8,3
"CA5A","s1324_SAT_M_BLOOD_ASEReadCounter.table","NW_015090842.1:9002600",3,6,3
"CA5A","s1324_SAT_M_BLOOD_ASEReadCounter.table","NW_015090842.1:9004312",4,5,1
"CA5A","s1324_SAT_M_BLOOD_ASEReadCounter.table","NW_015090842.1:9005140",0,1,1
"CA5A","s1324_SAT_M_BLOOD_ASEReadCounter.table","NW_015090842.1:9005152",0,1,1
"BANP","s1324_SAT_M_BLOOD_ASEReadCounter.table","NW_015090842.1:9033407",55,139,84
"BANP","s1324_SAT_M_BLOOD_ASEReadCounter.table","NW_015090842.1:9033409",54,139,85
"BANP","s1324_SAT_M_BLOOD_ASEReadCounter.table","NW_015090842.1:9033420",65,168,103
"BANP","s1324_SAT_M_BLOOD_ASEReadCounter.table","NW_015090842.1:9055284",68,157,89
"ZC3H18","s1324_SAT_M_BLOOD_ASEReadCounter.table","NW_015090842.1:9528933",18,40,22
"MVD","s1324_SAT_M_BLOOD_ASEReadCounter.table","NW_015090842.1:9550690",13,13,0
"MVD","s1324_SAT_M_BLOOD_ASEReadCounter.table","NW_015090842.1:9550691",13,13,0
"MVD","s1324_SAT_M_BLOOD_ASEReadCounter.table","NW_015090842.1:9550699",16,16,0
"MVD","s1324_SAT_M_BLOOD_ASEReadCounter.table","NW_015090842.1:9550701",17,17,0
"MVD","s1324_SAT_M_BLOOD_ASEReadCounter.table","NW_015090842.1:9552202",26,26,0
"MVD","s1324_SAT_M_BLOOD_ASEReadCounter.table","NW_015090842.1:9552223",26,26,0
"MVD","s1324_SAT_M_BLOOD_ASEReadCounter.table","NW_015090842.1:9552533",15,15,0
"MVD","s1324_SAT_M_BLOOD_ASEReadCounter.table","NW_015090842.1:9552644",10,17,7
"PIEZO1","s1324_SAT_M_BLOOD_ASEReadCounter.table","NW_015090842.1:9577447",1,2,1
"PIEZO1","s1324_SAT_M_BLOOD_ASEReadCounter.table","NW_015090842.1:9582630",0,1,1
"PIEZO1","s1324_SAT_M_BLOOD_ASEReadCounter.table","NW_015090842.1:9583326",1,1,0
"CDT1","s1324_SAT_M_BLOOD_ASEReadCounter.table","NW_015090842.1:9598873",1,1,0
"ACSF3","s1324_SAT_M_BLOOD_ASEReadCounter.table","NW_015090842.1:9776737",17,29,12
"ACSF3","s1324_SAT_M_BLOOD_ASEReadCounter.table","NW_015090842.1:9809639",116,116,0
"ACSF3","s1324_SAT_M_BLOOD_ASEReadCounter.table","NW_015090842.1:9834743",89,143,54
"ACSF3","s1324_SAT_M_BLOOD_ASEReadCounter.table","NW_015090842.1:9834762",146,147,1
"ACSF3","s1324_SAT_M_BLOOD_ASEReadCounter.table","NW_015090842.1:9834852",65,114,49
"ACSF3","s1324_SAT_M_BLOOD_ASEReadCounter.table","NW_015090842.1:9834861",57,107,50
"ACSF3","s1324_SAT_M_BLOOD_ASEReadCounter.table","NW_015090842.1:9839359",45,81,36
"ACSF3","s1324_SAT_M_BLOOD_ASEReadCounter.table","NW_015090842.1:9839378",43,75,32
"ACSF3","s1324_SAT_M_BLOOD_ASEReadCounter.table","NW_015090842.1:9839455",43,80,37
"ACSF3","s1324_SAT_M_BLOOD_ASEReadCounter.table","NW_015090842.1:9839457",43,77,34
"ACSF3","s1324_SAT_M_BLOOD_ASEReadCounter.table","NW_015090842.1:9839489",31,62,31
"ACSF3","s1324_SAT_M_BLOOD_ASEReadCounter.table","NW_015090842.1:9839500",20,46,26
"ACSF3","s1324_SAT_M_BLOOD_ASEReadCounter.table","NW_015090842.1:9839501",20,45,25
"ACSF3","s1324_SAT_M_BLOOD_ASEReadCounter.table","NW_015090842.1:9839504",26,51,25
"ACSF3","s1324_SAT_M_BLOOD_ASEReadCounter.table","NW_015090842.1:9839512",23,39,16
"ACSF3","s1324_SAT_M_BLOOD_ASEReadCounter.table","NW_015090842.1:9839527",15,28,13
"ACSF3","s1324_SAT_M_BLOOD_ASEReadCounter.table","NW_015090842.1:9839533",10,21,11
"ACSF3","s1324_SAT_M_BLOOD_ASEReadCounter.table","NW_015090842.1:9839535",10,20,10
"ACSF3","s1324_SAT_M_BLOOD_ASEReadCounter.table","NW_015090842.1:9839545",8,19,11
"ACSF3","s1324_SAT_M_BLOOD_ASEReadCounter.table","NW_015090842.1:9839550",7,17,10
"ACSF3","s1324_SAT_M_BLOOD_ASEReadCounter.table","NW_015090842.1:9839551",7,16,9
"SLC22A31","s1324_SAT_M_BLOOD_ASEReadCounter.table","NW_015090842.1:9853102",1,1,0
"SLC22A31","s1324_SAT_M_BLOOD_ASEReadCounter.table","NW_015090842.1:9853421",1,1,0
"SLC22A31","s1324_SAT_M_BLOOD_ASEReadCounter.table","NW_015090842.1:9853457",1,1,0
"ANKRD11","s1324_SAT_M_BLOOD_ASEReadCounter.table","NW_015090842.1:9858863",3,7,4
"ANKRD11","s1324_SAT_M_BLOOD_ASEReadCounter.table","NW_015090842.1:9859101",77,155,78
"ANKRD11","s1324_SAT_M_BLOOD_ASEReadCounter.table","NW_015090842.1:9859352",121,216,95
"ANKRD11","s1324_SAT_M_BLOOD_ASEReadCounter.table","NW_015090842.1:9859381",76,134,58
"ANKRD11","s1324_SAT_M_BLOOD_ASEReadCounter.table","NW_015090842.1:9859527",47,81,34
"ANKRD11","s1324_SAT_M_BLOOD_ASEReadCounter.table","NW_015090842.1:9859529",49,83,34
"ANKRD11","s1324_SAT_M_BLOOD_ASEReadCounter.table","NW_015090842.1:9859679",120,215,95
"ANKRD11","s1324_SAT_M_BLOOD_ASEReadCounter.table","NW_015090842.1:9861097",93,182,89
"ANKRD11","s1324_SAT_M_BLOOD_ASEReadCounter.table","NW_015090842.1:9862571",82,140,58
"ANKRD11","s1324_SAT_M_BLOOD_ASEReadCounter.table","NW_015090842.1:9866071",0,84,84
"ANKRD11","s1324_SAT_M_BLOOD_ASEReadCounter.table","NW_015090842.1:9866200",0,78,78
"ANKRD11","s1324_SAT_M_BLOOD_ASEReadCounter.table","NW_015090842.1:9867391",64,106,42
"ANKRD11","s1324_SAT_M_BLOOD_ASEReadCounter.table","NW_015090842.1:9867472",91,169,78
"ANKRD11","s1324_SAT_M_BLOOD_ASEReadCounter.table","NW_015090842.1:9867559",100,177,77
"ANKRD11","s1324_SAT_M_BLOOD_ASEReadCounter.table","NW_015090842.1:9867934",91,186,95
"ANKRD11","s1324_SAT_M_BLOOD_ASEReadCounter.table","NW_015090842.1:9868093",97,195,98
"ANKRD11","s1324_SAT_M_BLOOD_ASEReadCounter.table","NW_015090842.1:9868222",87,197,110
"ANKRD11","s1324_SAT_M_BLOOD_ASEReadCounter.table","NW_015090842.1:9868327",100,177,77
"ANKRD11","s1324_SAT_M_BLOOD_ASEReadCounter.table","NW_015090842.1:9868414",109,216,107
"ANKRD11","s1324_SAT_M_BLOOD_ASEReadCounter.table","NW_015090842.1:9868441",102,206,104
"ANKRD11","s1324_SAT_M_BLOOD_ASEReadCounter.table","NW_015090842.1:9868444",106,218,112
"ANKRD11","s1324_SAT_M_BLOOD_ASEReadCounter.table","NW_015090842.1:9868519",127,260,133
"ANKRD11","s1324_SAT_M_BLOOD_ASEReadCounter.table","NW_015090842.1:9868609",147,274,127
"ANKRD11","s1324_SAT_M_BLOOD_ASEReadCounter.table","NW_015090842.1:9868666",150,289,139
"ANKRD11","s1324_SAT_M_BLOOD_ASEReadCounter.table","NW_015090842.1:9869431",140,256,116
"ANKRD11","s1324_SAT_M_BLOOD_ASEReadCounter.table","NW_015090842.1:9869578",179,338,159
"ANKRD11","s1324_SAT_M_BLOOD_ASEReadCounter.table","NW_015090842.1:9869734",194,368,174
"ANKRD11","s1324_SAT_M_BLOOD_ASEReadCounter.table","NW_015090842.1:9870070",141,292,151
"ANKRD11","s1324_SAT_M_BLOOD_ASEReadCounter.table","NW_015090842.1:9870349",155,315,160
"ANKRD11","s1324_SAT_M_BLOOD_ASEReadCounter.table","NW_015090842.1:9870604",141,291,150
"ANKRD11","s1324_SAT_M_BLOOD_ASEReadCounter.table","NW_015090842.1:9870613",152,305,153
"ANKRD11","s1324_SAT_M_BLOOD_ASEReadCounter.table","NW_015090842.1:9870685",184,378,194
"ANKRD11","s1324_SAT_M_BLOOD_ASEReadCounter.table","NW_015090842.1:9870847",174,348,174
"ANKRD11","s1324_SAT_M_BLOOD_ASEReadCounter.table","NW_015090842.1:9871103",173,310,137
"ANKRD11","s1324_SAT_M_BLOOD_ASEReadCounter.table","NW_015090842.1:9871165",166,321,155
"ANKRD11","s1324_SAT_M_BLOOD_ASEReadCounter.table","NW_015090842.1:9871820",94,192,98
"ANKRD11","s1324_SAT_M_BLOOD_ASEReadCounter.table","NW_015090842.1:9871994",223,223,0
"ANKRD11","s1324_SAT_M_BLOOD_ASEReadCounter.table","NW_015090842.1:9872118",126,239,113
"SPG7","s1324_SAT_M_BLOOD_ASEReadCounter.table","NW_015090842.1:10051190",41,77,36
"SPG7","s1324_SAT_M_BLOOD_ASEReadCounter.table","NW_015090842.1:10051218",53,88,35
"SPG7","s1324_SAT_M_BLOOD_ASEReadCounter.table","NW_015090842.1:10052348",59,106,47
"SPG7","s1324_SAT_M_BLOOD_ASEReadCounter.table","NW_015090842.1:10052366",49,92,43
"SPG7","s1324_SAT_M_BLOOD_ASEReadCounter.table","NW_015090842.1:10065173",66,111,45
"SPG7","s1324_SAT_M_BLOOD_ASEReadCounter.table","NW_015090842.1:10065215",66,103,37
"SPG7","s1324_SAT_M_BLOOD_ASEReadCounter.table","NW_015090842.1:10066301",50,75,25
"SPG7","s1324_SAT_M_BLOOD_ASEReadCounter.table","NW_015090842.1:10066365",51,82,31
"SPG7","s1324_SAT_M_BLOOD_ASEReadCounter.table","NW_015090842.1:10069752",45,89,44
"SPG7","s1324_SAT_M_BLOOD_ASEReadCounter.table","NW_015090842.1:10069800",51,97,46
"SPG7","s1324_SAT_M_BLOOD_ASEReadCounter.table","NW_015090842.1:10071192",51,90,39
"SPG7","s1324_SAT_M_BLOOD_ASEReadCounter.table","NW_015090842.1:10071204",47,86,39
"SPG7","s1324_SAT_M_BLOOD_ASEReadCounter.table","NW_015090842.1:10071219",43,84,41
"SPG7","s1324_SAT_M_BLOOD_ASEReadCounter.table","NW_015090842.1:10071967",39,80,41
"SPG7","s1324_SAT_M_BLOOD_ASEReadCounter.table","NW_015090842.1:10075109",55,88,33
"SPG7","s1324_SAT_M_BLOOD_ASEReadCounter.table","NW_015090842.1:10075114",58,90,32
"SPG7","s1324_SAT_M_BLOOD_ASEReadCounter.table","NW_015090842.1:10075198",48,79,31
"SPG7","s1324_SAT_M_BLOOD_ASEReadCounter.table","NW_015090842.1:10075487",18,38,20
"SPG7","s1324_SAT_M_BLOOD_ASEReadCounter.table","NW_015090842.1:10075488",18,39,21
"SPG7","s1324_SAT_M_BLOOD_ASEReadCounter.table","NW_015090842.1:10075548",17,28,11
"RPL13","s1324_SAT_M_BLOOD_ASEReadCounter.table","NW_015090842.1:10076979",20,28,8
"RPL13","s1324_SAT_M_BLOOD_ASEReadCounter.table","NW_015090842.1:10077387",660,1533,873
"RPL13","s1324_SAT_M_BLOOD_ASEReadCounter.table","NW_015090842.1:10077978",1096,2232,1136
"RPL13","s1324_SAT_M_BLOOD_ASEReadCounter.table","NW_015090842.1:10077992",1097,2191,1094
"CHMP1A","s1324_SAT_M_BLOOD_ASEReadCounter.table","NW_015090842.1:10102901",38,77,39
"CHMP1A","s1324_SAT_M_BLOOD_ASEReadCounter.table","NW_015090842.1:10102961",59,126,67
"CHMP1A","s1324_SAT_M_BLOOD_ASEReadCounter.table","NW_015090842.1:10102996",60,122,62
"CHMP1A","s1324_SAT_M_BLOOD_ASEReadCounter.table","NW_015090842.1:10103004",64,127,63
"CHMP1A","s1324_SAT_M_BLOOD_ASEReadCounter.table","NW_015090842.1:10103006",64,127,63
"CHMP1A","s1324_SAT_M_BLOOD_ASEReadCounter.table","NW_015090842.1:10103052",80,145,65
"CHMP1A","s1324_SAT_M_BLOOD_ASEReadCounter.table","NW_015090842.1:10103095",78,161,83
"CHMP1A","s1324_SAT_M_BLOOD_ASEReadCounter.table","NW_015090842.1:10103096",80,163,83
"CHMP1A","s1324_SAT_M_BLOOD_ASEReadCounter.table","NW_015090842.1:10103152",69,142,73
"CHMP1A","s1324_SAT_M_BLOOD_ASEReadCounter.table","NW_015090842.1:10103334",50,97,47
"CHMP1A","s1324_SAT_M_BLOOD_ASEReadCounter.table","NW_015090842.1:10103373",36,83,47
"CHMP1A","s1324_SAT_M_BLOOD_ASEReadCounter.table","NW_015090842.1:10103408",60,129,69
"CHMP1A","s1324_SAT_M_BLOOD_ASEReadCounter.table","NW_015090842.1:10103412",67,143,76
"CHMP1A","s1324_SAT_M_BLOOD_ASEReadCounter.table","NW_015090842.1:10103512",96,181,85
"CHMP1A","s1324_SAT_M_BLOOD_ASEReadCounter.table","NW_015090842.1:10103513",93,177,84
"CHMP1A","s1324_SAT_M_BLOOD_ASEReadCounter.table","NW_015090842.1:10103583",76,135,59
"CHMP1A","s1324_SAT_M_BLOOD_ASEReadCounter.table","NW_015090842.1:10103614",69,128,59
"CHMP1A","s1324_SAT_M_BLOOD_ASEReadCounter.table","NW_015090842.1:10103657",67,133,66
"CHMP1A","s1324_SAT_M_BLOOD_ASEReadCounter.table","NW_015090842.1:10103669",53,113,60
"CHMP1A","s1324_SAT_M_BLOOD_ASEReadCounter.table","NW_015090842.1:10103674",59,118,59
"CHMP1A","s1324_SAT_M_BLOOD_ASEReadCounter.table","NW_015090842.1:10103677",58,115,57
"CHMP1A","s1324_SAT_M_BLOOD_ASEReadCounter.table","NW_015090842.1:10103729",84,136,52
"CHMP1A","s1324_SAT_M_BLOOD_ASEReadCounter.table","NW_015090842.1:10103758",98,145,47
"CHMP1A","s1324_SAT_M_BLOOD_ASEReadCounter.table","NW_015090842.1:10103761",97,153,56
"CHMP1A","s1324_SAT_M_BLOOD_ASEReadCounter.table","NW_015090842.1:10103788",91,168,77
"CHMP1A","s1324_SAT_M_BLOOD_ASEReadCounter.table","NW_015090842.1:10103789",93,171,78
"CHMP1A","s1324_SAT_M_BLOOD_ASEReadCounter.table","NW_015090842.1:10103790",92,170,78
"CHMP1A","s1324_SAT_M_BLOOD_ASEReadCounter.table","NW_015090842.1:10103950",91,170,79
"CHMP1A","s1324_SAT_M_BLOOD_ASEReadCounter.table","NW_015090842.1:10104335",62,133,71
"CHMP1A","s1324_SAT_M_BLOOD_ASEReadCounter.table","NW_015090842.1:10104429",102,197,95
"CHMP1A","s1324_SAT_M_BLOOD_ASEReadCounter.table","NW_015090842.1:10104532",84,187,103
"CHMP1A","s1324_SAT_M_BLOOD_ASEReadCounter.table","NW_015090842.1:10104633",73,143,70
"CHMP1A","s1324_SAT_M_BLOOD_ASEReadCounter.table","NW_015090842.1:10104759",80,156,76
"CHMP1A","s1324_SAT_M_BLOOD_ASEReadCounter.table","NW_015090842.1:10104794",100,181,81
"CHMP1A","s1324_SAT_M_BLOOD_ASEReadCounter.table","NW_015090842.1:10104844",91,155,64
"CHMP1A","s1324_SAT_M_BLOOD_ASEReadCounter.table","NW_015090842.1:10106290",69,138,69
"CHMP1A","s1324_SAT_M_BLOOD_ASEReadCounter.table","NW_015090842.1:10106335",82,159,77
"CHMP1A","s1324_SAT_M_BLOOD_ASEReadCounter.table","NW_015090842.1:10106383",114,209,95
"CHMP1A","s1324_SAT_M_BLOOD_ASEReadCounter.table","NW_015090842.1:10106747",105,201,96
"CHMP1A","s1324_SAT_M_BLOOD_ASEReadCounter.table","NW_015090842.1:10107404",111,235,124
"CHMP1A","s1324_SAT_M_BLOOD_ASEReadCounter.table","NW_015090842.1:10107410",118,241,123
"CHMP1A","s1324_SAT_M_BLOOD_ASEReadCounter.table","NW_015090842.1:10107876",77,171,94
"CDK10","s1324_SAT_M_BLOOD_ASEReadCounter.table","NW_015090842.1:10109030",29,30,1
"CDK10","s1324_SAT_M_BLOOD_ASEReadCounter.table","NW_015090842.1:10109963",113,225,112
"CDK10","s1324_SAT_M_BLOOD_ASEReadCounter.table","NW_015090842.1:10110887",131,282,151
"CDK10","s1324_SAT_M_BLOOD_ASEReadCounter.table","NW_015090842.1:10111254",104,259,155
"CDK10","s1324_SAT_M_BLOOD_ASEReadCounter.table","NW_015090842.1:10111380",115,287,172
"CDK10","s1324_SAT_M_BLOOD_ASEReadCounter.table","NW_015090842.1:10111395",124,285,161
"CDK10","s1324_SAT_M_BLOOD_ASEReadCounter.table","NW_015090842.1:10111437",133,295,162
"CDK10","s1324_SAT_M_BLOOD_ASEReadCounter.table","NW_015090842.1:10111798",135,279,144
"CDK10","s1324_SAT_M_BLOOD_ASEReadCounter.table","NW_015090842.1:10111840",153,305,152
"CDK10","s1324_SAT_M_BLOOD_ASEReadCounter.table","NW_015090842.1:10112031",145,313,168
"CDK10","s1324_SAT_M_BLOOD_ASEReadCounter.table","NW_015090842.1:10112285",125,263,138
"CDK10","s1324_SAT_M_BLOOD_ASEReadCounter.table","NW_015090842.1:10112398",135,270,135
"CDK10","s1324_SAT_M_BLOOD_ASEReadCounter.table","NW_015090842.1:10112455",105,228,123
"CDK10","s1324_SAT_M_BLOOD_ASEReadCounter.table","NW_015090842.1:10112461",97,211,114
"CDK10","s1324_SAT_M_BLOOD_ASEReadCounter.table","NW_015090842.1:10112497",96,187,91
"CDK10","s1324_SAT_M_BLOOD_ASEReadCounter.table","NW_015090842.1:10112508",107,201,94
"CDK10","s1324_SAT_M_BLOOD_ASEReadCounter.table","NW_015090842.1:10112518",104,186,82
"CDK10","s1324_SAT_M_BLOOD_ASEReadCounter.table","NW_015090842.1:10112540",118,189,71
"CDK10","s1324_SAT_M_BLOOD_ASEReadCounter.table","NW_015090842.1:10112556",111,200,89
"CDK10","s1324_SAT_M_BLOOD_ASEReadCounter.table","NW_015090842.1:10112561",108,203,95
"CDK10","s1324_SAT_M_BLOOD_ASEReadCounter.table","NW_015090842.1:10112596",105,198,93
"CDK10","s1324_SAT_M_BLOOD_ASEReadCounter.table","NW_015090842.1:10112630",75,155,80
"CDK10","s1324_SAT_M_BLOOD_ASEReadCounter.table","NW_015090842.1:10112656",82,159,77
"CDK10","s1324_SAT_M_BLOOD_ASEReadCounter.table","NW_015090842.1:10112665",69,137,68
"CDK10","s1324_SAT_M_BLOOD_ASEReadCounter.table","NW_015090842.1:10112668",67,132,65
"CDK10","s1324_SAT_M_BLOOD_ASEReadCounter.table","NW_015090842.1:10112781",33,61,28
"CDK10","s1324_SAT_M_BLOOD_ASEReadCounter.table","NW_015090842.1:10112782",34,61,27
"CDK10","s1324_SAT_M_BLOOD_ASEReadCounter.table","NW_015090842.1:10112795",32,57,25
"CDK10","s1324_SAT_M_BLOOD_ASEReadCounter.table","NW_015090842.1:10112841",4,6,2
"CDK10","s1324_SAT_M_BLOOD_ASEReadCounter.table","NW_015090842.1:10112861",1,3,2
"SPATA2L","s1324_SAT_M_BLOOD_ASEReadCounter.table","NW_015090842.1:10113212",2,7,5
"SPATA2L","s1324_SAT_M_BLOOD_ASEReadCounter.table","NW_015090842.1:10113280",2,8,6
"SPATA2L","s1324_SAT_M_BLOOD_ASEReadCounter.table","NW_015090842.1:10113296",3,8,5
"SPATA2L","s1324_SAT_M_BLOOD_ASEReadCounter.table","NW_015090842.1:10113321",3,10,7
"SPATA2L","s1324_SAT_M_BLOOD_ASEReadCounter.table","NW_015090842.1:10113332",3,11,8
"SPATA2L","s1324_SAT_M_BLOOD_ASEReadCounter.table","NW_015090842.1:10113380",1,8,7
"SPATA2L","s1324_SAT_M_BLOOD_ASEReadCounter.table","NW_015090842.1:10113381",1,9,8
"SPATA2L","s1324_SAT_M_BLOOD_ASEReadCounter.table","NW_015090842.1:10113412",2,12,10
"SPATA2L","s1324_SAT_M_BLOOD_ASEReadCounter.table","NW_015090842.1:10113421",2,11,9
"SPATA2L","s1324_SAT_M_BLOOD_ASEReadCounter.table","NW_015090842.1:10113465",5,13,8
"SPATA2L","s1324_SAT_M_BLOOD_ASEReadCounter.table","NW_015090842.1:10113535",7,16,9
"SPATA2L","s1324_SAT_M_BLOOD_ASEReadCounter.table","NW_015090842.1:10113645",3,14,11
"SPATA2L","s1324_SAT_M_BLOOD_ASEReadCounter.table","NW_015090842.1:10113682",5,18,13
"SPATA2L","s1324_SAT_M_BLOOD_ASEReadCounter.table","NW_015090842.1:10113696",5,18,13
"SPATA2L","s1324_SAT_M_BLOOD_ASEReadCounter.table","NW_015090842.1:10113727",6,21,15
"SPATA2L","s1324_SAT_M_BLOOD_ASEReadCounter.table","NW_015090842.1:10113729",6,21,15
"SPATA2L","s1324_SAT_M_BLOOD_ASEReadCounter.table","NW_015090842.1:10113799",1,19,18
"SPATA2L","s1324_SAT_M_BLOOD_ASEReadCounter.table","NW_015090842.1:10113809",1,20,19
"SPATA2L","s1324_SAT_M_BLOOD_ASEReadCounter.table","NW_015090842.1:10113827",0,19,19
"SPATA2L","s1324_SAT_M_BLOOD_ASEReadCounter.table","NW_015090842.1:10113831",0,18,18
"SPATA2L","s1324_SAT_M_BLOOD_ASEReadCounter.table","NW_015090842.1:10113894",1,17,16
"SPATA2L","s1324_SAT_M_BLOOD_ASEReadCounter.table","NW_015090842.1:10113905",1,20,19
"SPATA2L","s1324_SAT_M_BLOOD_ASEReadCounter.table","NW_015090842.1:10113914",3,20,17
"SPATA2L","s1324_SAT_M_BLOOD_ASEReadCounter.table","NW_015090842.1:10113920",4,23,19
"SPATA2L","s1324_SAT_M_BLOOD_ASEReadCounter.table","NW_015090842.1:10113937",5,26,21
"SPATA2L","s1324_SAT_M_BLOOD_ASEReadCounter.table","NW_015090842.1:10113971",5,22,17
"SPATA2L","s1324_SAT_M_BLOOD_ASEReadCounter.table","NW_015090842.1:10113976",5,23,18
"SPATA2L","s1324_SAT_M_BLOOD_ASEReadCounter.table","NW_015090842.1:10113985",5,21,16
"SPATA2L","s1324_SAT_M_BLOOD_ASEReadCounter.table","NW_015090842.1:10113994",5,22,17
"SPATA2L","s1324_SAT_M_BLOOD_ASEReadCounter.table","NW_015090842.1:10114063",2,14,12
"SPATA2L","s1324_SAT_M_BLOOD_ASEReadCounter.table","NW_015090842.1:10114066",2,14,12
"SPATA2L","s1324_SAT_M_BLOOD_ASEReadCounter.table","NW_015090842.1:10114069",2,15,13
"SPATA2L","s1324_SAT_M_BLOOD_ASEReadCounter.table","NW_015090842.1:10114159",1,12,11
"SPATA2L","s1324_SAT_M_BLOOD_ASEReadCounter.table","NW_015090842.1:10114262",18,18,0
"SPATA2L","s1324_SAT_M_BLOOD_ASEReadCounter.table","NW_015090842.1:10114470",2,8,6
"SPATA2L","s1324_SAT_M_BLOOD_ASEReadCounter.table","NW_015090842.1:10114524",1,8,7
"VPS9D1","s1324_SAT_M_BLOOD_ASEReadCounter.table","NW_015090842.1:10116377",0,1,1
"VPS9D1","s1324_SAT_M_BLOOD_ASEReadCounter.table","NW_015090842.1:10116415",0,1,1
"VPS9D1","s1324_SAT_M_BLOOD_ASEReadCounter.table","NW_015090842.1:10117480",0,1,1
"VPS9D1","s1324_SAT_M_BLOOD_ASEReadCounter.table","NW_015090842.1:10117773",0,1,1
"VPS9D1","s1324_SAT_M_BLOOD_ASEReadCounter.table","NW_015090842.1:10117937",0,1,1
"VPS9D1","s1324_SAT_M_BLOOD_ASEReadCounter.table","NW_015090842.1:10118414",0,1,1
"ZNF276","s1324_SAT_M_BLOOD_ASEReadCounter.table","NW_015090842.1:10121760",5,7,2
"ZNF276","s1324_SAT_M_BLOOD_ASEReadCounter.table","NW_015090842.1:10121769",5,7,2
"ZNF276","s1324_SAT_M_BLOOD_ASEReadCounter.table","NW_015090842.1:10121802",9,15,6
"ZNF276","s1324_SAT_M_BLOOD_ASEReadCounter.table","NW_015090842.1:10121971",17,33,16
"ZNF276","s1324_SAT_M_BLOOD_ASEReadCounter.table","NW_015090842.1:10122161",37,37,0
"ZNF276","s1324_SAT_M_BLOOD_ASEReadCounter.table","NW_015090842.1:10122164",36,36,0
"ZNF276","s1324_SAT_M_BLOOD_ASEReadCounter.table","NW_015090842.1:10122184",32,32,0
"ZNF276","s1324_SAT_M_BLOOD_ASEReadCounter.table","NW_015090842.1:10122883",16,27,11
"ZNF276","s1324_SAT_M_BLOOD_ASEReadCounter.table","NW_015090842.1:10122997",20,35,15
"ZNF276","s1324_SAT_M_BLOOD_ASEReadCounter.table","NW_015090842.1:10123069",18,36,18
"ZNF276","s1324_SAT_M_BLOOD_ASEReadCounter.table","NW_015090842.1:10123207",24,43,19
"ZNF276","s1324_SAT_M_BLOOD_ASEReadCounter.table","NW_015090842.1:10125787",15,33,18
"ZNF276","s1324_SAT_M_BLOOD_ASEReadCounter.table","NW_015090842.1:10126309",29,42,13
"ZNF276","s1324_SAT_M_BLOOD_ASEReadCounter.table","NW_015090842.1:10126348",27,39,12
"ZNF276","s1324_SAT_M_BLOOD_ASEReadCounter.table","NW_015090842.1:10126978",19,31,12
"ZNF276","s1324_SAT_M_BLOOD_ASEReadCounter.table","NW_015090842.1:10126991",21,34,13
"ZNF276","s1324_SAT_M_BLOOD_ASEReadCounter.table","NW_015090842.1:10127023",22,31,9
"ZNF276","s1324_SAT_M_BLOOD_ASEReadCounter.table","NW_015090842.1:10127063",22,33,11
"ZNF276","s1324_SAT_M_BLOOD_ASEReadCounter.table","NW_015090842.1:10127373",28,41,13
"ZNF276","s1324_SAT_M_BLOOD_ASEReadCounter.table","NW_015090842.1:10127931",31,61,30
"ZNF276","s1324_SAT_M_BLOOD_ASEReadCounter.table","NW_015090842.1:10128070",35,65,30
"ZNF276","s1324_SAT_M_BLOOD_ASEReadCounter.table","NW_015090842.1:10128102",34,64,30
"ZNF276","s1324_SAT_M_BLOOD_ASEReadCounter.table","NW_015090842.1:10128356",24,41,17
"ZNF276","s1324_SAT_M_BLOOD_ASEReadCounter.table","NW_015090842.1:10128497",18,29,11
"FANCA","s1324_SAT_M_BLOOD_ASEReadCounter.table","NW_015090842.1:10128743",0,1,1
"FANCA","s1324_SAT_M_BLOOD_ASEReadCounter.table","NW_015090842.1:10128822",0,2,2
"FANCA","s1324_SAT_M_BLOOD_ASEReadCounter.table","NW_015090842.1:10129383",2,2,0
"FANCA","s1324_SAT_M_BLOOD_ASEReadCounter.table","NW_015090842.1:10129390",2,2,0
"FANCA","s1324_SAT_M_BLOOD_ASEReadCounter.table","NW_015090842.1:10129422",1,3,2
"FANCA","s1324_SAT_M_BLOOD_ASEReadCounter.table","NW_015090842.1:10130399",1,4,3
"FANCA","s1324_SAT_M_BLOOD_ASEReadCounter.table","NW_015090842.1:10130857",0,1,1
"FANCA","s1324_SAT_M_BLOOD_ASEReadCounter.table","NW_015090842.1:10130878",0,1,1
"FANCA","s1324_SAT_M_BLOOD_ASEReadCounter.table","NW_015090842.1:10133530",0,1,1
"FANCA","s1324_SAT_M_BLOOD_ASEReadCounter.table","NW_015090842.1:10133533",0,1,1
"FANCA","s1324_SAT_M_BLOOD_ASEReadCounter.table","NW_015090842.1:10133536",0,1,1
"FANCA","s1324_SAT_M_BLOOD_ASEReadCounter.table","NW_015090842.1:10133601",0,1,1
"SPIRE2","s1324_SAT_M_BLOOD_ASEReadCounter.table","NW_015090842.1:10175704",1,1,0
"TCF25","s1324_SAT_M_BLOOD_ASEReadCounter.table","NW_015090842.1:10180912",46,91,45
"TCF25","s1324_SAT_M_BLOOD_ASEReadCounter.table","NW_015090842.1:10180924",46,91,45
"TCF25","s1324_SAT_M_BLOOD_ASEReadCounter.table","NW_015090842.1:10180931",45,90,45
"TCF25","s1324_SAT_M_BLOOD_ASEReadCounter.table","NW_015090842.1:10185332",125,240,115
"TCF25","s1324_SAT_M_BLOOD_ASEReadCounter.table","NW_015090842.1:10196561",73,131,58
"TCF25","s1324_SAT_M_BLOOD_ASEReadCounter.table","NW_015090842.1:10197399",134,134,0
"GAS8","s1324_SAT_M_BLOOD_ASEReadCounter.table","NW_015090842.1:10228982",2,2,0
"GAS8","s1324_SAT_M_BLOOD_ASEReadCounter.table","NW_015090842.1:10229832",3,3,0
"GAS8","s1324_SAT_M_BLOOD_ASEReadCounter.table","NW_015090842.1:10232901",2,3,1
"GAS8","s1324_SAT_M_BLOOD_ASEReadCounter.table","NW_015090842.1:10232928",2,2,0
"GAS8","s1324_SAT_M_BLOOD_ASEReadCounter.table","NW_015090842.1:10232967",2,2,0
"GAS8","s1324_SAT_M_BLOOD_ASEReadCounter.table","NW_015090842.1:10233252",1,1,0
"GAS8","s1324_SAT_M_BLOOD_ASEReadCounter.table","NW_015090842.1:10233303",1,1,0
"LOC106888094","s1324_SAT_M_BLOOD_ASEReadCounter.table","NW_015090842.1:10233388",0,1,1
"LOC106888094","s1324_SAT_M_BLOOD_ASEReadCounter.table","NW_015090842.1:10233402",0,1,1
"LOC106888094","s1324_SAT_M_BLOOD_ASEReadCounter.table","NW_015090842.1:10233465",0,1,1
"LOC106888173","s1324_SAT_M_BLOOD_ASEReadCounter.table","NW_015090842.1:10240280",0,1,1
"LOC106888173","s1324_SAT_M_BLOOD_ASEReadCounter.table","NW_015090842.1:10241803",0,1,1
"LOC106888173","s1324_SAT_M_BLOOD_ASEReadCounter.table","NW_015090842.1:10242909",0,1,1
"LOC106888173","s1324_SAT_M_BLOOD_ASEReadCounter.table","NW_015090842.1:10243347",1,1,0
"LOC106888173","s1324_SAT_M_BLOOD_ASEReadCounter.table","NW_015090842.1:10243353",1,1,0
"LOC106888173","s1324_SAT_M_BLOOD_ASEReadCounter.table","NW_015090842.1:10243363",1,2,1
"LOC106888173","s1324_SAT_M_BLOOD_ASEReadCounter.table","NW_015090842.1:10243365",1,2,1
"LOC106888173","s1324_SAT_M_BLOOD_ASEReadCounter.table","NW_015090842.1:10243529",1,2,1
"LOC106888173","s1324_SAT_M_BLOOD_ASEReadCounter.table","NW_015090842.1:10243566",1,2,1
"LOC106888384","s1324_SAT_M_BLOOD_ASEReadCounter.table","NW_015090842.1:10255531",1,1,0
"LOC106888384","s1324_SAT_M_BLOOD_ASEReadCounter.table","NW_015090842.1:10255608",5,5,0
"LOC106888384","s1324_SAT_M_BLOOD_ASEReadCounter.table","NW_015090842.1:10255614",4,4,0
"LOC106888384","s1324_SAT_M_BLOOD_ASEReadCounter.table","NW_015090842.1:10255704",84,84,0
"LOC106888384","s1324_SAT_M_BLOOD_ASEReadCounter.table","NW_015090842.1:10255731",102,102,0
"LOC106888384","s1324_SAT_M_BLOOD_ASEReadCounter.table","NW_015090842.1:10255771",134,134,0
"TANGO6","s1324_SAT_M_BLOOD_ASEReadCounter.table","NW_015090842.1:10257782",9,18,9
"TANGO6","s1324_SAT_M_BLOOD_ASEReadCounter.table","NW_015090842.1:10258162",7,15,8
"TANGO6","s1324_SAT_M_BLOOD_ASEReadCounter.table","NW_015090842.1:10258185",8,16,8
"TANGO6","s1324_SAT_M_BLOOD_ASEReadCounter.table","NW_015090842.1:10259267",13,18,5
"TANGO6","s1324_SAT_M_BLOOD_ASEReadCounter.table","NW_015090842.1:10260250",16,26,10
"TANGO6","s1324_SAT_M_BLOOD_ASEReadCounter.table","NW_015090842.1:10260979",10,23,13
"TANGO6","s1324_SAT_M_BLOOD_ASEReadCounter.table","NW_015090842.1:10261599",15,26,11
"TANGO6","s1324_SAT_M_BLOOD_ASEReadCounter.table","NW_015090842.1:10268425",33,44,11
"TANGO6","s1324_SAT_M_BLOOD_ASEReadCounter.table","NW_015090842.1:10269831",28,43,15
"TANGO6","s1324_SAT_M_BLOOD_ASEReadCounter.table","NW_015090842.1:10270813",21,30,9
"TANGO6","s1324_SAT_M_BLOOD_ASEReadCounter.table","NW_015090842.1:10273952",12,23,11
"TANGO6","s1324_SAT_M_BLOOD_ASEReadCounter.table","NW_015090842.1:10273970",16,27,11
"TANGO6","s1324_SAT_M_BLOOD_ASEReadCounter.table","NW_015090842.1:10274018",16,27,11
"TANGO6","s1324_SAT_M_BLOOD_ASEReadCounter.table","NW_015090842.1:10275974",11,19,8
"TANGO6","s1324_SAT_M_BLOOD_ASEReadCounter.table","NW_015090842.1:10275976",11,19,8
"TANGO6","s1324_SAT_M_BLOOD_ASEReadCounter.table","NW_015090842.1:10276123",3,13,10
"TANGO6","s1324_SAT_M_BLOOD_ASEReadCounter.table","NW_015090842.1:10276271",8,16,8
"TANGO6","s1324_SAT_M_BLOOD_ASEReadCounter.table","NW_015090842.1:10276272",8,16,8
"TANGO6","s1324_SAT_M_BLOOD_ASEReadCounter.table","NW_015090842.1:10276275",8,16,8
"TANGO6","s1324_SAT_M_BLOOD_ASEReadCounter.table","NW_015090842.1:10276278",8,16,8
"TANGO6","s1324_SAT_M_BLOOD_ASEReadCounter.table","NW_015090842.1:10276368",8,16,8
"TANGO6","s1324_SAT_M_BLOOD_ASEReadCounter.table","NW_015090842.1:10276373",7,16,9
"TANGO6","s1324_SAT_M_BLOOD_ASEReadCounter.table","NW_015090842.1:10276630",7,15,8
"TANGO6","s1324_SAT_M_BLOOD_ASEReadCounter.table","NW_015090842.1:10281498",9,16,7
"TANGO6","s1324_SAT_M_BLOOD_ASEReadCounter.table","NW_015090842.1:10282842",15,26,11
"TANGO6","s1324_SAT_M_BLOOD_ASEReadCounter.table","NW_015090842.1:10282863",12,23,11
"TANGO6","s1324_SAT_M_BLOOD_ASEReadCounter.table","NW_015090842.1:10282869",12,21,9
"TANGO6","s1324_SAT_M_BLOOD_ASEReadCounter.table","NW_015090842.1:10282903",16,27,11
"TANGO6","s1324_SAT_M_BLOOD_ASEReadCounter.table","NW_015090842.1:10283757",16,24,8
"TANGO6","s1324_SAT_M_BLOOD_ASEReadCounter.table","NW_015090842.1:10283785",9,17,8
"HAS3","s1324_SAT_M_BLOOD_ASEReadCounter.table","NW_015090842.1:10288266",1,1,0
"HAS3","s1324_SAT_M_BLOOD_ASEReadCounter.table","NW_015090842.1:10288274",1,1,0
"HAS3","s1324_SAT_M_BLOOD_ASEReadCounter.table","NW_015090842.1:10289469",3,3,0
"HAS3","s1324_SAT_M_BLOOD_ASEReadCounter.table","NW_015090842.1:10289708",1,3,2
"CHTF8","s1324_SAT_M_BLOOD_ASEReadCounter.table","NW_015090842.1:10291319",1,2,1
"CHTF8","s1324_SAT_M_BLOOD_ASEReadCounter.table","NW_015090842.1:10291342",1,2,1
"CHTF8","s1324_SAT_M_BLOOD_ASEReadCounter.table","NW_015090842.1:10291491",1,2,1
"CHTF8","s1324_SAT_M_BLOOD_ASEReadCounter.table","NW_015090842.1:10291520",1,4,3
"CHTF8","s1324_SAT_M_BLOOD_ASEReadCounter.table","NW_015090842.1:10291593",0,3,3
"CHTF8","s1324_SAT_M_BLOOD_ASEReadCounter.table","NW_015090842.1:10291600",0,2,2
"CHTF8","s1324_SAT_M_BLOOD_ASEReadCounter.table","NW_015090842.1:10291609",0,1,1
"CHTF8","s1324_SAT_M_BLOOD_ASEReadCounter.table","NW_015090842.1:10291648",1,1,0
"CHTF8","s1324_SAT_M_BLOOD_ASEReadCounter.table","NW_015090842.1:10291656",1,1,0
"CHTF8","s1324_SAT_M_BLOOD_ASEReadCounter.table","NW_015090842.1:10291675",1,1,0
"CHTF8","s1324_SAT_M_BLOOD_ASEReadCounter.table","NW_015090842.1:10291696",1,1,0
"CHTF8","s1324_SAT_M_BLOOD_ASEReadCounter.table","NW_015090842.1:10291714",1,1,0
"CHTF8","s1324_SAT_M_BLOOD_ASEReadCounter.table","NW_015090842.1:10291732",1,2,1
"CHTF8","s1324_SAT_M_BLOOD_ASEReadCounter.table","NW_015090842.1:10291755",1,2,1
"CHTF8","s1324_SAT_M_BLOOD_ASEReadCounter.table","NW_015090842.1:10291756",1,2,1
"CHTF8","s1324_SAT_M_BLOOD_ASEReadCounter.table","NW_015090842.1:10291758",1,2,1
"CHTF8","s1324_SAT_M_BLOOD_ASEReadCounter.table","NW_015090842.1:10291792",1,2,1
"CHTF8","s1324_SAT_M_BLOOD_ASEReadCounter.table","NW_015090842.1:10291895",1,5,4
"CHTF8","s1324_SAT_M_BLOOD_ASEReadCounter.table","NW_015090842.1:10292132",3,4,1
"CHTF8","s1324_SAT_M_BLOOD_ASEReadCounter.table","NW_015090842.1:10292314",3,3,0
"CHTF8","s1324_SAT_M_BLOOD_ASEReadCounter.table","NW_015090842.1:10292317",3,3,0
"CHTF8","s1324_SAT_M_BLOOD_ASEReadCounter.table","NW_015090842.1:10292928",0,1,1
"UTP4","s1324_SAT_M_BLOOD_ASEReadCounter.table","NW_015090842.1:10293146",4,12,8
"UTP4","s1324_SAT_M_BLOOD_ASEReadCounter.table","NW_015090842.1:10293151",4,12,8
"UTP4","s1324_SAT_M_BLOOD_ASEReadCounter.table","NW_015090842.1:10293191",2,9,7
"UTP4","s1324_SAT_M_BLOOD_ASEReadCounter.table","NW_015090842.1:10293362",3,9,6
"UTP4","s1324_SAT_M_BLOOD_ASEReadCounter.table","NW_015090842.1:10293430",4,9,5
"UTP4","s1324_SAT_M_BLOOD_ASEReadCounter.table","NW_015090842.1:10293625",4,8,4
"UTP4","s1324_SAT_M_BLOOD_ASEReadCounter.table","NW_015090842.1:10293684",5,7,2
"UTP4","s1324_SAT_M_BLOOD_ASEReadCounter.table","NW_015090842.1:10294093",1,6,5
"UTP4","s1324_SAT_M_BLOOD_ASEReadCounter.table","NW_015090842.1:10294568",4,9,5
"UTP4","s1324_SAT_M_BLOOD_ASEReadCounter.table","NW_015090842.1:10294622",4,11,7
"UTP4","s1324_SAT_M_BLOOD_ASEReadCounter.table","NW_015090842.1:10294632",4,9,5
"UTP4","s1324_SAT_M_BLOOD_ASEReadCounter.table","NW_015090842.1:10295238",4,7,3
"UTP4","s1324_SAT_M_BLOOD_ASEReadCounter.table","NW_015090842.1:10295880",5,7,2
"UTP4","s1324_SAT_M_BLOOD_ASEReadCounter.table","NW_015090842.1:10295884",5,8,3
"UTP4","s1324_SAT_M_BLOOD_ASEReadCounter.table","NW_015090842.1:10295903",5,7,2
"UTP4","s1324_SAT_M_BLOOD_ASEReadCounter.table","NW_015090842.1:10295906",5,7,2
"UTP4","s1324_SAT_M_BLOOD_ASEReadCounter.table","NW_015090842.1:10295915",5,7,2
"UTP4","s1324_SAT_M_BLOOD_ASEReadCounter.table","NW_015090842.1:10295938",5,9,4
"UTP4","s1324_SAT_M_BLOOD_ASEReadCounter.table","NW_015090842.1:10296175",2,5,3
"UTP4","s1324_SAT_M_BLOOD_ASEReadCounter.table","NW_015090842.1:10296660",4,7,3
"UTP4","s1324_SAT_M_BLOOD_ASEReadCounter.table","NW_015090842.1:10296679",3,7,4
"UTP4","s1324_SAT_M_BLOOD_ASEReadCounter.table","NW_015090842.1:10297193",6,9,3
"UTP4","s1324_SAT_M_BLOOD_ASEReadCounter.table","NW_015090842.1:10297220",6,9,3
"UTP4","s1324_SAT_M_BLOOD_ASEReadCounter.table","NW_015090842.1:10297307",3,5,2
"UTP4","s1324_SAT_M_BLOOD_ASEReadCounter.table","NW_015090842.1:10297558",4,10,6
"UTP4","s1324_SAT_M_BLOOD_ASEReadCounter.table","NW_015090842.1:10297943",3,6,3
"UTP4","s1324_SAT_M_BLOOD_ASEReadCounter.table","NW_015090842.1:10297979",3,5,2
"UTP4","s1324_SAT_M_BLOOD_ASEReadCounter.table","NW_015090842.1:10298022",3,5,2
"UTP4","s1324_SAT_M_BLOOD_ASEReadCounter.table","NW_015090842.1:10298079",0,2,2
"UTP4","s1324_SAT_M_BLOOD_ASEReadCounter.table","NW_015090842.1:10298081",0,2,2
"UTP4","s1324_SAT_M_BLOOD_ASEReadCounter.table","NW_015090842.1:10298082",0,2,2
"SNTB2","s1324_SAT_M_BLOOD_ASEReadCounter.table","NW_015090842.1:10304167",1,1,0
"SNTB2","s1324_SAT_M_BLOOD_ASEReadCounter.table","NW_015090842.1:10304176",1,1,0
"SNTB2","s1324_SAT_M_BLOOD_ASEReadCounter.table","NW_015090842.1:10305099",1,1,0
"SNTB2","s1324_SAT_M_BLOOD_ASEReadCounter.table","NW_015090842.1:10305451",2,2,0
"SNTB2","s1324_SAT_M_BLOOD_ASEReadCounter.table","NW_015090842.1:10306457",1,1,0
"VPS4A","s1324_SAT_M_BLOOD_ASEReadCounter.table","NW_015090842.1:10308566",78,229,151
"VPS4A","s1324_SAT_M_BLOOD_ASEReadCounter.table","NW_015090842.1:10308573",78,227,149
"VPS4A","s1324_SAT_M_BLOOD_ASEReadCounter.table","NW_015090842.1:10308856",113,338,225
"VPS4A","s1324_SAT_M_BLOOD_ASEReadCounter.table","NW_015090842.1:10309056",125,356,231
"VPS4A","s1324_SAT_M_BLOOD_ASEReadCounter.table","NW_015090842.1:10309089",146,383,237
"VPS4A","s1324_SAT_M_BLOOD_ASEReadCounter.table","NW_015090842.1:10309392",127,359,232
"VPS4A","s1324_SAT_M_BLOOD_ASEReadCounter.table","NW_015090842.1:10309413",132,375,243
"VPS4A","s1324_SAT_M_BLOOD_ASEReadCounter.table","NW_015090842.1:10309467",141,442,301
"VPS4A","s1324_SAT_M_BLOOD_ASEReadCounter.table","NW_015090842.1:10310230",148,432,284
"VPS4A","s1324_SAT_M_BLOOD_ASEReadCounter.table","NW_015090842.1:10310425",125,339,214
"VPS4A","s1324_SAT_M_BLOOD_ASEReadCounter.table","NW_015090842.1:10310639",156,394,238
"VPS4A","s1324_SAT_M_BLOOD_ASEReadCounter.table","NW_015090842.1:10310640",393,393,0
"VPS4A","s1324_SAT_M_BLOOD_ASEReadCounter.table","NW_015090842.1:10310687",173,411,238
"VPS4A","s1324_SAT_M_BLOOD_ASEReadCounter.table","NW_015090842.1:10310734",125,318,193
"VPS4A","s1324_SAT_M_BLOOD_ASEReadCounter.table","NW_015090842.1:10310737",122,315,193
"VPS4A","s1324_SAT_M_BLOOD_ASEReadCounter.table","NW_015090842.1:10310746",121,321,200
"VPS4A","s1324_SAT_M_BLOOD_ASEReadCounter.table","NW_015090842.1:10310767",123,324,201
"VPS4A","s1324_SAT_M_BLOOD_ASEReadCounter.table","NW_015090842.1:10310995",123,300,177
"VPS4A","s1324_SAT_M_BLOOD_ASEReadCounter.table","NW_015090842.1:10311004",125,291,166
"VPS4A","s1324_SAT_M_BLOOD_ASEReadCounter.table","NW_015090842.1:10311007",121,298,177
"VPS4A","s1324_SAT_M_BLOOD_ASEReadCounter.table","NW_015090842.1:10311013",128,310,182
"VPS4A","s1324_SAT_M_BLOOD_ASEReadCounter.table","NW_015090842.1:10311022",120,305,185
"VPS4A","s1324_SAT_M_BLOOD_ASEReadCounter.table","NW_015090842.1:10311023",120,299,179
"VPS4A","s1324_SAT_M_BLOOD_ASEReadCounter.table","NW_015090842.1:10311426",126,343,217
"VPS4A","s1324_SAT_M_BLOOD_ASEReadCounter.table","NW_015090842.1:10311489",2,5,3
"VPS4A","s1324_SAT_M_BLOOD_ASEReadCounter.table","NW_015090842.1:10311490",2,5,3
"VPS4A","s1324_SAT_M_BLOOD_ASEReadCounter.table","NW_015090842.1:10311525",1,8,7
"VPS4A","s1324_SAT_M_BLOOD_ASEReadCounter.table","NW_015090842.1:10311529",1,11,10
"VPS4A","s1324_SAT_M_BLOOD_ASEReadCounter.table","NW_015090842.1:10311530",1,11,10
"VPS4A","s1324_SAT_M_BLOOD_ASEReadCounter.table","NW_015090842.1:10311552",16,32,16
"VPS4A","s1324_SAT_M_BLOOD_ASEReadCounter.table","NW_015090842.1:10311689",9,21,12
"VPS4A","s1324_SAT_M_BLOOD_ASEReadCounter.table","NW_015090842.1:10311700",11,21,10
"VPS4A","s1324_SAT_M_BLOOD_ASEReadCounter.table","NW_015090842.1:10311701",11,22,11
"VPS4A","s1324_SAT_M_BLOOD_ASEReadCounter.table","NW_015090842.1:10311703",11,22,11
"COG8","s1324_SAT_M_BLOOD_ASEReadCounter.table","NW_015090842.1:10313487",3,3,0
"COG8","s1324_SAT_M_BLOOD_ASEReadCounter.table","NW_015090842.1:10313559",6,9,3
"COG8","s1324_SAT_M_BLOOD_ASEReadCounter.table","NW_015090842.1:10313579",5,9,4
"COG8","s1324_SAT_M_BLOOD_ASEReadCounter.table","NW_015090842.1:10313665",4,6,2
"COG8","s1324_SAT_M_BLOOD_ASEReadCounter.table","NW_015090842.1:10313681",5,9,4
"COG8","s1324_SAT_M_BLOOD_ASEReadCounter.table","NW_015090842.1:10313768",7,14,7
"COG8","s1324_SAT_M_BLOOD_ASEReadCounter.table","NW_015090842.1:10313775",7,14,7
"COG8","s1324_SAT_M_BLOOD_ASEReadCounter.table","NW_015090842.1:10313811",6,13,7
"COG8","s1324_SAT_M_BLOOD_ASEReadCounter.table","NW_015090842.1:10313858",5,14,9
"COG8","s1324_SAT_M_BLOOD_ASEReadCounter.table","NW_015090842.1:10313859",16,16,0
"COG8","s1324_SAT_M_BLOOD_ASEReadCounter.table","NW_015090842.1:10314100",3,13,10
"COG8","s1324_SAT_M_BLOOD_ASEReadCounter.table","NW_015090842.1:10314213",4,13,9
"COG8","s1324_SAT_M_BLOOD_ASEReadCounter.table","NW_015090842.1:10315093",4,8,4
"COG8","s1324_SAT_M_BLOOD_ASEReadCounter.table","NW_015090842.1:10315162",7,18,11
"COG8","s1324_SAT_M_BLOOD_ASEReadCounter.table","NW_015090842.1:10315285",4,23,19
"COG8","s1324_SAT_M_BLOOD_ASEReadCounter.table","NW_015090842.1:10315360",8,24,16
"COG8","s1324_SAT_M_BLOOD_ASEReadCounter.table","NW_015090842.1:10315369",8,24,16
"COG8","s1324_SAT_M_BLOOD_ASEReadCounter.table","NW_015090842.1:10315508",3,17,14
"COG8","s1324_SAT_M_BLOOD_ASEReadCounter.table","NW_015090842.1:10315624",8,23,15
"COG8","s1324_SAT_M_BLOOD_ASEReadCounter.table","NW_015090842.1:10315693",4,21,17
"COG8","s1324_SAT_M_BLOOD_ASEReadCounter.table","NW_015090842.1:10315698",5,22,17
"COG8","s1324_SAT_M_BLOOD_ASEReadCounter.table","NW_015090842.1:10315768",5,20,15
"COG8","s1324_SAT_M_BLOOD_ASEReadCounter.table","NW_015090842.1:10315769",5,20,15
"COG8","s1324_SAT_M_BLOOD_ASEReadCounter.table","NW_015090842.1:10315784",6,20,14
"COG8","s1324_SAT_M_BLOOD_ASEReadCounter.table","NW_015090842.1:10316093",6,13,7
"COG8","s1324_SAT_M_BLOOD_ASEReadCounter.table","NW_015090842.1:10316133",5,13,8
"NIP7","s1324_SAT_M_BLOOD_ASEReadCounter.table","NW_015090842.1:10316759",3,10,7
"NIP7","s1324_SAT_M_BLOOD_ASEReadCounter.table","NW_015090842.1:10316967",32,70,38
"NIP7","s1324_SAT_M_BLOOD_ASEReadCounter.table","NW_015090842.1:10316995",41,86,45
"NIP7","s1324_SAT_M_BLOOD_ASEReadCounter.table","NW_015090842.1:10317240",61,122,61
"NIP7","s1324_SAT_M_BLOOD_ASEReadCounter.table","NW_015090842.1:10317247",64,122,58
"NIP7","s1324_SAT_M_BLOOD_ASEReadCounter.table","NW_015090842.1:10317264",59,114,55
"NIP7","s1324_SAT_M_BLOOD_ASEReadCounter.table","NW_015090842.1:10317433",62,135,73
"NIP7","s1324_SAT_M_BLOOD_ASEReadCounter.table","NW_015090842.1:10317738",28,78,50
"NIP7","s1324_SAT_M_BLOOD_ASEReadCounter.table","NW_015090842.1:10317769",34,81,47
"NIP7","s1324_SAT_M_BLOOD_ASEReadCounter.table","NW_015090842.1:10317808",30,65,35
"NIP7","s1324_SAT_M_BLOOD_ASEReadCounter.table","NW_015090842.1:10317870",10,33,23
"NIP7","s1324_SAT_M_BLOOD_ASEReadCounter.table","NW_015090842.1:10317871",10,33,23
"NIP7","s1324_SAT_M_BLOOD_ASEReadCounter.table","NW_015090842.1:10317898",6,22,16
"NIP7","s1324_SAT_M_BLOOD_ASEReadCounter.table","NW_015090842.1:10317911",6,18,12
"TMED6","s1324_SAT_M_BLOOD_ASEReadCounter.table","NW_015090842.1:10318514",9,16,7
"TMED6","s1324_SAT_M_BLOOD_ASEReadCounter.table","NW_015090842.1:10318731",6,12,6
"TERF2","s1324_SAT_M_BLOOD_ASEReadCounter.table","NW_015090842.1:10321768",49,104,55
"TERF2","s1324_SAT_M_BLOOD_ASEReadCounter.table","NW_015090842.1:10321777",43,96,53
"TERF2","s1324_SAT_M_BLOOD_ASEReadCounter.table","NW_015090842.1:10321805",56,105,49
"TERF2","s1324_SAT_M_BLOOD_ASEReadCounter.table","NW_015090842.1:10321878",73,147,74
"TERF2","s1324_SAT_M_BLOOD_ASEReadCounter.table","NW_015090842.1:10321893",69,138,69
"TERF2","s1324_SAT_M_BLOOD_ASEReadCounter.table","NW_015090842.1:10321897",67,133,66
"TERF2","s1324_SAT_M_BLOOD_ASEReadCounter.table","NW_015090842.1:10321908",64,134,70
"TERF2","s1324_SAT_M_BLOOD_ASEReadCounter.table","NW_015090842.1:10322001",98,203,105
"TERF2","s1324_SAT_M_BLOOD_ASEReadCounter.table","NW_015090842.1:10322035",79,167,88
"TERF2","s1324_SAT_M_BLOOD_ASEReadCounter.table","NW_015090842.1:10322051",78,183,105
"TERF2","s1324_SAT_M_BLOOD_ASEReadCounter.table","NW_015090842.1:10322137",72,153,81
"TERF2","s1324_SAT_M_BLOOD_ASEReadCounter.table","NW_015090842.1:10322144",77,162,85
"TERF2","s1324_SAT_M_BLOOD_ASEReadCounter.table","NW_015090842.1:10322388",61,141,80
"TERF2","s1324_SAT_M_BLOOD_ASEReadCounter.table","NW_015090842.1:10322396",61,135,74
"TERF2","s1324_SAT_M_BLOOD_ASEReadCounter.table","NW_015090842.1:10322502",90,191,101
"TERF2","s1324_SAT_M_BLOOD_ASEReadCounter.table","NW_015090842.1:10322504",90,192,102
"TERF2","s1324_SAT_M_BLOOD_ASEReadCounter.table","NW_015090842.1:10322510",88,193,105
"TERF2","s1324_SAT_M_BLOOD_ASEReadCounter.table","NW_015090842.1:10323580",135,240,105
"TERF2","s1324_SAT_M_BLOOD_ASEReadCounter.table","NW_015090842.1:10324314",107,206,99
"TERF2","s1324_SAT_M_BLOOD_ASEReadCounter.table","NW_015090842.1:10326832",87,185,98
"TERF2","s1324_SAT_M_BLOOD_ASEReadCounter.table","NW_015090842.1:10327787",85,164,79
"TERF2","s1324_SAT_M_BLOOD_ASEReadCounter.table","NW_015090842.1:10328588",103,191,88
"TERF2","s1324_SAT_M_BLOOD_ASEReadCounter.table","NW_015090842.1:10328644",91,178,87
"TERF2","s1324_SAT_M_BLOOD_ASEReadCounter.table","NW_015090842.1:10329813",81,151,70
"TERF2","s1324_SAT_M_BLOOD_ASEReadCounter.table","NW_015090842.1:10330749",51,104,53
"TERF2","s1324_SAT_M_BLOOD_ASEReadCounter.table","NW_015090842.1:10330789",61,104,43
"CYB5B","s1324_SAT_M_BLOOD_ASEReadCounter.table","NW_015090842.1:10336667",0,1,1
"CYB5B","s1324_SAT_M_BLOOD_ASEReadCounter.table","NW_015090842.1:10336689",0,3,3
"CYB5B","s1324_SAT_M_BLOOD_ASEReadCounter.table","NW_015090842.1:10336728",2,6,4
"CYB5B","s1324_SAT_M_BLOOD_ASEReadCounter.table","NW_015090842.1:10345068",2,3,1
"CYB5B","s1324_SAT_M_BLOOD_ASEReadCounter.table","NW_015090842.1:10348800",3,4,1
"CYB5B","s1324_SAT_M_BLOOD_ASEReadCounter.table","NW_015090842.1:10349046",2,3,1
"CYB5B","s1324_SAT_M_BLOOD_ASEReadCounter.table","NW_015090842.1:10349119",1,2,1
"CYB5B","s1324_SAT_M_BLOOD_ASEReadCounter.table","NW_015090842.1:10349146",1,2,1
"CYB5B","s1324_SAT_M_BLOOD_ASEReadCounter.table","NW_015090842.1:10349157",1,3,2
"CYB5B","s1324_SAT_M_BLOOD_ASEReadCounter.table","NW_015090842.1:10349263",2,2,0
