"gene","id","snp","ref_count","total_count","alt_count"
"CENPN","s1321_S_GON_01_ASEReadCounter.table","NW_015090842.1:5801612",61,321,260
"CENPN","s1321_S_GON_01_ASEReadCounter.table","NW_015090842.1:5801618",145,416,271
"CENPN","s1321_S_GON_01_ASEReadCounter.table","NW_015090842.1:5801623",178,453,275
"CENPN","s1321_S_GON_01_ASEReadCounter.table","NW_015090842.1:5801631",234,508,274
"CENPN","s1321_S_GON_01_ASEReadCounter.table","NW_015090842.1:5801632",231,509,278
"CENPN","s1321_S_GON_01_ASEReadCounter.table","NW_015090842.1:5801655",229,452,223
"CENPN","s1321_S_GON_01_ASEReadCounter.table","NW_015090842.1:5801670",266,516,250
"CENPN","s1321_S_GON_01_ASEReadCounter.table","NW_015090842.1:5801674",265,517,252
"CENPN","s1321_S_GON_01_ASEReadCounter.table","NW_015090842.1:5801692",282,562,280
"CENPN","s1321_S_GON_01_ASEReadCounter.table","NW_015090842.1:5802008",327,951,624
"CENPN","s1321_S_GON_01_ASEReadCounter.table","NW_015090842.1:5802012",329,942,613
"CENPN","s1321_S_GON_01_ASEReadCounter.table","NW_015090842.1:5802087",429,1178,749
"CENPN","s1321_S_GON_01_ASEReadCounter.table","NW_015090842.1:5810113",26,37,11
"CENPN","s1321_S_GON_01_ASEReadCounter.table","NW_015090842.1:5810147",37,51,14
"CENPN","s1321_S_GON_01_ASEReadCounter.table","NW_015090842.1:5810148",37,51,14
"ATMIN","s1321_S_GON_01_ASEReadCounter.table","NW_015090842.1:5818789",32,45,13
"ATMIN","s1321_S_GON_01_ASEReadCounter.table","NW_015090842.1:5819958",26,43,17
"ATMIN","s1321_S_GON_01_ASEReadCounter.table","NW_015090842.1:5820004",24,45,21
"ATMIN","s1321_S_GON_01_ASEReadCounter.table","NW_015090842.1:5820217",20,31,11
"ATMIN","s1321_S_GON_01_ASEReadCounter.table","NW_015090842.1:5820250",26,36,10
"ATMIN","s1321_S_GON_01_ASEReadCounter.table","NW_015090842.1:5820298",22,33,11
"ATMIN","s1321_S_GON_01_ASEReadCounter.table","NW_015090842.1:5820417",13,22,9
"ATMIN","s1321_S_GON_01_ASEReadCounter.table","NW_015090842.1:5820421",13,24,11
"ATMIN","s1321_S_GON_01_ASEReadCounter.table","NW_015090842.1:5820448",14,26,12
"ATMIN","s1321_S_GON_01_ASEReadCounter.table","NW_015090842.1:5820457",11,24,13
"ATMIN","s1321_S_GON_01_ASEReadCounter.table","NW_015090842.1:5820510",10,22,12
"ATMIN","s1321_S_GON_01_ASEReadCounter.table","NW_015090842.1:5820673",13,25,12
"ATMIN","s1321_S_GON_01_ASEReadCounter.table","NW_015090842.1:5820754",12,23,11
"ATMIN","s1321_S_GON_01_ASEReadCounter.table","NW_015090842.1:5820820",11,27,16
"ATMIN","s1321_S_GON_01_ASEReadCounter.table","NW_015090842.1:5820865",17,34,17
"ATMIN","s1321_S_GON_01_ASEReadCounter.table","NW_015090842.1:5820889",18,32,14
"ATMIN","s1321_S_GON_01_ASEReadCounter.table","NW_015090842.1:5820891",18,32,14
"ATMIN","s1321_S_GON_01_ASEReadCounter.table","NW_015090842.1:5820997",20,36,16
"ATMIN","s1321_S_GON_01_ASEReadCounter.table","NW_015090842.1:5821063",22,36,14
"ATMIN","s1321_S_GON_01_ASEReadCounter.table","NW_015090842.1:5821132",22,31,9
"ATMIN","s1321_S_GON_01_ASEReadCounter.table","NW_015090842.1:5821645",25,41,16
"ATMIN","s1321_S_GON_01_ASEReadCounter.table","NW_015090842.1:5825066",11,33,22
"ATMIN","s1321_S_GON_01_ASEReadCounter.table","NW_015090842.1:5825106",18,48,30
"ATMIN","s1321_S_GON_01_ASEReadCounter.table","NW_015090842.1:5825122",19,46,27
"ATMIN","s1321_S_GON_01_ASEReadCounter.table","NW_015090842.1:5825178",26,57,31
"ATMIN","s1321_S_GON_01_ASEReadCounter.table","NW_015090842.1:5825194",27,58,31
"ATMIN","s1321_S_GON_01_ASEReadCounter.table","NW_015090842.1:5825195",26,57,31
"ATMIN","s1321_S_GON_01_ASEReadCounter.table","NW_015090842.1:5825220",25,61,36
"ATMIN","s1321_S_GON_01_ASEReadCounter.table","NW_015090842.1:5825240",26,57,31
"ATMIN","s1321_S_GON_01_ASEReadCounter.table","NW_015090842.1:5825303",30,73,43
"ATMIN","s1321_S_GON_01_ASEReadCounter.table","NW_015090842.1:5825304",31,76,45
"ATMIN","s1321_S_GON_01_ASEReadCounter.table","NW_015090842.1:5825310",33,75,42
"ATMIN","s1321_S_GON_01_ASEReadCounter.table","NW_015090842.1:5825406",28,69,41
"ATMIN","s1321_S_GON_01_ASEReadCounter.table","NW_015090842.1:5825415",28,69,41
"ATMIN","s1321_S_GON_01_ASEReadCounter.table","NW_015090842.1:5825438",32,68,36
"ATMIN","s1321_S_GON_01_ASEReadCounter.table","NW_015090842.1:5825485",25,64,39
"ATMIN","s1321_S_GON_01_ASEReadCounter.table","NW_015090842.1:5825524",27,60,33
"ATMIN","s1321_S_GON_01_ASEReadCounter.table","NW_015090842.1:5825557",28,56,28
"ATMIN","s1321_S_GON_01_ASEReadCounter.table","NW_015090842.1:5825571",32,56,24
"ATMIN","s1321_S_GON_01_ASEReadCounter.table","NW_015090842.1:5825579",32,54,22
"ATMIN","s1321_S_GON_01_ASEReadCounter.table","NW_015090842.1:5825590",32,51,19
"ATMIN","s1321_S_GON_01_ASEReadCounter.table","NW_015090842.1:5825689",27,60,33
"ATMIN","s1321_S_GON_01_ASEReadCounter.table","NW_015090842.1:5825703",36,71,35
"ATMIN","s1321_S_GON_01_ASEReadCounter.table","NW_015090842.1:5825787",35,61,26
"ATMIN","s1321_S_GON_01_ASEReadCounter.table","NW_015090842.1:5825833",33,67,34
"ATMIN","s1321_S_GON_01_ASEReadCounter.table","NW_015090842.1:5825841",26,60,34
"ATMIN","s1321_S_GON_01_ASEReadCounter.table","NW_015090842.1:5825895",30,63,33
"ATMIN","s1321_S_GON_01_ASEReadCounter.table","NW_015090842.1:5825984",21,52,31
"ATMIN","s1321_S_GON_01_ASEReadCounter.table","NW_015090842.1:5826162",32,64,32
"ATMIN","s1321_S_GON_01_ASEReadCounter.table","NW_015090842.1:5826194",35,76,41
"ATMIN","s1321_S_GON_01_ASEReadCounter.table","NW_015090842.1:5826235",38,84,46
"ATMIN","s1321_S_GON_01_ASEReadCounter.table","NW_015090842.1:5826245",39,88,49
"ATMIN","s1321_S_GON_01_ASEReadCounter.table","NW_015090842.1:5826335",18,47,29
"ATMIN","s1321_S_GON_01_ASEReadCounter.table","NW_015090842.1:5826417",28,58,30
"ATMIN","s1321_S_GON_01_ASEReadCounter.table","NW_015090842.1:5826431",23,62,39
"ATMIN","s1321_S_GON_01_ASEReadCounter.table","NW_015090842.1:5826438",24,56,32
"ATMIN","s1321_S_GON_01_ASEReadCounter.table","NW_015090842.1:5826463",30,62,32
"ATMIN","s1321_S_GON_01_ASEReadCounter.table","NW_015090842.1:5826502",26,66,40
"ATMIN","s1321_S_GON_01_ASEReadCounter.table","NW_015090842.1:5826511",26,65,39
"ATMIN","s1321_S_GON_01_ASEReadCounter.table","NW_015090842.1:5826659",23,58,35
"ATMIN","s1321_S_GON_01_ASEReadCounter.table","NW_015090842.1:5826701",35,71,36
"ATMIN","s1321_S_GON_01_ASEReadCounter.table","NW_015090842.1:5826702",35,71,36
"ATMIN","s1321_S_GON_01_ASEReadCounter.table","NW_015090842.1:5826732",36,74,38
"ATMIN","s1321_S_GON_01_ASEReadCounter.table","NW_015090842.1:5826745",35,73,38
"ATMIN","s1321_S_GON_01_ASEReadCounter.table","NW_015090842.1:5826835",45,86,41
"ATMIN","s1321_S_GON_01_ASEReadCounter.table","NW_015090842.1:5826910",34,71,37
"ATMIN","s1321_S_GON_01_ASEReadCounter.table","NW_015090842.1:5826942",22,66,44
"ATMIN","s1321_S_GON_01_ASEReadCounter.table","NW_015090842.1:5827193",38,72,34
"ATMIN","s1321_S_GON_01_ASEReadCounter.table","NW_015090842.1:5827196",36,73,37
"ATMIN","s1321_S_GON_01_ASEReadCounter.table","NW_015090842.1:5827269",39,75,36
"ATMIN","s1321_S_GON_01_ASEReadCounter.table","NW_015090842.1:5827315",23,56,33
"ATMIN","s1321_S_GON_01_ASEReadCounter.table","NW_015090842.1:5827316",23,56,33
"ATMIN","s1321_S_GON_01_ASEReadCounter.table","NW_015090842.1:5827333",25,58,33
"PPP1R3E","s1321_S_GON_01_ASEReadCounter.table","NW_015090842.1:5837733",12,22,10
"PPP1R3E","s1321_S_GON_01_ASEReadCounter.table","NW_015090842.1:5837947",7,20,13
"PKD1L2","s1321_S_GON_01_ASEReadCounter.table","NW_015090842.1:5867509",26,54,28
"PKD1L2","s1321_S_GON_01_ASEReadCounter.table","NW_015090842.1:5867597",36,81,45
"PKD1L2","s1321_S_GON_01_ASEReadCounter.table","NW_015090842.1:5867600",38,89,51
"PKD1L2","s1321_S_GON_01_ASEReadCounter.table","NW_015090842.1:5867660",40,88,48
"PKD1L2","s1321_S_GON_01_ASEReadCounter.table","NW_015090842.1:5867675",42,111,69
"PKD1L2","s1321_S_GON_01_ASEReadCounter.table","NW_015090842.1:5867788",37,103,66
"PKD1L2","s1321_S_GON_01_ASEReadCounter.table","NW_015090842.1:5867843",43,116,73
"PKD1L2","s1321_S_GON_01_ASEReadCounter.table","NW_015090842.1:5872948",1,6,5
"BCO1","s1321_S_GON_01_ASEReadCounter.table","NW_015090842.1:5915610",41,103,62
"BCO1","s1321_S_GON_01_ASEReadCounter.table","NW_015090842.1:5915646",38,103,65
"BCO1","s1321_S_GON_01_ASEReadCounter.table","NW_015090842.1:5917836",41,103,62
"BCO1","s1321_S_GON_01_ASEReadCounter.table","NW_015090842.1:5917912",43,84,41
"BCO1","s1321_S_GON_01_ASEReadCounter.table","NW_015090842.1:5917941",38,72,34
"BCO1","s1321_S_GON_01_ASEReadCounter.table","NW_015090842.1:5917971",52,90,38
"BCO1","s1321_S_GON_01_ASEReadCounter.table","NW_015090842.1:5921679",46,96,50
"BCO1","s1321_S_GON_01_ASEReadCounter.table","NW_015090842.1:5921726",50,94,44
"BCO1","s1321_S_GON_01_ASEReadCounter.table","NW_015090842.1:5925669",27,57,30
"BCO1","s1321_S_GON_01_ASEReadCounter.table","NW_015090842.1:5925753",36,77,41
"BCO1","s1321_S_GON_01_ASEReadCounter.table","NW_015090842.1:5926937",35,72,37
"BCO1","s1321_S_GON_01_ASEReadCounter.table","NW_015090842.1:5927921",48,91,43
"BCO1","s1321_S_GON_01_ASEReadCounter.table","NW_015090842.1:5927948",55,101,46
"BCO1","s1321_S_GON_01_ASEReadCounter.table","NW_015090842.1:5927968",50,85,35
"BCO1","s1321_S_GON_01_ASEReadCounter.table","NW_015090842.1:5928052",40,80,40
"BCO1","s1321_S_GON_01_ASEReadCounter.table","NW_015090842.1:5932726",59,116,57
"BCO1","s1321_S_GON_01_ASEReadCounter.table","NW_015090842.1:5932801",53,94,41
"BCO1","s1321_S_GON_01_ASEReadCounter.table","NW_015090842.1:5934558",30,66,36
"BCO1","s1321_S_GON_01_ASEReadCounter.table","NW_015090842.1:5934575",31,65,34
"BCO1","s1321_S_GON_01_ASEReadCounter.table","NW_015090842.1:5934608",39,75,36
"BCO1","s1321_S_GON_01_ASEReadCounter.table","NW_015090842.1:5934647",37,69,32
"BCO1","s1321_S_GON_01_ASEReadCounter.table","NW_015090842.1:5934725",22,53,31
"BCO1","s1321_S_GON_01_ASEReadCounter.table","NW_015090842.1:5934726",22,53,31
"BCO1","s1321_S_GON_01_ASEReadCounter.table","NW_015090842.1:5934733",20,44,24
"BCO1","s1321_S_GON_01_ASEReadCounter.table","NW_015090842.1:5934821",31,60,29
"BCO1","s1321_S_GON_01_ASEReadCounter.table","NW_015090842.1:5934826",33,64,31
"BCO1","s1321_S_GON_01_ASEReadCounter.table","NW_015090842.1:5934844",19,42,23
"BCO1","s1321_S_GON_01_ASEReadCounter.table","NW_015090842.1:5934958",39,67,28
"BCO1","s1321_S_GON_01_ASEReadCounter.table","NW_015090842.1:5934976",44,80,36
"GAN","s1321_S_GON_01_ASEReadCounter.table","NW_015090842.1:5953759",20,44,24
"GAN","s1321_S_GON_01_ASEReadCounter.table","NW_015090842.1:5957502",11,36,25
"GAN","s1321_S_GON_01_ASEReadCounter.table","NW_015090842.1:5957578",18,44,26
"GAN","s1321_S_GON_01_ASEReadCounter.table","NW_015090842.1:5965028",22,53,31
"GAN","s1321_S_GON_01_ASEReadCounter.table","NW_015090842.1:5966047",20,57,37
"GAN","s1321_S_GON_01_ASEReadCounter.table","NW_015090842.1:5966126",16,43,27
"GAN","s1321_S_GON_01_ASEReadCounter.table","NW_015090842.1:5966127",16,43,27
"GAN","s1321_S_GON_01_ASEReadCounter.table","NW_015090842.1:5966162",27,60,33
"GAN","s1321_S_GON_01_ASEReadCounter.table","NW_015090842.1:5966483",16,40,24
"CMIP","s1321_S_GON_01_ASEReadCounter.table","NW_015090842.1:6109159",44,61,17
"CMIP","s1321_S_GON_01_ASEReadCounter.table","NW_015090842.1:6109166",42,55,13
"CMIP","s1321_S_GON_01_ASEReadCounter.table","NW_015090842.1:6114641",41,64,23
"CMIP","s1321_S_GON_01_ASEReadCounter.table","NW_015090842.1:6114751",31,51,20
"CMIP","s1321_S_GON_01_ASEReadCounter.table","NW_015090842.1:6114824",31,47,16
"CMIP","s1321_S_GON_01_ASEReadCounter.table","NW_015090842.1:6128998",53,84,31
"CMIP","s1321_S_GON_01_ASEReadCounter.table","NW_015090842.1:6130562",61,110,49
"CMIP","s1321_S_GON_01_ASEReadCounter.table","NW_015090842.1:6132522",49,83,34
"CMIP","s1321_S_GON_01_ASEReadCounter.table","NW_015090842.1:6134088",51,89,38
"CMIP","s1321_S_GON_01_ASEReadCounter.table","NW_015090842.1:6138265",40,70,30
"CMIP","s1321_S_GON_01_ASEReadCounter.table","NW_015090842.1:6138300",44,75,31
"CMIP","s1321_S_GON_01_ASEReadCounter.table","NW_015090842.1:6138342",48,76,28
"CMIP","s1321_S_GON_01_ASEReadCounter.table","NW_015090842.1:6138343",46,74,28
"CMIP","s1321_S_GON_01_ASEReadCounter.table","NW_015090842.1:6138345",47,75,28
"CMIP","s1321_S_GON_01_ASEReadCounter.table","NW_015090842.1:6138647",43,67,24
"CMIP","s1321_S_GON_01_ASEReadCounter.table","NW_015090842.1:6138745",32,55,23
"CMIP","s1321_S_GON_01_ASEReadCounter.table","NW_015090842.1:6138832",9,16,7
"CMIP","s1321_S_GON_01_ASEReadCounter.table","NW_015090842.1:6138967",39,51,12
"CMIP","s1321_S_GON_01_ASEReadCounter.table","NW_015090842.1:6139131",25,38,13
"CMIP","s1321_S_GON_01_ASEReadCounter.table","NW_015090842.1:6139163",6,19,13
"CMIP","s1321_S_GON_01_ASEReadCounter.table","NW_015090842.1:6139360",10,16,6
"CMIP","s1321_S_GON_01_ASEReadCounter.table","NW_015090842.1:6139572",11,17,6
"CMIP","s1321_S_GON_01_ASEReadCounter.table","NW_015090842.1:6139773",22,35,13
"PLCG2","s1321_S_GON_01_ASEReadCounter.table","NW_015090842.1:6179613",4,6,2
"PLCG2","s1321_S_GON_01_ASEReadCounter.table","NW_015090842.1:6179658",9,11,2
"PLCG2","s1321_S_GON_01_ASEReadCounter.table","NW_015090842.1:6203766",10,17,7
"PLCG2","s1321_S_GON_01_ASEReadCounter.table","NW_015090842.1:6203775",7,13,6
"PLCG2","s1321_S_GON_01_ASEReadCounter.table","NW_015090842.1:6203787",9,15,6
"PLCG2","s1321_S_GON_01_ASEReadCounter.table","NW_015090842.1:6205047",23,30,7
"PLCG2","s1321_S_GON_01_ASEReadCounter.table","NW_015090842.1:6208541",25,35,10
"PLCG2","s1321_S_GON_01_ASEReadCounter.table","NW_015090842.1:6209741",13,26,13
"PLCG2","s1321_S_GON_01_ASEReadCounter.table","NW_015090842.1:6209798",13,25,12
"PLCG2","s1321_S_GON_01_ASEReadCounter.table","NW_015090842.1:6209816",11,23,12
"PLCG2","s1321_S_GON_01_ASEReadCounter.table","NW_015090842.1:6217547",18,30,12
"PLCG2","s1321_S_GON_01_ASEReadCounter.table","NW_015090842.1:6218641",20,28,8
"PLCG2","s1321_S_GON_01_ASEReadCounter.table","NW_015090842.1:6220552",19,37,18
"PLCG2","s1321_S_GON_01_ASEReadCounter.table","NW_015090842.1:6221969",23,36,13
"PLCG2","s1321_S_GON_01_ASEReadCounter.table","NW_015090842.1:6228672",10,19,9
"PLCG2","s1321_S_GON_01_ASEReadCounter.table","NW_015090842.1:6228694",9,18,9
"PLCG2","s1321_S_GON_01_ASEReadCounter.table","NW_015090842.1:6228722",10,23,13
"PLCG2","s1321_S_GON_01_ASEReadCounter.table","NW_015090842.1:6228747",5,22,17
"PLCG2","s1321_S_GON_01_ASEReadCounter.table","NW_015090842.1:6228835",10,21,11
"PLCG2","s1321_S_GON_01_ASEReadCounter.table","NW_015090842.1:6228841",11,22,11
"PLCG2","s1321_S_GON_01_ASEReadCounter.table","NW_015090842.1:6228865",10,19,9
"PLCG2","s1321_S_GON_01_ASEReadCounter.table","NW_015090842.1:6228917",18,31,13
"PLCG2","s1321_S_GON_01_ASEReadCounter.table","NW_015090842.1:6228926",17,31,14
"PLCG2","s1321_S_GON_01_ASEReadCounter.table","NW_015090842.1:6228954",17,27,10
"PLCG2","s1321_S_GON_01_ASEReadCounter.table","NW_015090842.1:6229002",17,28,11
"PLCG2","s1321_S_GON_01_ASEReadCounter.table","NW_015090842.1:6229006",16,28,12
"PLCG2","s1321_S_GON_01_ASEReadCounter.table","NW_015090842.1:6229081",14,21,7
"PLCG2","s1321_S_GON_01_ASEReadCounter.table","NW_015090842.1:6229097",12,17,5
"PLCG2","s1321_S_GON_01_ASEReadCounter.table","NW_015090842.1:6229160",10,16,6
"PLCG2","s1321_S_GON_01_ASEReadCounter.table","NW_015090842.1:6229213",13,20,7
"PLCG2","s1321_S_GON_01_ASEReadCounter.table","NW_015090842.1:6229231",19,25,6
"PLCG2","s1321_S_GON_01_ASEReadCounter.table","NW_015090842.1:6229663",18,22,4
"PLCG2","s1321_S_GON_01_ASEReadCounter.table","NW_015090842.1:6229748",12,18,6
"PLCG2","s1321_S_GON_01_ASEReadCounter.table","NW_015090842.1:6229892",28,33,5
"PLCG2","s1321_S_GON_01_ASEReadCounter.table","NW_015090842.1:6230248",27,29,2
"PLCG2","s1321_S_GON_01_ASEReadCounter.table","NW_015090842.1:6230255",26,28,2
"PLCG2","s1321_S_GON_01_ASEReadCounter.table","NW_015090842.1:6230296",13,15,2
"PLCG2","s1321_S_GON_01_ASEReadCounter.table","NW_015090842.1:6230349",19,24,5
"PLCG2","s1321_S_GON_01_ASEReadCounter.table","NW_015090842.1:6230381",23,27,4
"PLCG2","s1321_S_GON_01_ASEReadCounter.table","NW_015090842.1:6230408",30,35,5
"PLCG2","s1321_S_GON_01_ASEReadCounter.table","NW_015090842.1:6230439",26,31,5
"PLCG2","s1321_S_GON_01_ASEReadCounter.table","NW_015090842.1:6230757",4,5,1
"PLCG2","s1321_S_GON_01_ASEReadCounter.table","NW_015090842.1:6230758",3,4,1
"PLCG2","s1321_S_GON_01_ASEReadCounter.table","NW_015090842.1:6230898",30,31,1
"PLCG2","s1321_S_GON_01_ASEReadCounter.table","NW_015090842.1:6230976",19,21,2
"PLCG2","s1321_S_GON_01_ASEReadCounter.table","NW_015090842.1:6231078",30,36,6
"PLCG2","s1321_S_GON_01_ASEReadCounter.table","NW_015090842.1:6231138",28,35,7
"PLCG2","s1321_S_GON_01_ASEReadCounter.table","NW_015090842.1:6231177",24,29,5
"PLCG2","s1321_S_GON_01_ASEReadCounter.table","NW_015090842.1:6231263",25,30,5
"PLCG2","s1321_S_GON_01_ASEReadCounter.table","NW_015090842.1:6231309",13,17,4
"SDR42E1","s1321_S_GON_01_ASEReadCounter.table","NW_015090842.1:6235292",9,23,14
"SDR42E1","s1321_S_GON_01_ASEReadCounter.table","NW_015090842.1:6235315",10,34,24
"SDR42E1","s1321_S_GON_01_ASEReadCounter.table","NW_015090842.1:6235348",24,60,36
"SDR42E1","s1321_S_GON_01_ASEReadCounter.table","NW_015090842.1:6235355",27,63,36
"SDR42E1","s1321_S_GON_01_ASEReadCounter.table","NW_015090842.1:6235417",37,91,54
"SDR42E1","s1321_S_GON_01_ASEReadCounter.table","NW_015090842.1:6235526",119,119,0
"SDR42E1","s1321_S_GON_01_ASEReadCounter.table","NW_015090842.1:6235558",38,90,52
"SDR42E1","s1321_S_GON_01_ASEReadCounter.table","NW_015090842.1:6235603",110,110,0
"SDR42E1","s1321_S_GON_01_ASEReadCounter.table","NW_015090842.1:6235741",78,150,72
"SDR42E1","s1321_S_GON_01_ASEReadCounter.table","NW_015090842.1:6235777",73,152,79
"SDR42E1","s1321_S_GON_01_ASEReadCounter.table","NW_015090842.1:6235806",79,160,81
"SDR42E1","s1321_S_GON_01_ASEReadCounter.table","NW_015090842.1:6235809",78,159,81
"SDR42E1","s1321_S_GON_01_ASEReadCounter.table","NW_015090842.1:6235816",75,153,78
"SDR42E1","s1321_S_GON_01_ASEReadCounter.table","NW_015090842.1:6235914",53,116,63
"SDR42E1","s1321_S_GON_01_ASEReadCounter.table","NW_015090842.1:6235935",58,125,67
"SDR42E1","s1321_S_GON_01_ASEReadCounter.table","NW_015090842.1:6235957",56,123,67
"SDR42E1","s1321_S_GON_01_ASEReadCounter.table","NW_015090842.1:6236040",39,87,48
"SDR42E1","s1321_S_GON_01_ASEReadCounter.table","NW_015090842.1:6236260",58,105,47
"SDR42E1","s1321_S_GON_01_ASEReadCounter.table","NW_015090842.1:6236281",60,108,48
"SDR42E1","s1321_S_GON_01_ASEReadCounter.table","NW_015090842.1:6236305",63,113,50
"SDR42E1","s1321_S_GON_01_ASEReadCounter.table","NW_015090842.1:6236458",59,102,43
"SDR42E1","s1321_S_GON_01_ASEReadCounter.table","NW_015090842.1:6236476",66,115,49
"SDR42E1","s1321_S_GON_01_ASEReadCounter.table","NW_015090842.1:6236608",76,131,55
"SDR42E1","s1321_S_GON_01_ASEReadCounter.table","NW_015090842.1:6238244",44,88,44
"SDR42E1","s1321_S_GON_01_ASEReadCounter.table","NW_015090842.1:6238829",27,48,21
"HSD17B2","s1321_S_GON_01_ASEReadCounter.table","NW_015090842.1:6257670",1,1,0
"HSD17B2","s1321_S_GON_01_ASEReadCounter.table","NW_015090842.1:6257684",2,2,0
"HSD17B2","s1321_S_GON_01_ASEReadCounter.table","NW_015090842.1:6257829",1,2,1
"HSD17B2","s1321_S_GON_01_ASEReadCounter.table","NW_015090842.1:6262951",1,5,4
"HSD17B2","s1321_S_GON_01_ASEReadCounter.table","NW_015090842.1:6262974",3,8,5
"HSD17B2","s1321_S_GON_01_ASEReadCounter.table","NW_015090842.1:6266125",7,12,5
"HSD17B2","s1321_S_GON_01_ASEReadCounter.table","NW_015090842.1:6266135",7,12,5
"HSD17B2","s1321_S_GON_01_ASEReadCounter.table","NW_015090842.1:6266795",6,10,4
"HSD17B2","s1321_S_GON_01_ASEReadCounter.table","NW_015090842.1:6266918",2,4,2
"HSD17B2","s1321_S_GON_01_ASEReadCounter.table","NW_015090842.1:6266944",2,6,4
"HSD17B2","s1321_S_GON_01_ASEReadCounter.table","NW_015090842.1:6266997",4,7,3
"HSD17B2","s1321_S_GON_01_ASEReadCounter.table","NW_015090842.1:6267053",5,8,3
"HSD17B2","s1321_S_GON_01_ASEReadCounter.table","NW_015090842.1:6267196",1,5,4
"HSD17B2","s1321_S_GON_01_ASEReadCounter.table","NW_015090842.1:6267273",2,9,7
"HSD17B2","s1321_S_GON_01_ASEReadCounter.table","NW_015090842.1:6267358",4,14,10
"HSD17B2","s1321_S_GON_01_ASEReadCounter.table","NW_015090842.1:6267674",3,4,1
"HSD17B2","s1321_S_GON_01_ASEReadCounter.table","NW_015090842.1:6267913",4,7,3
"HSD17B2","s1321_S_GON_01_ASEReadCounter.table","NW_015090842.1:6268098",3,8,5
"HSD17B2","s1321_S_GON_01_ASEReadCounter.table","NW_015090842.1:6268180",8,8,0
"HSD17B2","s1321_S_GON_01_ASEReadCounter.table","NW_015090842.1:6268203",4,13,9
"ARY2","s1321_S_GON_01_ASEReadCounter.table","NW_015090842.1:6303922",26,26,0
"ARY2","s1321_S_GON_01_ASEReadCounter.table","NW_015090842.1:6303954",30,30,0
"ARY2","s1321_S_GON_01_ASEReadCounter.table","NW_015090842.1:6303979",28,28,0
"ARY2","s1321_S_GON_01_ASEReadCounter.table","NW_015090842.1:6305848",23,24,1
"ARY2","s1321_S_GON_01_ASEReadCounter.table","NW_015090842.1:6305856",22,24,2
"ARY2","s1321_S_GON_01_ASEReadCounter.table","NW_015090842.1:6305857",22,24,2
"ARY2","s1321_S_GON_01_ASEReadCounter.table","NW_015090842.1:6306017",23,23,0
"ARY2","s1321_S_GON_01_ASEReadCounter.table","NW_015090842.1:6306052",25,25,0
"ARY2","s1321_S_GON_01_ASEReadCounter.table","NW_015090842.1:6306094",25,26,1
"ARY2","s1321_S_GON_01_ASEReadCounter.table","NW_015090842.1:6306100",26,27,1
"ARY2","s1321_S_GON_01_ASEReadCounter.table","NW_015090842.1:6306146",21,25,4
"ARY2","s1321_S_GON_01_ASEReadCounter.table","NW_015090842.1:6306147",22,26,4
"ARY2","s1321_S_GON_01_ASEReadCounter.table","NW_015090842.1:6306390",22,24,2
"ARY2","s1321_S_GON_01_ASEReadCounter.table","NW_015090842.1:6306567",10,12,2
"ARY2","s1321_S_GON_01_ASEReadCounter.table","NW_015090842.1:6306705",0,1,1
"ARY2","s1321_S_GON_01_ASEReadCounter.table","NW_015090842.1:6306713",1,1,0
"ARY2","s1321_S_GON_01_ASEReadCounter.table","NW_015090842.1:6306773",0,1,1
"ARY2","s1321_S_GON_01_ASEReadCounter.table","NW_015090842.1:6307039",1,1,0
"ARY2","s1321_S_GON_01_ASEReadCounter.table","NW_015090842.1:6307043",1,1,0
"ARY2","s1321_S_GON_01_ASEReadCounter.table","NW_015090842.1:6307093",1,1,0
"ARY2","s1321_S_GON_01_ASEReadCounter.table","NW_015090842.1:6307157",1,2,1
"ARY2","s1321_S_GON_01_ASEReadCounter.table","NW_015090842.1:6307187",1,2,1
"ARY2","s1321_S_GON_01_ASEReadCounter.table","NW_015090842.1:6307278",1,2,1
"ARY2","s1321_S_GON_01_ASEReadCounter.table","NW_015090842.1:6307305",1,2,1
"ARY2","s1321_S_GON_01_ASEReadCounter.table","NW_015090842.1:6307318",0,1,1
"ARY2","s1321_S_GON_01_ASEReadCounter.table","NW_015090842.1:6307429",2,3,1
"ARYL","s1321_S_GON_01_ASEReadCounter.table","NW_015090842.1:6313360",6,14,8
"ARYL","s1321_S_GON_01_ASEReadCounter.table","NW_015090842.1:6313377",8,16,8
"ARYL","s1321_S_GON_01_ASEReadCounter.table","NW_015090842.1:6313767",6,10,4
"ARY1","s1321_S_GON_01_ASEReadCounter.table","NW_015090842.1:6313909",7,7,0
"ARY1","s1321_S_GON_01_ASEReadCounter.table","NW_015090842.1:6314296",6,8,2
"ARY1","s1321_S_GON_01_ASEReadCounter.table","NW_015090842.1:6314541",12,14,2
"ARY1","s1321_S_GON_01_ASEReadCounter.table","NW_015090842.1:6314597",12,12,0
"ARY1","s1321_S_GON_01_ASEReadCounter.table","NW_015090842.1:6314750",5,10,5
"ARY1","s1321_S_GON_01_ASEReadCounter.table","NW_015090842.1:6314794",7,13,6
"ARY1","s1321_S_GON_01_ASEReadCounter.table","NW_015090842.1:6314827",10,18,8
"ARY1","s1321_S_GON_01_ASEReadCounter.table","NW_015090842.1:6314843",18,18,0
"ARY1","s1321_S_GON_01_ASEReadCounter.table","NW_015090842.1:6314859",11,23,12
"ARY1","s1321_S_GON_01_ASEReadCounter.table","NW_015090842.1:6314886",9,21,12
"ARY1","s1321_S_GON_01_ASEReadCounter.table","NW_015090842.1:6314943",11,11,0
"ARY1","s1321_S_GON_01_ASEReadCounter.table","NW_015090842.1:6314949",9,9,0
"ARY1","s1321_S_GON_01_ASEReadCounter.table","NW_015090842.1:6315022",4,13,9
"ARY1","s1321_S_GON_01_ASEReadCounter.table","NW_015090842.1:6315026",4,13,9
"ARY1","s1321_S_GON_01_ASEReadCounter.table","NW_015090842.1:6315043",4,13,9
"ARY1","s1321_S_GON_01_ASEReadCounter.table","NW_015090842.1:6315065",5,14,9
"ARY1","s1321_S_GON_01_ASEReadCounter.table","NW_015090842.1:6315409",3,14,11
"ARY1","s1321_S_GON_01_ASEReadCounter.table","NW_015090842.1:6315479",8,15,7
"ARY1","s1321_S_GON_01_ASEReadCounter.table","NW_015090842.1:6318342",8,14,6
"ARY1","s1321_S_GON_01_ASEReadCounter.table","NW_015090842.1:6318427",15,26,11
"ARY1","s1321_S_GON_01_ASEReadCounter.table","NW_015090842.1:6318603",8,14,6
"ARY1","s1321_S_GON_01_ASEReadCounter.table","NW_015090842.1:6318708",10,12,2
"ARY1","s1321_S_GON_01_ASEReadCounter.table","NW_015090842.1:6318858",14,22,8
"ARY1","s1321_S_GON_01_ASEReadCounter.table","NW_015090842.1:6318952",12,20,8
"MPHOSPH6","s1321_S_GON_01_ASEReadCounter.table","NW_015090842.1:6324063",20,44,24
"MPHOSPH6","s1321_S_GON_01_ASEReadCounter.table","NW_015090842.1:6324174",34,65,31
"MPHOSPH6","s1321_S_GON_01_ASEReadCounter.table","NW_015090842.1:6324270",43,97,54
"MPHOSPH6","s1321_S_GON_01_ASEReadCounter.table","NW_015090842.1:6324762",51,103,52
"MPHOSPH6","s1321_S_GON_01_ASEReadCounter.table","NW_015090842.1:6324772",46,93,47
"MPHOSPH6","s1321_S_GON_01_ASEReadCounter.table","NW_015090842.1:6324780",41,88,47
"MPHOSPH6","s1321_S_GON_01_ASEReadCounter.table","NW_015090842.1:6324902",45,100,55
"MPHOSPH6","s1321_S_GON_01_ASEReadCounter.table","NW_015090842.1:6324910",98,98,0
"MPHOSPH6","s1321_S_GON_01_ASEReadCounter.table","NW_015090842.1:6325066",44,104,60
"MPHOSPH6","s1321_S_GON_01_ASEReadCounter.table","NW_015090842.1:6325089",49,123,74
"MPHOSPH6","s1321_S_GON_01_ASEReadCounter.table","NW_015090842.1:6325298",94,203,109
"MPHOSPH6","s1321_S_GON_01_ASEReadCounter.table","NW_015090842.1:6325877",89,194,105
"MPHOSPH6","s1321_S_GON_01_ASEReadCounter.table","NW_015090842.1:6326976",69,154,85
"CDH13","s1321_S_GON_01_ASEReadCounter.table","NW_015090842.1:6662283",6,15,9
"CDH13","s1321_S_GON_01_ASEReadCounter.table","NW_015090842.1:6693665",11,20,9
"CDH13","s1321_S_GON_01_ASEReadCounter.table","NW_015090842.1:6693697",12,17,5
"CDH13","s1321_S_GON_01_ASEReadCounter.table","NW_015090842.1:6693712",11,18,7
"CDH13","s1321_S_GON_01_ASEReadCounter.table","NW_015090842.1:6693723",11,18,7
"CDH13","s1321_S_GON_01_ASEReadCounter.table","NW_015090842.1:6693738",7,13,6
"CDH13","s1321_S_GON_01_ASEReadCounter.table","NW_015090842.1:6823730",18,27,9
"CDH13","s1321_S_GON_01_ASEReadCounter.table","NW_015090842.1:6889713",23,35,12
"CDH13","s1321_S_GON_01_ASEReadCounter.table","NW_015090842.1:6955167",21,30,9
"MLYCD","s1321_S_GON_01_ASEReadCounter.table","NW_015090842.1:7150054",23,49,26
"MLYCD","s1321_S_GON_01_ASEReadCounter.table","NW_015090842.1:7150131",53,100,47
"MLYCD","s1321_S_GON_01_ASEReadCounter.table","NW_015090842.1:7150585",41,83,42
"MLYCD","s1321_S_GON_01_ASEReadCounter.table","NW_015090842.1:7150686",20,48,28
"MLYCD","s1321_S_GON_01_ASEReadCounter.table","NW_015090842.1:7150696",30,61,31
"MLYCD","s1321_S_GON_01_ASEReadCounter.table","NW_015090842.1:7150698",62,62,0
"MLYCD","s1321_S_GON_01_ASEReadCounter.table","NW_015090842.1:7150869",24,60,36
"MLYCD","s1321_S_GON_01_ASEReadCounter.table","NW_015090842.1:7151100",43,89,46
"MLYCD","s1321_S_GON_01_ASEReadCounter.table","NW_015090842.1:7151127",40,89,49
"MLYCD","s1321_S_GON_01_ASEReadCounter.table","NW_015090842.1:7157538",35,76,41
"MLYCD","s1321_S_GON_01_ASEReadCounter.table","NW_015090842.1:7167662",12,43,31
"MLYCD","s1321_S_GON_01_ASEReadCounter.table","NW_015090842.1:7167675",13,45,32
"MLYCD","s1321_S_GON_01_ASEReadCounter.table","NW_015090842.1:7167710",11,37,26
"MLYCD","s1321_S_GON_01_ASEReadCounter.table","NW_015090842.1:7167781",21,34,13
"MLYCD","s1321_S_GON_01_ASEReadCounter.table","NW_015090842.1:7167803",16,27,11
"MLYCD","s1321_S_GON_01_ASEReadCounter.table","NW_015090842.1:7167812",15,27,12
"MLYCD","s1321_S_GON_01_ASEReadCounter.table","NW_015090842.1:7167845",13,31,18
"MLYCD","s1321_S_GON_01_ASEReadCounter.table","NW_015090842.1:7167862",13,29,16
"MLYCD","s1321_S_GON_01_ASEReadCounter.table","NW_015090842.1:7167929",8,23,15
"MLYCD","s1321_S_GON_01_ASEReadCounter.table","NW_015090842.1:7167995",7,25,18
"MLYCD","s1321_S_GON_01_ASEReadCounter.table","NW_015090842.1:7168005",9,29,20
"MLYCD","s1321_S_GON_01_ASEReadCounter.table","NW_015090842.1:7168037",8,26,18
"HSBP1","s1321_S_GON_01_ASEReadCounter.table","NW_015090842.1:7245192",137,231,94
"HSBP1","s1321_S_GON_01_ASEReadCounter.table","NW_015090842.1:7245226",165,304,139
"HSBP1","s1321_S_GON_01_ASEReadCounter.table","NW_015090842.1:7245257",138,269,131
"HSBP1","s1321_S_GON_01_ASEReadCounter.table","NW_015090842.1:7245296",127,270,143
"HSBP1","s1321_S_GON_01_ASEReadCounter.table","NW_015090842.1:7245389",183,341,158
"HSBP1","s1321_S_GON_01_ASEReadCounter.table","NW_015090842.1:7245400",190,339,149
"HSBP1","s1321_S_GON_01_ASEReadCounter.table","NW_015090842.1:7245445",176,312,136
"HSBP1","s1321_S_GON_01_ASEReadCounter.table","NW_015090842.1:7245495",164,299,135
"HSBP1","s1321_S_GON_01_ASEReadCounter.table","NW_015090842.1:7245515",192,330,138
"HSBP1","s1321_S_GON_01_ASEReadCounter.table","NW_015090842.1:7245733",119,222,103
"HSBP1","s1321_S_GON_01_ASEReadCounter.table","NW_015090842.1:7245771",152,262,110
"HSBP1","s1321_S_GON_01_ASEReadCounter.table","NW_015090842.1:7245813",153,265,112
"HSBP1","s1321_S_GON_01_ASEReadCounter.table","NW_015090842.1:7245926",189,319,130
"HSBP1","s1321_S_GON_01_ASEReadCounter.table","NW_015090842.1:7245927",186,313,127
"HSBP1","s1321_S_GON_01_ASEReadCounter.table","NW_015090842.1:7245933",186,309,123
"HSBP1","s1321_S_GON_01_ASEReadCounter.table","NW_015090842.1:7246002",137,252,115
"HSBP1","s1321_S_GON_01_ASEReadCounter.table","NW_015090842.1:7246094",191,324,133
"HSBP1","s1321_S_GON_01_ASEReadCounter.table","NW_015090842.1:7246167",176,306,130
"HSBP1","s1321_S_GON_01_ASEReadCounter.table","NW_015090842.1:7246183",162,294,132
"HSBP1","s1321_S_GON_01_ASEReadCounter.table","NW_015090842.1:7247285",38,52,14
"HSBP1","s1321_S_GON_01_ASEReadCounter.table","NW_015090842.1:7247651",334,771,437
"HSBP1","s1321_S_GON_01_ASEReadCounter.table","NW_015090842.1:7247657",345,781,436
"HSBP1","s1321_S_GON_01_ASEReadCounter.table","NW_015090842.1:7248520",259,544,285
"HSBP1","s1321_S_GON_01_ASEReadCounter.table","NW_015090842.1:7248535",228,460,232
"KCNG4","s1321_S_GON_01_ASEReadCounter.table","NW_015090842.1:7282481",14,65,51
"KCNG4","s1321_S_GON_01_ASEReadCounter.table","NW_015090842.1:7282500",10,56,46
"KCNG4","s1321_S_GON_01_ASEReadCounter.table","NW_015090842.1:7282542",17,50,33
"KCNG4","s1321_S_GON_01_ASEReadCounter.table","NW_015090842.1:7282579",19,52,33
"KCNG4","s1321_S_GON_01_ASEReadCounter.table","NW_015090842.1:7282630",19,64,45
"KCNG4","s1321_S_GON_01_ASEReadCounter.table","NW_015090842.1:7282760",20,43,23
"KCNG4","s1321_S_GON_01_ASEReadCounter.table","NW_015090842.1:7283056",15,48,33
"KCNG4","s1321_S_GON_01_ASEReadCounter.table","NW_015090842.1:7283245",17,46,29
"KCNG4","s1321_S_GON_01_ASEReadCounter.table","NW_015090842.1:7299491",19,49,30
"KCNG4","s1321_S_GON_01_ASEReadCounter.table","NW_015090842.1:7301195",11,34,23
"KCNG4","s1321_S_GON_01_ASEReadCounter.table","NW_015090842.1:7301227",8,37,29
"KCNG4","s1321_S_GON_01_ASEReadCounter.table","NW_015090842.1:7301240",10,38,28
"KCNG4","s1321_S_GON_01_ASEReadCounter.table","NW_015090842.1:7301413",16,37,21
"WFDC1","s1321_S_GON_01_ASEReadCounter.table","NW_015090842.1:7366517",4,6,2
"ATP2C2","s1321_S_GON_01_ASEReadCounter.table","NW_015090842.1:7413747",0,1,1
"TLDC1","s1321_S_GON_01_ASEReadCounter.table","NW_015090842.1:7421997",23,44,21
"COTL1","s1321_S_GON_01_ASEReadCounter.table","NW_015090842.1:7490707",5,17,12
"COTL1","s1321_S_GON_01_ASEReadCounter.table","NW_015090842.1:7490708",5,17,12
"COTL1","s1321_S_GON_01_ASEReadCounter.table","NW_015090842.1:7490711",5,17,12
"COTL1","s1321_S_GON_01_ASEReadCounter.table","NW_015090842.1:7490739",5,13,8
"COTL1","s1321_S_GON_01_ASEReadCounter.table","NW_015090842.1:7490785",6,11,5
"COTL1","s1321_S_GON_01_ASEReadCounter.table","NW_015090842.1:7490820",0,5,5
"COTL1","s1321_S_GON_01_ASEReadCounter.table","NW_015090842.1:7490846",8,8,0
"COTL1","s1321_S_GON_01_ASEReadCounter.table","NW_015090842.1:7505571",0,8,8
"KLHL36","s1321_S_GON_01_ASEReadCounter.table","NW_015090842.1:7526337",5,10,5
"KLHL36","s1321_S_GON_01_ASEReadCounter.table","NW_015090842.1:7537681",14,14,0
"USP10","s1321_S_GON_01_ASEReadCounter.table","NW_015090842.1:7572213",31,70,39
"USP10","s1321_S_GON_01_ASEReadCounter.table","NW_015090842.1:7572358",51,51,0
"CRISPLD2","s1321_S_GON_01_ASEReadCounter.table","NW_015090842.1:7619796",13,31,18
"CRISPLD2","s1321_S_GON_01_ASEReadCounter.table","NW_015090842.1:7630779",16,16,0
"CRISPLD2","s1321_S_GON_01_ASEReadCounter.table","NW_015090842.1:7633611",32,32,0
"CRISPLD2","s1321_S_GON_01_ASEReadCounter.table","NW_015090842.1:7633787",15,31,16
"CRISPLD2","s1321_S_GON_01_ASEReadCounter.table","NW_015090842.1:7634023",9,22,13
"CRISPLD2","s1321_S_GON_01_ASEReadCounter.table","NW_015090842.1:7634620",30,30,0
"CRISPLD2","s1321_S_GON_01_ASEReadCounter.table","NW_015090842.1:7636315",2,4,2
"LOC106888312","s1321_S_GON_01_ASEReadCounter.table","NW_015090842.1:7732198",12,12,0
"MTHFSD","s1321_S_GON_01_ASEReadCounter.table","NW_015090842.1:8152578",62,126,64
"EMC8","s1321_S_GON_01_ASEReadCounter.table","NW_015090842.1:8452385",19,32,13
"GINS2","s1321_S_GON_01_ASEReadCounter.table","NW_015090842.1:8467469",317,318,1
"GINS2","s1321_S_GON_01_ASEReadCounter.table","NW_015090842.1:8470290",247,544,297
"GINS2","s1321_S_GON_01_ASEReadCounter.table","NW_015090842.1:8470305",236,540,304
"GINS2","s1321_S_GON_01_ASEReadCounter.table","NW_015090842.1:8470376",253,550,297
"GINS2","s1321_S_GON_01_ASEReadCounter.table","NW_015090842.1:8471057",34,62,28
"KIAA0513","s1321_S_GON_01_ASEReadCounter.table","NW_015090842.1:8674736",27,27,0
"KIAA0513","s1321_S_GON_01_ASEReadCounter.table","NW_015090842.1:8687268",0,1,1
"KIAA0513","s1321_S_GON_01_ASEReadCounter.table","NW_015090842.1:8693655",15,15,0
"ZCCHC14","s1321_S_GON_01_ASEReadCounter.table","NW_015090842.1:8750189",108,108,0
"KLHDC4","s1321_S_GON_01_ASEReadCounter.table","NW_015090842.1:8891175",612,612,0
"KLHDC4","s1321_S_GON_01_ASEReadCounter.table","NW_015090842.1:8905251",108,248,140
"KLHDC4","s1321_S_GON_01_ASEReadCounter.table","NW_015090842.1:8919630",33,71,38
"SLC7A5","s1321_S_GON_01_ASEReadCounter.table","NW_015090842.1:8940382",87,87,0
"SLC7A5","s1321_S_GON_01_ASEReadCounter.table","NW_015090842.1:8941818",69,69,0
"SLC7A5","s1321_S_GON_01_ASEReadCounter.table","NW_015090842.1:8944655",87,87,0
"CA5A","s1321_S_GON_01_ASEReadCounter.table","NW_015090842.1:8989479",34,70,36
"CA5A","s1321_S_GON_01_ASEReadCounter.table","NW_015090842.1:8989562",39,83,44
"CA5A","s1321_S_GON_01_ASEReadCounter.table","NW_015090842.1:8989609",31,71,40
"CA5A","s1321_S_GON_01_ASEReadCounter.table","NW_015090842.1:8989693",42,95,53
"CA5A","s1321_S_GON_01_ASEReadCounter.table","NW_015090842.1:8989702",44,98,54
"CA5A","s1321_S_GON_01_ASEReadCounter.table","NW_015090842.1:8989746",43,103,60
"CA5A","s1321_S_GON_01_ASEReadCounter.table","NW_015090842.1:8989880",27,94,67
"CA5A","s1321_S_GON_01_ASEReadCounter.table","NW_015090842.1:8989885",27,94,67
"CA5A","s1321_S_GON_01_ASEReadCounter.table","NW_015090842.1:8989929",34,103,69
"CA5A","s1321_S_GON_01_ASEReadCounter.table","NW_015090842.1:8990002",27,77,50
"CA5A","s1321_S_GON_01_ASEReadCounter.table","NW_015090842.1:8990004",26,79,53
"CA5A","s1321_S_GON_01_ASEReadCounter.table","NW_015090842.1:8990005",27,80,53
"CA5A","s1321_S_GON_01_ASEReadCounter.table","NW_015090842.1:8990017",27,74,47
"CA5A","s1321_S_GON_01_ASEReadCounter.table","NW_015090842.1:8990043",30,79,49
"CA5A","s1321_S_GON_01_ASEReadCounter.table","NW_015090842.1:8990080",24,88,64
"CA5A","s1321_S_GON_01_ASEReadCounter.table","NW_015090842.1:8990084",21,87,66
"CA5A","s1321_S_GON_01_ASEReadCounter.table","NW_015090842.1:8990090",24,87,63
"CA5A","s1321_S_GON_01_ASEReadCounter.table","NW_015090842.1:8990095",25,90,65
"CA5A","s1321_S_GON_01_ASEReadCounter.table","NW_015090842.1:8990111",22,83,61
"CA5A","s1321_S_GON_01_ASEReadCounter.table","NW_015090842.1:8990112",23,82,59
"CA5A","s1321_S_GON_01_ASEReadCounter.table","NW_015090842.1:8990115",30,90,60
"CA5A","s1321_S_GON_01_ASEReadCounter.table","NW_015090842.1:8990166",37,79,42
"CA5A","s1321_S_GON_01_ASEReadCounter.table","NW_015090842.1:8990169",42,84,42
"CA5A","s1321_S_GON_01_ASEReadCounter.table","NW_015090842.1:8990222",22,75,53
"CA5A","s1321_S_GON_01_ASEReadCounter.table","NW_015090842.1:8990289",26,86,60
"CA5A","s1321_S_GON_01_ASEReadCounter.table","NW_015090842.1:8990314",25,79,54
"CA5A","s1321_S_GON_01_ASEReadCounter.table","NW_015090842.1:8990361",25,60,35
"CA5A","s1321_S_GON_01_ASEReadCounter.table","NW_015090842.1:8990368",25,57,32
"CA5A","s1321_S_GON_01_ASEReadCounter.table","NW_015090842.1:8990429",27,66,39
"CA5A","s1321_S_GON_01_ASEReadCounter.table","NW_015090842.1:8990466",24,62,38
"CA5A","s1321_S_GON_01_ASEReadCounter.table","NW_015090842.1:8990663",23,63,40
"CA5A","s1321_S_GON_01_ASEReadCounter.table","NW_015090842.1:8990797",24,52,28
"CA5A","s1321_S_GON_01_ASEReadCounter.table","NW_015090842.1:8990836",21,50,29
"CA5A","s1321_S_GON_01_ASEReadCounter.table","NW_015090842.1:8990842",18,46,28
"CA5A","s1321_S_GON_01_ASEReadCounter.table","NW_015090842.1:8990851",20,50,30
"CA5A","s1321_S_GON_01_ASEReadCounter.table","NW_015090842.1:8990918",25,64,39
"CA5A","s1321_S_GON_01_ASEReadCounter.table","NW_015090842.1:8990921",25,67,42
"CA5A","s1321_S_GON_01_ASEReadCounter.table","NW_015090842.1:8990942",36,80,44
"CA5A","s1321_S_GON_01_ASEReadCounter.table","NW_015090842.1:8991001",34,90,56
"CA5A","s1321_S_GON_01_ASEReadCounter.table","NW_015090842.1:8991038",20,62,42
"CA5A","s1321_S_GON_01_ASEReadCounter.table","NW_015090842.1:8991149",29,73,44
"CA5A","s1321_S_GON_01_ASEReadCounter.table","NW_015090842.1:8991176",25,67,42
"CA5A","s1321_S_GON_01_ASEReadCounter.table","NW_015090842.1:8991241",28,78,50
"CA5A","s1321_S_GON_01_ASEReadCounter.table","NW_015090842.1:8991262",32,76,44
"CA5A","s1321_S_GON_01_ASEReadCounter.table","NW_015090842.1:8991316",33,34,1
"CA5A","s1321_S_GON_01_ASEReadCounter.table","NW_015090842.1:8991319",32,33,1
"CA5A","s1321_S_GON_01_ASEReadCounter.table","NW_015090842.1:8991330",28,28,0
"CA5A","s1321_S_GON_01_ASEReadCounter.table","NW_015090842.1:8991334",27,28,1
"CA5A","s1321_S_GON_01_ASEReadCounter.table","NW_015090842.1:8991362",31,61,30
"CA5A","s1321_S_GON_01_ASEReadCounter.table","NW_015090842.1:8991368",31,62,31
"CA5A","s1321_S_GON_01_ASEReadCounter.table","NW_015090842.1:8991390",32,67,35
"CA5A","s1321_S_GON_01_ASEReadCounter.table","NW_015090842.1:8991395",33,70,37
"CA5A","s1321_S_GON_01_ASEReadCounter.table","NW_015090842.1:8991422",28,69,41
"CA5A","s1321_S_GON_01_ASEReadCounter.table","NW_015090842.1:8991467",25,63,38
"CA5A","s1321_S_GON_01_ASEReadCounter.table","NW_015090842.1:8991576",20,55,35
"CA5A","s1321_S_GON_01_ASEReadCounter.table","NW_015090842.1:8991587",17,54,37
"CA5A","s1321_S_GON_01_ASEReadCounter.table","NW_015090842.1:8991655",19,65,46
"CA5A","s1321_S_GON_01_ASEReadCounter.table","NW_015090842.1:8991717",13,56,43
"CA5A","s1321_S_GON_01_ASEReadCounter.table","NW_015090842.1:8991726",19,65,46
"CA5A","s1321_S_GON_01_ASEReadCounter.table","NW_015090842.1:8991799",18,59,41
"CA5A","s1321_S_GON_01_ASEReadCounter.table","NW_015090842.1:8991809",15,54,39
"CA5A","s1321_S_GON_01_ASEReadCounter.table","NW_015090842.1:8991848",15,47,32
"CA5A","s1321_S_GON_01_ASEReadCounter.table","NW_015090842.1:8991849",15,47,32
"CA5A","s1321_S_GON_01_ASEReadCounter.table","NW_015090842.1:8991927",21,58,37
"CA5A","s1321_S_GON_01_ASEReadCounter.table","NW_015090842.1:8991941",20,53,33
"CA5A","s1321_S_GON_01_ASEReadCounter.table","NW_015090842.1:8992121",24,60,36
"CA5A","s1321_S_GON_01_ASEReadCounter.table","NW_015090842.1:8992224",26,79,53
"CA5A","s1321_S_GON_01_ASEReadCounter.table","NW_015090842.1:9002570",25,73,48
"CA5A","s1321_S_GON_01_ASEReadCounter.table","NW_015090842.1:9002600",25,72,47
"CA5A","s1321_S_GON_01_ASEReadCounter.table","NW_015090842.1:9004312",26,71,45
"CA5A","s1321_S_GON_01_ASEReadCounter.table","NW_015090842.1:9004506",19,35,16
"CA5A","s1321_S_GON_01_ASEReadCounter.table","NW_015090842.1:9004523",18,33,15
"CA5A","s1321_S_GON_01_ASEReadCounter.table","NW_015090842.1:9004530",22,36,14
"CA5A","s1321_S_GON_01_ASEReadCounter.table","NW_015090842.1:9004556",27,50,23
"CA5A","s1321_S_GON_01_ASEReadCounter.table","NW_015090842.1:9004620",35,90,55
"CA5A","s1321_S_GON_01_ASEReadCounter.table","NW_015090842.1:9005116",40,122,82
"CA5A","s1321_S_GON_01_ASEReadCounter.table","NW_015090842.1:9005120",40,121,81
"CA5A","s1321_S_GON_01_ASEReadCounter.table","NW_015090842.1:9005140",35,116,81
"CA5A","s1321_S_GON_01_ASEReadCounter.table","NW_015090842.1:9005152",34,116,82
"CA5A","s1321_S_GON_01_ASEReadCounter.table","NW_015090842.1:9011011",3,4,1
"CA5A","s1321_S_GON_01_ASEReadCounter.table","NW_015090842.1:9011189",0,3,3
"CA5A","s1321_S_GON_01_ASEReadCounter.table","NW_015090842.1:9011194",0,3,3
"BANP","s1321_S_GON_01_ASEReadCounter.table","NW_015090842.1:9033407",2,8,6
"BANP","s1321_S_GON_01_ASEReadCounter.table","NW_015090842.1:9033409",2,8,6
"BANP","s1321_S_GON_01_ASEReadCounter.table","NW_015090842.1:9033420",3,9,6
"BANP","s1321_S_GON_01_ASEReadCounter.table","NW_015090842.1:9055284",7,16,9
"CIDEC","s1321_S_GON_01_ASEReadCounter.table","NW_015090842.1:9481199",9,15,6
"ZC3H18","s1321_S_GON_01_ASEReadCounter.table","NW_015090842.1:9528933",82,151,69
"MVD","s1321_S_GON_01_ASEReadCounter.table","NW_015090842.1:9550690",33,33,0
"MVD","s1321_S_GON_01_ASEReadCounter.table","NW_015090842.1:9550691",31,31,0
"MVD","s1321_S_GON_01_ASEReadCounter.table","NW_015090842.1:9550699",37,37,0
"MVD","s1321_S_GON_01_ASEReadCounter.table","NW_015090842.1:9550701",36,36,0
"MVD","s1321_S_GON_01_ASEReadCounter.table","NW_015090842.1:9552202",53,54,1
"MVD","s1321_S_GON_01_ASEReadCounter.table","NW_015090842.1:9552223",49,50,1
"MVD","s1321_S_GON_01_ASEReadCounter.table","NW_015090842.1:9552533",39,39,0
"MVD","s1321_S_GON_01_ASEReadCounter.table","NW_015090842.1:9552644",20,36,16
"PIEZO1","s1321_S_GON_01_ASEReadCounter.table","NW_015090842.1:9577447",17,40,23
"PIEZO1","s1321_S_GON_01_ASEReadCounter.table","NW_015090842.1:9579101",21,44,23
"PIEZO1","s1321_S_GON_01_ASEReadCounter.table","NW_015090842.1:9582630",11,20,9
"PIEZO1","s1321_S_GON_01_ASEReadCounter.table","NW_015090842.1:9582976",12,21,9
"PIEZO1","s1321_S_GON_01_ASEReadCounter.table","NW_015090842.1:9583326",24,24,0
"CDT1","s1321_S_GON_01_ASEReadCounter.table","NW_015090842.1:9596711",15,27,12
"CDT1","s1321_S_GON_01_ASEReadCounter.table","NW_015090842.1:9597033",63,63,0
"CDT1","s1321_S_GON_01_ASEReadCounter.table","NW_015090842.1:9597756",34,57,23
"CDT1","s1321_S_GON_01_ASEReadCounter.table","NW_015090842.1:9598873",85,85,0
"PABPN1L","s1321_S_GON_01_ASEReadCounter.table","NW_015090842.1:9669510",16,32,16
"ACSF3","s1321_S_GON_01_ASEReadCounter.table","NW_015090842.1:9776737",27,44,17
"ACSF3","s1321_S_GON_01_ASEReadCounter.table","NW_015090842.1:9809639",28,28,0
"ACSF3","s1321_S_GON_01_ASEReadCounter.table","NW_015090842.1:9834743",33,45,12
"ACSF3","s1321_S_GON_01_ASEReadCounter.table","NW_015090842.1:9834762",45,45,0
"ACSF3","s1321_S_GON_01_ASEReadCounter.table","NW_015090842.1:9834852",23,42,19
"ACSF3","s1321_S_GON_01_ASEReadCounter.table","NW_015090842.1:9834861",24,40,16
"ACSF3","s1321_S_GON_01_ASEReadCounter.table","NW_015090842.1:9839359",14,20,6
"ACSF3","s1321_S_GON_01_ASEReadCounter.table","NW_015090842.1:9839378",12,16,4
"ACSF3","s1321_S_GON_01_ASEReadCounter.table","NW_015090842.1:9839455",14,21,7
"ACSF3","s1321_S_GON_01_ASEReadCounter.table","NW_015090842.1:9839457",14,19,5
"ACSF3","s1321_S_GON_01_ASEReadCounter.table","NW_015090842.1:9839489",11,14,3
"ACSF3","s1321_S_GON_01_ASEReadCounter.table","NW_015090842.1:9839500",6,9,3
"ACSF3","s1321_S_GON_01_ASEReadCounter.table","NW_015090842.1:9839501",6,9,3
"ACSF3","s1321_S_GON_01_ASEReadCounter.table","NW_015090842.1:9839504",9,12,3
"ACSF3","s1321_S_GON_01_ASEReadCounter.table","NW_015090842.1:9839512",10,12,2
"ACSF3","s1321_S_GON_01_ASEReadCounter.table","NW_015090842.1:9839527",9,11,2
"ACSF3","s1321_S_GON_01_ASEReadCounter.table","NW_015090842.1:9839533",6,6,0
"ACSF3","s1321_S_GON_01_ASEReadCounter.table","NW_015090842.1:9839535",6,6,0
"ACSF3","s1321_S_GON_01_ASEReadCounter.table","NW_015090842.1:9839545",6,6,0
"ACSF3","s1321_S_GON_01_ASEReadCounter.table","NW_015090842.1:9839550",5,5,0
"ACSF3","s1321_S_GON_01_ASEReadCounter.table","NW_015090842.1:9839551",5,5,0
"CDH15","s1321_S_GON_01_ASEReadCounter.table","NW_015090842.1:9847163",1,1,0
"CDH15","s1321_S_GON_01_ASEReadCounter.table","NW_015090842.1:9847174",1,1,0
"CDH15","s1321_S_GON_01_ASEReadCounter.table","NW_015090842.1:9848220",1,1,0
"CDH15","s1321_S_GON_01_ASEReadCounter.table","NW_015090842.1:9848265",1,2,1
"CDH15","s1321_S_GON_01_ASEReadCounter.table","NW_015090842.1:9848531",0,2,2
"CDH15","s1321_S_GON_01_ASEReadCounter.table","NW_015090842.1:9848552",0,2,2
"CDH15","s1321_S_GON_01_ASEReadCounter.table","NW_015090842.1:9849086",2,2,0
"CDH15","s1321_S_GON_01_ASEReadCounter.table","NW_015090842.1:9849119",2,2,0
"CDH15","s1321_S_GON_01_ASEReadCounter.table","NW_015090842.1:9849140",2,2,0
"CDH15","s1321_S_GON_01_ASEReadCounter.table","NW_015090842.1:9849473",1,1,0
"CDH15","s1321_S_GON_01_ASEReadCounter.table","NW_015090842.1:9850141",1,1,0
"CDH15","s1321_S_GON_01_ASEReadCounter.table","NW_015090842.1:9850386",1,1,0
"CDH15","s1321_S_GON_01_ASEReadCounter.table","NW_015090842.1:9850432",1,1,0
"CDH15","s1321_S_GON_01_ASEReadCounter.table","NW_015090842.1:9850609",3,3,0
"SLC22A31","s1321_S_GON_01_ASEReadCounter.table","NW_015090842.1:9850797",1,1,0
"SLC22A31","s1321_S_GON_01_ASEReadCounter.table","NW_015090842.1:9850818",1,1,0
"SLC22A31","s1321_S_GON_01_ASEReadCounter.table","NW_015090842.1:9850929",1,2,1
"SLC22A31","s1321_S_GON_01_ASEReadCounter.table","NW_015090842.1:9850936",1,2,1
"SLC22A31","s1321_S_GON_01_ASEReadCounter.table","NW_015090842.1:9850940",1,2,1
"SLC22A31","s1321_S_GON_01_ASEReadCounter.table","NW_015090842.1:9850948",0,1,1
"SLC22A31","s1321_S_GON_01_ASEReadCounter.table","NW_015090842.1:9851130",50,63,13
"SLC22A31","s1321_S_GON_01_ASEReadCounter.table","NW_015090842.1:9851139",49,65,16
"SLC22A31","s1321_S_GON_01_ASEReadCounter.table","NW_015090842.1:9851265",70,103,33
"SLC22A31","s1321_S_GON_01_ASEReadCounter.table","NW_015090842.1:9851302",68,94,26
"SLC22A31","s1321_S_GON_01_ASEReadCounter.table","NW_015090842.1:9851303",69,93,24
"SLC22A31","s1321_S_GON_01_ASEReadCounter.table","NW_015090842.1:9851305",69,91,22
"SLC22A31","s1321_S_GON_01_ASEReadCounter.table","NW_015090842.1:9851343",83,104,21
"SLC22A31","s1321_S_GON_01_ASEReadCounter.table","NW_015090842.1:9851344",88,108,20
"SLC22A31","s1321_S_GON_01_ASEReadCounter.table","NW_015090842.1:9851381",106,132,26
"SLC22A31","s1321_S_GON_01_ASEReadCounter.table","NW_015090842.1:9851421",100,136,36
"SLC22A31","s1321_S_GON_01_ASEReadCounter.table","NW_015090842.1:9851526",107,142,35
"SLC22A31","s1321_S_GON_01_ASEReadCounter.table","NW_015090842.1:9851589",131,169,38
"SLC22A31","s1321_S_GON_01_ASEReadCounter.table","NW_015090842.1:9851712",143,179,36
"SLC22A31","s1321_S_GON_01_ASEReadCounter.table","NW_015090842.1:9851899",133,165,32
"SLC22A31","s1321_S_GON_01_ASEReadCounter.table","NW_015090842.1:9852139",132,170,38
"SLC22A31","s1321_S_GON_01_ASEReadCounter.table","NW_015090842.1:9852380",169,215,46
"SLC22A31","s1321_S_GON_01_ASEReadCounter.table","NW_015090842.1:9852431",108,148,40
"SLC22A31","s1321_S_GON_01_ASEReadCounter.table","NW_015090842.1:9852630",109,144,35
"SLC22A31","s1321_S_GON_01_ASEReadCounter.table","NW_015090842.1:9852711",84,107,23
"SLC22A31","s1321_S_GON_01_ASEReadCounter.table","NW_015090842.1:9852742",83,107,24
"SLC22A31","s1321_S_GON_01_ASEReadCounter.table","NW_015090842.1:9853099",100,120,20
"SLC22A31","s1321_S_GON_01_ASEReadCounter.table","NW_015090842.1:9853102",102,121,19
"SLC22A31","s1321_S_GON_01_ASEReadCounter.table","NW_015090842.1:9853421",75,75,0
"SLC22A31","s1321_S_GON_01_ASEReadCounter.table","NW_015090842.1:9853457",89,89,0
"SLC22A31","s1321_S_GON_01_ASEReadCounter.table","NW_015090842.1:9853502",67,67,0
"ANKRD11","s1321_S_GON_01_ASEReadCounter.table","NW_015090842.1:9858863",1,2,1
"ANKRD11","s1321_S_GON_01_ASEReadCounter.table","NW_015090842.1:9859101",21,44,23
"ANKRD11","s1321_S_GON_01_ASEReadCounter.table","NW_015090842.1:9859352",27,70,43
"ANKRD11","s1321_S_GON_01_ASEReadCounter.table","NW_015090842.1:9859381",2,29,27
"ANKRD11","s1321_S_GON_01_ASEReadCounter.table","NW_015090842.1:9859527",24,41,17
"ANKRD11","s1321_S_GON_01_ASEReadCounter.table","NW_015090842.1:9859529",24,44,20
"ANKRD11","s1321_S_GON_01_ASEReadCounter.table","NW_015090842.1:9859679",38,80,42
"ANKRD11","s1321_S_GON_01_ASEReadCounter.table","NW_015090842.1:9861097",39,80,41
"ANKRD11","s1321_S_GON_01_ASEReadCounter.table","NW_015090842.1:9862571",36,64,28
"ANKRD11","s1321_S_GON_01_ASEReadCounter.table","NW_015090842.1:9866071",0,27,27
"ANKRD11","s1321_S_GON_01_ASEReadCounter.table","NW_015090842.1:9866200",0,34,34
"ANKRD11","s1321_S_GON_01_ASEReadCounter.table","NW_015090842.1:9867391",13,26,13
"ANKRD11","s1321_S_GON_01_ASEReadCounter.table","NW_015090842.1:9867472",22,41,19
"ANKRD11","s1321_S_GON_01_ASEReadCounter.table","NW_015090842.1:9867559",22,45,23
"ANKRD11","s1321_S_GON_01_ASEReadCounter.table","NW_015090842.1:9867934",27,54,27
"ANKRD11","s1321_S_GON_01_ASEReadCounter.table","NW_015090842.1:9868093",26,45,19
"ANKRD11","s1321_S_GON_01_ASEReadCounter.table","NW_015090842.1:9868222",23,43,20
"ANKRD11","s1321_S_GON_01_ASEReadCounter.table","NW_015090842.1:9868327",23,39,16
"ANKRD11","s1321_S_GON_01_ASEReadCounter.table","NW_015090842.1:9868414",21,36,15
"ANKRD11","s1321_S_GON_01_ASEReadCounter.table","NW_015090842.1:9868441",18,29,11
"ANKRD11","s1321_S_GON_01_ASEReadCounter.table","NW_015090842.1:9868444",21,34,13
"ANKRD11","s1321_S_GON_01_ASEReadCounter.table","NW_015090842.1:9868519",23,38,15
"ANKRD11","s1321_S_GON_01_ASEReadCounter.table","NW_015090842.1:9868609",29,50,21
"ANKRD11","s1321_S_GON_01_ASEReadCounter.table","NW_015090842.1:9868666",28,52,24
"ANKRD11","s1321_S_GON_01_ASEReadCounter.table","NW_015090842.1:9869431",19,45,26
"ANKRD11","s1321_S_GON_01_ASEReadCounter.table","NW_015090842.1:9869578",27,60,33
"ANKRD11","s1321_S_GON_01_ASEReadCounter.table","NW_015090842.1:9869734",30,53,23
"ANKRD11","s1321_S_GON_01_ASEReadCounter.table","NW_015090842.1:9870070",25,46,21
"ANKRD11","s1321_S_GON_01_ASEReadCounter.table","NW_015090842.1:9870349",20,36,16
"ANKRD11","s1321_S_GON_01_ASEReadCounter.table","NW_015090842.1:9870604",31,53,22
"ANKRD11","s1321_S_GON_01_ASEReadCounter.table","NW_015090842.1:9870613",33,57,24
"ANKRD11","s1321_S_GON_01_ASEReadCounter.table","NW_015090842.1:9870685",37,64,27
"ANKRD11","s1321_S_GON_01_ASEReadCounter.table","NW_015090842.1:9870847",21,39,18
"ANKRD11","s1321_S_GON_01_ASEReadCounter.table","NW_015090842.1:9871103",13,27,14
"ANKRD11","s1321_S_GON_01_ASEReadCounter.table","NW_015090842.1:9871165",16,39,23
"ANKRD11","s1321_S_GON_01_ASEReadCounter.table","NW_015090842.1:9871820",14,23,9
"ANKRD11","s1321_S_GON_01_ASEReadCounter.table","NW_015090842.1:9871994",21,21,0
"ANKRD11","s1321_S_GON_01_ASEReadCounter.table","NW_015090842.1:9872118",17,29,12
"SPG7","s1321_S_GON_01_ASEReadCounter.table","NW_015090842.1:10051190",240,541,301
"SPG7","s1321_S_GON_01_ASEReadCounter.table","NW_015090842.1:10051218",272,644,372
"SPG7","s1321_S_GON_01_ASEReadCounter.table","NW_015090842.1:10052348",297,675,378
"SPG7","s1321_S_GON_01_ASEReadCounter.table","NW_015090842.1:10052366",305,690,385
"SPG7","s1321_S_GON_01_ASEReadCounter.table","NW_015090842.1:10065173",271,669,398
"SPG7","s1321_S_GON_01_ASEReadCounter.table","NW_015090842.1:10065215",256,604,348
"SPG7","s1321_S_GON_01_ASEReadCounter.table","NW_015090842.1:10066301",208,522,314
"SPG7","s1321_S_GON_01_ASEReadCounter.table","NW_015090842.1:10066365",241,567,326
"SPG7","s1321_S_GON_01_ASEReadCounter.table","NW_015090842.1:10069752",285,691,406
"SPG7","s1321_S_GON_01_ASEReadCounter.table","NW_015090842.1:10069800",278,713,435
"SPG7","s1321_S_GON_01_ASEReadCounter.table","NW_015090842.1:10071192",297,722,425
"SPG7","s1321_S_GON_01_ASEReadCounter.table","NW_015090842.1:10071204",277,662,385
"SPG7","s1321_S_GON_01_ASEReadCounter.table","NW_015090842.1:10071219",267,632,365
"SPG7","s1321_S_GON_01_ASEReadCounter.table","NW_015090842.1:10071967",238,589,351
"SPG7","s1321_S_GON_01_ASEReadCounter.table","NW_015090842.1:10075109",330,740,410
"SPG7","s1321_S_GON_01_ASEReadCounter.table","NW_015090842.1:10075114",341,740,399
"SPG7","s1321_S_GON_01_ASEReadCounter.table","NW_015090842.1:10075198",289,578,289
"SPG7","s1321_S_GON_01_ASEReadCounter.table","NW_015090842.1:10075487",188,502,314
"SPG7","s1321_S_GON_01_ASEReadCounter.table","NW_015090842.1:10075488",187,503,316
"SPG7","s1321_S_GON_01_ASEReadCounter.table","NW_015090842.1:10075548",138,362,224
"RPL13","s1321_S_GON_01_ASEReadCounter.table","NW_015090842.1:10076979",4,10,6
"RPL13","s1321_S_GON_01_ASEReadCounter.table","NW_015090842.1:10077387",535,1312,777
"RPL13","s1321_S_GON_01_ASEReadCounter.table","NW_015090842.1:10077978",785,1801,1016
"RPL13","s1321_S_GON_01_ASEReadCounter.table","NW_015090842.1:10077992",768,1724,956
"CPNE7","s1321_S_GON_01_ASEReadCounter.table","NW_015090842.1:10084001",0,1,1
"CPNE7","s1321_S_GON_01_ASEReadCounter.table","NW_015090842.1:10084856",0,2,2
"CPNE7","s1321_S_GON_01_ASEReadCounter.table","NW_015090842.1:10084872",0,2,2
"CPNE7","s1321_S_GON_01_ASEReadCounter.table","NW_015090842.1:10084892",2,5,3
"CPNE7","s1321_S_GON_01_ASEReadCounter.table","NW_015090842.1:10084921",3,6,3
"CPNE7","s1321_S_GON_01_ASEReadCounter.table","NW_015090842.1:10084935",3,6,3
"CPNE7","s1321_S_GON_01_ASEReadCounter.table","NW_015090842.1:10085000",2,2,0
"CPNE7","s1321_S_GON_01_ASEReadCounter.table","NW_015090842.1:10085089",4,6,2
"CPNE7","s1321_S_GON_01_ASEReadCounter.table","NW_015090842.1:10085096",5,7,2
"CPNE7","s1321_S_GON_01_ASEReadCounter.table","NW_015090842.1:10085126",5,8,3
"CPNE7","s1321_S_GON_01_ASEReadCounter.table","NW_015090842.1:10085180",4,7,3
"CPNE7","s1321_S_GON_01_ASEReadCounter.table","NW_015090842.1:10085201",3,6,3
"CPNE7","s1321_S_GON_01_ASEReadCounter.table","NW_015090842.1:10088134",3,5,2
"CPNE7","s1321_S_GON_01_ASEReadCounter.table","NW_015090842.1:10088146",3,6,3
"CPNE7","s1321_S_GON_01_ASEReadCounter.table","NW_015090842.1:10088940",3,7,4
"CPNE7","s1321_S_GON_01_ASEReadCounter.table","NW_015090842.1:10088965",2,4,2
"CPNE7","s1321_S_GON_01_ASEReadCounter.table","NW_015090842.1:10088967",2,4,2
"CPNE7","s1321_S_GON_01_ASEReadCounter.table","NW_015090842.1:10088973",2,4,2
"CPNE7","s1321_S_GON_01_ASEReadCounter.table","NW_015090842.1:10090924",7,12,5
"CPNE7","s1321_S_GON_01_ASEReadCounter.table","NW_015090842.1:10090930",6,11,5
"CPNE7","s1321_S_GON_01_ASEReadCounter.table","NW_015090842.1:10091075",7,11,4
"CPNE7","s1321_S_GON_01_ASEReadCounter.table","NW_015090842.1:10091389",7,9,2
"CPNE7","s1321_S_GON_01_ASEReadCounter.table","NW_015090842.1:10091407",8,10,2
"CPNE7","s1321_S_GON_01_ASEReadCounter.table","NW_015090842.1:10091530",3,4,1
"CPNE7","s1321_S_GON_01_ASEReadCounter.table","NW_015090842.1:10091875",2,8,6
"CPNE7","s1321_S_GON_01_ASEReadCounter.table","NW_015090842.1:10091983",3,8,5
"CPNE7","s1321_S_GON_01_ASEReadCounter.table","NW_015090842.1:10091997",2,7,5
"CPNE7","s1321_S_GON_01_ASEReadCounter.table","NW_015090842.1:10092038",1,3,2
"CPNE7","s1321_S_GON_01_ASEReadCounter.table","NW_015090842.1:10092140",1,3,2
"CPNE7","s1321_S_GON_01_ASEReadCounter.table","NW_015090842.1:10092183",1,3,2
"CPNE7","s1321_S_GON_01_ASEReadCounter.table","NW_015090842.1:10092201",1,3,2
"CPNE7","s1321_S_GON_01_ASEReadCounter.table","NW_015090842.1:10092230",1,1,0
"LOC106888185","s1321_S_GON_01_ASEReadCounter.table","NW_015090842.1:10094965",3,8,5
"LOC106888185","s1321_S_GON_01_ASEReadCounter.table","NW_015090842.1:10094966",3,8,5
"LOC106888185","s1321_S_GON_01_ASEReadCounter.table","NW_015090842.1:10094985",4,9,5
"LOC106888185","s1321_S_GON_01_ASEReadCounter.table","NW_015090842.1:10095055",0,6,6
"LOC106888185","s1321_S_GON_01_ASEReadCounter.table","NW_015090842.1:10095062",0,5,5
"LOC106888185","s1321_S_GON_01_ASEReadCounter.table","NW_015090842.1:10095130",0,9,9
"LOC106888185","s1321_S_GON_01_ASEReadCounter.table","NW_015090842.1:10095265",13,31,18
"LOC106888185","s1321_S_GON_01_ASEReadCounter.table","NW_015090842.1:10095586",12,36,24
"LOC106888185","s1321_S_GON_01_ASEReadCounter.table","NW_015090842.1:10095593",12,37,25
"LOC106888185","s1321_S_GON_01_ASEReadCounter.table","NW_015090842.1:10095616",10,36,26
"LOC106888185","s1321_S_GON_01_ASEReadCounter.table","NW_015090842.1:10095662",12,36,24
"LOC106888185","s1321_S_GON_01_ASEReadCounter.table","NW_015090842.1:10095674",12,35,23
"LOC106888185","s1321_S_GON_01_ASEReadCounter.table","NW_015090842.1:10095786",13,40,27
"LOC106888185","s1321_S_GON_01_ASEReadCounter.table","NW_015090842.1:10095831",14,38,24
"LOC106888185","s1321_S_GON_01_ASEReadCounter.table","NW_015090842.1:10096230",22,41,19
"LOC106888185","s1321_S_GON_01_ASEReadCounter.table","NW_015090842.1:10096249",25,49,24
"LOC106888185","s1321_S_GON_01_ASEReadCounter.table","NW_015090842.1:10096272",24,48,24
"LOC106888185","s1321_S_GON_01_ASEReadCounter.table","NW_015090842.1:10096288",23,48,25
"LOC106888185","s1321_S_GON_01_ASEReadCounter.table","NW_015090842.1:10097248",20,40,20
"LOC106888185","s1321_S_GON_01_ASEReadCounter.table","NW_015090842.1:10097265",17,43,26
"LOC106888185","s1321_S_GON_01_ASEReadCounter.table","NW_015090842.1:10097446",2,8,6
"DPEP1","s1321_S_GON_01_ASEReadCounter.table","NW_015090842.1:10098017",0,9,9
"DPEP1","s1321_S_GON_01_ASEReadCounter.table","NW_015090842.1:10098518",1,13,12
"DPEP1","s1321_S_GON_01_ASEReadCounter.table","NW_015090842.1:10098595",1,10,9
"DPEP1","s1321_S_GON_01_ASEReadCounter.table","NW_015090842.1:10098597",1,10,9
"DPEP1","s1321_S_GON_01_ASEReadCounter.table","NW_015090842.1:10098601",1,10,9
"DPEP1","s1321_S_GON_01_ASEReadCounter.table","NW_015090842.1:10098608",2,9,7
"DPEP1","s1321_S_GON_01_ASEReadCounter.table","NW_015090842.1:10098630",1,9,8
"DPEP1","s1321_S_GON_01_ASEReadCounter.table","NW_015090842.1:10098659",2,10,8
"DPEP1","s1321_S_GON_01_ASEReadCounter.table","NW_015090842.1:10099765",3,10,7
"DPEP1","s1321_S_GON_01_ASEReadCounter.table","NW_015090842.1:10099985",7,19,12
"DPEP1","s1321_S_GON_01_ASEReadCounter.table","NW_015090842.1:10099986",7,19,12
"DPEP1","s1321_S_GON_01_ASEReadCounter.table","NW_015090842.1:10099991",6,21,15
"DPEP1","s1321_S_GON_01_ASEReadCounter.table","NW_015090842.1:10100044",4,20,16
"DPEP1","s1321_S_GON_01_ASEReadCounter.table","NW_015090842.1:10100045",4,19,15
"DPEP1","s1321_S_GON_01_ASEReadCounter.table","NW_015090842.1:10100084",5,24,19
"DPEP1","s1321_S_GON_01_ASEReadCounter.table","NW_015090842.1:10100295",6,15,9
"DPEP1","s1321_S_GON_01_ASEReadCounter.table","NW_015090842.1:10100529",6,21,15
"DPEP1","s1321_S_GON_01_ASEReadCounter.table","NW_015090842.1:10100893",6,27,21
"DPEP1","s1321_S_GON_01_ASEReadCounter.table","NW_015090842.1:10100902",6,23,17
"DPEP1","s1321_S_GON_01_ASEReadCounter.table","NW_015090842.1:10101072",4,22,18
"DPEP1","s1321_S_GON_01_ASEReadCounter.table","NW_015090842.1:10101199",4,22,18
"DPEP1","s1321_S_GON_01_ASEReadCounter.table","NW_015090842.1:10101483",2,17,15
"DPEP1","s1321_S_GON_01_ASEReadCounter.table","NW_015090842.1:10101497",3,17,14
"DPEP1","s1321_S_GON_01_ASEReadCounter.table","NW_015090842.1:10101525",4,14,10
"DPEP1","s1321_S_GON_01_ASEReadCounter.table","NW_015090842.1:10101875",9,28,19
"DPEP1","s1321_S_GON_01_ASEReadCounter.table","NW_015090842.1:10101913",7,22,15
"DPEP1","s1321_S_GON_01_ASEReadCounter.table","NW_015090842.1:10101996",4,14,10
"DPEP1","s1321_S_GON_01_ASEReadCounter.table","NW_015090842.1:10102014",2,12,10
"DPEP1","s1321_S_GON_01_ASEReadCounter.table","NW_015090842.1:10102035",2,7,5
"DPEP1","s1321_S_GON_01_ASEReadCounter.table","NW_015090842.1:10102076",1,1,0
"DPEP1","s1321_S_GON_01_ASEReadCounter.table","NW_015090842.1:10102077",1,1,0
"CHMP1A","s1321_S_GON_01_ASEReadCounter.table","NW_015090842.1:10102901",66,157,91
"CHMP1A","s1321_S_GON_01_ASEReadCounter.table","NW_015090842.1:10102961",63,172,109
"CHMP1A","s1321_S_GON_01_ASEReadCounter.table","NW_015090842.1:10102996",58,181,123
"CHMP1A","s1321_S_GON_01_ASEReadCounter.table","NW_015090842.1:10103004",66,187,121
"CHMP1A","s1321_S_GON_01_ASEReadCounter.table","NW_015090842.1:10103006",67,192,125
"CHMP1A","s1321_S_GON_01_ASEReadCounter.table","NW_015090842.1:10103052",95,229,134
"CHMP1A","s1321_S_GON_01_ASEReadCounter.table","NW_015090842.1:10103095",98,216,118
"CHMP1A","s1321_S_GON_01_ASEReadCounter.table","NW_015090842.1:10103096",101,219,118
"CHMP1A","s1321_S_GON_01_ASEReadCounter.table","NW_015090842.1:10103152",87,177,90
"CHMP1A","s1321_S_GON_01_ASEReadCounter.table","NW_015090842.1:10103334",78,183,105
"CHMP1A","s1321_S_GON_01_ASEReadCounter.table","NW_015090842.1:10103373",46,151,105
"CHMP1A","s1321_S_GON_01_ASEReadCounter.table","NW_015090842.1:10103408",73,203,130
"CHMP1A","s1321_S_GON_01_ASEReadCounter.table","NW_015090842.1:10103412",77,205,128
"CHMP1A","s1321_S_GON_01_ASEReadCounter.table","NW_015090842.1:10103512",99,236,137
"CHMP1A","s1321_S_GON_01_ASEReadCounter.table","NW_015090842.1:10103513",100,235,135
"CHMP1A","s1321_S_GON_01_ASEReadCounter.table","NW_015090842.1:10103583",67,160,93
"CHMP1A","s1321_S_GON_01_ASEReadCounter.table","NW_015090842.1:10103614",57,150,93
"CHMP1A","s1321_S_GON_01_ASEReadCounter.table","NW_015090842.1:10103657",61,156,95
"CHMP1A","s1321_S_GON_01_ASEReadCounter.table","NW_015090842.1:10103669",53,146,93
"CHMP1A","s1321_S_GON_01_ASEReadCounter.table","NW_015090842.1:10103674",62,148,86
"CHMP1A","s1321_S_GON_01_ASEReadCounter.table","NW_015090842.1:10103677",61,146,85
"CHMP1A","s1321_S_GON_01_ASEReadCounter.table","NW_015090842.1:10103729",91,167,76
"CHMP1A","s1321_S_GON_01_ASEReadCounter.table","NW_015090842.1:10103758",83,162,79
"CHMP1A","s1321_S_GON_01_ASEReadCounter.table","NW_015090842.1:10103761",82,164,82
"CHMP1A","s1321_S_GON_01_ASEReadCounter.table","NW_015090842.1:10103788",82,199,117
"CHMP1A","s1321_S_GON_01_ASEReadCounter.table","NW_015090842.1:10103789",85,201,116
"CHMP1A","s1321_S_GON_01_ASEReadCounter.table","NW_015090842.1:10103790",84,199,115
"CHMP1A","s1321_S_GON_01_ASEReadCounter.table","NW_015090842.1:10103950",89,235,146
"CHMP1A","s1321_S_GON_01_ASEReadCounter.table","NW_015090842.1:10104335",76,178,102
"CHMP1A","s1321_S_GON_01_ASEReadCounter.table","NW_015090842.1:10104429",109,212,103
"CHMP1A","s1321_S_GON_01_ASEReadCounter.table","NW_015090842.1:10104532",102,204,102
"CHMP1A","s1321_S_GON_01_ASEReadCounter.table","NW_015090842.1:10104633",108,198,90
"CHMP1A","s1321_S_GON_01_ASEReadCounter.table","NW_015090842.1:10104759",92,195,103
"CHMP1A","s1321_S_GON_01_ASEReadCounter.table","NW_015090842.1:10104794",106,229,123
"CHMP1A","s1321_S_GON_01_ASEReadCounter.table","NW_015090842.1:10104844",68,183,115
"CHMP1A","s1321_S_GON_01_ASEReadCounter.table","NW_015090842.1:10106290",102,180,78
"CHMP1A","s1321_S_GON_01_ASEReadCounter.table","NW_015090842.1:10106335",111,223,112
"CHMP1A","s1321_S_GON_01_ASEReadCounter.table","NW_015090842.1:10106383",137,289,152
"CHMP1A","s1321_S_GON_01_ASEReadCounter.table","NW_015090842.1:10106747",127,280,153
"CHMP1A","s1321_S_GON_01_ASEReadCounter.table","NW_015090842.1:10107404",95,245,150
"CHMP1A","s1321_S_GON_01_ASEReadCounter.table","NW_015090842.1:10107410",100,251,151
"CHMP1A","s1321_S_GON_01_ASEReadCounter.table","NW_015090842.1:10107876",112,248,136
"CDK10","s1321_S_GON_01_ASEReadCounter.table","NW_015090842.1:10109030",16,18,2
"CDK10","s1321_S_GON_01_ASEReadCounter.table","NW_015090842.1:10109963",98,195,97
"CDK10","s1321_S_GON_01_ASEReadCounter.table","NW_015090842.1:10110887",77,169,92
"CDK10","s1321_S_GON_01_ASEReadCounter.table","NW_015090842.1:10111254",48,129,81
"CDK10","s1321_S_GON_01_ASEReadCounter.table","NW_015090842.1:10111380",61,163,102
"CDK10","s1321_S_GON_01_ASEReadCounter.table","NW_015090842.1:10111395",62,156,94
"CDK10","s1321_S_GON_01_ASEReadCounter.table","NW_015090842.1:10111437",40,127,87
"CDK10","s1321_S_GON_01_ASEReadCounter.table","NW_015090842.1:10111798",71,147,76
"CDK10","s1321_S_GON_01_ASEReadCounter.table","NW_015090842.1:10111840",68,149,81
"CDK10","s1321_S_GON_01_ASEReadCounter.table","NW_015090842.1:10112031",70,147,77
"CDK10","s1321_S_GON_01_ASEReadCounter.table","NW_015090842.1:10112285",67,153,86
"CDK10","s1321_S_GON_01_ASEReadCounter.table","NW_015090842.1:10112398",72,168,96
"CDK10","s1321_S_GON_01_ASEReadCounter.table","NW_015090842.1:10112455",66,154,88
"CDK10","s1321_S_GON_01_ASEReadCounter.table","NW_015090842.1:10112461",60,143,83
"CDK10","s1321_S_GON_01_ASEReadCounter.table","NW_015090842.1:10112497",56,131,75
"CDK10","s1321_S_GON_01_ASEReadCounter.table","NW_015090842.1:10112508",45,125,80
"CDK10","s1321_S_GON_01_ASEReadCounter.table","NW_015090842.1:10112518",31,108,77
"CDK10","s1321_S_GON_01_ASEReadCounter.table","NW_015090842.1:10112540",12,90,78
"CDK10","s1321_S_GON_01_ASEReadCounter.table","NW_015090842.1:10112556",41,115,74
"CDK10","s1321_S_GON_01_ASEReadCounter.table","NW_015090842.1:10112561",43,129,86
"CDK10","s1321_S_GON_01_ASEReadCounter.table","NW_015090842.1:10112596",53,126,73
"CDK10","s1321_S_GON_01_ASEReadCounter.table","NW_015090842.1:10112630",48,107,59
"CDK10","s1321_S_GON_01_ASEReadCounter.table","NW_015090842.1:10112656",49,110,61
"CDK10","s1321_S_GON_01_ASEReadCounter.table","NW_015090842.1:10112665",36,84,48
"CDK10","s1321_S_GON_01_ASEReadCounter.table","NW_015090842.1:10112668",35,84,49
"CDK10","s1321_S_GON_01_ASEReadCounter.table","NW_015090842.1:10112781",17,40,23
"CDK10","s1321_S_GON_01_ASEReadCounter.table","NW_015090842.1:10112782",17,40,23
"CDK10","s1321_S_GON_01_ASEReadCounter.table","NW_015090842.1:10112795",13,35,22
"CDK10","s1321_S_GON_01_ASEReadCounter.table","NW_015090842.1:10112841",7,14,7
"CDK10","s1321_S_GON_01_ASEReadCounter.table","NW_015090842.1:10112861",7,15,8
"SPATA2L","s1321_S_GON_01_ASEReadCounter.table","NW_015090842.1:10113212",8,14,6
"SPATA2L","s1321_S_GON_01_ASEReadCounter.table","NW_015090842.1:10113280",7,20,13
"SPATA2L","s1321_S_GON_01_ASEReadCounter.table","NW_015090842.1:10113296",4,16,12
"SPATA2L","s1321_S_GON_01_ASEReadCounter.table","NW_015090842.1:10113321",6,19,13
"SPATA2L","s1321_S_GON_01_ASEReadCounter.table","NW_015090842.1:10113332",8,23,15
"SPATA2L","s1321_S_GON_01_ASEReadCounter.table","NW_015090842.1:10113380",20,32,12
"SPATA2L","s1321_S_GON_01_ASEReadCounter.table","NW_015090842.1:10113381",20,32,12
"SPATA2L","s1321_S_GON_01_ASEReadCounter.table","NW_015090842.1:10113412",21,34,13
"SPATA2L","s1321_S_GON_01_ASEReadCounter.table","NW_015090842.1:10113421",24,38,14
"SPATA2L","s1321_S_GON_01_ASEReadCounter.table","NW_015090842.1:10113465",24,42,18
"SPATA2L","s1321_S_GON_01_ASEReadCounter.table","NW_015090842.1:10113535",14,27,13
"SPATA2L","s1321_S_GON_01_ASEReadCounter.table","NW_015090842.1:10113645",8,25,17
"SPATA2L","s1321_S_GON_01_ASEReadCounter.table","NW_015090842.1:10113682",17,34,17
"SPATA2L","s1321_S_GON_01_ASEReadCounter.table","NW_015090842.1:10113696",19,39,20
"SPATA2L","s1321_S_GON_01_ASEReadCounter.table","NW_015090842.1:10113727",25,51,26
"SPATA2L","s1321_S_GON_01_ASEReadCounter.table","NW_015090842.1:10113729",52,52,0
"SPATA2L","s1321_S_GON_01_ASEReadCounter.table","NW_015090842.1:10113799",22,52,30
"SPATA2L","s1321_S_GON_01_ASEReadCounter.table","NW_015090842.1:10113809",22,53,31
"SPATA2L","s1321_S_GON_01_ASEReadCounter.table","NW_015090842.1:10113827",24,50,26
"SPATA2L","s1321_S_GON_01_ASEReadCounter.table","NW_015090842.1:10113831",22,47,25
"SPATA2L","s1321_S_GON_01_ASEReadCounter.table","NW_015090842.1:10113894",22,42,20
"SPATA2L","s1321_S_GON_01_ASEReadCounter.table","NW_015090842.1:10113905",19,37,18
"SPATA2L","s1321_S_GON_01_ASEReadCounter.table","NW_015090842.1:10113914",16,38,22
"SPATA2L","s1321_S_GON_01_ASEReadCounter.table","NW_015090842.1:10113920",17,42,25
"SPATA2L","s1321_S_GON_01_ASEReadCounter.table","NW_015090842.1:10113937",17,49,32
"SPATA2L","s1321_S_GON_01_ASEReadCounter.table","NW_015090842.1:10113971",13,42,29
"SPATA2L","s1321_S_GON_01_ASEReadCounter.table","NW_015090842.1:10113976",10,43,33
"SPATA2L","s1321_S_GON_01_ASEReadCounter.table","NW_015090842.1:10113985",10,40,30
"SPATA2L","s1321_S_GON_01_ASEReadCounter.table","NW_015090842.1:10113994",12,42,30
"SPATA2L","s1321_S_GON_01_ASEReadCounter.table","NW_015090842.1:10114063",15,39,24
"SPATA2L","s1321_S_GON_01_ASEReadCounter.table","NW_015090842.1:10114066",13,37,24
"SPATA2L","s1321_S_GON_01_ASEReadCounter.table","NW_015090842.1:10114069",13,37,24
"SPATA2L","s1321_S_GON_01_ASEReadCounter.table","NW_015090842.1:10114159",10,33,23
"SPATA2L","s1321_S_GON_01_ASEReadCounter.table","NW_015090842.1:10114262",35,35,0
"SPATA2L","s1321_S_GON_01_ASEReadCounter.table","NW_015090842.1:10114470",8,29,21
"SPATA2L","s1321_S_GON_01_ASEReadCounter.table","NW_015090842.1:10114524",8,18,10
"VPS9D1","s1321_S_GON_01_ASEReadCounter.table","NW_015090842.1:10116377",10,19,9
"VPS9D1","s1321_S_GON_01_ASEReadCounter.table","NW_015090842.1:10116415",11,23,12
"VPS9D1","s1321_S_GON_01_ASEReadCounter.table","NW_015090842.1:10116607",9,15,6
"VPS9D1","s1321_S_GON_01_ASEReadCounter.table","NW_015090842.1:10116821",11,20,9
"VPS9D1","s1321_S_GON_01_ASEReadCounter.table","NW_015090842.1:10116825",11,20,9
"VPS9D1","s1321_S_GON_01_ASEReadCounter.table","NW_015090842.1:10116882",15,23,8
"VPS9D1","s1321_S_GON_01_ASEReadCounter.table","NW_015090842.1:10116933",15,22,7
"VPS9D1","s1321_S_GON_01_ASEReadCounter.table","NW_015090842.1:10116942",14,19,5
"VPS9D1","s1321_S_GON_01_ASEReadCounter.table","NW_015090842.1:10117152",9,14,5
"VPS9D1","s1321_S_GON_01_ASEReadCounter.table","NW_015090842.1:10117480",3,6,3
"VPS9D1","s1321_S_GON_01_ASEReadCounter.table","NW_015090842.1:10117497",4,7,3
"VPS9D1","s1321_S_GON_01_ASEReadCounter.table","NW_015090842.1:10117499",4,8,4
"VPS9D1","s1321_S_GON_01_ASEReadCounter.table","NW_015090842.1:10117516",10,14,4
"VPS9D1","s1321_S_GON_01_ASEReadCounter.table","NW_015090842.1:10117525",10,14,4
"VPS9D1","s1321_S_GON_01_ASEReadCounter.table","NW_015090842.1:10117579",8,12,4
"VPS9D1","s1321_S_GON_01_ASEReadCounter.table","NW_015090842.1:10117627",6,9,3
"VPS9D1","s1321_S_GON_01_ASEReadCounter.table","NW_015090842.1:10117678",8,13,5
"VPS9D1","s1321_S_GON_01_ASEReadCounter.table","NW_015090842.1:10117773",9,14,5
"VPS9D1","s1321_S_GON_01_ASEReadCounter.table","NW_015090842.1:10117937",9,13,4
"VPS9D1","s1321_S_GON_01_ASEReadCounter.table","NW_015090842.1:10117961",4,7,3
"VPS9D1","s1321_S_GON_01_ASEReadCounter.table","NW_015090842.1:10118236",7,16,9
"VPS9D1","s1321_S_GON_01_ASEReadCounter.table","NW_015090842.1:10118414",5,13,8
"VPS9D1","s1321_S_GON_01_ASEReadCounter.table","NW_015090842.1:10118973",10,15,5
"VPS9D1","s1321_S_GON_01_ASEReadCounter.table","NW_015090842.1:10119500",6,16,10
"ZNF276","s1321_S_GON_01_ASEReadCounter.table","NW_015090842.1:10121760",2,3,1
"ZNF276","s1321_S_GON_01_ASEReadCounter.table","NW_015090842.1:10121769",2,4,2
"ZNF276","s1321_S_GON_01_ASEReadCounter.table","NW_015090842.1:10121802",7,12,5
"ZNF276","s1321_S_GON_01_ASEReadCounter.table","NW_015090842.1:10121971",12,28,16
"ZNF276","s1321_S_GON_01_ASEReadCounter.table","NW_015090842.1:10122161",27,27,0
"ZNF276","s1321_S_GON_01_ASEReadCounter.table","NW_015090842.1:10122164",26,26,0
"ZNF276","s1321_S_GON_01_ASEReadCounter.table","NW_015090842.1:10122184",20,20,0
"ZNF276","s1321_S_GON_01_ASEReadCounter.table","NW_015090842.1:10122883",5,14,9
"ZNF276","s1321_S_GON_01_ASEReadCounter.table","NW_015090842.1:10122997",10,23,13
"ZNF276","s1321_S_GON_01_ASEReadCounter.table","NW_015090842.1:10123069",9,32,23
"ZNF276","s1321_S_GON_01_ASEReadCounter.table","NW_015090842.1:10123207",15,30,15
"ZNF276","s1321_S_GON_01_ASEReadCounter.table","NW_015090842.1:10125787",15,44,29
"ZNF276","s1321_S_GON_01_ASEReadCounter.table","NW_015090842.1:10126309",20,52,32
"ZNF276","s1321_S_GON_01_ASEReadCounter.table","NW_015090842.1:10126348",18,44,26
"ZNF276","s1321_S_GON_01_ASEReadCounter.table","NW_015090842.1:10126978",27,63,36
"ZNF276","s1321_S_GON_01_ASEReadCounter.table","NW_015090842.1:10126991",22,54,32
"ZNF276","s1321_S_GON_01_ASEReadCounter.table","NW_015090842.1:10127023",22,57,35
"ZNF276","s1321_S_GON_01_ASEReadCounter.table","NW_015090842.1:10127063",19,57,38
"ZNF276","s1321_S_GON_01_ASEReadCounter.table","NW_015090842.1:10127373",19,53,34
"ZNF276","s1321_S_GON_01_ASEReadCounter.table","NW_015090842.1:10127931",24,56,32
"ZNF276","s1321_S_GON_01_ASEReadCounter.table","NW_015090842.1:10128070",16,48,32
"ZNF276","s1321_S_GON_01_ASEReadCounter.table","NW_015090842.1:10128102",17,47,30
"ZNF276","s1321_S_GON_01_ASEReadCounter.table","NW_015090842.1:10128356",20,47,27
"ZNF276","s1321_S_GON_01_ASEReadCounter.table","NW_015090842.1:10128497",10,21,11
"FANCA","s1321_S_GON_01_ASEReadCounter.table","NW_015090842.1:10128743",36,65,29
"FANCA","s1321_S_GON_01_ASEReadCounter.table","NW_015090842.1:10128822",38,68,30
"FANCA","s1321_S_GON_01_ASEReadCounter.table","NW_015090842.1:10129383",49,80,31
"FANCA","s1321_S_GON_01_ASEReadCounter.table","NW_015090842.1:10129390",48,78,30
"FANCA","s1321_S_GON_01_ASEReadCounter.table","NW_015090842.1:10129422",46,70,24
"FANCA","s1321_S_GON_01_ASEReadCounter.table","NW_015090842.1:10129969",49,75,26
"FANCA","s1321_S_GON_01_ASEReadCounter.table","NW_015090842.1:10130399",44,75,31
"FANCA","s1321_S_GON_01_ASEReadCounter.table","NW_015090842.1:10130857",37,62,25
"FANCA","s1321_S_GON_01_ASEReadCounter.table","NW_015090842.1:10130878",33,56,23
"FANCA","s1321_S_GON_01_ASEReadCounter.table","NW_015090842.1:10133530",25,51,26
"FANCA","s1321_S_GON_01_ASEReadCounter.table","NW_015090842.1:10133533",26,53,27
"FANCA","s1321_S_GON_01_ASEReadCounter.table","NW_015090842.1:10133536",26,54,28
"FANCA","s1321_S_GON_01_ASEReadCounter.table","NW_015090842.1:10133601",27,66,39
"FANCA","s1321_S_GON_01_ASEReadCounter.table","NW_015090842.1:10134492",33,62,29
"FANCA","s1321_S_GON_01_ASEReadCounter.table","NW_015090842.1:10136957",28,61,33
"FANCA","s1321_S_GON_01_ASEReadCounter.table","NW_015090842.1:10136982",28,53,25
"FANCA","s1321_S_GON_01_ASEReadCounter.table","NW_015090842.1:10136999",20,41,21
"FANCA","s1321_S_GON_01_ASEReadCounter.table","NW_015090842.1:10137019",28,57,29
"FANCA","s1321_S_GON_01_ASEReadCounter.table","NW_015090842.1:10137673",33,64,31
"FANCA","s1321_S_GON_01_ASEReadCounter.table","NW_015090842.1:10138618",32,52,20
"FANCA","s1321_S_GON_01_ASEReadCounter.table","NW_015090842.1:10139140",21,41,20
"FANCA","s1321_S_GON_01_ASEReadCounter.table","NW_015090842.1:10140699",41,55,14
"FANCA","s1321_S_GON_01_ASEReadCounter.table","NW_015090842.1:10141234",22,40,18
"FANCA","s1321_S_GON_01_ASEReadCounter.table","NW_015090842.1:10145030",23,43,20
"FANCA","s1321_S_GON_01_ASEReadCounter.table","NW_015090842.1:10150518",13,27,14
"FANCA","s1321_S_GON_01_ASEReadCounter.table","NW_015090842.1:10152863",22,44,22
"FANCA","s1321_S_GON_01_ASEReadCounter.table","NW_015090842.1:10154490",32,50,18
"FANCA","s1321_S_GON_01_ASEReadCounter.table","NW_015090842.1:10158162",16,32,16
"FANCA","s1321_S_GON_01_ASEReadCounter.table","NW_015090842.1:10158957",17,34,17
"FANCA","s1321_S_GON_01_ASEReadCounter.table","NW_015090842.1:10160177",11,20,9
"FANCA","s1321_S_GON_01_ASEReadCounter.table","NW_015090842.1:10163667",15,33,18
"FANCA","s1321_S_GON_01_ASEReadCounter.table","NW_015090842.1:10164257",20,29,9
"FANCA","s1321_S_GON_01_ASEReadCounter.table","NW_015090842.1:10165331",26,39,13
"SPIRE2","s1321_S_GON_01_ASEReadCounter.table","NW_015090842.1:10172284",6,6,0
"SPIRE2","s1321_S_GON_01_ASEReadCounter.table","NW_015090842.1:10175262",5,5,0
"SPIRE2","s1321_S_GON_01_ASEReadCounter.table","NW_015090842.1:10175352",5,5,0
"SPIRE2","s1321_S_GON_01_ASEReadCounter.table","NW_015090842.1:10175400",8,9,1
"SPIRE2","s1321_S_GON_01_ASEReadCounter.table","NW_015090842.1:10175418",9,10,1
"SPIRE2","s1321_S_GON_01_ASEReadCounter.table","NW_015090842.1:10175704",10,11,1
"SPIRE2","s1321_S_GON_01_ASEReadCounter.table","NW_015090842.1:10176115",22,22,0
"SPIRE2","s1321_S_GON_01_ASEReadCounter.table","NW_015090842.1:10176561",14,15,1
"SPIRE2","s1321_S_GON_01_ASEReadCounter.table","NW_015090842.1:10176817",19,21,2
"SPIRE2","s1321_S_GON_01_ASEReadCounter.table","NW_015090842.1:10177084",10,10,0
"SPIRE2","s1321_S_GON_01_ASEReadCounter.table","NW_015090842.1:10177838",15,16,1
"SPIRE2","s1321_S_GON_01_ASEReadCounter.table","NW_015090842.1:10178000",16,16,0
"SPIRE2","s1321_S_GON_01_ASEReadCounter.table","NW_015090842.1:10178164",16,18,2
"SPIRE2","s1321_S_GON_01_ASEReadCounter.table","NW_015090842.1:10178216",13,13,0
"SPIRE2","s1321_S_GON_01_ASEReadCounter.table","NW_015090842.1:10178303",9,10,1
"SPIRE2","s1321_S_GON_01_ASEReadCounter.table","NW_015090842.1:10178403",12,16,4
"SPIRE2","s1321_S_GON_01_ASEReadCounter.table","NW_015090842.1:10178409",11,14,3
"SPIRE2","s1321_S_GON_01_ASEReadCounter.table","NW_015090842.1:10178524",5,6,1
"SPIRE2","s1321_S_GON_01_ASEReadCounter.table","NW_015090842.1:10178526",5,6,1
"SPIRE2","s1321_S_GON_01_ASEReadCounter.table","NW_015090842.1:10178531",5,6,1
"SPIRE2","s1321_S_GON_01_ASEReadCounter.table","NW_015090842.1:10178565",4,5,1
"SPIRE2","s1321_S_GON_01_ASEReadCounter.table","NW_015090842.1:10178587",3,4,1
"SPIRE2","s1321_S_GON_01_ASEReadCounter.table","NW_015090842.1:10178640",3,5,2
"SPIRE2","s1321_S_GON_01_ASEReadCounter.table","NW_015090842.1:10178651",3,5,2
"SPIRE2","s1321_S_GON_01_ASEReadCounter.table","NW_015090842.1:10178682",3,5,2
"TCF25","s1321_S_GON_01_ASEReadCounter.table","NW_015090842.1:10180912",36,103,67
"TCF25","s1321_S_GON_01_ASEReadCounter.table","NW_015090842.1:10180924",38,99,61
"TCF25","s1321_S_GON_01_ASEReadCounter.table","NW_015090842.1:10180931",37,105,68
"TCF25","s1321_S_GON_01_ASEReadCounter.table","NW_015090842.1:10185332",124,322,198
"TCF25","s1321_S_GON_01_ASEReadCounter.table","NW_015090842.1:10196561",105,257,152
"TCF25","s1321_S_GON_01_ASEReadCounter.table","NW_015090842.1:10197399",357,357,0
"MC1R","s1321_S_GON_01_ASEReadCounter.table","NW_015090842.1:10201853",0,1,1
"MC1R","s1321_S_GON_01_ASEReadCounter.table","NW_015090842.1:10202160",1,1,0
"MC1R","s1321_S_GON_01_ASEReadCounter.table","NW_015090842.1:10202447",1,3,2
"GAS8","s1321_S_GON_01_ASEReadCounter.table","NW_015090842.1:10228982",725,1503,778
"GAS8","s1321_S_GON_01_ASEReadCounter.table","NW_015090842.1:10229832",604,1281,677
"GAS8","s1321_S_GON_01_ASEReadCounter.table","NW_015090842.1:10232901",477,935,458
"GAS8","s1321_S_GON_01_ASEReadCounter.table","NW_015090842.1:10232928",390,741,351
"GAS8","s1321_S_GON_01_ASEReadCounter.table","NW_015090842.1:10232967",300,589,289
"GAS8","s1321_S_GON_01_ASEReadCounter.table","NW_015090842.1:10233032",175,341,166
"GAS8","s1321_S_GON_01_ASEReadCounter.table","NW_015090842.1:10233057",125,260,135
"GAS8","s1321_S_GON_01_ASEReadCounter.table","NW_015090842.1:10233058",124,257,133
"GAS8","s1321_S_GON_01_ASEReadCounter.table","NW_015090842.1:10233176",123,235,112
"GAS8","s1321_S_GON_01_ASEReadCounter.table","NW_015090842.1:10233196",113,228,115
"GAS8","s1321_S_GON_01_ASEReadCounter.table","NW_015090842.1:10233252",91,174,83
"GAS8","s1321_S_GON_01_ASEReadCounter.table","NW_015090842.1:10233303",32,62,30
"LOC106888094","s1321_S_GON_01_ASEReadCounter.table","NW_015090842.1:10233334",0,3,3
"LOC106888094","s1321_S_GON_01_ASEReadCounter.table","NW_015090842.1:10233362",1,15,14
"LOC106888094","s1321_S_GON_01_ASEReadCounter.table","NW_015090842.1:10233373",1,18,17
"LOC106888094","s1321_S_GON_01_ASEReadCounter.table","NW_015090842.1:10233388",4,24,20
"LOC106888094","s1321_S_GON_01_ASEReadCounter.table","NW_015090842.1:10233402",5,24,19
"LOC106888094","s1321_S_GON_01_ASEReadCounter.table","NW_015090842.1:10233465",14,38,24
"LOC106888094","s1321_S_GON_01_ASEReadCounter.table","NW_015090842.1:10233803",28,55,27
"LOC106888094","s1321_S_GON_01_ASEReadCounter.table","NW_015090842.1:10233815",25,49,24
"LOC106888094","s1321_S_GON_01_ASEReadCounter.table","NW_015090842.1:10235484",25,32,7
"LOC106888094","s1321_S_GON_01_ASEReadCounter.table","NW_015090842.1:10235611",17,29,12
"LOC106888094","s1321_S_GON_01_ASEReadCounter.table","NW_015090842.1:10235977",11,11,0
"LOC106888094","s1321_S_GON_01_ASEReadCounter.table","NW_015090842.1:10236098",7,15,8
"LOC106888094","s1321_S_GON_01_ASEReadCounter.table","NW_015090842.1:10236161",10,18,8
"LOC106888094","s1321_S_GON_01_ASEReadCounter.table","NW_015090842.1:10236380",9,13,4
"LOC106888094","s1321_S_GON_01_ASEReadCounter.table","NW_015090842.1:10236388",11,15,4
"LOC106888094","s1321_S_GON_01_ASEReadCounter.table","NW_015090842.1:10236425",10,16,6
"LOC106888094","s1321_S_GON_01_ASEReadCounter.table","NW_015090842.1:10236426",10,16,6
"LOC106888094","s1321_S_GON_01_ASEReadCounter.table","NW_015090842.1:10236603",8,13,5
"LOC106888173","s1321_S_GON_01_ASEReadCounter.table","NW_015090842.1:10239596",6,12,6
"LOC106888173","s1321_S_GON_01_ASEReadCounter.table","NW_015090842.1:10240036",20,23,3
"LOC106888173","s1321_S_GON_01_ASEReadCounter.table","NW_015090842.1:10240095",26,33,7
"LOC106888173","s1321_S_GON_01_ASEReadCounter.table","NW_015090842.1:10240280",29,37,8
"LOC106888173","s1321_S_GON_01_ASEReadCounter.table","NW_015090842.1:10240557",41,52,11
"LOC106888173","s1321_S_GON_01_ASEReadCounter.table","NW_015090842.1:10240603",39,48,9
"LOC106888173","s1321_S_GON_01_ASEReadCounter.table","NW_015090842.1:10240609",41,49,8
"LOC106888173","s1321_S_GON_01_ASEReadCounter.table","NW_015090842.1:10240924",16,24,8
"LOC106888173","s1321_S_GON_01_ASEReadCounter.table","NW_015090842.1:10241037",20,30,10
"LOC106888173","s1321_S_GON_01_ASEReadCounter.table","NW_015090842.1:10241046",21,30,9
"LOC106888173","s1321_S_GON_01_ASEReadCounter.table","NW_015090842.1:10241058",23,33,10
"LOC106888173","s1321_S_GON_01_ASEReadCounter.table","NW_015090842.1:10241064",28,40,12
"LOC106888173","s1321_S_GON_01_ASEReadCounter.table","NW_015090842.1:10241163",33,47,14
"LOC106888173","s1321_S_GON_01_ASEReadCounter.table","NW_015090842.1:10241803",42,54,12
"LOC106888173","s1321_S_GON_01_ASEReadCounter.table","NW_015090842.1:10241827",44,57,13
"LOC106888173","s1321_S_GON_01_ASEReadCounter.table","NW_015090842.1:10241869",41,53,12
"LOC106888173","s1321_S_GON_01_ASEReadCounter.table","NW_015090842.1:10242079",37,43,6
"LOC106888173","s1321_S_GON_01_ASEReadCounter.table","NW_015090842.1:10242103",39,47,8
"LOC106888173","s1321_S_GON_01_ASEReadCounter.table","NW_015090842.1:10242157",42,54,12
"LOC106888173","s1321_S_GON_01_ASEReadCounter.table","NW_015090842.1:10242455",45,52,7
"LOC106888173","s1321_S_GON_01_ASEReadCounter.table","NW_015090842.1:10242481",41,50,9
"LOC106888173","s1321_S_GON_01_ASEReadCounter.table","NW_015090842.1:10242590",46,54,8
"LOC106888173","s1321_S_GON_01_ASEReadCounter.table","NW_015090842.1:10242794",38,44,6
"LOC106888173","s1321_S_GON_01_ASEReadCounter.table","NW_015090842.1:10242909",41,52,11
"LOC106888173","s1321_S_GON_01_ASEReadCounter.table","NW_015090842.1:10243094",41,51,10
"LOC106888173","s1321_S_GON_01_ASEReadCounter.table","NW_015090842.1:10243133",34,41,7
"LOC106888173","s1321_S_GON_01_ASEReadCounter.table","NW_015090842.1:10243273",51,62,11
"LOC106888173","s1321_S_GON_01_ASEReadCounter.table","NW_015090842.1:10243278",53,64,11
"LOC106888173","s1321_S_GON_01_ASEReadCounter.table","NW_015090842.1:10243281",53,64,11
"LOC106888173","s1321_S_GON_01_ASEReadCounter.table","NW_015090842.1:10243347",46,46,0
"LOC106888173","s1321_S_GON_01_ASEReadCounter.table","NW_015090842.1:10243353",37,42,5
"LOC106888173","s1321_S_GON_01_ASEReadCounter.table","NW_015090842.1:10243363",29,33,4
"LOC106888173","s1321_S_GON_01_ASEReadCounter.table","NW_015090842.1:10243365",29,33,4
"LOC106888173","s1321_S_GON_01_ASEReadCounter.table","NW_015090842.1:10243529",24,28,4
"LOC106888173","s1321_S_GON_01_ASEReadCounter.table","NW_015090842.1:10243566",38,48,10
"LOC106888173","s1321_S_GON_01_ASEReadCounter.table","NW_015090842.1:10243605",42,52,10
"LOC106888173","s1321_S_GON_01_ASEReadCounter.table","NW_015090842.1:10243614",37,46,9
"LOC106888173","s1321_S_GON_01_ASEReadCounter.table","NW_015090842.1:10243615",35,45,10
"LOC106888173","s1321_S_GON_01_ASEReadCounter.table","NW_015090842.1:10243640",35,47,12
"LOC106888173","s1321_S_GON_01_ASEReadCounter.table","NW_015090842.1:10243680",31,38,7
"LOC106888173","s1321_S_GON_01_ASEReadCounter.table","NW_015090842.1:10243742",42,52,10
"LOC106888173","s1321_S_GON_01_ASEReadCounter.table","NW_015090842.1:10243804",28,34,6
"LOC106888173","s1321_S_GON_01_ASEReadCounter.table","NW_015090842.1:10243913",9,12,3
"LOC106888173","s1321_S_GON_01_ASEReadCounter.table","NW_015090842.1:10243921",7,10,3
"LOC106888384","s1321_S_GON_01_ASEReadCounter.table","NW_015090842.1:10244714",2,3,1
"LOC106888384","s1321_S_GON_01_ASEReadCounter.table","NW_015090842.1:10244998",3,4,1
"LOC106888384","s1321_S_GON_01_ASEReadCounter.table","NW_015090842.1:10250743",5,9,4
"LOC106888384","s1321_S_GON_01_ASEReadCounter.table","NW_015090842.1:10250771",3,7,4
"LOC106888384","s1321_S_GON_01_ASEReadCounter.table","NW_015090842.1:10251343",2,2,0
"LOC106888384","s1321_S_GON_01_ASEReadCounter.table","NW_015090842.1:10251344",2,2,0
"LOC106888384","s1321_S_GON_01_ASEReadCounter.table","NW_015090842.1:10251349",1,1,0
"LOC106888384","s1321_S_GON_01_ASEReadCounter.table","NW_015090842.1:10251354",2,11,9
"LOC106888384","s1321_S_GON_01_ASEReadCounter.table","NW_015090842.1:10251358",2,11,9
"LOC106888384","s1321_S_GON_01_ASEReadCounter.table","NW_015090842.1:10251369",0,10,10
"LOC106888384","s1321_S_GON_01_ASEReadCounter.table","NW_015090842.1:10251370",1,10,9
"LOC106888384","s1321_S_GON_01_ASEReadCounter.table","NW_015090842.1:10251375",1,10,9
"LOC106888384","s1321_S_GON_01_ASEReadCounter.table","NW_015090842.1:10251388",0,9,9
"LOC106888384","s1321_S_GON_01_ASEReadCounter.table","NW_015090842.1:10251390",0,9,9
"LOC106888384","s1321_S_GON_01_ASEReadCounter.table","NW_015090842.1:10251393",0,8,8
"LOC106888384","s1321_S_GON_01_ASEReadCounter.table","NW_015090842.1:10251399",0,7,7
"LOC106888384","s1321_S_GON_01_ASEReadCounter.table","NW_015090842.1:10251492",4,4,0
"LOC106888384","s1321_S_GON_01_ASEReadCounter.table","NW_015090842.1:10253165",4,9,5
"LOC106888384","s1321_S_GON_01_ASEReadCounter.table","NW_015090842.1:10253284",4,6,2
"LOC106888384","s1321_S_GON_01_ASEReadCounter.table","NW_015090842.1:10253605",2,3,1
"LOC106888384","s1321_S_GON_01_ASEReadCounter.table","NW_015090842.1:10254028",3,10,7
"LOC106888384","s1321_S_GON_01_ASEReadCounter.table","NW_015090842.1:10254227",2,3,1
"LOC106888384","s1321_S_GON_01_ASEReadCounter.table","NW_015090842.1:10254233",1,2,1
"LOC106888384","s1321_S_GON_01_ASEReadCounter.table","NW_015090842.1:10254263",2,4,2
"LOC106888384","s1321_S_GON_01_ASEReadCounter.table","NW_015090842.1:10254293",1,5,4
"LOC106888384","s1321_S_GON_01_ASEReadCounter.table","NW_015090842.1:10254570",1,4,3
"LOC106888384","s1321_S_GON_01_ASEReadCounter.table","NW_015090842.1:10254647",0,3,3
"LOC106888384","s1321_S_GON_01_ASEReadCounter.table","NW_015090842.1:10254663",0,3,3
"LOC106888384","s1321_S_GON_01_ASEReadCounter.table","NW_015090842.1:10254840",0,1,1
"LOC106888384","s1321_S_GON_01_ASEReadCounter.table","NW_015090842.1:10254854",3,3,0
"LOC106888384","s1321_S_GON_01_ASEReadCounter.table","NW_015090842.1:10254891",3,3,0
"LOC106888384","s1321_S_GON_01_ASEReadCounter.table","NW_015090842.1:10254900",0,3,3
"LOC106888384","s1321_S_GON_01_ASEReadCounter.table","NW_015090842.1:10254915",0,3,3
"LOC106888384","s1321_S_GON_01_ASEReadCounter.table","NW_015090842.1:10254965",2,2,0
"LOC106888384","s1321_S_GON_01_ASEReadCounter.table","NW_015090842.1:10254975",0,2,2
"LOC106888384","s1321_S_GON_01_ASEReadCounter.table","NW_015090842.1:10255077",1,2,1
"LOC106888384","s1321_S_GON_01_ASEReadCounter.table","NW_015090842.1:10255117",3,7,4
"LOC106888384","s1321_S_GON_01_ASEReadCounter.table","NW_015090842.1:10255138",3,7,4
"LOC106888384","s1321_S_GON_01_ASEReadCounter.table","NW_015090842.1:10255139",3,7,4
"LOC106888384","s1321_S_GON_01_ASEReadCounter.table","NW_015090842.1:10255209",1,5,4
"LOC106888384","s1321_S_GON_01_ASEReadCounter.table","NW_015090842.1:10255211",1,3,2
"LOC106888384","s1321_S_GON_01_ASEReadCounter.table","NW_015090842.1:10255236",1,3,2
"LOC106888384","s1321_S_GON_01_ASEReadCounter.table","NW_015090842.1:10255262",2,4,2
"LOC106888384","s1321_S_GON_01_ASEReadCounter.table","NW_015090842.1:10255264",2,4,2
"LOC106888384","s1321_S_GON_01_ASEReadCounter.table","NW_015090842.1:10255306",5,10,5
"LOC106888384","s1321_S_GON_01_ASEReadCounter.table","NW_015090842.1:10255340",5,11,6
"LOC106888384","s1321_S_GON_01_ASEReadCounter.table","NW_015090842.1:10255410",3,7,4
"LOC106888384","s1321_S_GON_01_ASEReadCounter.table","NW_015090842.1:10255449",2,5,3
"LOC106888384","s1321_S_GON_01_ASEReadCounter.table","NW_015090842.1:10255496",2,5,3
"LOC106888384","s1321_S_GON_01_ASEReadCounter.table","NW_015090842.1:10255505",2,4,2
"LOC106888384","s1321_S_GON_01_ASEReadCounter.table","NW_015090842.1:10255531",3,7,4
"LOC106888384","s1321_S_GON_01_ASEReadCounter.table","NW_015090842.1:10255608",5,9,4
"LOC106888384","s1321_S_GON_01_ASEReadCounter.table","NW_015090842.1:10255614",5,9,4
"LOC106888384","s1321_S_GON_01_ASEReadCounter.table","NW_015090842.1:10255704",64,74,10
"LOC106888384","s1321_S_GON_01_ASEReadCounter.table","NW_015090842.1:10255731",65,76,11
"LOC106888384","s1321_S_GON_01_ASEReadCounter.table","NW_015090842.1:10255771",63,74,11
"TANGO6","s1321_S_GON_01_ASEReadCounter.table","NW_015090842.1:10257782",52,78,26
"TANGO6","s1321_S_GON_01_ASEReadCounter.table","NW_015090842.1:10258162",41,76,35
"TANGO6","s1321_S_GON_01_ASEReadCounter.table","NW_015090842.1:10258185",43,87,44
"TANGO6","s1321_S_GON_01_ASEReadCounter.table","NW_015090842.1:10259267",47,95,48
"TANGO6","s1321_S_GON_01_ASEReadCounter.table","NW_015090842.1:10260250",109,188,79
"TANGO6","s1321_S_GON_01_ASEReadCounter.table","NW_015090842.1:10260979",61,117,56
"TANGO6","s1321_S_GON_01_ASEReadCounter.table","NW_015090842.1:10261599",87,142,55
"TANGO6","s1321_S_GON_01_ASEReadCounter.table","NW_015090842.1:10268425",108,194,86
"TANGO6","s1321_S_GON_01_ASEReadCounter.table","NW_015090842.1:10269831",104,202,98
"TANGO6","s1321_S_GON_01_ASEReadCounter.table","NW_015090842.1:10270813",72,147,75
"TANGO6","s1321_S_GON_01_ASEReadCounter.table","NW_015090842.1:10273952",20,32,12
"TANGO6","s1321_S_GON_01_ASEReadCounter.table","NW_015090842.1:10273970",21,35,14
"TANGO6","s1321_S_GON_01_ASEReadCounter.table","NW_015090842.1:10274018",22,37,15
"TANGO6","s1321_S_GON_01_ASEReadCounter.table","NW_015090842.1:10275974",24,29,5
"TANGO6","s1321_S_GON_01_ASEReadCounter.table","NW_015090842.1:10275976",24,29,5
"TANGO6","s1321_S_GON_01_ASEReadCounter.table","NW_015090842.1:10276123",17,28,11
"TANGO6","s1321_S_GON_01_ASEReadCounter.table","NW_015090842.1:10276271",30,46,16
"TANGO6","s1321_S_GON_01_ASEReadCounter.table","NW_015090842.1:10276272",29,45,16
"TANGO6","s1321_S_GON_01_ASEReadCounter.table","NW_015090842.1:10276275",29,45,16
"TANGO6","s1321_S_GON_01_ASEReadCounter.table","NW_015090842.1:10276278",30,46,16
"TANGO6","s1321_S_GON_01_ASEReadCounter.table","NW_015090842.1:10276368",17,24,7
"TANGO6","s1321_S_GON_01_ASEReadCounter.table","NW_015090842.1:10276373",16,23,7
"TANGO6","s1321_S_GON_01_ASEReadCounter.table","NW_015090842.1:10276630",19,33,14
"TANGO6","s1321_S_GON_01_ASEReadCounter.table","NW_015090842.1:10281498",20,32,12
"TANGO6","s1321_S_GON_01_ASEReadCounter.table","NW_015090842.1:10282842",15,31,16
"TANGO6","s1321_S_GON_01_ASEReadCounter.table","NW_015090842.1:10282863",11,24,13
"TANGO6","s1321_S_GON_01_ASEReadCounter.table","NW_015090842.1:10282869",10,23,13
"TANGO6","s1321_S_GON_01_ASEReadCounter.table","NW_015090842.1:10282903",9,28,19
"TANGO6","s1321_S_GON_01_ASEReadCounter.table","NW_015090842.1:10283757",13,27,14
"TANGO6","s1321_S_GON_01_ASEReadCounter.table","NW_015090842.1:10283785",17,30,13
"HAS3","s1321_S_GON_01_ASEReadCounter.table","NW_015090842.1:10288093",1,9,8
"HAS3","s1321_S_GON_01_ASEReadCounter.table","NW_015090842.1:10288266",3,15,12
"HAS3","s1321_S_GON_01_ASEReadCounter.table","NW_015090842.1:10288274",2,12,10
"HAS3","s1321_S_GON_01_ASEReadCounter.table","NW_015090842.1:10288364",4,13,9
"HAS3","s1321_S_GON_01_ASEReadCounter.table","NW_015090842.1:10288405",4,13,9
"HAS3","s1321_S_GON_01_ASEReadCounter.table","NW_015090842.1:10289469",4,7,3
"HAS3","s1321_S_GON_01_ASEReadCounter.table","NW_015090842.1:10289708",3,11,8
"HAS3","s1321_S_GON_01_ASEReadCounter.table","NW_015090842.1:10290375",0,4,4
"HAS3","s1321_S_GON_01_ASEReadCounter.table","NW_015090842.1:10290395",0,6,6
"HAS3","s1321_S_GON_01_ASEReadCounter.table","NW_015090842.1:10290561",2,9,7
"HAS3","s1321_S_GON_01_ASEReadCounter.table","NW_015090842.1:10290609",3,6,3
"HAS3","s1321_S_GON_01_ASEReadCounter.table","NW_015090842.1:10290666",3,7,4
"HAS3","s1321_S_GON_01_ASEReadCounter.table","NW_015090842.1:10290723",2,8,6
"HAS3","s1321_S_GON_01_ASEReadCounter.table","NW_015090842.1:10290927",4,11,7
"HAS3","s1321_S_GON_01_ASEReadCounter.table","NW_015090842.1:10291004",4,8,4
"CHTF8","s1321_S_GON_01_ASEReadCounter.table","NW_015090842.1:10291319",7,24,17
"CHTF8","s1321_S_GON_01_ASEReadCounter.table","NW_015090842.1:10291342",14,31,17
"CHTF8","s1321_S_GON_01_ASEReadCounter.table","NW_015090842.1:10291491",54,79,25
"CHTF8","s1321_S_GON_01_ASEReadCounter.table","NW_015090842.1:10291520",55,102,47
"CHTF8","s1321_S_GON_01_ASEReadCounter.table","NW_015090842.1:10291593",80,140,60
"CHTF8","s1321_S_GON_01_ASEReadCounter.table","NW_015090842.1:10291600",76,134,58
"CHTF8","s1321_S_GON_01_ASEReadCounter.table","NW_015090842.1:10291609",77,128,51
"CHTF8","s1321_S_GON_01_ASEReadCounter.table","NW_015090842.1:10291639",79,119,40
"CHTF8","s1321_S_GON_01_ASEReadCounter.table","NW_015090842.1:10291641",77,119,42
"CHTF8","s1321_S_GON_01_ASEReadCounter.table","NW_015090842.1:10291648",89,131,42
"CHTF8","s1321_S_GON_01_ASEReadCounter.table","NW_015090842.1:10291656",88,129,41
"CHTF8","s1321_S_GON_01_ASEReadCounter.table","NW_015090842.1:10291675",94,141,47
"CHTF8","s1321_S_GON_01_ASEReadCounter.table","NW_015090842.1:10291696",80,120,40
"CHTF8","s1321_S_GON_01_ASEReadCounter.table","NW_015090842.1:10291714",80,123,43
"CHTF8","s1321_S_GON_01_ASEReadCounter.table","NW_015090842.1:10291732",77,130,53
"CHTF8","s1321_S_GON_01_ASEReadCounter.table","NW_015090842.1:10291755",58,107,49
"CHTF8","s1321_S_GON_01_ASEReadCounter.table","NW_015090842.1:10291756",58,104,46
"CHTF8","s1321_S_GON_01_ASEReadCounter.table","NW_015090842.1:10291758",58,112,54
"CHTF8","s1321_S_GON_01_ASEReadCounter.table","NW_015090842.1:10291792",61,113,52
"CHTF8","s1321_S_GON_01_ASEReadCounter.table","NW_015090842.1:10291895",88,145,57
"CHTF8","s1321_S_GON_01_ASEReadCounter.table","NW_015090842.1:10292132",61,110,49
"CHTF8","s1321_S_GON_01_ASEReadCounter.table","NW_015090842.1:10292314",68,115,47
"CHTF8","s1321_S_GON_01_ASEReadCounter.table","NW_015090842.1:10292317",67,119,52
"CHTF8","s1321_S_GON_01_ASEReadCounter.table","NW_015090842.1:10292928",16,28,12
"UTP4","s1321_S_GON_01_ASEReadCounter.table","NW_015090842.1:10293146",33,83,50
"UTP4","s1321_S_GON_01_ASEReadCounter.table","NW_015090842.1:10293151",33,80,47
"UTP4","s1321_S_GON_01_ASEReadCounter.table","NW_015090842.1:10293191",21,53,32
"UTP4","s1321_S_GON_01_ASEReadCounter.table","NW_015090842.1:10293362",26,65,39
"UTP4","s1321_S_GON_01_ASEReadCounter.table","NW_015090842.1:10293430",25,60,35
"UTP4","s1321_S_GON_01_ASEReadCounter.table","NW_015090842.1:10293625",30,63,33
"UTP4","s1321_S_GON_01_ASEReadCounter.table","NW_015090842.1:10293684",31,63,32
"UTP4","s1321_S_GON_01_ASEReadCounter.table","NW_015090842.1:10294093",25,48,23
"UTP4","s1321_S_GON_01_ASEReadCounter.table","NW_015090842.1:10294568",27,69,42
"UTP4","s1321_S_GON_01_ASEReadCounter.table","NW_015090842.1:10294622",23,52,29
"UTP4","s1321_S_GON_01_ASEReadCounter.table","NW_015090842.1:10294632",25,58,33
"UTP4","s1321_S_GON_01_ASEReadCounter.table","NW_015090842.1:10295238",28,53,25
"UTP4","s1321_S_GON_01_ASEReadCounter.table","NW_015090842.1:10295880",38,71,33
"UTP4","s1321_S_GON_01_ASEReadCounter.table","NW_015090842.1:10295884",37,72,35
"UTP4","s1321_S_GON_01_ASEReadCounter.table","NW_015090842.1:10295903",37,66,29
"UTP4","s1321_S_GON_01_ASEReadCounter.table","NW_015090842.1:10295906",37,66,29
"UTP4","s1321_S_GON_01_ASEReadCounter.table","NW_015090842.1:10295915",35,63,28
"UTP4","s1321_S_GON_01_ASEReadCounter.table","NW_015090842.1:10295938",33,65,32
"UTP4","s1321_S_GON_01_ASEReadCounter.table","NW_015090842.1:10296175",32,55,23
"UTP4","s1321_S_GON_01_ASEReadCounter.table","NW_015090842.1:10296660",27,55,28
"UTP4","s1321_S_GON_01_ASEReadCounter.table","NW_015090842.1:10296679",24,51,27
"UTP4","s1321_S_GON_01_ASEReadCounter.table","NW_015090842.1:10297193",35,66,31
"UTP4","s1321_S_GON_01_ASEReadCounter.table","NW_015090842.1:10297220",43,81,38
"UTP4","s1321_S_GON_01_ASEReadCounter.table","NW_015090842.1:10297307",38,75,37
"UTP4","s1321_S_GON_01_ASEReadCounter.table","NW_015090842.1:10297558",42,80,38
"UTP4","s1321_S_GON_01_ASEReadCounter.table","NW_015090842.1:10297943",22,64,42
"UTP4","s1321_S_GON_01_ASEReadCounter.table","NW_015090842.1:10297979",27,66,39
"UTP4","s1321_S_GON_01_ASEReadCounter.table","NW_015090842.1:10298022",20,41,21
"UTP4","s1321_S_GON_01_ASEReadCounter.table","NW_015090842.1:10298079",2,10,8
"UTP4","s1321_S_GON_01_ASEReadCounter.table","NW_015090842.1:10298081",2,10,8
"UTP4","s1321_S_GON_01_ASEReadCounter.table","NW_015090842.1:10298082",2,9,7
"SNTB2","s1321_S_GON_01_ASEReadCounter.table","NW_015090842.1:10298905",3,5,2
"SNTB2","s1321_S_GON_01_ASEReadCounter.table","NW_015090842.1:10298928",7,10,3
"SNTB2","s1321_S_GON_01_ASEReadCounter.table","NW_015090842.1:10303506",16,33,17
"SNTB2","s1321_S_GON_01_ASEReadCounter.table","NW_015090842.1:10303524",16,29,13
"SNTB2","s1321_S_GON_01_ASEReadCounter.table","NW_015090842.1:10304059",8,17,9
"SNTB2","s1321_S_GON_01_ASEReadCounter.table","NW_015090842.1:10304089",10,22,12
"SNTB2","s1321_S_GON_01_ASEReadCounter.table","NW_015090842.1:10304167",9,24,15
"SNTB2","s1321_S_GON_01_ASEReadCounter.table","NW_015090842.1:10304176",11,27,16
"SNTB2","s1321_S_GON_01_ASEReadCounter.table","NW_015090842.1:10305069",16,30,14
"SNTB2","s1321_S_GON_01_ASEReadCounter.table","NW_015090842.1:10305099",12,26,14
"SNTB2","s1321_S_GON_01_ASEReadCounter.table","NW_015090842.1:10305451",9,24,15
"SNTB2","s1321_S_GON_01_ASEReadCounter.table","NW_015090842.1:10305547",15,31,16
"SNTB2","s1321_S_GON_01_ASEReadCounter.table","NW_015090842.1:10305847",12,22,10
"SNTB2","s1321_S_GON_01_ASEReadCounter.table","NW_015090842.1:10305911",7,24,17
"SNTB2","s1321_S_GON_01_ASEReadCounter.table","NW_015090842.1:10306173",12,23,11
"SNTB2","s1321_S_GON_01_ASEReadCounter.table","NW_015090842.1:10306275",3,12,9
"SNTB2","s1321_S_GON_01_ASEReadCounter.table","NW_015090842.1:10306457",9,21,12
"SNTB2","s1321_S_GON_01_ASEReadCounter.table","NW_015090842.1:10306496",9,18,9
"SNTB2","s1321_S_GON_01_ASEReadCounter.table","NW_015090842.1:10306499",9,15,6
"VPS4A","s1321_S_GON_01_ASEReadCounter.table","NW_015090842.1:10308566",118,284,166
"VPS4A","s1321_S_GON_01_ASEReadCounter.table","NW_015090842.1:10308573",124,296,172
"VPS4A","s1321_S_GON_01_ASEReadCounter.table","NW_015090842.1:10308856",177,442,265
"VPS4A","s1321_S_GON_01_ASEReadCounter.table","NW_015090842.1:10309056",197,518,321
"VPS4A","s1321_S_GON_01_ASEReadCounter.table","NW_015090842.1:10309089",223,546,323
"VPS4A","s1321_S_GON_01_ASEReadCounter.table","NW_015090842.1:10309392",246,515,269
"VPS4A","s1321_S_GON_01_ASEReadCounter.table","NW_015090842.1:10309413",250,527,277
"VPS4A","s1321_S_GON_01_ASEReadCounter.table","NW_015090842.1:10309467",246,573,327
"VPS4A","s1321_S_GON_01_ASEReadCounter.table","NW_015090842.1:10310230",260,650,390
"VPS4A","s1321_S_GON_01_ASEReadCounter.table","NW_015090842.1:10310425",225,559,334
"VPS4A","s1321_S_GON_01_ASEReadCounter.table","NW_015090842.1:10310639",249,602,353
"VPS4A","s1321_S_GON_01_ASEReadCounter.table","NW_015090842.1:10310640",251,609,358
"VPS4A","s1321_S_GON_01_ASEReadCounter.table","NW_015090842.1:10310687",266,595,329
"VPS4A","s1321_S_GON_01_ASEReadCounter.table","NW_015090842.1:10310734",219,482,263
"VPS4A","s1321_S_GON_01_ASEReadCounter.table","NW_015090842.1:10310737",228,493,265
"VPS4A","s1321_S_GON_01_ASEReadCounter.table","NW_015090842.1:10310746",211,484,273
"VPS4A","s1321_S_GON_01_ASEReadCounter.table","NW_015090842.1:10310767",216,480,264
"VPS4A","s1321_S_GON_01_ASEReadCounter.table","NW_015090842.1:10310995",238,482,244
"VPS4A","s1321_S_GON_01_ASEReadCounter.table","NW_015090842.1:10311004",234,454,220
"VPS4A","s1321_S_GON_01_ASEReadCounter.table","NW_015090842.1:10311007",238,469,231
"VPS4A","s1321_S_GON_01_ASEReadCounter.table","NW_015090842.1:10311013",240,463,223
"VPS4A","s1321_S_GON_01_ASEReadCounter.table","NW_015090842.1:10311022",210,436,226
"VPS4A","s1321_S_GON_01_ASEReadCounter.table","NW_015090842.1:10311023",212,439,227
"VPS4A","s1321_S_GON_01_ASEReadCounter.table","NW_015090842.1:10311426",210,508,298
"VPS4A","s1321_S_GON_01_ASEReadCounter.table","NW_015090842.1:10311489",2,12,10
"VPS4A","s1321_S_GON_01_ASEReadCounter.table","NW_015090842.1:10311490",4,10,6
"VPS4A","s1321_S_GON_01_ASEReadCounter.table","NW_015090842.1:10311525",9,24,15
"VPS4A","s1321_S_GON_01_ASEReadCounter.table","NW_015090842.1:10311529",9,30,21
"VPS4A","s1321_S_GON_01_ASEReadCounter.table","NW_015090842.1:10311530",9,31,22
"VPS4A","s1321_S_GON_01_ASEReadCounter.table","NW_015090842.1:10311552",32,59,27
"VPS4A","s1321_S_GON_01_ASEReadCounter.table","NW_015090842.1:10311689",19,48,29
"VPS4A","s1321_S_GON_01_ASEReadCounter.table","NW_015090842.1:10311700",27,57,30
"VPS4A","s1321_S_GON_01_ASEReadCounter.table","NW_015090842.1:10311701",28,61,33
"VPS4A","s1321_S_GON_01_ASEReadCounter.table","NW_015090842.1:10311703",27,63,36
"COG8","s1321_S_GON_01_ASEReadCounter.table","NW_015090842.1:10313487",27,76,49
"COG8","s1321_S_GON_01_ASEReadCounter.table","NW_015090842.1:10313559",38,98,60
"COG8","s1321_S_GON_01_ASEReadCounter.table","NW_015090842.1:10313579",37,95,58
"COG8","s1321_S_GON_01_ASEReadCounter.table","NW_015090842.1:10313665",37,76,39
"COG8","s1321_S_GON_01_ASEReadCounter.table","NW_015090842.1:10313681",41,84,43
"COG8","s1321_S_GON_01_ASEReadCounter.table","NW_015090842.1:10313768",43,109,66
"COG8","s1321_S_GON_01_ASEReadCounter.table","NW_015090842.1:10313775",46,111,65
"COG8","s1321_S_GON_01_ASEReadCounter.table","NW_015090842.1:10313811",38,94,56
"COG8","s1321_S_GON_01_ASEReadCounter.table","NW_015090842.1:10313858",24,73,49
"COG8","s1321_S_GON_01_ASEReadCounter.table","NW_015090842.1:10313859",70,70,0
"COG8","s1321_S_GON_01_ASEReadCounter.table","NW_015090842.1:10314100",37,93,56
"COG8","s1321_S_GON_01_ASEReadCounter.table","NW_015090842.1:10314213",48,104,56
"COG8","s1321_S_GON_01_ASEReadCounter.table","NW_015090842.1:10315093",35,82,47
"COG8","s1321_S_GON_01_ASEReadCounter.table","NW_015090842.1:10315162",37,89,52
"COG8","s1321_S_GON_01_ASEReadCounter.table","NW_015090842.1:10315285",56,101,45
"COG8","s1321_S_GON_01_ASEReadCounter.table","NW_015090842.1:10315360",37,85,48
"COG8","s1321_S_GON_01_ASEReadCounter.table","NW_015090842.1:10315369",42,91,49
"COG8","s1321_S_GON_01_ASEReadCounter.table","NW_015090842.1:10315508",19,52,33
"COG8","s1321_S_GON_01_ASEReadCounter.table","NW_015090842.1:10315624",44,103,59
"COG8","s1321_S_GON_01_ASEReadCounter.table","NW_015090842.1:10315693",40,96,56
"COG8","s1321_S_GON_01_ASEReadCounter.table","NW_015090842.1:10315698",40,95,55
"COG8","s1321_S_GON_01_ASEReadCounter.table","NW_015090842.1:10315768",30,82,52
"COG8","s1321_S_GON_01_ASEReadCounter.table","NW_015090842.1:10315769",32,83,51
"COG8","s1321_S_GON_01_ASEReadCounter.table","NW_015090842.1:10315784",31,75,44
"COG8","s1321_S_GON_01_ASEReadCounter.table","NW_015090842.1:10316093",33,75,42
"COG8","s1321_S_GON_01_ASEReadCounter.table","NW_015090842.1:10316133",30,68,38
"NIP7","s1321_S_GON_01_ASEReadCounter.table","NW_015090842.1:10316759",19,36,17
"NIP7","s1321_S_GON_01_ASEReadCounter.table","NW_015090842.1:10316967",131,234,103
"NIP7","s1321_S_GON_01_ASEReadCounter.table","NW_015090842.1:10316995",160,275,115
"NIP7","s1321_S_GON_01_ASEReadCounter.table","NW_015090842.1:10317240",179,330,151
"NIP7","s1321_S_GON_01_ASEReadCounter.table","NW_015090842.1:10317247",171,317,146
"NIP7","s1321_S_GON_01_ASEReadCounter.table","NW_015090842.1:10317264",176,309,133
"NIP7","s1321_S_GON_01_ASEReadCounter.table","NW_015090842.1:10317433",182,331,149
"NIP7","s1321_S_GON_01_ASEReadCounter.table","NW_015090842.1:10317738",129,282,153
"NIP7","s1321_S_GON_01_ASEReadCounter.table","NW_015090842.1:10317769",121,272,151
"NIP7","s1321_S_GON_01_ASEReadCounter.table","NW_015090842.1:10317808",71,162,91
"NIP7","s1321_S_GON_01_ASEReadCounter.table","NW_015090842.1:10317870",46,94,48
"NIP7","s1321_S_GON_01_ASEReadCounter.table","NW_015090842.1:10317871",46,94,48
"NIP7","s1321_S_GON_01_ASEReadCounter.table","NW_015090842.1:10317898",32,64,32
"NIP7","s1321_S_GON_01_ASEReadCounter.table","NW_015090842.1:10317911",30,59,29
"TMED6","s1321_S_GON_01_ASEReadCounter.table","NW_015090842.1:10318514",1,2,1
"TMED6","s1321_S_GON_01_ASEReadCounter.table","NW_015090842.1:10318731",1,2,1
"TERF2","s1321_S_GON_01_ASEReadCounter.table","NW_015090842.1:10321768",48,88,40
"TERF2","s1321_S_GON_01_ASEReadCounter.table","NW_015090842.1:10321777",48,87,39
"TERF2","s1321_S_GON_01_ASEReadCounter.table","NW_015090842.1:10321805",47,102,55
"TERF2","s1321_S_GON_01_ASEReadCounter.table","NW_015090842.1:10321878",67,142,75
"TERF2","s1321_S_GON_01_ASEReadCounter.table","NW_015090842.1:10321893",66,140,74
"TERF2","s1321_S_GON_01_ASEReadCounter.table","NW_015090842.1:10321897",62,128,66
"TERF2","s1321_S_GON_01_ASEReadCounter.table","NW_015090842.1:10321908",49,110,61
"TERF2","s1321_S_GON_01_ASEReadCounter.table","NW_015090842.1:10322001",72,187,115
"TERF2","s1321_S_GON_01_ASEReadCounter.table","NW_015090842.1:10322035",58,149,91
"TERF2","s1321_S_GON_01_ASEReadCounter.table","NW_015090842.1:10322051",57,166,109
"TERF2","s1321_S_GON_01_ASEReadCounter.table","NW_015090842.1:10322137",50,126,76
"TERF2","s1321_S_GON_01_ASEReadCounter.table","NW_015090842.1:10322144",53,122,69
"TERF2","s1321_S_GON_01_ASEReadCounter.table","NW_015090842.1:10322388",40,139,99
"TERF2","s1321_S_GON_01_ASEReadCounter.table","NW_015090842.1:10322396",43,137,94
"TERF2","s1321_S_GON_01_ASEReadCounter.table","NW_015090842.1:10322502",71,164,93
"TERF2","s1321_S_GON_01_ASEReadCounter.table","NW_015090842.1:10322504",71,165,94
"TERF2","s1321_S_GON_01_ASEReadCounter.table","NW_015090842.1:10322510",69,173,104
"TERF2","s1321_S_GON_01_ASEReadCounter.table","NW_015090842.1:10323580",82,188,106
"TERF2","s1321_S_GON_01_ASEReadCounter.table","NW_015090842.1:10324314",69,175,106
"TERF2","s1321_S_GON_01_ASEReadCounter.table","NW_015090842.1:10326832",66,151,85
"TERF2","s1321_S_GON_01_ASEReadCounter.table","NW_015090842.1:10327787",57,129,72
"TERF2","s1321_S_GON_01_ASEReadCounter.table","NW_015090842.1:10328588",72,154,82
"TERF2","s1321_S_GON_01_ASEReadCounter.table","NW_015090842.1:10328644",48,128,80
"TERF2","s1321_S_GON_01_ASEReadCounter.table","NW_015090842.1:10329813",43,109,66
"TERF2","s1321_S_GON_01_ASEReadCounter.table","NW_015090842.1:10330749",47,109,62
"TERF2","s1321_S_GON_01_ASEReadCounter.table","NW_015090842.1:10330789",46,102,56
"CYB5B","s1321_S_GON_01_ASEReadCounter.table","NW_015090842.1:10336595",28,65,37
"CYB5B","s1321_S_GON_01_ASEReadCounter.table","NW_015090842.1:10336667",130,293,163
"CYB5B","s1321_S_GON_01_ASEReadCounter.table","NW_015090842.1:10336689",194,415,221
"CYB5B","s1321_S_GON_01_ASEReadCounter.table","NW_015090842.1:10336728",261,579,318
"CYB5B","s1321_S_GON_01_ASEReadCounter.table","NW_015090842.1:10345068",265,626,361
"CYB5B","s1321_S_GON_01_ASEReadCounter.table","NW_015090842.1:10348800",311,699,388
"CYB5B","s1321_S_GON_01_ASEReadCounter.table","NW_015090842.1:10349046",216,508,292
"CYB5B","s1321_S_GON_01_ASEReadCounter.table","NW_015090842.1:10349119",131,399,268
"CYB5B","s1321_S_GON_01_ASEReadCounter.table","NW_015090842.1:10349146",68,319,251
"CYB5B","s1321_S_GON_01_ASEReadCounter.table","NW_015090842.1:10349157",105,375,270
"CYB5B","s1321_S_GON_01_ASEReadCounter.table","NW_015090842.1:10349263",314,314,0
