"gene","id","snp","ref_count","total_count","alt_count"
"CENPN","s1324_S_RAP_03_ASEReadCounter.table","NW_015090842.1:5801612",0,2,2
"CENPN","s1324_S_RAP_03_ASEReadCounter.table","NW_015090842.1:5801618",0,2,2
"CENPN","s1324_S_RAP_03_ASEReadCounter.table","NW_015090842.1:5801623",0,2,2
"CENPN","s1324_S_RAP_03_ASEReadCounter.table","NW_015090842.1:5801631",0,2,2
"CENPN","s1324_S_RAP_03_ASEReadCounter.table","NW_015090842.1:5801632",0,2,2
"CENPN","s1324_S_RAP_03_ASEReadCounter.table","NW_015090842.1:5801655",2,8,6
"CENPN","s1324_S_RAP_03_ASEReadCounter.table","NW_015090842.1:5801670",3,9,6
"CENPN","s1324_S_RAP_03_ASEReadCounter.table","NW_015090842.1:5801674",3,9,6
"CENPN","s1324_S_RAP_03_ASEReadCounter.table","NW_015090842.1:5801692",3,8,5
"CENPN","s1324_S_RAP_03_ASEReadCounter.table","NW_015090842.1:5802008",7,17,10
"CENPN","s1324_S_RAP_03_ASEReadCounter.table","NW_015090842.1:5802012",7,16,9
"CENPN","s1324_S_RAP_03_ASEReadCounter.table","NW_015090842.1:5802087",8,21,13
"CENPN","s1324_S_RAP_03_ASEReadCounter.table","NW_015090842.1:5810113",22,22,0
"CENPN","s1324_S_RAP_03_ASEReadCounter.table","NW_015090842.1:5810147",30,30,0
"CENPN","s1324_S_RAP_03_ASEReadCounter.table","NW_015090842.1:5810148",30,30,0
"ATMIN","s1324_S_RAP_03_ASEReadCounter.table","NW_015090842.1:5818789",4,5,1
"ATMIN","s1324_S_RAP_03_ASEReadCounter.table","NW_015090842.1:5819958",3,5,2
"ATMIN","s1324_S_RAP_03_ASEReadCounter.table","NW_015090842.1:5820004",4,6,2
"ATMIN","s1324_S_RAP_03_ASEReadCounter.table","NW_015090842.1:5820217",2,6,4
"ATMIN","s1324_S_RAP_03_ASEReadCounter.table","NW_015090842.1:5820250",4,6,2
"ATMIN","s1324_S_RAP_03_ASEReadCounter.table","NW_015090842.1:5820298",5,8,3
"ATMIN","s1324_S_RAP_03_ASEReadCounter.table","NW_015090842.1:5820417",2,5,3
"ATMIN","s1324_S_RAP_03_ASEReadCounter.table","NW_015090842.1:5820421",3,6,3
"ATMIN","s1324_S_RAP_03_ASEReadCounter.table","NW_015090842.1:5820448",5,8,3
"ATMIN","s1324_S_RAP_03_ASEReadCounter.table","NW_015090842.1:5820457",5,8,3
"ATMIN","s1324_S_RAP_03_ASEReadCounter.table","NW_015090842.1:5820510",7,8,1
"ATMIN","s1324_S_RAP_03_ASEReadCounter.table","NW_015090842.1:5820673",5,8,3
"ATMIN","s1324_S_RAP_03_ASEReadCounter.table","NW_015090842.1:5820754",3,6,3
"ATMIN","s1324_S_RAP_03_ASEReadCounter.table","NW_015090842.1:5820820",1,5,4
"ATMIN","s1324_S_RAP_03_ASEReadCounter.table","NW_015090842.1:5820865",3,8,5
"ATMIN","s1324_S_RAP_03_ASEReadCounter.table","NW_015090842.1:5820889",4,9,5
"ATMIN","s1324_S_RAP_03_ASEReadCounter.table","NW_015090842.1:5820891",4,9,5
"ATMIN","s1324_S_RAP_03_ASEReadCounter.table","NW_015090842.1:5820997",5,9,4
"ATMIN","s1324_S_RAP_03_ASEReadCounter.table","NW_015090842.1:5821063",5,8,3
"ATMIN","s1324_S_RAP_03_ASEReadCounter.table","NW_015090842.1:5821132",7,10,3
"ATMIN","s1324_S_RAP_03_ASEReadCounter.table","NW_015090842.1:5821645",9,18,9
"ATMIN","s1324_S_RAP_03_ASEReadCounter.table","NW_015090842.1:5825066",16,33,17
"ATMIN","s1324_S_RAP_03_ASEReadCounter.table","NW_015090842.1:5825106",15,33,18
"ATMIN","s1324_S_RAP_03_ASEReadCounter.table","NW_015090842.1:5825122",15,30,15
"ATMIN","s1324_S_RAP_03_ASEReadCounter.table","NW_015090842.1:5825178",16,33,17
"ATMIN","s1324_S_RAP_03_ASEReadCounter.table","NW_015090842.1:5825194",20,37,17
"ATMIN","s1324_S_RAP_03_ASEReadCounter.table","NW_015090842.1:5825195",20,35,15
"ATMIN","s1324_S_RAP_03_ASEReadCounter.table","NW_015090842.1:5825220",19,32,13
"ATMIN","s1324_S_RAP_03_ASEReadCounter.table","NW_015090842.1:5825240",16,30,14
"ATMIN","s1324_S_RAP_03_ASEReadCounter.table","NW_015090842.1:5825303",22,31,9
"ATMIN","s1324_S_RAP_03_ASEReadCounter.table","NW_015090842.1:5825304",23,33,10
"ATMIN","s1324_S_RAP_03_ASEReadCounter.table","NW_015090842.1:5825310",23,34,11
"ATMIN","s1324_S_RAP_03_ASEReadCounter.table","NW_015090842.1:5825406",20,36,16
"ATMIN","s1324_S_RAP_03_ASEReadCounter.table","NW_015090842.1:5825415",20,37,17
"ATMIN","s1324_S_RAP_03_ASEReadCounter.table","NW_015090842.1:5825438",22,43,21
"ATMIN","s1324_S_RAP_03_ASEReadCounter.table","NW_015090842.1:5825485",23,43,20
"ATMIN","s1324_S_RAP_03_ASEReadCounter.table","NW_015090842.1:5825524",21,42,21
"ATMIN","s1324_S_RAP_03_ASEReadCounter.table","NW_015090842.1:5825557",15,35,20
"ATMIN","s1324_S_RAP_03_ASEReadCounter.table","NW_015090842.1:5825571",12,31,19
"ATMIN","s1324_S_RAP_03_ASEReadCounter.table","NW_015090842.1:5825579",12,31,19
"ATMIN","s1324_S_RAP_03_ASEReadCounter.table","NW_015090842.1:5825590",12,31,19
"ATMIN","s1324_S_RAP_03_ASEReadCounter.table","NW_015090842.1:5825689",21,41,20
"ATMIN","s1324_S_RAP_03_ASEReadCounter.table","NW_015090842.1:5825703",25,46,21
"ATMIN","s1324_S_RAP_03_ASEReadCounter.table","NW_015090842.1:5825787",21,44,23
"ATMIN","s1324_S_RAP_03_ASEReadCounter.table","NW_015090842.1:5825833",23,50,27
"ATMIN","s1324_S_RAP_03_ASEReadCounter.table","NW_015090842.1:5825841",20,45,25
"ATMIN","s1324_S_RAP_03_ASEReadCounter.table","NW_015090842.1:5825895",26,64,38
"ATMIN","s1324_S_RAP_03_ASEReadCounter.table","NW_015090842.1:5825984",22,58,36
"ATMIN","s1324_S_RAP_03_ASEReadCounter.table","NW_015090842.1:5826162",33,67,34
"ATMIN","s1324_S_RAP_03_ASEReadCounter.table","NW_015090842.1:5826194",32,72,40
"ATMIN","s1324_S_RAP_03_ASEReadCounter.table","NW_015090842.1:5826235",37,75,38
"ATMIN","s1324_S_RAP_03_ASEReadCounter.table","NW_015090842.1:5826245",37,75,38
"ATMIN","s1324_S_RAP_03_ASEReadCounter.table","NW_015090842.1:5826335",19,46,27
"ATMIN","s1324_S_RAP_03_ASEReadCounter.table","NW_015090842.1:5826417",25,58,33
"ATMIN","s1324_S_RAP_03_ASEReadCounter.table","NW_015090842.1:5826431",19,67,48
"ATMIN","s1324_S_RAP_03_ASEReadCounter.table","NW_015090842.1:5826438",23,57,34
"ATMIN","s1324_S_RAP_03_ASEReadCounter.table","NW_015090842.1:5826463",33,79,46
"ATMIN","s1324_S_RAP_03_ASEReadCounter.table","NW_015090842.1:5826502",44,95,51
"ATMIN","s1324_S_RAP_03_ASEReadCounter.table","NW_015090842.1:5826511",44,97,53
"ATMIN","s1324_S_RAP_03_ASEReadCounter.table","NW_015090842.1:5826659",47,86,39
"ATMIN","s1324_S_RAP_03_ASEReadCounter.table","NW_015090842.1:5826701",49,97,48
"ATMIN","s1324_S_RAP_03_ASEReadCounter.table","NW_015090842.1:5826702",48,95,47
"ATMIN","s1324_S_RAP_03_ASEReadCounter.table","NW_015090842.1:5826732",40,96,56
"ATMIN","s1324_S_RAP_03_ASEReadCounter.table","NW_015090842.1:5826745",49,102,53
"ATMIN","s1324_S_RAP_03_ASEReadCounter.table","NW_015090842.1:5826835",62,105,43
"ATMIN","s1324_S_RAP_03_ASEReadCounter.table","NW_015090842.1:5826910",48,100,52
"ATMIN","s1324_S_RAP_03_ASEReadCounter.table","NW_015090842.1:5826942",36,89,53
"ATMIN","s1324_S_RAP_03_ASEReadCounter.table","NW_015090842.1:5827193",59,128,69
"ATMIN","s1324_S_RAP_03_ASEReadCounter.table","NW_015090842.1:5827196",57,128,71
"ATMIN","s1324_S_RAP_03_ASEReadCounter.table","NW_015090842.1:5827269",60,134,74
"ATMIN","s1324_S_RAP_03_ASEReadCounter.table","NW_015090842.1:5827315",44,103,59
"ATMIN","s1324_S_RAP_03_ASEReadCounter.table","NW_015090842.1:5827316",44,108,64
"ATMIN","s1324_S_RAP_03_ASEReadCounter.table","NW_015090842.1:5827333",49,111,62
"PPP1R3E","s1324_S_RAP_03_ASEReadCounter.table","NW_015090842.1:5837733",5,9,4
"PPP1R3E","s1324_S_RAP_03_ASEReadCounter.table","NW_015090842.1:5837947",3,7,4
"PKD1L2","s1324_S_RAP_03_ASEReadCounter.table","NW_015090842.1:5867509",2,2,0
"PKD1L2","s1324_S_RAP_03_ASEReadCounter.table","NW_015090842.1:5867597",2,2,0
"PKD1L2","s1324_S_RAP_03_ASEReadCounter.table","NW_015090842.1:5867600",2,2,0
"PKD1L2","s1324_S_RAP_03_ASEReadCounter.table","NW_015090842.1:5867660",3,3,0
"PKD1L2","s1324_S_RAP_03_ASEReadCounter.table","NW_015090842.1:5867675",3,3,0
"PKD1L2","s1324_S_RAP_03_ASEReadCounter.table","NW_015090842.1:5867788",1,1,0
"BCO1","s1324_S_RAP_03_ASEReadCounter.table","NW_015090842.1:5915610",1,4,3
"BCO1","s1324_S_RAP_03_ASEReadCounter.table","NW_015090842.1:5915646",2,7,5
"BCO1","s1324_S_RAP_03_ASEReadCounter.table","NW_015090842.1:5917836",2,7,5
"BCO1","s1324_S_RAP_03_ASEReadCounter.table","NW_015090842.1:5917912",6,9,3
"BCO1","s1324_S_RAP_03_ASEReadCounter.table","NW_015090842.1:5917941",6,8,2
"BCO1","s1324_S_RAP_03_ASEReadCounter.table","NW_015090842.1:5917971",8,11,3
"BCO1","s1324_S_RAP_03_ASEReadCounter.table","NW_015090842.1:5921679",7,11,4
"BCO1","s1324_S_RAP_03_ASEReadCounter.table","NW_015090842.1:5921726",3,8,5
"BCO1","s1324_S_RAP_03_ASEReadCounter.table","NW_015090842.1:5925669",5,8,3
"BCO1","s1324_S_RAP_03_ASEReadCounter.table","NW_015090842.1:5925753",5,6,1
"BCO1","s1324_S_RAP_03_ASEReadCounter.table","NW_015090842.1:5926937",7,10,3
"BCO1","s1324_S_RAP_03_ASEReadCounter.table","NW_015090842.1:5927921",4,6,2
"BCO1","s1324_S_RAP_03_ASEReadCounter.table","NW_015090842.1:5927948",4,6,2
"BCO1","s1324_S_RAP_03_ASEReadCounter.table","NW_015090842.1:5927968",4,8,4
"BCO1","s1324_S_RAP_03_ASEReadCounter.table","NW_015090842.1:5928052",9,13,4
"BCO1","s1324_S_RAP_03_ASEReadCounter.table","NW_015090842.1:5932726",11,15,4
"BCO1","s1324_S_RAP_03_ASEReadCounter.table","NW_015090842.1:5932801",20,24,4
"BCO1","s1324_S_RAP_03_ASEReadCounter.table","NW_015090842.1:5934558",18,25,7
"BCO1","s1324_S_RAP_03_ASEReadCounter.table","NW_015090842.1:5934575",23,30,7
"BCO1","s1324_S_RAP_03_ASEReadCounter.table","NW_015090842.1:5934608",27,34,7
"BCO1","s1324_S_RAP_03_ASEReadCounter.table","NW_015090842.1:5934647",29,34,5
"BCO1","s1324_S_RAP_03_ASEReadCounter.table","NW_015090842.1:5934725",17,19,2
"BCO1","s1324_S_RAP_03_ASEReadCounter.table","NW_015090842.1:5934726",17,19,2
"BCO1","s1324_S_RAP_03_ASEReadCounter.table","NW_015090842.1:5934733",13,14,1
"BCO1","s1324_S_RAP_03_ASEReadCounter.table","NW_015090842.1:5934821",13,18,5
"BCO1","s1324_S_RAP_03_ASEReadCounter.table","NW_015090842.1:5934826",12,18,6
"BCO1","s1324_S_RAP_03_ASEReadCounter.table","NW_015090842.1:5934844",10,15,5
"BCO1","s1324_S_RAP_03_ASEReadCounter.table","NW_015090842.1:5934958",17,23,6
"BCO1","s1324_S_RAP_03_ASEReadCounter.table","NW_015090842.1:5934976",19,25,6
"GAN","s1324_S_RAP_03_ASEReadCounter.table","NW_015090842.1:5953759",9,21,12
"GAN","s1324_S_RAP_03_ASEReadCounter.table","NW_015090842.1:5957502",22,45,23
"GAN","s1324_S_RAP_03_ASEReadCounter.table","NW_015090842.1:5957578",21,43,22
"GAN","s1324_S_RAP_03_ASEReadCounter.table","NW_015090842.1:5965028",14,46,32
"GAN","s1324_S_RAP_03_ASEReadCounter.table","NW_015090842.1:5966047",23,50,27
"GAN","s1324_S_RAP_03_ASEReadCounter.table","NW_015090842.1:5966126",23,62,39
"GAN","s1324_S_RAP_03_ASEReadCounter.table","NW_015090842.1:5966127",23,62,39
"GAN","s1324_S_RAP_03_ASEReadCounter.table","NW_015090842.1:5966162",36,77,41
"GAN","s1324_S_RAP_03_ASEReadCounter.table","NW_015090842.1:5966483",41,87,46
"CMIP","s1324_S_RAP_03_ASEReadCounter.table","NW_015090842.1:6109159",22,37,15
"CMIP","s1324_S_RAP_03_ASEReadCounter.table","NW_015090842.1:6109166",22,39,17
"CMIP","s1324_S_RAP_03_ASEReadCounter.table","NW_015090842.1:6114641",33,61,28
"CMIP","s1324_S_RAP_03_ASEReadCounter.table","NW_015090842.1:6114751",31,56,25
"CMIP","s1324_S_RAP_03_ASEReadCounter.table","NW_015090842.1:6114824",27,49,22
"CMIP","s1324_S_RAP_03_ASEReadCounter.table","NW_015090842.1:6128998",48,89,41
"CMIP","s1324_S_RAP_03_ASEReadCounter.table","NW_015090842.1:6130562",82,163,81
"CMIP","s1324_S_RAP_03_ASEReadCounter.table","NW_015090842.1:6132522",82,146,64
"CMIP","s1324_S_RAP_03_ASEReadCounter.table","NW_015090842.1:6134088",69,141,72
"CMIP","s1324_S_RAP_03_ASEReadCounter.table","NW_015090842.1:6138265",107,259,152
"CMIP","s1324_S_RAP_03_ASEReadCounter.table","NW_015090842.1:6138300",111,272,161
"CMIP","s1324_S_RAP_03_ASEReadCounter.table","NW_015090842.1:6138342",95,228,133
"CMIP","s1324_S_RAP_03_ASEReadCounter.table","NW_015090842.1:6138343",96,230,134
"CMIP","s1324_S_RAP_03_ASEReadCounter.table","NW_015090842.1:6138345",93,229,136
"CMIP","s1324_S_RAP_03_ASEReadCounter.table","NW_015090842.1:6138647",94,168,74
"CMIP","s1324_S_RAP_03_ASEReadCounter.table","NW_015090842.1:6138745",108,194,86
"CMIP","s1324_S_RAP_03_ASEReadCounter.table","NW_015090842.1:6138832",21,64,43
"CMIP","s1324_S_RAP_03_ASEReadCounter.table","NW_015090842.1:6138967",93,174,81
"CMIP","s1324_S_RAP_03_ASEReadCounter.table","NW_015090842.1:6139131",69,122,53
"CMIP","s1324_S_RAP_03_ASEReadCounter.table","NW_015090842.1:6139163",33,79,46
"CMIP","s1324_S_RAP_03_ASEReadCounter.table","NW_015090842.1:6139360",62,101,39
"CMIP","s1324_S_RAP_03_ASEReadCounter.table","NW_015090842.1:6139572",43,78,35
"CMIP","s1324_S_RAP_03_ASEReadCounter.table","NW_015090842.1:6139773",98,98,0
"PLCG2","s1324_S_RAP_03_ASEReadCounter.table","NW_015090842.1:6179613",2,12,10
"PLCG2","s1324_S_RAP_03_ASEReadCounter.table","NW_015090842.1:6179658",3,11,8
"PLCG2","s1324_S_RAP_03_ASEReadCounter.table","NW_015090842.1:6203766",0,7,7
"PLCG2","s1324_S_RAP_03_ASEReadCounter.table","NW_015090842.1:6203775",0,6,6
"PLCG2","s1324_S_RAP_03_ASEReadCounter.table","NW_015090842.1:6203787",0,6,6
"PLCG2","s1324_S_RAP_03_ASEReadCounter.table","NW_015090842.1:6205047",1,7,6
"PLCG2","s1324_S_RAP_03_ASEReadCounter.table","NW_015090842.1:6208541",0,6,6
"PLCG2","s1324_S_RAP_03_ASEReadCounter.table","NW_015090842.1:6209741",1,4,3
"PLCG2","s1324_S_RAP_03_ASEReadCounter.table","NW_015090842.1:6209798",0,2,2
"PLCG2","s1324_S_RAP_03_ASEReadCounter.table","NW_015090842.1:6209816",1,4,3
"PLCG2","s1324_S_RAP_03_ASEReadCounter.table","NW_015090842.1:6217547",3,13,10
"PLCG2","s1324_S_RAP_03_ASEReadCounter.table","NW_015090842.1:6218641",0,6,6
"PLCG2","s1324_S_RAP_03_ASEReadCounter.table","NW_015090842.1:6220552",0,12,12
"PLCG2","s1324_S_RAP_03_ASEReadCounter.table","NW_015090842.1:6221969",2,6,4
"PLCG2","s1324_S_RAP_03_ASEReadCounter.table","NW_015090842.1:6228672",1,9,8
"PLCG2","s1324_S_RAP_03_ASEReadCounter.table","NW_015090842.1:6228694",0,7,7
"PLCG2","s1324_S_RAP_03_ASEReadCounter.table","NW_015090842.1:6228722",1,8,7
"PLCG2","s1324_S_RAP_03_ASEReadCounter.table","NW_015090842.1:6228747",1,12,11
"PLCG2","s1324_S_RAP_03_ASEReadCounter.table","NW_015090842.1:6228835",1,13,12
"PLCG2","s1324_S_RAP_03_ASEReadCounter.table","NW_015090842.1:6228841",1,15,14
"PLCG2","s1324_S_RAP_03_ASEReadCounter.table","NW_015090842.1:6228865",2,18,16
"PLCG2","s1324_S_RAP_03_ASEReadCounter.table","NW_015090842.1:6228917",2,21,19
"PLCG2","s1324_S_RAP_03_ASEReadCounter.table","NW_015090842.1:6228926",2,21,19
"PLCG2","s1324_S_RAP_03_ASEReadCounter.table","NW_015090842.1:6228954",1,13,12
"PLCG2","s1324_S_RAP_03_ASEReadCounter.table","NW_015090842.1:6229002",2,15,13
"PLCG2","s1324_S_RAP_03_ASEReadCounter.table","NW_015090842.1:6229006",2,14,12
"PLCG2","s1324_S_RAP_03_ASEReadCounter.table","NW_015090842.1:6229081",1,8,7
"PLCG2","s1324_S_RAP_03_ASEReadCounter.table","NW_015090842.1:6229097",2,8,6
"PLCG2","s1324_S_RAP_03_ASEReadCounter.table","NW_015090842.1:6229160",1,8,7
"PLCG2","s1324_S_RAP_03_ASEReadCounter.table","NW_015090842.1:6229213",1,7,6
"PLCG2","s1324_S_RAP_03_ASEReadCounter.table","NW_015090842.1:6229231",1,9,8
"PLCG2","s1324_S_RAP_03_ASEReadCounter.table","NW_015090842.1:6229663",2,6,4
"PLCG2","s1324_S_RAP_03_ASEReadCounter.table","NW_015090842.1:6229748",3,7,4
"PLCG2","s1324_S_RAP_03_ASEReadCounter.table","NW_015090842.1:6229892",4,7,3
"PLCG2","s1324_S_RAP_03_ASEReadCounter.table","NW_015090842.1:6230248",2,6,4
"PLCG2","s1324_S_RAP_03_ASEReadCounter.table","NW_015090842.1:6230255",2,8,6
"PLCG2","s1324_S_RAP_03_ASEReadCounter.table","NW_015090842.1:6230296",3,8,5
"PLCG2","s1324_S_RAP_03_ASEReadCounter.table","NW_015090842.1:6230349",4,8,4
"PLCG2","s1324_S_RAP_03_ASEReadCounter.table","NW_015090842.1:6230381",4,5,1
"PLCG2","s1324_S_RAP_03_ASEReadCounter.table","NW_015090842.1:6230408",3,6,3
"PLCG2","s1324_S_RAP_03_ASEReadCounter.table","NW_015090842.1:6230439",2,4,2
"PLCG2","s1324_S_RAP_03_ASEReadCounter.table","NW_015090842.1:6230898",5,9,4
"PLCG2","s1324_S_RAP_03_ASEReadCounter.table","NW_015090842.1:6230976",6,11,5
"PLCG2","s1324_S_RAP_03_ASEReadCounter.table","NW_015090842.1:6231078",10,12,2
"PLCG2","s1324_S_RAP_03_ASEReadCounter.table","NW_015090842.1:6231138",10,11,1
"PLCG2","s1324_S_RAP_03_ASEReadCounter.table","NW_015090842.1:6231177",11,12,1
"PLCG2","s1324_S_RAP_03_ASEReadCounter.table","NW_015090842.1:6231263",14,15,1
"PLCG2","s1324_S_RAP_03_ASEReadCounter.table","NW_015090842.1:6231309",12,13,1
"SDR42E1","s1324_S_RAP_03_ASEReadCounter.table","NW_015090842.1:6235292",1,11,10
"SDR42E1","s1324_S_RAP_03_ASEReadCounter.table","NW_015090842.1:6235315",2,13,11
"SDR42E1","s1324_S_RAP_03_ASEReadCounter.table","NW_015090842.1:6235348",4,18,14
"SDR42E1","s1324_S_RAP_03_ASEReadCounter.table","NW_015090842.1:6235355",4,17,13
"SDR42E1","s1324_S_RAP_03_ASEReadCounter.table","NW_015090842.1:6235417",4,20,16
"SDR42E1","s1324_S_RAP_03_ASEReadCounter.table","NW_015090842.1:6235526",20,20,0
"SDR42E1","s1324_S_RAP_03_ASEReadCounter.table","NW_015090842.1:6235558",1,23,22
"SDR42E1","s1324_S_RAP_03_ASEReadCounter.table","NW_015090842.1:6235603",24,24,0
"SDR42E1","s1324_S_RAP_03_ASEReadCounter.table","NW_015090842.1:6235741",9,29,20
"SDR42E1","s1324_S_RAP_03_ASEReadCounter.table","NW_015090842.1:6235777",7,22,15
"SDR42E1","s1324_S_RAP_03_ASEReadCounter.table","NW_015090842.1:6235806",7,21,14
"SDR42E1","s1324_S_RAP_03_ASEReadCounter.table","NW_015090842.1:6235809",5,19,14
"SDR42E1","s1324_S_RAP_03_ASEReadCounter.table","NW_015090842.1:6235816",5,18,13
"SDR42E1","s1324_S_RAP_03_ASEReadCounter.table","NW_015090842.1:6235914",6,18,12
"SDR42E1","s1324_S_RAP_03_ASEReadCounter.table","NW_015090842.1:6235935",7,20,13
"SDR42E1","s1324_S_RAP_03_ASEReadCounter.table","NW_015090842.1:6235957",6,21,15
"SDR42E1","s1324_S_RAP_03_ASEReadCounter.table","NW_015090842.1:6236040",2,11,9
"SDR42E1","s1324_S_RAP_03_ASEReadCounter.table","NW_015090842.1:6236260",2,12,10
"SDR42E1","s1324_S_RAP_03_ASEReadCounter.table","NW_015090842.1:6236281",1,9,8
"SDR42E1","s1324_S_RAP_03_ASEReadCounter.table","NW_015090842.1:6236305",2,11,9
"SDR42E1","s1324_S_RAP_03_ASEReadCounter.table","NW_015090842.1:6236458",4,12,8
"SDR42E1","s1324_S_RAP_03_ASEReadCounter.table","NW_015090842.1:6236476",4,8,4
"SDR42E1","s1324_S_RAP_03_ASEReadCounter.table","NW_015090842.1:6236608",3,10,7
"SDR42E1","s1324_S_RAP_03_ASEReadCounter.table","NW_015090842.1:6238244",2,10,8
"SDR42E1","s1324_S_RAP_03_ASEReadCounter.table","NW_015090842.1:6238829",0,4,4
"HSD17B2","s1324_S_RAP_03_ASEReadCounter.table","NW_015090842.1:6257616",0,1,1
"HSD17B2","s1324_S_RAP_03_ASEReadCounter.table","NW_015090842.1:6257684",0,1,1
"HSD17B2","s1324_S_RAP_03_ASEReadCounter.table","NW_015090842.1:6262974",0,1,1
"HSD17B2","s1324_S_RAP_03_ASEReadCounter.table","NW_015090842.1:6266125",0,2,2
"HSD17B2","s1324_S_RAP_03_ASEReadCounter.table","NW_015090842.1:6266135",0,1,1
"HSD17B2","s1324_S_RAP_03_ASEReadCounter.table","NW_015090842.1:6266795",0,1,1
"HSD17B2","s1324_S_RAP_03_ASEReadCounter.table","NW_015090842.1:6266944",0,1,1
"HSD17B2","s1324_S_RAP_03_ASEReadCounter.table","NW_015090842.1:6266997",0,2,2
"HSD17B2","s1324_S_RAP_03_ASEReadCounter.table","NW_015090842.1:6267053",0,1,1
"HSD17B2","s1324_S_RAP_03_ASEReadCounter.table","NW_015090842.1:6267196",0,1,1
"HSD17B2","s1324_S_RAP_03_ASEReadCounter.table","NW_015090842.1:6267273",0,2,2
"HSD17B2","s1324_S_RAP_03_ASEReadCounter.table","NW_015090842.1:6267358",0,1,1
"HSD17B2","s1324_S_RAP_03_ASEReadCounter.table","NW_015090842.1:6268098",0,2,2
"HSD17B2","s1324_S_RAP_03_ASEReadCounter.table","NW_015090842.1:6268180",0,1,1
"HSD17B2","s1324_S_RAP_03_ASEReadCounter.table","NW_015090842.1:6268203",0,3,3
"ARY2","s1324_S_RAP_03_ASEReadCounter.table","NW_015090842.1:6303922",19,25,6
"ARY2","s1324_S_RAP_03_ASEReadCounter.table","NW_015090842.1:6303954",16,25,9
"ARY2","s1324_S_RAP_03_ASEReadCounter.table","NW_015090842.1:6303979",14,23,9
"ARY2","s1324_S_RAP_03_ASEReadCounter.table","NW_015090842.1:6305848",14,17,3
"ARY2","s1324_S_RAP_03_ASEReadCounter.table","NW_015090842.1:6305856",13,16,3
"ARY2","s1324_S_RAP_03_ASEReadCounter.table","NW_015090842.1:6305857",13,16,3
"ARY2","s1324_S_RAP_03_ASEReadCounter.table","NW_015090842.1:6306017",12,15,3
"ARY2","s1324_S_RAP_03_ASEReadCounter.table","NW_015090842.1:6306052",14,22,8
"ARY2","s1324_S_RAP_03_ASEReadCounter.table","NW_015090842.1:6306094",18,28,10
"ARY2","s1324_S_RAP_03_ASEReadCounter.table","NW_015090842.1:6306100",20,32,12
"ARY2","s1324_S_RAP_03_ASEReadCounter.table","NW_015090842.1:6306146",22,33,11
"ARY2","s1324_S_RAP_03_ASEReadCounter.table","NW_015090842.1:6306147",23,35,12
"ARY2","s1324_S_RAP_03_ASEReadCounter.table","NW_015090842.1:6306390",16,26,10
"ARY2","s1324_S_RAP_03_ASEReadCounter.table","NW_015090842.1:6306567",26,33,7
"ARY2","s1324_S_RAP_03_ASEReadCounter.table","NW_015090842.1:6306705",26,34,8
"ARY2","s1324_S_RAP_03_ASEReadCounter.table","NW_015090842.1:6306713",33,33,0
"ARY2","s1324_S_RAP_03_ASEReadCounter.table","NW_015090842.1:6306773",17,22,5
"ARY2","s1324_S_RAP_03_ASEReadCounter.table","NW_015090842.1:6307039",21,31,10
"ARY2","s1324_S_RAP_03_ASEReadCounter.table","NW_015090842.1:6307043",21,32,11
"ARY2","s1324_S_RAP_03_ASEReadCounter.table","NW_015090842.1:6307093",25,36,11
"ARY2","s1324_S_RAP_03_ASEReadCounter.table","NW_015090842.1:6307138",28,40,12
"ARY2","s1324_S_RAP_03_ASEReadCounter.table","NW_015090842.1:6307157",31,44,13
"ARY2","s1324_S_RAP_03_ASEReadCounter.table","NW_015090842.1:6307187",44,52,8
"ARY2","s1324_S_RAP_03_ASEReadCounter.table","NW_015090842.1:6307278",24,35,11
"ARY2","s1324_S_RAP_03_ASEReadCounter.table","NW_015090842.1:6307305",28,34,6
"ARY2","s1324_S_RAP_03_ASEReadCounter.table","NW_015090842.1:6307318",30,37,7
"ARY2","s1324_S_RAP_03_ASEReadCounter.table","NW_015090842.1:6307429",33,44,11
"ARY2","s1324_S_RAP_03_ASEReadCounter.table","NW_015090842.1:6307487",23,38,15
"ARY2","s1324_S_RAP_03_ASEReadCounter.table","NW_015090842.1:6307670",20,25,5
"ARYL","s1324_S_RAP_03_ASEReadCounter.table","NW_015090842.1:6313360",5,9,4
"ARYL","s1324_S_RAP_03_ASEReadCounter.table","NW_015090842.1:6313377",4,7,3
"ARYL","s1324_S_RAP_03_ASEReadCounter.table","NW_015090842.1:6313767",5,12,7
"ARY1","s1324_S_RAP_03_ASEReadCounter.table","NW_015090842.1:6313909",11,11,0
"ARY1","s1324_S_RAP_03_ASEReadCounter.table","NW_015090842.1:6314296",7,9,2
"ARY1","s1324_S_RAP_03_ASEReadCounter.table","NW_015090842.1:6314541",11,12,1
"ARY1","s1324_S_RAP_03_ASEReadCounter.table","NW_015090842.1:6314597",14,17,3
"ARY1","s1324_S_RAP_03_ASEReadCounter.table","NW_015090842.1:6314750",11,17,6
"ARY1","s1324_S_RAP_03_ASEReadCounter.table","NW_015090842.1:6314794",9,15,6
"ARY1","s1324_S_RAP_03_ASEReadCounter.table","NW_015090842.1:6314827",12,20,8
"ARY1","s1324_S_RAP_03_ASEReadCounter.table","NW_015090842.1:6314843",13,22,9
"ARY1","s1324_S_RAP_03_ASEReadCounter.table","NW_015090842.1:6314859",15,24,9
"ARY1","s1324_S_RAP_03_ASEReadCounter.table","NW_015090842.1:6314886",18,28,10
"ARY1","s1324_S_RAP_03_ASEReadCounter.table","NW_015090842.1:6314943",18,18,0
"ARY1","s1324_S_RAP_03_ASEReadCounter.table","NW_015090842.1:6314949",18,18,0
"ARY1","s1324_S_RAP_03_ASEReadCounter.table","NW_015090842.1:6315022",19,22,3
"ARY1","s1324_S_RAP_03_ASEReadCounter.table","NW_015090842.1:6315026",19,22,3
"ARY1","s1324_S_RAP_03_ASEReadCounter.table","NW_015090842.1:6315043",14,16,2
"ARY1","s1324_S_RAP_03_ASEReadCounter.table","NW_015090842.1:6315065",13,19,6
"ARY1","s1324_S_RAP_03_ASEReadCounter.table","NW_015090842.1:6315409",9,16,7
"ARY1","s1324_S_RAP_03_ASEReadCounter.table","NW_015090842.1:6315479",17,27,10
"ARY1","s1324_S_RAP_03_ASEReadCounter.table","NW_015090842.1:6318342",13,22,9
"ARY1","s1324_S_RAP_03_ASEReadCounter.table","NW_015090842.1:6318427",20,32,12
"ARY1","s1324_S_RAP_03_ASEReadCounter.table","NW_015090842.1:6318603",20,27,7
"ARY1","s1324_S_RAP_03_ASEReadCounter.table","NW_015090842.1:6318708",14,25,11
"ARY1","s1324_S_RAP_03_ASEReadCounter.table","NW_015090842.1:6318858",15,22,7
"ARY1","s1324_S_RAP_03_ASEReadCounter.table","NW_015090842.1:6318952",23,31,8
"MPHOSPH6","s1324_S_RAP_03_ASEReadCounter.table","NW_015090842.1:6324063",47,107,60
"MPHOSPH6","s1324_S_RAP_03_ASEReadCounter.table","NW_015090842.1:6324174",89,195,106
"MPHOSPH6","s1324_S_RAP_03_ASEReadCounter.table","NW_015090842.1:6324270",100,223,123
"MPHOSPH6","s1324_S_RAP_03_ASEReadCounter.table","NW_015090842.1:6324762",79,167,88
"MPHOSPH6","s1324_S_RAP_03_ASEReadCounter.table","NW_015090842.1:6324772",75,157,82
"MPHOSPH6","s1324_S_RAP_03_ASEReadCounter.table","NW_015090842.1:6324780",70,148,78
"MPHOSPH6","s1324_S_RAP_03_ASEReadCounter.table","NW_015090842.1:6324902",92,193,101
"MPHOSPH6","s1324_S_RAP_03_ASEReadCounter.table","NW_015090842.1:6324910",196,196,0
"MPHOSPH6","s1324_S_RAP_03_ASEReadCounter.table","NW_015090842.1:6325066",93,188,95
"MPHOSPH6","s1324_S_RAP_03_ASEReadCounter.table","NW_015090842.1:6325089",101,206,105
"MPHOSPH6","s1324_S_RAP_03_ASEReadCounter.table","NW_015090842.1:6325298",125,260,135
"MPHOSPH6","s1324_S_RAP_03_ASEReadCounter.table","NW_015090842.1:6325877",88,185,97
"MPHOSPH6","s1324_S_RAP_03_ASEReadCounter.table","NW_015090842.1:6326976",48,124,76
"CDH13","s1324_S_RAP_03_ASEReadCounter.table","NW_015090842.1:6662283",7,16,9
"CDH13","s1324_S_RAP_03_ASEReadCounter.table","NW_015090842.1:6693665",9,24,15
"CDH13","s1324_S_RAP_03_ASEReadCounter.table","NW_015090842.1:6693697",12,23,11
"CDH13","s1324_S_RAP_03_ASEReadCounter.table","NW_015090842.1:6693712",12,22,10
"CDH13","s1324_S_RAP_03_ASEReadCounter.table","NW_015090842.1:6693723",12,19,7
"CDH13","s1324_S_RAP_03_ASEReadCounter.table","NW_015090842.1:6693738",12,21,9
"CDH13","s1324_S_RAP_03_ASEReadCounter.table","NW_015090842.1:6823730",19,36,17
"CDH13","s1324_S_RAP_03_ASEReadCounter.table","NW_015090842.1:6889713",24,39,15
"CDH13","s1324_S_RAP_03_ASEReadCounter.table","NW_015090842.1:6955167",42,67,25
"MLYCD","s1324_S_RAP_03_ASEReadCounter.table","NW_015090842.1:7150054",84,150,66
"MLYCD","s1324_S_RAP_03_ASEReadCounter.table","NW_015090842.1:7150131",120,235,115
"MLYCD","s1324_S_RAP_03_ASEReadCounter.table","NW_015090842.1:7150585",91,160,69
"MLYCD","s1324_S_RAP_03_ASEReadCounter.table","NW_015090842.1:7150686",61,120,59
"MLYCD","s1324_S_RAP_03_ASEReadCounter.table","NW_015090842.1:7150696",64,127,63
"MLYCD","s1324_S_RAP_03_ASEReadCounter.table","NW_015090842.1:7150698",125,125,0
"MLYCD","s1324_S_RAP_03_ASEReadCounter.table","NW_015090842.1:7150869",65,115,50
"MLYCD","s1324_S_RAP_03_ASEReadCounter.table","NW_015090842.1:7151100",72,116,44
"MLYCD","s1324_S_RAP_03_ASEReadCounter.table","NW_015090842.1:7151127",69,118,49
"MLYCD","s1324_S_RAP_03_ASEReadCounter.table","NW_015090842.1:7157538",38,76,38
"MLYCD","s1324_S_RAP_03_ASEReadCounter.table","NW_015090842.1:7167662",17,33,16
"MLYCD","s1324_S_RAP_03_ASEReadCounter.table","NW_015090842.1:7167675",21,38,17
"MLYCD","s1324_S_RAP_03_ASEReadCounter.table","NW_015090842.1:7167710",20,35,15
"MLYCD","s1324_S_RAP_03_ASEReadCounter.table","NW_015090842.1:7167781",16,26,10
"MLYCD","s1324_S_RAP_03_ASEReadCounter.table","NW_015090842.1:7167803",12,16,4
"MLYCD","s1324_S_RAP_03_ASEReadCounter.table","NW_015090842.1:7167812",11,16,5
"MLYCD","s1324_S_RAP_03_ASEReadCounter.table","NW_015090842.1:7167845",15,22,7
"MLYCD","s1324_S_RAP_03_ASEReadCounter.table","NW_015090842.1:7167862",14,24,10
"MLYCD","s1324_S_RAP_03_ASEReadCounter.table","NW_015090842.1:7167929",9,23,14
"MLYCD","s1324_S_RAP_03_ASEReadCounter.table","NW_015090842.1:7167995",7,22,15
"MLYCD","s1324_S_RAP_03_ASEReadCounter.table","NW_015090842.1:7168005",10,24,14
"MLYCD","s1324_S_RAP_03_ASEReadCounter.table","NW_015090842.1:7168037",12,25,13
"HSBP1","s1324_S_RAP_03_ASEReadCounter.table","NW_015090842.1:7245192",377,632,255
"HSBP1","s1324_S_RAP_03_ASEReadCounter.table","NW_015090842.1:7245226",416,731,315
"HSBP1","s1324_S_RAP_03_ASEReadCounter.table","NW_015090842.1:7245257",364,632,268
"HSBP1","s1324_S_RAP_03_ASEReadCounter.table","NW_015090842.1:7245296",330,616,286
"HSBP1","s1324_S_RAP_03_ASEReadCounter.table","NW_015090842.1:7245389",479,846,367
"HSBP1","s1324_S_RAP_03_ASEReadCounter.table","NW_015090842.1:7245400",502,852,350
"HSBP1","s1324_S_RAP_03_ASEReadCounter.table","NW_015090842.1:7245445",451,828,377
"HSBP1","s1324_S_RAP_03_ASEReadCounter.table","NW_015090842.1:7245495",418,755,337
"HSBP1","s1324_S_RAP_03_ASEReadCounter.table","NW_015090842.1:7245515",453,832,379
"HSBP1","s1324_S_RAP_03_ASEReadCounter.table","NW_015090842.1:7245733",301,555,254
"HSBP1","s1324_S_RAP_03_ASEReadCounter.table","NW_015090842.1:7245771",321,554,233
"HSBP1","s1324_S_RAP_03_ASEReadCounter.table","NW_015090842.1:7245813",317,519,202
"HSBP1","s1324_S_RAP_03_ASEReadCounter.table","NW_015090842.1:7245926",341,599,258
"HSBP1","s1324_S_RAP_03_ASEReadCounter.table","NW_015090842.1:7245927",339,593,254
"HSBP1","s1324_S_RAP_03_ASEReadCounter.table","NW_015090842.1:7245933",352,598,246
"HSBP1","s1324_S_RAP_03_ASEReadCounter.table","NW_015090842.1:7246002",266,472,206
"HSBP1","s1324_S_RAP_03_ASEReadCounter.table","NW_015090842.1:7246094",309,533,224
"HSBP1","s1324_S_RAP_03_ASEReadCounter.table","NW_015090842.1:7246167",326,546,220
"HSBP1","s1324_S_RAP_03_ASEReadCounter.table","NW_015090842.1:7246183",291,503,212
"HSBP1","s1324_S_RAP_03_ASEReadCounter.table","NW_015090842.1:7247285",34,41,7
"HSBP1","s1324_S_RAP_03_ASEReadCounter.table","NW_015090842.1:7247651",390,758,368
"HSBP1","s1324_S_RAP_03_ASEReadCounter.table","NW_015090842.1:7247657",380,752,372
"HSBP1","s1324_S_RAP_03_ASEReadCounter.table","NW_015090842.1:7248520",301,537,236
"HSBP1","s1324_S_RAP_03_ASEReadCounter.table","NW_015090842.1:7248535",260,456,196
"KCNG4","s1324_S_RAP_03_ASEReadCounter.table","NW_015090842.1:7282481",5,15,10
"KCNG4","s1324_S_RAP_03_ASEReadCounter.table","NW_015090842.1:7282500",6,15,9
"KCNG4","s1324_S_RAP_03_ASEReadCounter.table","NW_015090842.1:7282542",6,10,4
"KCNG4","s1324_S_RAP_03_ASEReadCounter.table","NW_015090842.1:7282579",6,10,4
"KCNG4","s1324_S_RAP_03_ASEReadCounter.table","NW_015090842.1:7282630",4,8,4
"KCNG4","s1324_S_RAP_03_ASEReadCounter.table","NW_015090842.1:7282760",2,8,6
"KCNG4","s1324_S_RAP_03_ASEReadCounter.table","NW_015090842.1:7283056",1,3,2
"KCNG4","s1324_S_RAP_03_ASEReadCounter.table","NW_015090842.1:7283245",0,1,1
"KCNG4","s1324_S_RAP_03_ASEReadCounter.table","NW_015090842.1:7299491",1,6,5
"KCNG4","s1324_S_RAP_03_ASEReadCounter.table","NW_015090842.1:7301195",0,2,2
"KCNG4","s1324_S_RAP_03_ASEReadCounter.table","NW_015090842.1:7301227",0,1,1
"KCNG4","s1324_S_RAP_03_ASEReadCounter.table","NW_015090842.1:7301240",0,1,1
"WFDC1","s1324_S_RAP_03_ASEReadCounter.table","NW_015090842.1:7366517",3,3,0
"ATP2C2","s1324_S_RAP_03_ASEReadCounter.table","NW_015090842.1:7413747",0,9,9
"TLDC1","s1324_S_RAP_03_ASEReadCounter.table","NW_015090842.1:7421997",75,123,48
"COTL1","s1324_S_RAP_03_ASEReadCounter.table","NW_015090842.1:7490707",580,1244,664
"COTL1","s1324_S_RAP_03_ASEReadCounter.table","NW_015090842.1:7490708",578,1245,667
"COTL1","s1324_S_RAP_03_ASEReadCounter.table","NW_015090842.1:7490711",591,1259,668
"COTL1","s1324_S_RAP_03_ASEReadCounter.table","NW_015090842.1:7490739",559,1202,643
"COTL1","s1324_S_RAP_03_ASEReadCounter.table","NW_015090842.1:7490785",537,1159,622
"COTL1","s1324_S_RAP_03_ASEReadCounter.table","NW_015090842.1:7490820",61,752,691
"COTL1","s1324_S_RAP_03_ASEReadCounter.table","NW_015090842.1:7490846",555,1131,576
"KLHL36","s1324_S_RAP_03_ASEReadCounter.table","NW_015090842.1:7526337",30,30,0
"KLHL36","s1324_S_RAP_03_ASEReadCounter.table","NW_015090842.1:7537681",119,119,0
"USP10","s1324_S_RAP_03_ASEReadCounter.table","NW_015090842.1:7572213",49,88,39
"USP10","s1324_S_RAP_03_ASEReadCounter.table","NW_015090842.1:7572358",53,53,0
"CRISPLD2","s1324_S_RAP_03_ASEReadCounter.table","NW_015090842.1:7619796",1,2,1
"CRISPLD2","s1324_S_RAP_03_ASEReadCounter.table","NW_015090842.1:7630779",7,7,0
"CRISPLD2","s1324_S_RAP_03_ASEReadCounter.table","NW_015090842.1:7633611",5,5,0
"CRISPLD2","s1324_S_RAP_03_ASEReadCounter.table","NW_015090842.1:7633787",4,8,4
"CRISPLD2","s1324_S_RAP_03_ASEReadCounter.table","NW_015090842.1:7634023",1,3,2
"CRISPLD2","s1324_S_RAP_03_ASEReadCounter.table","NW_015090842.1:7634620",5,5,0
"MTHFSD","s1324_S_RAP_03_ASEReadCounter.table","NW_015090842.1:8152578",25,40,15
"DUSP15","s1324_S_RAP_03_ASEReadCounter.table","NW_015090842.1:8422840",0,1,1
"DUSP15","s1324_S_RAP_03_ASEReadCounter.table","NW_015090842.1:8431988",0,2,2
"EMC8","s1324_S_RAP_03_ASEReadCounter.table","NW_015090842.1:8452385",16,38,22
"GINS2","s1324_S_RAP_03_ASEReadCounter.table","NW_015090842.1:8467469",35,35,0
"GINS2","s1324_S_RAP_03_ASEReadCounter.table","NW_015090842.1:8470290",36,75,39
"GINS2","s1324_S_RAP_03_ASEReadCounter.table","NW_015090842.1:8470305",32,74,42
"GINS2","s1324_S_RAP_03_ASEReadCounter.table","NW_015090842.1:8470376",31,77,46
"GINS2","s1324_S_RAP_03_ASEReadCounter.table","NW_015090842.1:8471057",4,13,9
"GSE1","s1324_S_RAP_03_ASEReadCounter.table","NW_015090842.1:8483570",13,13,0
"KIAA0513","s1324_S_RAP_03_ASEReadCounter.table","NW_015090842.1:8674736",154,155,1
"KIAA0513","s1324_S_RAP_03_ASEReadCounter.table","NW_015090842.1:8687268",2,2,0
"KIAA0513","s1324_S_RAP_03_ASEReadCounter.table","NW_015090842.1:8693655",10,10,0
"ZCCHC14","s1324_S_RAP_03_ASEReadCounter.table","NW_015090842.1:8750189",81,81,0
"JPH3","s1324_S_RAP_03_ASEReadCounter.table","NW_015090842.1:8872294",67,130,63
"KLHDC4","s1324_S_RAP_03_ASEReadCounter.table","NW_015090842.1:8891175",130,236,106
"KLHDC4","s1324_S_RAP_03_ASEReadCounter.table","NW_015090842.1:8905251",33,57,24
"KLHDC4","s1324_S_RAP_03_ASEReadCounter.table","NW_015090842.1:8919630",7,11,4
"SLC7A5","s1324_S_RAP_03_ASEReadCounter.table","NW_015090842.1:8940382",238,238,0
"SLC7A5","s1324_S_RAP_03_ASEReadCounter.table","NW_015090842.1:8941818",169,169,0
"SLC7A5","s1324_S_RAP_03_ASEReadCounter.table","NW_015090842.1:8944655",75,75,0
"CA5A","s1324_S_RAP_03_ASEReadCounter.table","NW_015090842.1:8989479",147,245,98
"CA5A","s1324_S_RAP_03_ASEReadCounter.table","NW_015090842.1:8989562",194,313,119
"CA5A","s1324_S_RAP_03_ASEReadCounter.table","NW_015090842.1:8989609",194,327,133
"CA5A","s1324_S_RAP_03_ASEReadCounter.table","NW_015090842.1:8989693",203,373,170
"CA5A","s1324_S_RAP_03_ASEReadCounter.table","NW_015090842.1:8989702",210,373,163
"CA5A","s1324_S_RAP_03_ASEReadCounter.table","NW_015090842.1:8989746",222,396,174
"CA5A","s1324_S_RAP_03_ASEReadCounter.table","NW_015090842.1:8989880",170,345,175
"CA5A","s1324_S_RAP_03_ASEReadCounter.table","NW_015090842.1:8989885",181,352,171
"CA5A","s1324_S_RAP_03_ASEReadCounter.table","NW_015090842.1:8989929",190,355,165
"CA5A","s1324_S_RAP_03_ASEReadCounter.table","NW_015090842.1:8990002",169,308,139
"CA5A","s1324_S_RAP_03_ASEReadCounter.table","NW_015090842.1:8990004",166,309,143
"CA5A","s1324_S_RAP_03_ASEReadCounter.table","NW_015090842.1:8990005",165,311,146
"CA5A","s1324_S_RAP_03_ASEReadCounter.table","NW_015090842.1:8990017",169,299,130
"CA5A","s1324_S_RAP_03_ASEReadCounter.table","NW_015090842.1:8990043",152,255,103
"CA5A","s1324_S_RAP_03_ASEReadCounter.table","NW_015090842.1:8990080",123,217,94
"CA5A","s1324_S_RAP_03_ASEReadCounter.table","NW_015090842.1:8990084",123,217,94
"CA5A","s1324_S_RAP_03_ASEReadCounter.table","NW_015090842.1:8990090",135,232,97
"CA5A","s1324_S_RAP_03_ASEReadCounter.table","NW_015090842.1:8990095",127,225,98
"CA5A","s1324_S_RAP_03_ASEReadCounter.table","NW_015090842.1:8990111",106,193,87
"CA5A","s1324_S_RAP_03_ASEReadCounter.table","NW_015090842.1:8990112",106,194,88
"CA5A","s1324_S_RAP_03_ASEReadCounter.table","NW_015090842.1:8990115",123,210,87
"CA5A","s1324_S_RAP_03_ASEReadCounter.table","NW_015090842.1:8990166",132,206,74
"CA5A","s1324_S_RAP_03_ASEReadCounter.table","NW_015090842.1:8990169",143,216,73
"CA5A","s1324_S_RAP_03_ASEReadCounter.table","NW_015090842.1:8990222",117,187,70
"CA5A","s1324_S_RAP_03_ASEReadCounter.table","NW_015090842.1:8990289",108,198,90
"CA5A","s1324_S_RAP_03_ASEReadCounter.table","NW_015090842.1:8990314",107,195,88
"CA5A","s1324_S_RAP_03_ASEReadCounter.table","NW_015090842.1:8990361",102,186,84
"CA5A","s1324_S_RAP_03_ASEReadCounter.table","NW_015090842.1:8990368",103,185,82
"CA5A","s1324_S_RAP_03_ASEReadCounter.table","NW_015090842.1:8990429",105,190,85
"CA5A","s1324_S_RAP_03_ASEReadCounter.table","NW_015090842.1:8990466",82,149,67
"CA5A","s1324_S_RAP_03_ASEReadCounter.table","NW_015090842.1:8990663",105,171,66
"CA5A","s1324_S_RAP_03_ASEReadCounter.table","NW_015090842.1:8990797",69,136,67
"CA5A","s1324_S_RAP_03_ASEReadCounter.table","NW_015090842.1:8990836",95,160,65
"CA5A","s1324_S_RAP_03_ASEReadCounter.table","NW_015090842.1:8990842",95,157,62
"CA5A","s1324_S_RAP_03_ASEReadCounter.table","NW_015090842.1:8990851",90,147,57
"CA5A","s1324_S_RAP_03_ASEReadCounter.table","NW_015090842.1:8990918",93,145,52
"CA5A","s1324_S_RAP_03_ASEReadCounter.table","NW_015090842.1:8990921",82,137,55
"CA5A","s1324_S_RAP_03_ASEReadCounter.table","NW_015090842.1:8990942",99,152,53
"CA5A","s1324_S_RAP_03_ASEReadCounter.table","NW_015090842.1:8991001",119,191,72
"CA5A","s1324_S_RAP_03_ASEReadCounter.table","NW_015090842.1:8991038",106,168,62
"CA5A","s1324_S_RAP_03_ASEReadCounter.table","NW_015090842.1:8991149",98,176,78
"CA5A","s1324_S_RAP_03_ASEReadCounter.table","NW_015090842.1:8991176",105,183,78
"CA5A","s1324_S_RAP_03_ASEReadCounter.table","NW_015090842.1:8991241",93,176,83
"CA5A","s1324_S_RAP_03_ASEReadCounter.table","NW_015090842.1:8991262",83,158,75
"CA5A","s1324_S_RAP_03_ASEReadCounter.table","NW_015090842.1:8991316",73,79,6
"CA5A","s1324_S_RAP_03_ASEReadCounter.table","NW_015090842.1:8991319",73,78,5
"CA5A","s1324_S_RAP_03_ASEReadCounter.table","NW_015090842.1:8991330",69,73,4
"CA5A","s1324_S_RAP_03_ASEReadCounter.table","NW_015090842.1:8991334",67,73,6
"CA5A","s1324_S_RAP_03_ASEReadCounter.table","NW_015090842.1:8991362",76,113,37
"CA5A","s1324_S_RAP_03_ASEReadCounter.table","NW_015090842.1:8991368",81,118,37
"CA5A","s1324_S_RAP_03_ASEReadCounter.table","NW_015090842.1:8991390",86,125,39
"CA5A","s1324_S_RAP_03_ASEReadCounter.table","NW_015090842.1:8991395",90,133,43
"CA5A","s1324_S_RAP_03_ASEReadCounter.table","NW_015090842.1:8991422",72,123,51
"CA5A","s1324_S_RAP_03_ASEReadCounter.table","NW_015090842.1:8991467",75,110,35
"CA5A","s1324_S_RAP_03_ASEReadCounter.table","NW_015090842.1:8991576",60,109,49
"CA5A","s1324_S_RAP_03_ASEReadCounter.table","NW_015090842.1:8991587",71,124,53
"CA5A","s1324_S_RAP_03_ASEReadCounter.table","NW_015090842.1:8991655",79,131,52
"CA5A","s1324_S_RAP_03_ASEReadCounter.table","NW_015090842.1:8991717",75,132,57
"CA5A","s1324_S_RAP_03_ASEReadCounter.table","NW_015090842.1:8991726",73,132,59
"CA5A","s1324_S_RAP_03_ASEReadCounter.table","NW_015090842.1:8991799",66,114,48
"CA5A","s1324_S_RAP_03_ASEReadCounter.table","NW_015090842.1:8991809",60,102,42
"CA5A","s1324_S_RAP_03_ASEReadCounter.table","NW_015090842.1:8991848",60,97,37
"CA5A","s1324_S_RAP_03_ASEReadCounter.table","NW_015090842.1:8991849",61,96,35
"CA5A","s1324_S_RAP_03_ASEReadCounter.table","NW_015090842.1:8991927",67,106,39
"CA5A","s1324_S_RAP_03_ASEReadCounter.table","NW_015090842.1:8991941",66,99,33
"CA5A","s1324_S_RAP_03_ASEReadCounter.table","NW_015090842.1:8992121",52,92,40
"CA5A","s1324_S_RAP_03_ASEReadCounter.table","NW_015090842.1:8992224",57,82,25
"CA5A","s1324_S_RAP_03_ASEReadCounter.table","NW_015090842.1:9002570",24,40,16
"CA5A","s1324_S_RAP_03_ASEReadCounter.table","NW_015090842.1:9002600",25,42,17
"CA5A","s1324_S_RAP_03_ASEReadCounter.table","NW_015090842.1:9004312",18,32,14
"CA5A","s1324_S_RAP_03_ASEReadCounter.table","NW_015090842.1:9004506",3,5,2
"CA5A","s1324_S_RAP_03_ASEReadCounter.table","NW_015090842.1:9004523",3,4,1
"CA5A","s1324_S_RAP_03_ASEReadCounter.table","NW_015090842.1:9004530",4,5,1
"CA5A","s1324_S_RAP_03_ASEReadCounter.table","NW_015090842.1:9004556",3,4,1
"CA5A","s1324_S_RAP_03_ASEReadCounter.table","NW_015090842.1:9004620",2,3,1
"CA5A","s1324_S_RAP_03_ASEReadCounter.table","NW_015090842.1:9005116",6,7,1
"CA5A","s1324_S_RAP_03_ASEReadCounter.table","NW_015090842.1:9005120",6,7,1
"CA5A","s1324_S_RAP_03_ASEReadCounter.table","NW_015090842.1:9005140",4,5,1
"CA5A","s1324_S_RAP_03_ASEReadCounter.table","NW_015090842.1:9005152",5,6,1
"CA5A","s1324_S_RAP_03_ASEReadCounter.table","NW_015090842.1:9011011",1,1,0
"BANP","s1324_S_RAP_03_ASEReadCounter.table","NW_015090842.1:9033407",5,7,2
"BANP","s1324_S_RAP_03_ASEReadCounter.table","NW_015090842.1:9033409",5,7,2
"BANP","s1324_S_RAP_03_ASEReadCounter.table","NW_015090842.1:9033420",5,7,2
"BANP","s1324_S_RAP_03_ASEReadCounter.table","NW_015090842.1:9055284",6,18,12
"ZC3H18","s1324_S_RAP_03_ASEReadCounter.table","NW_015090842.1:9528933",26,56,30
"MVD","s1324_S_RAP_03_ASEReadCounter.table","NW_015090842.1:9550690",56,56,0
"MVD","s1324_S_RAP_03_ASEReadCounter.table","NW_015090842.1:9550691",57,57,0
"MVD","s1324_S_RAP_03_ASEReadCounter.table","NW_015090842.1:9550699",68,68,0
"MVD","s1324_S_RAP_03_ASEReadCounter.table","NW_015090842.1:9550701",66,66,0
"MVD","s1324_S_RAP_03_ASEReadCounter.table","NW_015090842.1:9552202",104,104,0
"MVD","s1324_S_RAP_03_ASEReadCounter.table","NW_015090842.1:9552223",102,103,1
"MVD","s1324_S_RAP_03_ASEReadCounter.table","NW_015090842.1:9552533",82,82,0
"MVD","s1324_S_RAP_03_ASEReadCounter.table","NW_015090842.1:9552644",25,55,30
"PIEZO1","s1324_S_RAP_03_ASEReadCounter.table","NW_015090842.1:9577447",4,11,7
"PIEZO1","s1324_S_RAP_03_ASEReadCounter.table","NW_015090842.1:9579101",7,16,9
"PIEZO1","s1324_S_RAP_03_ASEReadCounter.table","NW_015090842.1:9582630",9,12,3
"PIEZO1","s1324_S_RAP_03_ASEReadCounter.table","NW_015090842.1:9582976",5,10,5
"PIEZO1","s1324_S_RAP_03_ASEReadCounter.table","NW_015090842.1:9583326",5,5,0
"CDT1","s1324_S_RAP_03_ASEReadCounter.table","NW_015090842.1:9596711",1,4,3
"CDT1","s1324_S_RAP_03_ASEReadCounter.table","NW_015090842.1:9597033",10,10,0
"CDT1","s1324_S_RAP_03_ASEReadCounter.table","NW_015090842.1:9597756",6,11,5
"CDT1","s1324_S_RAP_03_ASEReadCounter.table","NW_015090842.1:9598873",13,13,0
"ACSF3","s1324_S_RAP_03_ASEReadCounter.table","NW_015090842.1:9776737",12,20,8
"ACSF3","s1324_S_RAP_03_ASEReadCounter.table","NW_015090842.1:9809639",96,97,1
"ACSF3","s1324_S_RAP_03_ASEReadCounter.table","NW_015090842.1:9834743",75,125,50
"ACSF3","s1324_S_RAP_03_ASEReadCounter.table","NW_015090842.1:9834762",129,129,0
"ACSF3","s1324_S_RAP_03_ASEReadCounter.table","NW_015090842.1:9834852",79,134,55
"ACSF3","s1324_S_RAP_03_ASEReadCounter.table","NW_015090842.1:9834861",64,116,52
"ACSF3","s1324_S_RAP_03_ASEReadCounter.table","NW_015090842.1:9839359",63,95,32
"ACSF3","s1324_S_RAP_03_ASEReadCounter.table","NW_015090842.1:9839378",61,91,30
"ACSF3","s1324_S_RAP_03_ASEReadCounter.table","NW_015090842.1:9839455",70,111,41
"ACSF3","s1324_S_RAP_03_ASEReadCounter.table","NW_015090842.1:9839457",71,108,37
"ACSF3","s1324_S_RAP_03_ASEReadCounter.table","NW_015090842.1:9839489",55,84,29
"ACSF3","s1324_S_RAP_03_ASEReadCounter.table","NW_015090842.1:9839500",37,60,23
"ACSF3","s1324_S_RAP_03_ASEReadCounter.table","NW_015090842.1:9839501",38,61,23
"ACSF3","s1324_S_RAP_03_ASEReadCounter.table","NW_015090842.1:9839504",41,65,24
"ACSF3","s1324_S_RAP_03_ASEReadCounter.table","NW_015090842.1:9839512",34,55,21
"ACSF3","s1324_S_RAP_03_ASEReadCounter.table","NW_015090842.1:9839527",27,46,19
"ACSF3","s1324_S_RAP_03_ASEReadCounter.table","NW_015090842.1:9839533",13,28,15
"ACSF3","s1324_S_RAP_03_ASEReadCounter.table","NW_015090842.1:9839535",14,29,15
"ACSF3","s1324_S_RAP_03_ASEReadCounter.table","NW_015090842.1:9839545",9,22,13
"ACSF3","s1324_S_RAP_03_ASEReadCounter.table","NW_015090842.1:9839550",6,20,14
"ACSF3","s1324_S_RAP_03_ASEReadCounter.table","NW_015090842.1:9839551",7,19,12
"CDH15","s1324_S_RAP_03_ASEReadCounter.table","NW_015090842.1:9847163",0,1,1
"CDH15","s1324_S_RAP_03_ASEReadCounter.table","NW_015090842.1:9848220",2,5,3
"CDH15","s1324_S_RAP_03_ASEReadCounter.table","NW_015090842.1:9848265",1,2,1
"CDH15","s1324_S_RAP_03_ASEReadCounter.table","NW_015090842.1:9848531",1,1,0
"CDH15","s1324_S_RAP_03_ASEReadCounter.table","NW_015090842.1:9848552",2,2,0
"CDH15","s1324_S_RAP_03_ASEReadCounter.table","NW_015090842.1:9848888",1,3,2
"CDH15","s1324_S_RAP_03_ASEReadCounter.table","NW_015090842.1:9849086",3,3,0
"CDH15","s1324_S_RAP_03_ASEReadCounter.table","NW_015090842.1:9849119",1,1,0
"CDH15","s1324_S_RAP_03_ASEReadCounter.table","NW_015090842.1:9849140",1,2,1
"CDH15","s1324_S_RAP_03_ASEReadCounter.table","NW_015090842.1:9849473",1,3,2
"CDH15","s1324_S_RAP_03_ASEReadCounter.table","NW_015090842.1:9850141",3,4,1
"CDH15","s1324_S_RAP_03_ASEReadCounter.table","NW_015090842.1:9850386",3,3,0
"CDH15","s1324_S_RAP_03_ASEReadCounter.table","NW_015090842.1:9850432",2,2,0
"CDH15","s1324_S_RAP_03_ASEReadCounter.table","NW_015090842.1:9850609",3,3,0
"SLC22A31","s1324_S_RAP_03_ASEReadCounter.table","NW_015090842.1:9850797",2,4,2
"SLC22A31","s1324_S_RAP_03_ASEReadCounter.table","NW_015090842.1:9850818",1,3,2
"SLC22A31","s1324_S_RAP_03_ASEReadCounter.table","NW_015090842.1:9850929",1,2,1
"SLC22A31","s1324_S_RAP_03_ASEReadCounter.table","NW_015090842.1:9850936",1,2,1
"SLC22A31","s1324_S_RAP_03_ASEReadCounter.table","NW_015090842.1:9850940",1,2,1
"SLC22A31","s1324_S_RAP_03_ASEReadCounter.table","NW_015090842.1:9850948",1,2,1
"SLC22A31","s1324_S_RAP_03_ASEReadCounter.table","NW_015090842.1:9850961",2,3,1
"SLC22A31","s1324_S_RAP_03_ASEReadCounter.table","NW_015090842.1:9850970",2,4,2
"SLC22A31","s1324_S_RAP_03_ASEReadCounter.table","NW_015090842.1:9850978",2,4,2
"SLC22A31","s1324_S_RAP_03_ASEReadCounter.table","NW_015090842.1:9850981",2,4,2
"SLC22A31","s1324_S_RAP_03_ASEReadCounter.table","NW_015090842.1:9851032",2,3,1
"SLC22A31","s1324_S_RAP_03_ASEReadCounter.table","NW_015090842.1:9851053",2,3,1
"SLC22A31","s1324_S_RAP_03_ASEReadCounter.table","NW_015090842.1:9851130",5,10,5
"SLC22A31","s1324_S_RAP_03_ASEReadCounter.table","NW_015090842.1:9851139",6,12,6
"SLC22A31","s1324_S_RAP_03_ASEReadCounter.table","NW_015090842.1:9851265",13,23,10
"SLC22A31","s1324_S_RAP_03_ASEReadCounter.table","NW_015090842.1:9851302",12,19,7
"SLC22A31","s1324_S_RAP_03_ASEReadCounter.table","NW_015090842.1:9851303",12,19,7
"SLC22A31","s1324_S_RAP_03_ASEReadCounter.table","NW_015090842.1:9851305",12,19,7
"SLC22A31","s1324_S_RAP_03_ASEReadCounter.table","NW_015090842.1:9851343",5,8,3
"SLC22A31","s1324_S_RAP_03_ASEReadCounter.table","NW_015090842.1:9851344",7,9,2
"SLC22A31","s1324_S_RAP_03_ASEReadCounter.table","NW_015090842.1:9851381",11,15,4
"SLC22A31","s1324_S_RAP_03_ASEReadCounter.table","NW_015090842.1:9851421",11,20,9
"SLC22A31","s1324_S_RAP_03_ASEReadCounter.table","NW_015090842.1:9851526",9,19,10
"SLC22A31","s1324_S_RAP_03_ASEReadCounter.table","NW_015090842.1:9851589",8,14,6
"SLC22A31","s1324_S_RAP_03_ASEReadCounter.table","NW_015090842.1:9851712",13,19,6
"SLC22A31","s1324_S_RAP_03_ASEReadCounter.table","NW_015090842.1:9851899",13,20,7
"SLC22A31","s1324_S_RAP_03_ASEReadCounter.table","NW_015090842.1:9852139",10,20,10
"SLC22A31","s1324_S_RAP_03_ASEReadCounter.table","NW_015090842.1:9852380",7,17,10
"SLC22A31","s1324_S_RAP_03_ASEReadCounter.table","NW_015090842.1:9852431",4,8,4
"SLC22A31","s1324_S_RAP_03_ASEReadCounter.table","NW_015090842.1:9852630",6,16,10
"SLC22A31","s1324_S_RAP_03_ASEReadCounter.table","NW_015090842.1:9852711",5,12,7
"SLC22A31","s1324_S_RAP_03_ASEReadCounter.table","NW_015090842.1:9852742",7,13,6
"SLC22A31","s1324_S_RAP_03_ASEReadCounter.table","NW_015090842.1:9853099",6,8,2
"SLC22A31","s1324_S_RAP_03_ASEReadCounter.table","NW_015090842.1:9853102",9,11,2
"SLC22A31","s1324_S_RAP_03_ASEReadCounter.table","NW_015090842.1:9853421",2,3,1
"SLC22A31","s1324_S_RAP_03_ASEReadCounter.table","NW_015090842.1:9853457",3,6,3
"SLC22A31","s1324_S_RAP_03_ASEReadCounter.table","NW_015090842.1:9853502",4,6,2
"ANKRD11","s1324_S_RAP_03_ASEReadCounter.table","NW_015090842.1:9858863",19,40,21
"ANKRD11","s1324_S_RAP_03_ASEReadCounter.table","NW_015090842.1:9859101",158,324,166
"ANKRD11","s1324_S_RAP_03_ASEReadCounter.table","NW_015090842.1:9859352",163,365,202
"ANKRD11","s1324_S_RAP_03_ASEReadCounter.table","NW_015090842.1:9859381",33,192,159
"ANKRD11","s1324_S_RAP_03_ASEReadCounter.table","NW_015090842.1:9859527",77,158,81
"ANKRD11","s1324_S_RAP_03_ASEReadCounter.table","NW_015090842.1:9859529",78,159,81
"ANKRD11","s1324_S_RAP_03_ASEReadCounter.table","NW_015090842.1:9859679",168,309,141
"ANKRD11","s1324_S_RAP_03_ASEReadCounter.table","NW_015090842.1:9861097",136,287,151
"ANKRD11","s1324_S_RAP_03_ASEReadCounter.table","NW_015090842.1:9862571",87,165,78
"ANKRD11","s1324_S_RAP_03_ASEReadCounter.table","NW_015090842.1:9866071",0,95,95
"ANKRD11","s1324_S_RAP_03_ASEReadCounter.table","NW_015090842.1:9866200",0,73,73
"ANKRD11","s1324_S_RAP_03_ASEReadCounter.table","NW_015090842.1:9867391",30,52,22
"ANKRD11","s1324_S_RAP_03_ASEReadCounter.table","NW_015090842.1:9867472",52,104,52
"ANKRD11","s1324_S_RAP_03_ASEReadCounter.table","NW_015090842.1:9867559",52,99,47
"ANKRD11","s1324_S_RAP_03_ASEReadCounter.table","NW_015090842.1:9867934",45,95,50
"ANKRD11","s1324_S_RAP_03_ASEReadCounter.table","NW_015090842.1:9868093",47,95,48
"ANKRD11","s1324_S_RAP_03_ASEReadCounter.table","NW_015090842.1:9868222",52,108,56
"ANKRD11","s1324_S_RAP_03_ASEReadCounter.table","NW_015090842.1:9868327",54,110,56
"ANKRD11","s1324_S_RAP_03_ASEReadCounter.table","NW_015090842.1:9868414",65,131,66
"ANKRD11","s1324_S_RAP_03_ASEReadCounter.table","NW_015090842.1:9868441",69,123,54
"ANKRD11","s1324_S_RAP_03_ASEReadCounter.table","NW_015090842.1:9868444",72,135,63
"ANKRD11","s1324_S_RAP_03_ASEReadCounter.table","NW_015090842.1:9868519",80,174,94
"ANKRD11","s1324_S_RAP_03_ASEReadCounter.table","NW_015090842.1:9868609",85,179,94
"ANKRD11","s1324_S_RAP_03_ASEReadCounter.table","NW_015090842.1:9868666",101,209,108
"ANKRD11","s1324_S_RAP_03_ASEReadCounter.table","NW_015090842.1:9869431",159,300,141
"ANKRD11","s1324_S_RAP_03_ASEReadCounter.table","NW_015090842.1:9869578",237,465,228
"ANKRD11","s1324_S_RAP_03_ASEReadCounter.table","NW_015090842.1:9869734",220,452,232
"ANKRD11","s1324_S_RAP_03_ASEReadCounter.table","NW_015090842.1:9870070",197,414,217
"ANKRD11","s1324_S_RAP_03_ASEReadCounter.table","NW_015090842.1:9870349",200,417,217
"ANKRD11","s1324_S_RAP_03_ASEReadCounter.table","NW_015090842.1:9870604",213,447,234
"ANKRD11","s1324_S_RAP_03_ASEReadCounter.table","NW_015090842.1:9870613",231,480,249
"ANKRD11","s1324_S_RAP_03_ASEReadCounter.table","NW_015090842.1:9870685",277,599,322
"ANKRD11","s1324_S_RAP_03_ASEReadCounter.table","NW_015090842.1:9870847",239,480,241
"ANKRD11","s1324_S_RAP_03_ASEReadCounter.table","NW_015090842.1:9871103",200,388,188
"ANKRD11","s1324_S_RAP_03_ASEReadCounter.table","NW_015090842.1:9871165",199,405,206
"ANKRD11","s1324_S_RAP_03_ASEReadCounter.table","NW_015090842.1:9871820",69,147,78
"ANKRD11","s1324_S_RAP_03_ASEReadCounter.table","NW_015090842.1:9871994",107,107,0
"ANKRD11","s1324_S_RAP_03_ASEReadCounter.table","NW_015090842.1:9872118",74,132,58
"SPG7","s1324_S_RAP_03_ASEReadCounter.table","NW_015090842.1:10051190",106,210,104
"SPG7","s1324_S_RAP_03_ASEReadCounter.table","NW_015090842.1:10051218",123,244,121
"SPG7","s1324_S_RAP_03_ASEReadCounter.table","NW_015090842.1:10052348",148,291,143
"SPG7","s1324_S_RAP_03_ASEReadCounter.table","NW_015090842.1:10052366",146,297,151
"SPG7","s1324_S_RAP_03_ASEReadCounter.table","NW_015090842.1:10065173",182,378,196
"SPG7","s1324_S_RAP_03_ASEReadCounter.table","NW_015090842.1:10065215",162,336,174
"SPG7","s1324_S_RAP_03_ASEReadCounter.table","NW_015090842.1:10066301",112,246,134
"SPG7","s1324_S_RAP_03_ASEReadCounter.table","NW_015090842.1:10066365",170,324,154
"SPG7","s1324_S_RAP_03_ASEReadCounter.table","NW_015090842.1:10069752",188,365,177
"SPG7","s1324_S_RAP_03_ASEReadCounter.table","NW_015090842.1:10069800",183,393,210
"SPG7","s1324_S_RAP_03_ASEReadCounter.table","NW_015090842.1:10071192",213,434,221
"SPG7","s1324_S_RAP_03_ASEReadCounter.table","NW_015090842.1:10071204",210,413,203
"SPG7","s1324_S_RAP_03_ASEReadCounter.table","NW_015090842.1:10071219",219,427,208
"SPG7","s1324_S_RAP_03_ASEReadCounter.table","NW_015090842.1:10071967",194,415,221
"SPG7","s1324_S_RAP_03_ASEReadCounter.table","NW_015090842.1:10075109",348,651,303
"SPG7","s1324_S_RAP_03_ASEReadCounter.table","NW_015090842.1:10075114",345,633,288
"SPG7","s1324_S_RAP_03_ASEReadCounter.table","NW_015090842.1:10075198",267,496,229
"SPG7","s1324_S_RAP_03_ASEReadCounter.table","NW_015090842.1:10075487",200,408,208
"SPG7","s1324_S_RAP_03_ASEReadCounter.table","NW_015090842.1:10075488",199,414,215
"SPG7","s1324_S_RAP_03_ASEReadCounter.table","NW_015090842.1:10075548",158,304,146
"RPL13","s1324_S_RAP_03_ASEReadCounter.table","NW_015090842.1:10076979",2,5,3
"RPL13","s1324_S_RAP_03_ASEReadCounter.table","NW_015090842.1:10077387",531,1184,653
"RPL13","s1324_S_RAP_03_ASEReadCounter.table","NW_015090842.1:10077978",777,1702,925
"RPL13","s1324_S_RAP_03_ASEReadCounter.table","NW_015090842.1:10077992",754,1628,874
"CPNE7","s1324_S_RAP_03_ASEReadCounter.table","NW_015090842.1:10084001",4,5,1
"CPNE7","s1324_S_RAP_03_ASEReadCounter.table","NW_015090842.1:10084856",2,3,1
"CPNE7","s1324_S_RAP_03_ASEReadCounter.table","NW_015090842.1:10084872",1,2,1
"CPNE7","s1324_S_RAP_03_ASEReadCounter.table","NW_015090842.1:10084892",1,2,1
"CPNE7","s1324_S_RAP_03_ASEReadCounter.table","NW_015090842.1:10084921",2,3,1
"CPNE7","s1324_S_RAP_03_ASEReadCounter.table","NW_015090842.1:10084935",3,4,1
"CPNE7","s1324_S_RAP_03_ASEReadCounter.table","NW_015090842.1:10085000",4,4,0
"CPNE7","s1324_S_RAP_03_ASEReadCounter.table","NW_015090842.1:10085089",3,3,0
"CPNE7","s1324_S_RAP_03_ASEReadCounter.table","NW_015090842.1:10085096",3,3,0
"CPNE7","s1324_S_RAP_03_ASEReadCounter.table","NW_015090842.1:10085126",3,3,0
"CPNE7","s1324_S_RAP_03_ASEReadCounter.table","NW_015090842.1:10085180",2,3,1
"CPNE7","s1324_S_RAP_03_ASEReadCounter.table","NW_015090842.1:10085201",3,5,2
"CPNE7","s1324_S_RAP_03_ASEReadCounter.table","NW_015090842.1:10088134",7,9,2
"CPNE7","s1324_S_RAP_03_ASEReadCounter.table","NW_015090842.1:10088146",6,9,3
"CPNE7","s1324_S_RAP_03_ASEReadCounter.table","NW_015090842.1:10088940",11,17,6
"CPNE7","s1324_S_RAP_03_ASEReadCounter.table","NW_015090842.1:10088965",9,14,5
"CPNE7","s1324_S_RAP_03_ASEReadCounter.table","NW_015090842.1:10088967",8,13,5
"CPNE7","s1324_S_RAP_03_ASEReadCounter.table","NW_015090842.1:10088973",9,14,5
"CPNE7","s1324_S_RAP_03_ASEReadCounter.table","NW_015090842.1:10090924",13,16,3
"CPNE7","s1324_S_RAP_03_ASEReadCounter.table","NW_015090842.1:10090930",13,18,5
"CPNE7","s1324_S_RAP_03_ASEReadCounter.table","NW_015090842.1:10091075",12,19,7
"CPNE7","s1324_S_RAP_03_ASEReadCounter.table","NW_015090842.1:10091389",11,18,7
"CPNE7","s1324_S_RAP_03_ASEReadCounter.table","NW_015090842.1:10091407",10,17,7
"CPNE7","s1324_S_RAP_03_ASEReadCounter.table","NW_015090842.1:10091530",9,12,3
"CPNE7","s1324_S_RAP_03_ASEReadCounter.table","NW_015090842.1:10091875",16,25,9
"CPNE7","s1324_S_RAP_03_ASEReadCounter.table","NW_015090842.1:10091983",16,22,6
"CPNE7","s1324_S_RAP_03_ASEReadCounter.table","NW_015090842.1:10091997",13,20,7
"CPNE7","s1324_S_RAP_03_ASEReadCounter.table","NW_015090842.1:10092038",6,10,4
"CPNE7","s1324_S_RAP_03_ASEReadCounter.table","NW_015090842.1:10092140",11,19,8
"CPNE7","s1324_S_RAP_03_ASEReadCounter.table","NW_015090842.1:10092183",5,9,4
"CPNE7","s1324_S_RAP_03_ASEReadCounter.table","NW_015090842.1:10092201",1,5,4
"CPNE7","s1324_S_RAP_03_ASEReadCounter.table","NW_015090842.1:10092230",1,3,2
"CPNE7","s1324_S_RAP_03_ASEReadCounter.table","NW_015090842.1:10092246",1,2,1
"LOC106888185","s1324_S_RAP_03_ASEReadCounter.table","NW_015090842.1:10094965",2,8,6
"LOC106888185","s1324_S_RAP_03_ASEReadCounter.table","NW_015090842.1:10094966",2,7,5
"LOC106888185","s1324_S_RAP_03_ASEReadCounter.table","NW_015090842.1:10094985",3,8,5
"LOC106888185","s1324_S_RAP_03_ASEReadCounter.table","NW_015090842.1:10095055",2,11,9
"LOC106888185","s1324_S_RAP_03_ASEReadCounter.table","NW_015090842.1:10095062",3,13,10
"LOC106888185","s1324_S_RAP_03_ASEReadCounter.table","NW_015090842.1:10095130",2,8,6
"LOC106888185","s1324_S_RAP_03_ASEReadCounter.table","NW_015090842.1:10095265",8,22,14
"LOC106888185","s1324_S_RAP_03_ASEReadCounter.table","NW_015090842.1:10095586",12,26,14
"LOC106888185","s1324_S_RAP_03_ASEReadCounter.table","NW_015090842.1:10095593",13,27,14
"LOC106888185","s1324_S_RAP_03_ASEReadCounter.table","NW_015090842.1:10095616",11,25,14
"LOC106888185","s1324_S_RAP_03_ASEReadCounter.table","NW_015090842.1:10095662",6,17,11
"LOC106888185","s1324_S_RAP_03_ASEReadCounter.table","NW_015090842.1:10095674",4,15,11
"LOC106888185","s1324_S_RAP_03_ASEReadCounter.table","NW_015090842.1:10095786",4,16,12
"LOC106888185","s1324_S_RAP_03_ASEReadCounter.table","NW_015090842.1:10095831",6,18,12
"LOC106888185","s1324_S_RAP_03_ASEReadCounter.table","NW_015090842.1:10096230",11,17,6
"LOC106888185","s1324_S_RAP_03_ASEReadCounter.table","NW_015090842.1:10096249",9,18,9
"LOC106888185","s1324_S_RAP_03_ASEReadCounter.table","NW_015090842.1:10096272",5,12,7
"LOC106888185","s1324_S_RAP_03_ASEReadCounter.table","NW_015090842.1:10096288",6,15,9
"LOC106888185","s1324_S_RAP_03_ASEReadCounter.table","NW_015090842.1:10097248",4,17,13
"LOC106888185","s1324_S_RAP_03_ASEReadCounter.table","NW_015090842.1:10097265",5,19,14
"LOC106888185","s1324_S_RAP_03_ASEReadCounter.table","NW_015090842.1:10097446",2,5,3
"DPEP1","s1324_S_RAP_03_ASEReadCounter.table","NW_015090842.1:10098518",0,1,1
"DPEP1","s1324_S_RAP_03_ASEReadCounter.table","NW_015090842.1:10098597",0,1,1
"DPEP1","s1324_S_RAP_03_ASEReadCounter.table","NW_015090842.1:10098601",0,1,1
"DPEP1","s1324_S_RAP_03_ASEReadCounter.table","NW_015090842.1:10098608",0,1,1
"DPEP1","s1324_S_RAP_03_ASEReadCounter.table","NW_015090842.1:10098630",0,2,2
"DPEP1","s1324_S_RAP_03_ASEReadCounter.table","NW_015090842.1:10098659",0,2,2
"DPEP1","s1324_S_RAP_03_ASEReadCounter.table","NW_015090842.1:10099765",0,2,2
"DPEP1","s1324_S_RAP_03_ASEReadCounter.table","NW_015090842.1:10099985",0,1,1
"DPEP1","s1324_S_RAP_03_ASEReadCounter.table","NW_015090842.1:10099986",0,1,1
"DPEP1","s1324_S_RAP_03_ASEReadCounter.table","NW_015090842.1:10099991",0,1,1
"DPEP1","s1324_S_RAP_03_ASEReadCounter.table","NW_015090842.1:10100044",0,2,2
"DPEP1","s1324_S_RAP_03_ASEReadCounter.table","NW_015090842.1:10100045",0,2,2
"DPEP1","s1324_S_RAP_03_ASEReadCounter.table","NW_015090842.1:10100084",0,2,2
"DPEP1","s1324_S_RAP_03_ASEReadCounter.table","NW_015090842.1:10100529",0,1,1
"DPEP1","s1324_S_RAP_03_ASEReadCounter.table","NW_015090842.1:10100893",0,1,1
"DPEP1","s1324_S_RAP_03_ASEReadCounter.table","NW_015090842.1:10100902",0,1,1
"DPEP1","s1324_S_RAP_03_ASEReadCounter.table","NW_015090842.1:10101072",0,1,1
"DPEP1","s1324_S_RAP_03_ASEReadCounter.table","NW_015090842.1:10101199",0,1,1
"DPEP1","s1324_S_RAP_03_ASEReadCounter.table","NW_015090842.1:10101913",0,1,1
"DPEP1","s1324_S_RAP_03_ASEReadCounter.table","NW_015090842.1:10101996",0,1,1
"DPEP1","s1324_S_RAP_03_ASEReadCounter.table","NW_015090842.1:10102014",0,1,1
"DPEP1","s1324_S_RAP_03_ASEReadCounter.table","NW_015090842.1:10102035",0,1,1
"CHMP1A","s1324_S_RAP_03_ASEReadCounter.table","NW_015090842.1:10102901",79,210,131
"CHMP1A","s1324_S_RAP_03_ASEReadCounter.table","NW_015090842.1:10102961",63,205,142
"CHMP1A","s1324_S_RAP_03_ASEReadCounter.table","NW_015090842.1:10102996",58,207,149
"CHMP1A","s1324_S_RAP_03_ASEReadCounter.table","NW_015090842.1:10103004",67,219,152
"CHMP1A","s1324_S_RAP_03_ASEReadCounter.table","NW_015090842.1:10103006",67,219,152
"CHMP1A","s1324_S_RAP_03_ASEReadCounter.table","NW_015090842.1:10103052",111,291,180
"CHMP1A","s1324_S_RAP_03_ASEReadCounter.table","NW_015090842.1:10103095",119,276,157
"CHMP1A","s1324_S_RAP_03_ASEReadCounter.table","NW_015090842.1:10103096",118,275,157
"CHMP1A","s1324_S_RAP_03_ASEReadCounter.table","NW_015090842.1:10103152",100,201,101
"CHMP1A","s1324_S_RAP_03_ASEReadCounter.table","NW_015090842.1:10103334",70,150,80
"CHMP1A","s1324_S_RAP_03_ASEReadCounter.table","NW_015090842.1:10103373",43,133,90
"CHMP1A","s1324_S_RAP_03_ASEReadCounter.table","NW_015090842.1:10103408",81,185,104
"CHMP1A","s1324_S_RAP_03_ASEReadCounter.table","NW_015090842.1:10103412",86,188,102
"CHMP1A","s1324_S_RAP_03_ASEReadCounter.table","NW_015090842.1:10103512",110,236,126
"CHMP1A","s1324_S_RAP_03_ASEReadCounter.table","NW_015090842.1:10103513",110,237,127
"CHMP1A","s1324_S_RAP_03_ASEReadCounter.table","NW_015090842.1:10103583",74,157,83
"CHMP1A","s1324_S_RAP_03_ASEReadCounter.table","NW_015090842.1:10103614",71,166,95
"CHMP1A","s1324_S_RAP_03_ASEReadCounter.table","NW_015090842.1:10103657",89,184,95
"CHMP1A","s1324_S_RAP_03_ASEReadCounter.table","NW_015090842.1:10103669",73,167,94
"CHMP1A","s1324_S_RAP_03_ASEReadCounter.table","NW_015090842.1:10103674",72,161,89
"CHMP1A","s1324_S_RAP_03_ASEReadCounter.table","NW_015090842.1:10103677",71,158,87
"CHMP1A","s1324_S_RAP_03_ASEReadCounter.table","NW_015090842.1:10103729",83,162,79
"CHMP1A","s1324_S_RAP_03_ASEReadCounter.table","NW_015090842.1:10103758",77,149,72
"CHMP1A","s1324_S_RAP_03_ASEReadCounter.table","NW_015090842.1:10103761",79,154,75
"CHMP1A","s1324_S_RAP_03_ASEReadCounter.table","NW_015090842.1:10103788",82,176,94
"CHMP1A","s1324_S_RAP_03_ASEReadCounter.table","NW_015090842.1:10103789",82,173,91
"CHMP1A","s1324_S_RAP_03_ASEReadCounter.table","NW_015090842.1:10103790",84,178,94
"CHMP1A","s1324_S_RAP_03_ASEReadCounter.table","NW_015090842.1:10103950",81,183,102
"CHMP1A","s1324_S_RAP_03_ASEReadCounter.table","NW_015090842.1:10104335",74,154,80
"CHMP1A","s1324_S_RAP_03_ASEReadCounter.table","NW_015090842.1:10104429",84,177,93
"CHMP1A","s1324_S_RAP_03_ASEReadCounter.table","NW_015090842.1:10104532",73,192,119
"CHMP1A","s1324_S_RAP_03_ASEReadCounter.table","NW_015090842.1:10104633",57,139,82
"CHMP1A","s1324_S_RAP_03_ASEReadCounter.table","NW_015090842.1:10104759",58,132,74
"CHMP1A","s1324_S_RAP_03_ASEReadCounter.table","NW_015090842.1:10104794",73,152,79
"CHMP1A","s1324_S_RAP_03_ASEReadCounter.table","NW_015090842.1:10104844",47,117,70
"CHMP1A","s1324_S_RAP_03_ASEReadCounter.table","NW_015090842.1:10106290",54,110,56
"CHMP1A","s1324_S_RAP_03_ASEReadCounter.table","NW_015090842.1:10106335",54,124,70
"CHMP1A","s1324_S_RAP_03_ASEReadCounter.table","NW_015090842.1:10106383",66,159,93
"CHMP1A","s1324_S_RAP_03_ASEReadCounter.table","NW_015090842.1:10106747",74,166,92
"CHMP1A","s1324_S_RAP_03_ASEReadCounter.table","NW_015090842.1:10107404",61,152,91
"CHMP1A","s1324_S_RAP_03_ASEReadCounter.table","NW_015090842.1:10107410",64,155,91
"CHMP1A","s1324_S_RAP_03_ASEReadCounter.table","NW_015090842.1:10107876",61,124,63
"CDK10","s1324_S_RAP_03_ASEReadCounter.table","NW_015090842.1:10109030",17,18,1
"CDK10","s1324_S_RAP_03_ASEReadCounter.table","NW_015090842.1:10109963",60,155,95
"CDK10","s1324_S_RAP_03_ASEReadCounter.table","NW_015090842.1:10110887",51,131,80
"CDK10","s1324_S_RAP_03_ASEReadCounter.table","NW_015090842.1:10111254",32,125,93
"CDK10","s1324_S_RAP_03_ASEReadCounter.table","NW_015090842.1:10111380",37,143,106
"CDK10","s1324_S_RAP_03_ASEReadCounter.table","NW_015090842.1:10111395",40,143,103
"CDK10","s1324_S_RAP_03_ASEReadCounter.table","NW_015090842.1:10111437",27,129,102
"CDK10","s1324_S_RAP_03_ASEReadCounter.table","NW_015090842.1:10111798",58,163,105
"CDK10","s1324_S_RAP_03_ASEReadCounter.table","NW_015090842.1:10111840",59,166,107
"CDK10","s1324_S_RAP_03_ASEReadCounter.table","NW_015090842.1:10112031",58,170,112
"CDK10","s1324_S_RAP_03_ASEReadCounter.table","NW_015090842.1:10112285",63,182,119
"CDK10","s1324_S_RAP_03_ASEReadCounter.table","NW_015090842.1:10112398",67,189,122
"CDK10","s1324_S_RAP_03_ASEReadCounter.table","NW_015090842.1:10112455",50,173,123
"CDK10","s1324_S_RAP_03_ASEReadCounter.table","NW_015090842.1:10112461",50,159,109
"CDK10","s1324_S_RAP_03_ASEReadCounter.table","NW_015090842.1:10112497",38,145,107
"CDK10","s1324_S_RAP_03_ASEReadCounter.table","NW_015090842.1:10112508",35,143,108
"CDK10","s1324_S_RAP_03_ASEReadCounter.table","NW_015090842.1:10112518",26,126,100
"CDK10","s1324_S_RAP_03_ASEReadCounter.table","NW_015090842.1:10112540",8,99,91
"CDK10","s1324_S_RAP_03_ASEReadCounter.table","NW_015090842.1:10112556",21,109,88
"CDK10","s1324_S_RAP_03_ASEReadCounter.table","NW_015090842.1:10112561",23,129,106
"CDK10","s1324_S_RAP_03_ASEReadCounter.table","NW_015090842.1:10112596",33,135,102
"CDK10","s1324_S_RAP_03_ASEReadCounter.table","NW_015090842.1:10112630",37,127,90
"CDK10","s1324_S_RAP_03_ASEReadCounter.table","NW_015090842.1:10112656",39,117,78
"CDK10","s1324_S_RAP_03_ASEReadCounter.table","NW_015090842.1:10112665",32,85,53
"CDK10","s1324_S_RAP_03_ASEReadCounter.table","NW_015090842.1:10112668",33,89,56
"CDK10","s1324_S_RAP_03_ASEReadCounter.table","NW_015090842.1:10112781",18,56,38
"CDK10","s1324_S_RAP_03_ASEReadCounter.table","NW_015090842.1:10112782",18,57,39
"CDK10","s1324_S_RAP_03_ASEReadCounter.table","NW_015090842.1:10112795",15,48,33
"CDK10","s1324_S_RAP_03_ASEReadCounter.table","NW_015090842.1:10112841",5,18,13
"CDK10","s1324_S_RAP_03_ASEReadCounter.table","NW_015090842.1:10112861",2,13,11
"SPATA2L","s1324_S_RAP_03_ASEReadCounter.table","NW_015090842.1:10113212",25,65,40
"SPATA2L","s1324_S_RAP_03_ASEReadCounter.table","NW_015090842.1:10113280",32,109,77
"SPATA2L","s1324_S_RAP_03_ASEReadCounter.table","NW_015090842.1:10113296",34,111,77
"SPATA2L","s1324_S_RAP_03_ASEReadCounter.table","NW_015090842.1:10113321",45,133,88
"SPATA2L","s1324_S_RAP_03_ASEReadCounter.table","NW_015090842.1:10113332",51,153,102
"SPATA2L","s1324_S_RAP_03_ASEReadCounter.table","NW_015090842.1:10113380",61,177,116
"SPATA2L","s1324_S_RAP_03_ASEReadCounter.table","NW_015090842.1:10113381",62,179,117
"SPATA2L","s1324_S_RAP_03_ASEReadCounter.table","NW_015090842.1:10113412",63,179,116
"SPATA2L","s1324_S_RAP_03_ASEReadCounter.table","NW_015090842.1:10113421",66,172,106
"SPATA2L","s1324_S_RAP_03_ASEReadCounter.table","NW_015090842.1:10113465",64,162,98
"SPATA2L","s1324_S_RAP_03_ASEReadCounter.table","NW_015090842.1:10113535",83,162,79
"SPATA2L","s1324_S_RAP_03_ASEReadCounter.table","NW_015090842.1:10113645",71,198,127
"SPATA2L","s1324_S_RAP_03_ASEReadCounter.table","NW_015090842.1:10113682",76,240,164
"SPATA2L","s1324_S_RAP_03_ASEReadCounter.table","NW_015090842.1:10113696",76,221,145
"SPATA2L","s1324_S_RAP_03_ASEReadCounter.table","NW_015090842.1:10113727",80,229,149
"SPATA2L","s1324_S_RAP_03_ASEReadCounter.table","NW_015090842.1:10113729",82,224,142
"SPATA2L","s1324_S_RAP_03_ASEReadCounter.table","NW_015090842.1:10113799",104,250,146
"SPATA2L","s1324_S_RAP_03_ASEReadCounter.table","NW_015090842.1:10113809",116,263,147
"SPATA2L","s1324_S_RAP_03_ASEReadCounter.table","NW_015090842.1:10113827",114,262,148
"SPATA2L","s1324_S_RAP_03_ASEReadCounter.table","NW_015090842.1:10113831",116,270,154
"SPATA2L","s1324_S_RAP_03_ASEReadCounter.table","NW_015090842.1:10113894",92,203,111
"SPATA2L","s1324_S_RAP_03_ASEReadCounter.table","NW_015090842.1:10113905",81,194,113
"SPATA2L","s1324_S_RAP_03_ASEReadCounter.table","NW_015090842.1:10113914",90,199,109
"SPATA2L","s1324_S_RAP_03_ASEReadCounter.table","NW_015090842.1:10113920",85,196,111
"SPATA2L","s1324_S_RAP_03_ASEReadCounter.table","NW_015090842.1:10113937",92,212,120
"SPATA2L","s1324_S_RAP_03_ASEReadCounter.table","NW_015090842.1:10113971",70,189,119
"SPATA2L","s1324_S_RAP_03_ASEReadCounter.table","NW_015090842.1:10113976",67,197,130
"SPATA2L","s1324_S_RAP_03_ASEReadCounter.table","NW_015090842.1:10113985",70,181,111
"SPATA2L","s1324_S_RAP_03_ASEReadCounter.table","NW_015090842.1:10113994",87,202,115
"SPATA2L","s1324_S_RAP_03_ASEReadCounter.table","NW_015090842.1:10114063",74,170,96
"SPATA2L","s1324_S_RAP_03_ASEReadCounter.table","NW_015090842.1:10114066",70,164,94
"SPATA2L","s1324_S_RAP_03_ASEReadCounter.table","NW_015090842.1:10114069",67,159,92
"SPATA2L","s1324_S_RAP_03_ASEReadCounter.table","NW_015090842.1:10114159",47,138,91
"SPATA2L","s1324_S_RAP_03_ASEReadCounter.table","NW_015090842.1:10114262",164,164,0
"SPATA2L","s1324_S_RAP_03_ASEReadCounter.table","NW_015090842.1:10114470",48,128,80
"SPATA2L","s1324_S_RAP_03_ASEReadCounter.table","NW_015090842.1:10114524",47,105,58
"VPS9D1","s1324_S_RAP_03_ASEReadCounter.table","NW_015090842.1:10116377",47,118,71
"VPS9D1","s1324_S_RAP_03_ASEReadCounter.table","NW_015090842.1:10116415",55,140,85
"VPS9D1","s1324_S_RAP_03_ASEReadCounter.table","NW_015090842.1:10116607",53,145,92
"VPS9D1","s1324_S_RAP_03_ASEReadCounter.table","NW_015090842.1:10116821",32,89,57
"VPS9D1","s1324_S_RAP_03_ASEReadCounter.table","NW_015090842.1:10116825",32,86,54
"VPS9D1","s1324_S_RAP_03_ASEReadCounter.table","NW_015090842.1:10116882",41,98,57
"VPS9D1","s1324_S_RAP_03_ASEReadCounter.table","NW_015090842.1:10116933",43,96,53
"VPS9D1","s1324_S_RAP_03_ASEReadCounter.table","NW_015090842.1:10116942",45,103,58
"VPS9D1","s1324_S_RAP_03_ASEReadCounter.table","NW_015090842.1:10117152",39,103,64
"VPS9D1","s1324_S_RAP_03_ASEReadCounter.table","NW_015090842.1:10117480",20,75,55
"VPS9D1","s1324_S_RAP_03_ASEReadCounter.table","NW_015090842.1:10117497",16,64,48
"VPS9D1","s1324_S_RAP_03_ASEReadCounter.table","NW_015090842.1:10117499",17,71,54
"VPS9D1","s1324_S_RAP_03_ASEReadCounter.table","NW_015090842.1:10117516",21,77,56
"VPS9D1","s1324_S_RAP_03_ASEReadCounter.table","NW_015090842.1:10117525",28,85,57
"VPS9D1","s1324_S_RAP_03_ASEReadCounter.table","NW_015090842.1:10117579",25,92,67
"VPS9D1","s1324_S_RAP_03_ASEReadCounter.table","NW_015090842.1:10117627",15,72,57
"VPS9D1","s1324_S_RAP_03_ASEReadCounter.table","NW_015090842.1:10117678",15,80,65
"VPS9D1","s1324_S_RAP_03_ASEReadCounter.table","NW_015090842.1:10117773",29,104,75
"VPS9D1","s1324_S_RAP_03_ASEReadCounter.table","NW_015090842.1:10117937",39,123,84
"VPS9D1","s1324_S_RAP_03_ASEReadCounter.table","NW_015090842.1:10117961",37,115,78
"VPS9D1","s1324_S_RAP_03_ASEReadCounter.table","NW_015090842.1:10118236",35,127,92
"VPS9D1","s1324_S_RAP_03_ASEReadCounter.table","NW_015090842.1:10118414",39,122,83
"VPS9D1","s1324_S_RAP_03_ASEReadCounter.table","NW_015090842.1:10118973",43,141,98
"VPS9D1","s1324_S_RAP_03_ASEReadCounter.table","NW_015090842.1:10119500",23,90,67
"ZNF276","s1324_S_RAP_03_ASEReadCounter.table","NW_015090842.1:10121760",2,13,11
"ZNF276","s1324_S_RAP_03_ASEReadCounter.table","NW_015090842.1:10121769",2,13,11
"ZNF276","s1324_S_RAP_03_ASEReadCounter.table","NW_015090842.1:10121802",4,14,10
"ZNF276","s1324_S_RAP_03_ASEReadCounter.table","NW_015090842.1:10121971",9,19,10
"ZNF276","s1324_S_RAP_03_ASEReadCounter.table","NW_015090842.1:10122161",26,26,0
"ZNF276","s1324_S_RAP_03_ASEReadCounter.table","NW_015090842.1:10122164",26,26,0
"ZNF276","s1324_S_RAP_03_ASEReadCounter.table","NW_015090842.1:10122184",30,30,0
"ZNF276","s1324_S_RAP_03_ASEReadCounter.table","NW_015090842.1:10122883",10,24,14
"ZNF276","s1324_S_RAP_03_ASEReadCounter.table","NW_015090842.1:10122997",15,22,7
"ZNF276","s1324_S_RAP_03_ASEReadCounter.table","NW_015090842.1:10123069",15,28,13
"ZNF276","s1324_S_RAP_03_ASEReadCounter.table","NW_015090842.1:10123207",25,47,22
"ZNF276","s1324_S_RAP_03_ASEReadCounter.table","NW_015090842.1:10125787",30,62,32
"ZNF276","s1324_S_RAP_03_ASEReadCounter.table","NW_015090842.1:10126309",24,62,38
"ZNF276","s1324_S_RAP_03_ASEReadCounter.table","NW_015090842.1:10126348",25,66,41
"ZNF276","s1324_S_RAP_03_ASEReadCounter.table","NW_015090842.1:10126978",28,71,43
"ZNF276","s1324_S_RAP_03_ASEReadCounter.table","NW_015090842.1:10126991",24,57,33
"ZNF276","s1324_S_RAP_03_ASEReadCounter.table","NW_015090842.1:10127023",34,64,30
"ZNF276","s1324_S_RAP_03_ASEReadCounter.table","NW_015090842.1:10127063",33,72,39
"ZNF276","s1324_S_RAP_03_ASEReadCounter.table","NW_015090842.1:10127373",27,65,38
"ZNF276","s1324_S_RAP_03_ASEReadCounter.table","NW_015090842.1:10127931",42,87,45
"ZNF276","s1324_S_RAP_03_ASEReadCounter.table","NW_015090842.1:10128070",50,95,45
"ZNF276","s1324_S_RAP_03_ASEReadCounter.table","NW_015090842.1:10128102",43,86,43
"ZNF276","s1324_S_RAP_03_ASEReadCounter.table","NW_015090842.1:10128356",35,68,33
"ZNF276","s1324_S_RAP_03_ASEReadCounter.table","NW_015090842.1:10128497",19,50,31
"FANCA","s1324_S_RAP_03_ASEReadCounter.table","NW_015090842.1:10128743",1,2,1
"FANCA","s1324_S_RAP_03_ASEReadCounter.table","NW_015090842.1:10128822",2,4,2
"FANCA","s1324_S_RAP_03_ASEReadCounter.table","NW_015090842.1:10129383",2,3,1
"FANCA","s1324_S_RAP_03_ASEReadCounter.table","NW_015090842.1:10129390",2,3,1
"FANCA","s1324_S_RAP_03_ASEReadCounter.table","NW_015090842.1:10129422",3,4,1
"FANCA","s1324_S_RAP_03_ASEReadCounter.table","NW_015090842.1:10129969",1,4,3
"FANCA","s1324_S_RAP_03_ASEReadCounter.table","NW_015090842.1:10130399",1,5,4
"FANCA","s1324_S_RAP_03_ASEReadCounter.table","NW_015090842.1:10130857",1,1,0
"FANCA","s1324_S_RAP_03_ASEReadCounter.table","NW_015090842.1:10130878",1,1,0
"FANCA","s1324_S_RAP_03_ASEReadCounter.table","NW_015090842.1:10133530",1,3,2
"FANCA","s1324_S_RAP_03_ASEReadCounter.table","NW_015090842.1:10133533",1,4,3
"FANCA","s1324_S_RAP_03_ASEReadCounter.table","NW_015090842.1:10133536",1,4,3
"FANCA","s1324_S_RAP_03_ASEReadCounter.table","NW_015090842.1:10133601",1,4,3
"FANCA","s1324_S_RAP_03_ASEReadCounter.table","NW_015090842.1:10134492",0,2,2
"FANCA","s1324_S_RAP_03_ASEReadCounter.table","NW_015090842.1:10136957",0,2,2
"FANCA","s1324_S_RAP_03_ASEReadCounter.table","NW_015090842.1:10136982",0,1,1
"FANCA","s1324_S_RAP_03_ASEReadCounter.table","NW_015090842.1:10136999",0,1,1
"FANCA","s1324_S_RAP_03_ASEReadCounter.table","NW_015090842.1:10137019",1,3,2
"FANCA","s1324_S_RAP_03_ASEReadCounter.table","NW_015090842.1:10137673",2,7,5
"FANCA","s1324_S_RAP_03_ASEReadCounter.table","NW_015090842.1:10138618",2,4,2
"FANCA","s1324_S_RAP_03_ASEReadCounter.table","NW_015090842.1:10139140",1,2,1
"FANCA","s1324_S_RAP_03_ASEReadCounter.table","NW_015090842.1:10140699",1,2,1
"FANCA","s1324_S_RAP_03_ASEReadCounter.table","NW_015090842.1:10145030",1,1,0
"FANCA","s1324_S_RAP_03_ASEReadCounter.table","NW_015090842.1:10154490",0,1,1
"FANCA","s1324_S_RAP_03_ASEReadCounter.table","NW_015090842.1:10164257",0,1,1
"SPIRE2","s1324_S_RAP_03_ASEReadCounter.table","NW_015090842.1:10172284",26,49,23
"SPIRE2","s1324_S_RAP_03_ASEReadCounter.table","NW_015090842.1:10175262",42,85,43
"SPIRE2","s1324_S_RAP_03_ASEReadCounter.table","NW_015090842.1:10175352",23,41,18
"SPIRE2","s1324_S_RAP_03_ASEReadCounter.table","NW_015090842.1:10175400",74,140,66
"SPIRE2","s1324_S_RAP_03_ASEReadCounter.table","NW_015090842.1:10175418",87,159,72
"SPIRE2","s1324_S_RAP_03_ASEReadCounter.table","NW_015090842.1:10175704",86,171,85
"SPIRE2","s1324_S_RAP_03_ASEReadCounter.table","NW_015090842.1:10176115",114,265,151
"SPIRE2","s1324_S_RAP_03_ASEReadCounter.table","NW_015090842.1:10176561",117,268,151
"SPIRE2","s1324_S_RAP_03_ASEReadCounter.table","NW_015090842.1:10176817",123,268,145
"SPIRE2","s1324_S_RAP_03_ASEReadCounter.table","NW_015090842.1:10177084",68,172,104
"SPIRE2","s1324_S_RAP_03_ASEReadCounter.table","NW_015090842.1:10177838",137,268,131
"SPIRE2","s1324_S_RAP_03_ASEReadCounter.table","NW_015090842.1:10178000",144,283,139
"SPIRE2","s1324_S_RAP_03_ASEReadCounter.table","NW_015090842.1:10178164",144,287,143
"SPIRE2","s1324_S_RAP_03_ASEReadCounter.table","NW_015090842.1:10178216",147,320,173
"SPIRE2","s1324_S_RAP_03_ASEReadCounter.table","NW_015090842.1:10178303",137,273,136
"SPIRE2","s1324_S_RAP_03_ASEReadCounter.table","NW_015090842.1:10178403",138,304,166
"SPIRE2","s1324_S_RAP_03_ASEReadCounter.table","NW_015090842.1:10178409",134,293,159
"SPIRE2","s1324_S_RAP_03_ASEReadCounter.table","NW_015090842.1:10178524",133,301,168
"SPIRE2","s1324_S_RAP_03_ASEReadCounter.table","NW_015090842.1:10178526",134,302,168
"SPIRE2","s1324_S_RAP_03_ASEReadCounter.table","NW_015090842.1:10178531",135,303,168
"SPIRE2","s1324_S_RAP_03_ASEReadCounter.table","NW_015090842.1:10178565",113,280,167
"SPIRE2","s1324_S_RAP_03_ASEReadCounter.table","NW_015090842.1:10178587",101,254,153
"SPIRE2","s1324_S_RAP_03_ASEReadCounter.table","NW_015090842.1:10178640",83,190,107
"SPIRE2","s1324_S_RAP_03_ASEReadCounter.table","NW_015090842.1:10178651",85,196,111
"SPIRE2","s1324_S_RAP_03_ASEReadCounter.table","NW_015090842.1:10178682",84,175,91
"TCF25","s1324_S_RAP_03_ASEReadCounter.table","NW_015090842.1:10180912",65,116,51
"TCF25","s1324_S_RAP_03_ASEReadCounter.table","NW_015090842.1:10180924",66,117,51
"TCF25","s1324_S_RAP_03_ASEReadCounter.table","NW_015090842.1:10180931",67,119,52
"TCF25","s1324_S_RAP_03_ASEReadCounter.table","NW_015090842.1:10185332",139,275,136
"TCF25","s1324_S_RAP_03_ASEReadCounter.table","NW_015090842.1:10196561",91,206,115
"TCF25","s1324_S_RAP_03_ASEReadCounter.table","NW_015090842.1:10197399",295,295,0
"MC1R","s1324_S_RAP_03_ASEReadCounter.table","NW_015090842.1:10201853",0,1,1
"MC1R","s1324_S_RAP_03_ASEReadCounter.table","NW_015090842.1:10201986",0,3,3
"MC1R","s1324_S_RAP_03_ASEReadCounter.table","NW_015090842.1:10202160",2,5,3
"MC1R","s1324_S_RAP_03_ASEReadCounter.table","NW_015090842.1:10202447",1,3,2
"TUBB3","s1324_S_RAP_03_ASEReadCounter.table","NW_015090842.1:10205322",2,631,629
"GAS8","s1324_S_RAP_03_ASEReadCounter.table","NW_015090842.1:10228982",27,43,16
"GAS8","s1324_S_RAP_03_ASEReadCounter.table","NW_015090842.1:10229832",19,37,18
"GAS8","s1324_S_RAP_03_ASEReadCounter.table","NW_015090842.1:10232901",40,77,37
"GAS8","s1324_S_RAP_03_ASEReadCounter.table","NW_015090842.1:10232928",45,81,36
"GAS8","s1324_S_RAP_03_ASEReadCounter.table","NW_015090842.1:10232967",44,80,36
"GAS8","s1324_S_RAP_03_ASEReadCounter.table","NW_015090842.1:10233032",31,63,32
"GAS8","s1324_S_RAP_03_ASEReadCounter.table","NW_015090842.1:10233057",29,52,23
"GAS8","s1324_S_RAP_03_ASEReadCounter.table","NW_015090842.1:10233058",28,52,24
"GAS8","s1324_S_RAP_03_ASEReadCounter.table","NW_015090842.1:10233176",29,53,24
"GAS8","s1324_S_RAP_03_ASEReadCounter.table","NW_015090842.1:10233196",31,51,20
"GAS8","s1324_S_RAP_03_ASEReadCounter.table","NW_015090842.1:10233252",24,44,20
"GAS8","s1324_S_RAP_03_ASEReadCounter.table","NW_015090842.1:10233303",9,17,8
"LOC106888094","s1324_S_RAP_03_ASEReadCounter.table","NW_015090842.1:10233334",0,8,8
"LOC106888094","s1324_S_RAP_03_ASEReadCounter.table","NW_015090842.1:10233362",7,30,23
"LOC106888094","s1324_S_RAP_03_ASEReadCounter.table","NW_015090842.1:10233373",7,29,22
"LOC106888094","s1324_S_RAP_03_ASEReadCounter.table","NW_015090842.1:10233388",10,39,29
"LOC106888094","s1324_S_RAP_03_ASEReadCounter.table","NW_015090842.1:10233402",11,41,30
"LOC106888094","s1324_S_RAP_03_ASEReadCounter.table","NW_015090842.1:10233465",15,46,31
"LOC106888094","s1324_S_RAP_03_ASEReadCounter.table","NW_015090842.1:10233803",17,62,45
"LOC106888094","s1324_S_RAP_03_ASEReadCounter.table","NW_015090842.1:10233815",15,60,45
"LOC106888094","s1324_S_RAP_03_ASEReadCounter.table","NW_015090842.1:10235484",3,5,2
"LOC106888094","s1324_S_RAP_03_ASEReadCounter.table","NW_015090842.1:10235611",3,11,8
"LOC106888094","s1324_S_RAP_03_ASEReadCounter.table","NW_015090842.1:10235977",8,8,0
"LOC106888094","s1324_S_RAP_03_ASEReadCounter.table","NW_015090842.1:10236098",2,4,2
"LOC106888094","s1324_S_RAP_03_ASEReadCounter.table","NW_015090842.1:10236380",2,2,0
"LOC106888094","s1324_S_RAP_03_ASEReadCounter.table","NW_015090842.1:10236388",1,1,0
"LOC106888094","s1324_S_RAP_03_ASEReadCounter.table","NW_015090842.1:10236425",1,1,0
"LOC106888094","s1324_S_RAP_03_ASEReadCounter.table","NW_015090842.1:10236426",1,1,0
"LOC106888094","s1324_S_RAP_03_ASEReadCounter.table","NW_015090842.1:10236603",1,1,0
"LOC106888173","s1324_S_RAP_03_ASEReadCounter.table","NW_015090842.1:10239596",1,14,13
"LOC106888173","s1324_S_RAP_03_ASEReadCounter.table","NW_015090842.1:10240036",9,32,23
"LOC106888173","s1324_S_RAP_03_ASEReadCounter.table","NW_015090842.1:10240095",21,49,28
"LOC106888173","s1324_S_RAP_03_ASEReadCounter.table","NW_015090842.1:10240280",17,55,38
"LOC106888173","s1324_S_RAP_03_ASEReadCounter.table","NW_015090842.1:10240557",27,71,44
"LOC106888173","s1324_S_RAP_03_ASEReadCounter.table","NW_015090842.1:10240603",30,76,46
"LOC106888173","s1324_S_RAP_03_ASEReadCounter.table","NW_015090842.1:10240609",30,74,44
"LOC106888173","s1324_S_RAP_03_ASEReadCounter.table","NW_015090842.1:10240924",15,51,36
"LOC106888173","s1324_S_RAP_03_ASEReadCounter.table","NW_015090842.1:10241037",6,46,40
"LOC106888173","s1324_S_RAP_03_ASEReadCounter.table","NW_015090842.1:10241046",9,46,37
"LOC106888173","s1324_S_RAP_03_ASEReadCounter.table","NW_015090842.1:10241058",13,52,39
"LOC106888173","s1324_S_RAP_03_ASEReadCounter.table","NW_015090842.1:10241064",15,56,41
"LOC106888173","s1324_S_RAP_03_ASEReadCounter.table","NW_015090842.1:10241163",27,67,40
"LOC106888173","s1324_S_RAP_03_ASEReadCounter.table","NW_015090842.1:10241803",35,90,55
"LOC106888173","s1324_S_RAP_03_ASEReadCounter.table","NW_015090842.1:10241827",30,83,53
"LOC106888173","s1324_S_RAP_03_ASEReadCounter.table","NW_015090842.1:10241869",22,79,57
"LOC106888173","s1324_S_RAP_03_ASEReadCounter.table","NW_015090842.1:10242079",18,65,47
"LOC106888173","s1324_S_RAP_03_ASEReadCounter.table","NW_015090842.1:10242103",21,66,45
"LOC106888173","s1324_S_RAP_03_ASEReadCounter.table","NW_015090842.1:10242157",21,74,53
"LOC106888173","s1324_S_RAP_03_ASEReadCounter.table","NW_015090842.1:10242455",28,69,41
"LOC106888173","s1324_S_RAP_03_ASEReadCounter.table","NW_015090842.1:10242481",27,79,52
"LOC106888173","s1324_S_RAP_03_ASEReadCounter.table","NW_015090842.1:10242590",29,71,42
"LOC106888173","s1324_S_RAP_03_ASEReadCounter.table","NW_015090842.1:10242794",19,65,46
"LOC106888173","s1324_S_RAP_03_ASEReadCounter.table","NW_015090842.1:10242909",24,61,37
"LOC106888173","s1324_S_RAP_03_ASEReadCounter.table","NW_015090842.1:10243094",28,61,33
"LOC106888173","s1324_S_RAP_03_ASEReadCounter.table","NW_015090842.1:10243133",19,49,30
"LOC106888173","s1324_S_RAP_03_ASEReadCounter.table","NW_015090842.1:10243273",30,86,56
"LOC106888173","s1324_S_RAP_03_ASEReadCounter.table","NW_015090842.1:10243278",32,87,55
"LOC106888173","s1324_S_RAP_03_ASEReadCounter.table","NW_015090842.1:10243281",32,90,58
"LOC106888173","s1324_S_RAP_03_ASEReadCounter.table","NW_015090842.1:10243347",47,47,0
"LOC106888173","s1324_S_RAP_03_ASEReadCounter.table","NW_015090842.1:10243353",21,45,24
"LOC106888173","s1324_S_RAP_03_ASEReadCounter.table","NW_015090842.1:10243363",21,41,20
"LOC106888173","s1324_S_RAP_03_ASEReadCounter.table","NW_015090842.1:10243365",20,41,21
"LOC106888173","s1324_S_RAP_03_ASEReadCounter.table","NW_015090842.1:10243529",23,56,33
"LOC106888173","s1324_S_RAP_03_ASEReadCounter.table","NW_015090842.1:10243566",32,81,49
"LOC106888173","s1324_S_RAP_03_ASEReadCounter.table","NW_015090842.1:10243605",42,94,52
"LOC106888173","s1324_S_RAP_03_ASEReadCounter.table","NW_015090842.1:10243614",37,85,48
"LOC106888173","s1324_S_RAP_03_ASEReadCounter.table","NW_015090842.1:10243615",37,84,47
"LOC106888173","s1324_S_RAP_03_ASEReadCounter.table","NW_015090842.1:10243640",29,66,37
"LOC106888173","s1324_S_RAP_03_ASEReadCounter.table","NW_015090842.1:10243680",24,56,32
"LOC106888173","s1324_S_RAP_03_ASEReadCounter.table","NW_015090842.1:10243742",33,71,38
"LOC106888173","s1324_S_RAP_03_ASEReadCounter.table","NW_015090842.1:10243804",23,46,23
"LOC106888173","s1324_S_RAP_03_ASEReadCounter.table","NW_015090842.1:10243913",11,31,20
"LOC106888173","s1324_S_RAP_03_ASEReadCounter.table","NW_015090842.1:10243921",11,30,19
"LOC106888384","s1324_S_RAP_03_ASEReadCounter.table","NW_015090842.1:10251354",0,7,7
"LOC106888384","s1324_S_RAP_03_ASEReadCounter.table","NW_015090842.1:10251358",0,7,7
"LOC106888384","s1324_S_RAP_03_ASEReadCounter.table","NW_015090842.1:10251369",0,6,6
"LOC106888384","s1324_S_RAP_03_ASEReadCounter.table","NW_015090842.1:10251370",0,6,6
"LOC106888384","s1324_S_RAP_03_ASEReadCounter.table","NW_015090842.1:10251375",0,6,6
"LOC106888384","s1324_S_RAP_03_ASEReadCounter.table","NW_015090842.1:10251388",0,3,3
"LOC106888384","s1324_S_RAP_03_ASEReadCounter.table","NW_015090842.1:10251390",0,3,3
"LOC106888384","s1324_S_RAP_03_ASEReadCounter.table","NW_015090842.1:10251393",0,3,3
"LOC106888384","s1324_S_RAP_03_ASEReadCounter.table","NW_015090842.1:10251399",0,3,3
"LOC106888384","s1324_S_RAP_03_ASEReadCounter.table","NW_015090842.1:10253165",3,3,0
"LOC106888384","s1324_S_RAP_03_ASEReadCounter.table","NW_015090842.1:10253284",1,1,0
"LOC106888384","s1324_S_RAP_03_ASEReadCounter.table","NW_015090842.1:10253605",1,1,0
"LOC106888384","s1324_S_RAP_03_ASEReadCounter.table","NW_015090842.1:10254227",2,2,0
"LOC106888384","s1324_S_RAP_03_ASEReadCounter.table","NW_015090842.1:10254233",2,2,0
"LOC106888384","s1324_S_RAP_03_ASEReadCounter.table","NW_015090842.1:10254263",2,2,0
"LOC106888384","s1324_S_RAP_03_ASEReadCounter.table","NW_015090842.1:10254293",1,1,0
"LOC106888384","s1324_S_RAP_03_ASEReadCounter.table","NW_015090842.1:10254570",2,2,0
"LOC106888384","s1324_S_RAP_03_ASEReadCounter.table","NW_015090842.1:10254647",1,1,0
"LOC106888384","s1324_S_RAP_03_ASEReadCounter.table","NW_015090842.1:10254663",1,1,0
"LOC106888384","s1324_S_RAP_03_ASEReadCounter.table","NW_015090842.1:10254840",1,1,0
"LOC106888384","s1324_S_RAP_03_ASEReadCounter.table","NW_015090842.1:10254854",1,1,0
"LOC106888384","s1324_S_RAP_03_ASEReadCounter.table","NW_015090842.1:10254891",1,1,0
"LOC106888384","s1324_S_RAP_03_ASEReadCounter.table","NW_015090842.1:10254900",1,1,0
"LOC106888384","s1324_S_RAP_03_ASEReadCounter.table","NW_015090842.1:10254915",1,1,0
"LOC106888384","s1324_S_RAP_03_ASEReadCounter.table","NW_015090842.1:10255077",1,1,0
"LOC106888384","s1324_S_RAP_03_ASEReadCounter.table","NW_015090842.1:10255209",1,1,0
"LOC106888384","s1324_S_RAP_03_ASEReadCounter.table","NW_015090842.1:10255211",1,1,0
"LOC106888384","s1324_S_RAP_03_ASEReadCounter.table","NW_015090842.1:10255236",2,2,0
"LOC106888384","s1324_S_RAP_03_ASEReadCounter.table","NW_015090842.1:10255262",2,2,0
"LOC106888384","s1324_S_RAP_03_ASEReadCounter.table","NW_015090842.1:10255264",2,2,0
"LOC106888384","s1324_S_RAP_03_ASEReadCounter.table","NW_015090842.1:10255306",1,1,0
"LOC106888384","s1324_S_RAP_03_ASEReadCounter.table","NW_015090842.1:10255340",2,2,0
"LOC106888384","s1324_S_RAP_03_ASEReadCounter.table","NW_015090842.1:10255410",3,5,2
"LOC106888384","s1324_S_RAP_03_ASEReadCounter.table","NW_015090842.1:10255449",2,4,2
"LOC106888384","s1324_S_RAP_03_ASEReadCounter.table","NW_015090842.1:10255496",2,3,1
"LOC106888384","s1324_S_RAP_03_ASEReadCounter.table","NW_015090842.1:10255505",1,2,1
"LOC106888384","s1324_S_RAP_03_ASEReadCounter.table","NW_015090842.1:10255531",2,2,0
"LOC106888384","s1324_S_RAP_03_ASEReadCounter.table","NW_015090842.1:10255608",1,2,1
"LOC106888384","s1324_S_RAP_03_ASEReadCounter.table","NW_015090842.1:10255614",0,1,1
"LOC106888384","s1324_S_RAP_03_ASEReadCounter.table","NW_015090842.1:10255704",4,4,0
"LOC106888384","s1324_S_RAP_03_ASEReadCounter.table","NW_015090842.1:10255731",4,4,0
"LOC106888384","s1324_S_RAP_03_ASEReadCounter.table","NW_015090842.1:10255771",5,5,0
"TANGO6","s1324_S_RAP_03_ASEReadCounter.table","NW_015090842.1:10257782",5,11,6
"TANGO6","s1324_S_RAP_03_ASEReadCounter.table","NW_015090842.1:10258162",8,18,10
"TANGO6","s1324_S_RAP_03_ASEReadCounter.table","NW_015090842.1:10258185",6,14,8
"TANGO6","s1324_S_RAP_03_ASEReadCounter.table","NW_015090842.1:10259267",12,20,8
"TANGO6","s1324_S_RAP_03_ASEReadCounter.table","NW_015090842.1:10260250",45,64,19
"TANGO6","s1324_S_RAP_03_ASEReadCounter.table","NW_015090842.1:10260979",21,36,15
"TANGO6","s1324_S_RAP_03_ASEReadCounter.table","NW_015090842.1:10261599",28,45,17
"TANGO6","s1324_S_RAP_03_ASEReadCounter.table","NW_015090842.1:10268425",43,79,36
"TANGO6","s1324_S_RAP_03_ASEReadCounter.table","NW_015090842.1:10269831",40,70,30
"TANGO6","s1324_S_RAP_03_ASEReadCounter.table","NW_015090842.1:10270813",40,68,28
"TANGO6","s1324_S_RAP_03_ASEReadCounter.table","NW_015090842.1:10273952",32,49,17
"TANGO6","s1324_S_RAP_03_ASEReadCounter.table","NW_015090842.1:10273970",38,60,22
"TANGO6","s1324_S_RAP_03_ASEReadCounter.table","NW_015090842.1:10274018",39,58,19
"TANGO6","s1324_S_RAP_03_ASEReadCounter.table","NW_015090842.1:10275974",41,66,25
"TANGO6","s1324_S_RAP_03_ASEReadCounter.table","NW_015090842.1:10275976",40,66,26
"TANGO6","s1324_S_RAP_03_ASEReadCounter.table","NW_015090842.1:10276123",36,53,17
"TANGO6","s1324_S_RAP_03_ASEReadCounter.table","NW_015090842.1:10276271",37,65,28
"TANGO6","s1324_S_RAP_03_ASEReadCounter.table","NW_015090842.1:10276272",33,61,28
"TANGO6","s1324_S_RAP_03_ASEReadCounter.table","NW_015090842.1:10276275",37,65,28
"TANGO6","s1324_S_RAP_03_ASEReadCounter.table","NW_015090842.1:10276278",36,66,30
"TANGO6","s1324_S_RAP_03_ASEReadCounter.table","NW_015090842.1:10276368",28,45,17
"TANGO6","s1324_S_RAP_03_ASEReadCounter.table","NW_015090842.1:10276373",25,46,21
"TANGO6","s1324_S_RAP_03_ASEReadCounter.table","NW_015090842.1:10276630",25,49,24
"TANGO6","s1324_S_RAP_03_ASEReadCounter.table","NW_015090842.1:10281498",40,70,30
"TANGO6","s1324_S_RAP_03_ASEReadCounter.table","NW_015090842.1:10282842",52,89,37
"TANGO6","s1324_S_RAP_03_ASEReadCounter.table","NW_015090842.1:10282863",36,66,30
"TANGO6","s1324_S_RAP_03_ASEReadCounter.table","NW_015090842.1:10282869",40,68,28
"TANGO6","s1324_S_RAP_03_ASEReadCounter.table","NW_015090842.1:10282903",38,71,33
"TANGO6","s1324_S_RAP_03_ASEReadCounter.table","NW_015090842.1:10283757",50,82,32
"TANGO6","s1324_S_RAP_03_ASEReadCounter.table","NW_015090842.1:10283785",52,80,28
"HAS3","s1324_S_RAP_03_ASEReadCounter.table","NW_015090842.1:10288093",0,2,2
"HAS3","s1324_S_RAP_03_ASEReadCounter.table","NW_015090842.1:10288266",2,3,1
"HAS3","s1324_S_RAP_03_ASEReadCounter.table","NW_015090842.1:10288274",2,3,1
"HAS3","s1324_S_RAP_03_ASEReadCounter.table","NW_015090842.1:10288364",2,3,1
"HAS3","s1324_S_RAP_03_ASEReadCounter.table","NW_015090842.1:10288405",3,3,0
"HAS3","s1324_S_RAP_03_ASEReadCounter.table","NW_015090842.1:10289469",1,3,2
"HAS3","s1324_S_RAP_03_ASEReadCounter.table","NW_015090842.1:10289708",2,4,2
"HAS3","s1324_S_RAP_03_ASEReadCounter.table","NW_015090842.1:10290375",1,2,1
"HAS3","s1324_S_RAP_03_ASEReadCounter.table","NW_015090842.1:10290395",2,3,1
"HAS3","s1324_S_RAP_03_ASEReadCounter.table","NW_015090842.1:10290561",0,1,1
"HAS3","s1324_S_RAP_03_ASEReadCounter.table","NW_015090842.1:10290609",0,2,2
"HAS3","s1324_S_RAP_03_ASEReadCounter.table","NW_015090842.1:10290666",3,4,1
"HAS3","s1324_S_RAP_03_ASEReadCounter.table","NW_015090842.1:10290723",2,3,1
"HAS3","s1324_S_RAP_03_ASEReadCounter.table","NW_015090842.1:10290927",3,6,3
"HAS3","s1324_S_RAP_03_ASEReadCounter.table","NW_015090842.1:10291004",3,5,2
"CHTF8","s1324_S_RAP_03_ASEReadCounter.table","NW_015090842.1:10291319",4,7,3
"CHTF8","s1324_S_RAP_03_ASEReadCounter.table","NW_015090842.1:10291342",5,10,5
"CHTF8","s1324_S_RAP_03_ASEReadCounter.table","NW_015090842.1:10291491",13,16,3
"CHTF8","s1324_S_RAP_03_ASEReadCounter.table","NW_015090842.1:10291520",15,22,7
"CHTF8","s1324_S_RAP_03_ASEReadCounter.table","NW_015090842.1:10291593",14,23,9
"CHTF8","s1324_S_RAP_03_ASEReadCounter.table","NW_015090842.1:10291600",13,22,9
"CHTF8","s1324_S_RAP_03_ASEReadCounter.table","NW_015090842.1:10291609",12,19,7
"CHTF8","s1324_S_RAP_03_ASEReadCounter.table","NW_015090842.1:10291639",12,21,9
"CHTF8","s1324_S_RAP_03_ASEReadCounter.table","NW_015090842.1:10291641",11,20,9
"CHTF8","s1324_S_RAP_03_ASEReadCounter.table","NW_015090842.1:10291648",11,20,9
"CHTF8","s1324_S_RAP_03_ASEReadCounter.table","NW_015090842.1:10291656",11,18,7
"CHTF8","s1324_S_RAP_03_ASEReadCounter.table","NW_015090842.1:10291675",11,19,8
"CHTF8","s1324_S_RAP_03_ASEReadCounter.table","NW_015090842.1:10291696",9,18,9
"CHTF8","s1324_S_RAP_03_ASEReadCounter.table","NW_015090842.1:10291714",9,21,12
"CHTF8","s1324_S_RAP_03_ASEReadCounter.table","NW_015090842.1:10291732",9,22,13
"CHTF8","s1324_S_RAP_03_ASEReadCounter.table","NW_015090842.1:10291755",7,19,12
"CHTF8","s1324_S_RAP_03_ASEReadCounter.table","NW_015090842.1:10291756",7,19,12
"CHTF8","s1324_S_RAP_03_ASEReadCounter.table","NW_015090842.1:10291758",7,19,12
"CHTF8","s1324_S_RAP_03_ASEReadCounter.table","NW_015090842.1:10291792",9,19,10
"CHTF8","s1324_S_RAP_03_ASEReadCounter.table","NW_015090842.1:10291895",11,22,11
"CHTF8","s1324_S_RAP_03_ASEReadCounter.table","NW_015090842.1:10292132",13,19,6
"CHTF8","s1324_S_RAP_03_ASEReadCounter.table","NW_015090842.1:10292314",12,16,4
"CHTF8","s1324_S_RAP_03_ASEReadCounter.table","NW_015090842.1:10292317",12,16,4
"CHTF8","s1324_S_RAP_03_ASEReadCounter.table","NW_015090842.1:10292928",2,5,3
"UTP4","s1324_S_RAP_03_ASEReadCounter.table","NW_015090842.1:10293146",13,27,14
"UTP4","s1324_S_RAP_03_ASEReadCounter.table","NW_015090842.1:10293151",12,26,14
"UTP4","s1324_S_RAP_03_ASEReadCounter.table","NW_015090842.1:10293191",9,19,10
"UTP4","s1324_S_RAP_03_ASEReadCounter.table","NW_015090842.1:10293362",11,26,15
"UTP4","s1324_S_RAP_03_ASEReadCounter.table","NW_015090842.1:10293430",8,21,13
"UTP4","s1324_S_RAP_03_ASEReadCounter.table","NW_015090842.1:10293625",5,11,6
"UTP4","s1324_S_RAP_03_ASEReadCounter.table","NW_015090842.1:10293684",9,17,8
"UTP4","s1324_S_RAP_03_ASEReadCounter.table","NW_015090842.1:10294093",9,17,8
"UTP4","s1324_S_RAP_03_ASEReadCounter.table","NW_015090842.1:10294568",12,23,11
"UTP4","s1324_S_RAP_03_ASEReadCounter.table","NW_015090842.1:10294622",8,22,14
"UTP4","s1324_S_RAP_03_ASEReadCounter.table","NW_015090842.1:10294632",8,21,13
"UTP4","s1324_S_RAP_03_ASEReadCounter.table","NW_015090842.1:10295238",17,38,21
"UTP4","s1324_S_RAP_03_ASEReadCounter.table","NW_015090842.1:10295880",20,39,19
"UTP4","s1324_S_RAP_03_ASEReadCounter.table","NW_015090842.1:10295884",20,41,21
"UTP4","s1324_S_RAP_03_ASEReadCounter.table","NW_015090842.1:10295903",18,37,19
"UTP4","s1324_S_RAP_03_ASEReadCounter.table","NW_015090842.1:10295906",18,37,19
"UTP4","s1324_S_RAP_03_ASEReadCounter.table","NW_015090842.1:10295915",16,37,21
"UTP4","s1324_S_RAP_03_ASEReadCounter.table","NW_015090842.1:10295938",15,33,18
"UTP4","s1324_S_RAP_03_ASEReadCounter.table","NW_015090842.1:10296175",10,21,11
"UTP4","s1324_S_RAP_03_ASEReadCounter.table","NW_015090842.1:10296660",13,35,22
"UTP4","s1324_S_RAP_03_ASEReadCounter.table","NW_015090842.1:10296679",11,33,22
"UTP4","s1324_S_RAP_03_ASEReadCounter.table","NW_015090842.1:10297193",29,52,23
"UTP4","s1324_S_RAP_03_ASEReadCounter.table","NW_015090842.1:10297220",29,49,20
"UTP4","s1324_S_RAP_03_ASEReadCounter.table","NW_015090842.1:10297307",31,58,27
"UTP4","s1324_S_RAP_03_ASEReadCounter.table","NW_015090842.1:10297558",35,70,35
"UTP4","s1324_S_RAP_03_ASEReadCounter.table","NW_015090842.1:10297943",29,51,22
"UTP4","s1324_S_RAP_03_ASEReadCounter.table","NW_015090842.1:10297979",27,47,20
"UTP4","s1324_S_RAP_03_ASEReadCounter.table","NW_015090842.1:10298022",24,46,22
"UTP4","s1324_S_RAP_03_ASEReadCounter.table","NW_015090842.1:10298079",3,16,13
"UTP4","s1324_S_RAP_03_ASEReadCounter.table","NW_015090842.1:10298081",3,15,12
"UTP4","s1324_S_RAP_03_ASEReadCounter.table","NW_015090842.1:10298082",2,14,12
"SNTB2","s1324_S_RAP_03_ASEReadCounter.table","NW_015090842.1:10298905",1,1,0
"SNTB2","s1324_S_RAP_03_ASEReadCounter.table","NW_015090842.1:10298928",1,1,0
"SNTB2","s1324_S_RAP_03_ASEReadCounter.table","NW_015090842.1:10303506",5,11,6
"SNTB2","s1324_S_RAP_03_ASEReadCounter.table","NW_015090842.1:10303524",3,9,6
"SNTB2","s1324_S_RAP_03_ASEReadCounter.table","NW_015090842.1:10304059",4,6,2
"SNTB2","s1324_S_RAP_03_ASEReadCounter.table","NW_015090842.1:10304089",4,6,2
"SNTB2","s1324_S_RAP_03_ASEReadCounter.table","NW_015090842.1:10304167",3,6,3
"SNTB2","s1324_S_RAP_03_ASEReadCounter.table","NW_015090842.1:10304176",3,6,3
"SNTB2","s1324_S_RAP_03_ASEReadCounter.table","NW_015090842.1:10305069",5,7,2
"SNTB2","s1324_S_RAP_03_ASEReadCounter.table","NW_015090842.1:10305099",4,5,1
"SNTB2","s1324_S_RAP_03_ASEReadCounter.table","NW_015090842.1:10305451",2,3,1
"SNTB2","s1324_S_RAP_03_ASEReadCounter.table","NW_015090842.1:10305547",3,3,0
"SNTB2","s1324_S_RAP_03_ASEReadCounter.table","NW_015090842.1:10305847",4,7,3
"SNTB2","s1324_S_RAP_03_ASEReadCounter.table","NW_015090842.1:10305911",5,7,2
"SNTB2","s1324_S_RAP_03_ASEReadCounter.table","NW_015090842.1:10306173",4,6,2
"SNTB2","s1324_S_RAP_03_ASEReadCounter.table","NW_015090842.1:10306275",2,4,2
"SNTB2","s1324_S_RAP_03_ASEReadCounter.table","NW_015090842.1:10306457",3,6,3
"SNTB2","s1324_S_RAP_03_ASEReadCounter.table","NW_015090842.1:10306496",2,5,3
"SNTB2","s1324_S_RAP_03_ASEReadCounter.table","NW_015090842.1:10306499",2,5,3
"VPS4A","s1324_S_RAP_03_ASEReadCounter.table","NW_015090842.1:10308566",106,237,131
"VPS4A","s1324_S_RAP_03_ASEReadCounter.table","NW_015090842.1:10308573",116,250,134
"VPS4A","s1324_S_RAP_03_ASEReadCounter.table","NW_015090842.1:10308856",142,351,209
"VPS4A","s1324_S_RAP_03_ASEReadCounter.table","NW_015090842.1:10309056",197,430,233
"VPS4A","s1324_S_RAP_03_ASEReadCounter.table","NW_015090842.1:10309089",243,475,232
"VPS4A","s1324_S_RAP_03_ASEReadCounter.table","NW_015090842.1:10309392",223,435,212
"VPS4A","s1324_S_RAP_03_ASEReadCounter.table","NW_015090842.1:10309413",210,424,214
"VPS4A","s1324_S_RAP_03_ASEReadCounter.table","NW_015090842.1:10309467",202,451,249
"VPS4A","s1324_S_RAP_03_ASEReadCounter.table","NW_015090842.1:10310230",270,554,284
"VPS4A","s1324_S_RAP_03_ASEReadCounter.table","NW_015090842.1:10310425",219,472,253
"VPS4A","s1324_S_RAP_03_ASEReadCounter.table","NW_015090842.1:10310639",235,526,291
"VPS4A","s1324_S_RAP_03_ASEReadCounter.table","NW_015090842.1:10310640",524,524,0
"VPS4A","s1324_S_RAP_03_ASEReadCounter.table","NW_015090842.1:10310687",259,573,314
"VPS4A","s1324_S_RAP_03_ASEReadCounter.table","NW_015090842.1:10310734",221,490,269
"VPS4A","s1324_S_RAP_03_ASEReadCounter.table","NW_015090842.1:10310737",228,505,277
"VPS4A","s1324_S_RAP_03_ASEReadCounter.table","NW_015090842.1:10310746",234,506,272
"VPS4A","s1324_S_RAP_03_ASEReadCounter.table","NW_015090842.1:10310767",240,497,257
"VPS4A","s1324_S_RAP_03_ASEReadCounter.table","NW_015090842.1:10310995",237,484,247
"VPS4A","s1324_S_RAP_03_ASEReadCounter.table","NW_015090842.1:10311004",245,487,242
"VPS4A","s1324_S_RAP_03_ASEReadCounter.table","NW_015090842.1:10311007",250,500,250
"VPS4A","s1324_S_RAP_03_ASEReadCounter.table","NW_015090842.1:10311013",271,523,252
"VPS4A","s1324_S_RAP_03_ASEReadCounter.table","NW_015090842.1:10311022",248,503,255
"VPS4A","s1324_S_RAP_03_ASEReadCounter.table","NW_015090842.1:10311023",247,499,252
"VPS4A","s1324_S_RAP_03_ASEReadCounter.table","NW_015090842.1:10311426",236,502,266
"VPS4A","s1324_S_RAP_03_ASEReadCounter.table","NW_015090842.1:10311489",2,11,9
"VPS4A","s1324_S_RAP_03_ASEReadCounter.table","NW_015090842.1:10311490",4,8,4
"VPS4A","s1324_S_RAP_03_ASEReadCounter.table","NW_015090842.1:10311525",15,27,12
"VPS4A","s1324_S_RAP_03_ASEReadCounter.table","NW_015090842.1:10311529",17,44,27
"VPS4A","s1324_S_RAP_03_ASEReadCounter.table","NW_015090842.1:10311530",17,44,27
"VPS4A","s1324_S_RAP_03_ASEReadCounter.table","NW_015090842.1:10311552",68,109,41
"VPS4A","s1324_S_RAP_03_ASEReadCounter.table","NW_015090842.1:10311689",53,96,43
"VPS4A","s1324_S_RAP_03_ASEReadCounter.table","NW_015090842.1:10311700",74,120,46
"VPS4A","s1324_S_RAP_03_ASEReadCounter.table","NW_015090842.1:10311701",74,121,47
"VPS4A","s1324_S_RAP_03_ASEReadCounter.table","NW_015090842.1:10311703",73,124,51
"COG8","s1324_S_RAP_03_ASEReadCounter.table","NW_015090842.1:10313487",21,66,45
"COG8","s1324_S_RAP_03_ASEReadCounter.table","NW_015090842.1:10313559",29,81,52
"COG8","s1324_S_RAP_03_ASEReadCounter.table","NW_015090842.1:10313579",27,72,45
"COG8","s1324_S_RAP_03_ASEReadCounter.table","NW_015090842.1:10313665",30,67,37
"COG8","s1324_S_RAP_03_ASEReadCounter.table","NW_015090842.1:10313681",29,69,40
"COG8","s1324_S_RAP_03_ASEReadCounter.table","NW_015090842.1:10313768",47,92,45
"COG8","s1324_S_RAP_03_ASEReadCounter.table","NW_015090842.1:10313775",51,96,45
"COG8","s1324_S_RAP_03_ASEReadCounter.table","NW_015090842.1:10313811",31,66,35
"COG8","s1324_S_RAP_03_ASEReadCounter.table","NW_015090842.1:10313858",26,60,34
"COG8","s1324_S_RAP_03_ASEReadCounter.table","NW_015090842.1:10313859",59,59,0
"COG8","s1324_S_RAP_03_ASEReadCounter.table","NW_015090842.1:10314100",41,81,40
"COG8","s1324_S_RAP_03_ASEReadCounter.table","NW_015090842.1:10314213",30,66,36
"COG8","s1324_S_RAP_03_ASEReadCounter.table","NW_015090842.1:10315093",16,43,27
"COG8","s1324_S_RAP_03_ASEReadCounter.table","NW_015090842.1:10315162",30,62,32
"COG8","s1324_S_RAP_03_ASEReadCounter.table","NW_015090842.1:10315285",36,62,26
"COG8","s1324_S_RAP_03_ASEReadCounter.table","NW_015090842.1:10315360",22,50,28
"COG8","s1324_S_RAP_03_ASEReadCounter.table","NW_015090842.1:10315369",23,48,25
"COG8","s1324_S_RAP_03_ASEReadCounter.table","NW_015090842.1:10315508",8,33,25
"COG8","s1324_S_RAP_03_ASEReadCounter.table","NW_015090842.1:10315624",18,47,29
"COG8","s1324_S_RAP_03_ASEReadCounter.table","NW_015090842.1:10315693",19,50,31
"COG8","s1324_S_RAP_03_ASEReadCounter.table","NW_015090842.1:10315698",19,56,37
"COG8","s1324_S_RAP_03_ASEReadCounter.table","NW_015090842.1:10315768",13,40,27
"COG8","s1324_S_RAP_03_ASEReadCounter.table","NW_015090842.1:10315769",12,38,26
"COG8","s1324_S_RAP_03_ASEReadCounter.table","NW_015090842.1:10315784",9,34,25
"COG8","s1324_S_RAP_03_ASEReadCounter.table","NW_015090842.1:10316093",16,33,17
"COG8","s1324_S_RAP_03_ASEReadCounter.table","NW_015090842.1:10316133",11,25,14
"NIP7","s1324_S_RAP_03_ASEReadCounter.table","NW_015090842.1:10316759",26,52,26
"NIP7","s1324_S_RAP_03_ASEReadCounter.table","NW_015090842.1:10316967",146,272,126
"NIP7","s1324_S_RAP_03_ASEReadCounter.table","NW_015090842.1:10316995",168,304,136
"NIP7","s1324_S_RAP_03_ASEReadCounter.table","NW_015090842.1:10317240",226,416,190
"NIP7","s1324_S_RAP_03_ASEReadCounter.table","NW_015090842.1:10317247",224,414,190
"NIP7","s1324_S_RAP_03_ASEReadCounter.table","NW_015090842.1:10317264",213,387,174
"NIP7","s1324_S_RAP_03_ASEReadCounter.table","NW_015090842.1:10317433",238,479,241
"NIP7","s1324_S_RAP_03_ASEReadCounter.table","NW_015090842.1:10317738",175,413,238
"NIP7","s1324_S_RAP_03_ASEReadCounter.table","NW_015090842.1:10317769",186,406,220
"NIP7","s1324_S_RAP_03_ASEReadCounter.table","NW_015090842.1:10317808",130,274,144
"NIP7","s1324_S_RAP_03_ASEReadCounter.table","NW_015090842.1:10317870",64,166,102
"NIP7","s1324_S_RAP_03_ASEReadCounter.table","NW_015090842.1:10317871",65,159,94
"NIP7","s1324_S_RAP_03_ASEReadCounter.table","NW_015090842.1:10317898",47,106,59
"NIP7","s1324_S_RAP_03_ASEReadCounter.table","NW_015090842.1:10317911",39,92,53
"TMED6","s1324_S_RAP_03_ASEReadCounter.table","NW_015090842.1:10318731",2,2,0
"TERF2","s1324_S_RAP_03_ASEReadCounter.table","NW_015090842.1:10321768",32,71,39
"TERF2","s1324_S_RAP_03_ASEReadCounter.table","NW_015090842.1:10321777",29,63,34
"TERF2","s1324_S_RAP_03_ASEReadCounter.table","NW_015090842.1:10321805",34,76,42
"TERF2","s1324_S_RAP_03_ASEReadCounter.table","NW_015090842.1:10321878",58,108,50
"TERF2","s1324_S_RAP_03_ASEReadCounter.table","NW_015090842.1:10321893",49,101,52
"TERF2","s1324_S_RAP_03_ASEReadCounter.table","NW_015090842.1:10321897",51,100,49
"TERF2","s1324_S_RAP_03_ASEReadCounter.table","NW_015090842.1:10321908",48,95,47
"TERF2","s1324_S_RAP_03_ASEReadCounter.table","NW_015090842.1:10322001",57,134,77
"TERF2","s1324_S_RAP_03_ASEReadCounter.table","NW_015090842.1:10322035",46,112,66
"TERF2","s1324_S_RAP_03_ASEReadCounter.table","NW_015090842.1:10322051",50,119,69
"TERF2","s1324_S_RAP_03_ASEReadCounter.table","NW_015090842.1:10322137",48,101,53
"TERF2","s1324_S_RAP_03_ASEReadCounter.table","NW_015090842.1:10322144",46,98,52
"TERF2","s1324_S_RAP_03_ASEReadCounter.table","NW_015090842.1:10322388",22,84,62
"TERF2","s1324_S_RAP_03_ASEReadCounter.table","NW_015090842.1:10322396",24,86,62
"TERF2","s1324_S_RAP_03_ASEReadCounter.table","NW_015090842.1:10322502",55,120,65
"TERF2","s1324_S_RAP_03_ASEReadCounter.table","NW_015090842.1:10322504",53,119,66
"TERF2","s1324_S_RAP_03_ASEReadCounter.table","NW_015090842.1:10322510",55,122,67
"TERF2","s1324_S_RAP_03_ASEReadCounter.table","NW_015090842.1:10323580",54,115,61
"TERF2","s1324_S_RAP_03_ASEReadCounter.table","NW_015090842.1:10324314",42,104,62
"TERF2","s1324_S_RAP_03_ASEReadCounter.table","NW_015090842.1:10326832",43,82,39
"TERF2","s1324_S_RAP_03_ASEReadCounter.table","NW_015090842.1:10327787",26,53,27
"TERF2","s1324_S_RAP_03_ASEReadCounter.table","NW_015090842.1:10328588",24,52,28
"TERF2","s1324_S_RAP_03_ASEReadCounter.table","NW_015090842.1:10328644",18,37,19
"TERF2","s1324_S_RAP_03_ASEReadCounter.table","NW_015090842.1:10329813",13,33,20
"TERF2","s1324_S_RAP_03_ASEReadCounter.table","NW_015090842.1:10330749",22,41,19
"TERF2","s1324_S_RAP_03_ASEReadCounter.table","NW_015090842.1:10330789",25,46,21
"CYB5B","s1324_S_RAP_03_ASEReadCounter.table","NW_015090842.1:10336595",3,11,8
"CYB5B","s1324_S_RAP_03_ASEReadCounter.table","NW_015090842.1:10336667",61,139,78
"CYB5B","s1324_S_RAP_03_ASEReadCounter.table","NW_015090842.1:10336689",83,188,105
"CYB5B","s1324_S_RAP_03_ASEReadCounter.table","NW_015090842.1:10336728",110,258,148
"CYB5B","s1324_S_RAP_03_ASEReadCounter.table","NW_015090842.1:10345068",122,295,173
"CYB5B","s1324_S_RAP_03_ASEReadCounter.table","NW_015090842.1:10348800",184,388,204
"CYB5B","s1324_S_RAP_03_ASEReadCounter.table","NW_015090842.1:10349046",143,303,160
"CYB5B","s1324_S_RAP_03_ASEReadCounter.table","NW_015090842.1:10349119",86,257,171
"CYB5B","s1324_S_RAP_03_ASEReadCounter.table","NW_015090842.1:10349146",51,221,170
"CYB5B","s1324_S_RAP_03_ASEReadCounter.table","NW_015090842.1:10349157",81,260,179
"CYB5B","s1324_S_RAP_03_ASEReadCounter.table","NW_015090842.1:10349263",257,257,0
