"gene","id","snp","ref_count","total_count","alt_count"
"CENPN","s1324_S_LS_02_ASEReadCounter.table","NW_015090842.1:5801618",0,1,1
"CENPN","s1324_S_LS_02_ASEReadCounter.table","NW_015090842.1:5801623",0,1,1
"CENPN","s1324_S_LS_02_ASEReadCounter.table","NW_015090842.1:5801631",0,1,1
"CENPN","s1324_S_LS_02_ASEReadCounter.table","NW_015090842.1:5801632",0,1,1
"CENPN","s1324_S_LS_02_ASEReadCounter.table","NW_015090842.1:5801655",4,6,2
"CENPN","s1324_S_LS_02_ASEReadCounter.table","NW_015090842.1:5801670",4,6,2
"CENPN","s1324_S_LS_02_ASEReadCounter.table","NW_015090842.1:5801674",4,6,2
"CENPN","s1324_S_LS_02_ASEReadCounter.table","NW_015090842.1:5801692",4,6,2
"CENPN","s1324_S_LS_02_ASEReadCounter.table","NW_015090842.1:5802008",2,4,2
"CENPN","s1324_S_LS_02_ASEReadCounter.table","NW_015090842.1:5802012",3,5,2
"CENPN","s1324_S_LS_02_ASEReadCounter.table","NW_015090842.1:5802087",2,6,4
"CENPN","s1324_S_LS_02_ASEReadCounter.table","NW_015090842.1:5810113",17,17,0
"CENPN","s1324_S_LS_02_ASEReadCounter.table","NW_015090842.1:5810147",18,18,0
"CENPN","s1324_S_LS_02_ASEReadCounter.table","NW_015090842.1:5810148",18,18,0
"ATMIN","s1324_S_LS_02_ASEReadCounter.table","NW_015090842.1:5818789",1,3,2
"ATMIN","s1324_S_LS_02_ASEReadCounter.table","NW_015090842.1:5819958",3,6,3
"ATMIN","s1324_S_LS_02_ASEReadCounter.table","NW_015090842.1:5820004",5,8,3
"ATMIN","s1324_S_LS_02_ASEReadCounter.table","NW_015090842.1:5820217",7,9,2
"ATMIN","s1324_S_LS_02_ASEReadCounter.table","NW_015090842.1:5820250",9,13,4
"ATMIN","s1324_S_LS_02_ASEReadCounter.table","NW_015090842.1:5820298",10,12,2
"ATMIN","s1324_S_LS_02_ASEReadCounter.table","NW_015090842.1:5820417",3,4,1
"ATMIN","s1324_S_LS_02_ASEReadCounter.table","NW_015090842.1:5820421",2,3,1
"ATMIN","s1324_S_LS_02_ASEReadCounter.table","NW_015090842.1:5820448",3,6,3
"ATMIN","s1324_S_LS_02_ASEReadCounter.table","NW_015090842.1:5820457",3,7,4
"ATMIN","s1324_S_LS_02_ASEReadCounter.table","NW_015090842.1:5820510",3,10,7
"ATMIN","s1324_S_LS_02_ASEReadCounter.table","NW_015090842.1:5820673",2,5,3
"ATMIN","s1324_S_LS_02_ASEReadCounter.table","NW_015090842.1:5820754",7,9,2
"ATMIN","s1324_S_LS_02_ASEReadCounter.table","NW_015090842.1:5820820",4,8,4
"ATMIN","s1324_S_LS_02_ASEReadCounter.table","NW_015090842.1:5820865",6,9,3
"ATMIN","s1324_S_LS_02_ASEReadCounter.table","NW_015090842.1:5820889",6,9,3
"ATMIN","s1324_S_LS_02_ASEReadCounter.table","NW_015090842.1:5820891",6,9,3
"ATMIN","s1324_S_LS_02_ASEReadCounter.table","NW_015090842.1:5820997",7,17,10
"ATMIN","s1324_S_LS_02_ASEReadCounter.table","NW_015090842.1:5821063",10,19,9
"ATMIN","s1324_S_LS_02_ASEReadCounter.table","NW_015090842.1:5821132",4,10,6
"ATMIN","s1324_S_LS_02_ASEReadCounter.table","NW_015090842.1:5821645",7,15,8
"ATMIN","s1324_S_LS_02_ASEReadCounter.table","NW_015090842.1:5825066",15,24,9
"ATMIN","s1324_S_LS_02_ASEReadCounter.table","NW_015090842.1:5825106",12,29,17
"ATMIN","s1324_S_LS_02_ASEReadCounter.table","NW_015090842.1:5825122",11,25,14
"ATMIN","s1324_S_LS_02_ASEReadCounter.table","NW_015090842.1:5825178",16,37,21
"ATMIN","s1324_S_LS_02_ASEReadCounter.table","NW_015090842.1:5825194",16,36,20
"ATMIN","s1324_S_LS_02_ASEReadCounter.table","NW_015090842.1:5825195",17,37,20
"ATMIN","s1324_S_LS_02_ASEReadCounter.table","NW_015090842.1:5825220",16,39,23
"ATMIN","s1324_S_LS_02_ASEReadCounter.table","NW_015090842.1:5825240",19,38,19
"ATMIN","s1324_S_LS_02_ASEReadCounter.table","NW_015090842.1:5825303",17,41,24
"ATMIN","s1324_S_LS_02_ASEReadCounter.table","NW_015090842.1:5825304",17,40,23
"ATMIN","s1324_S_LS_02_ASEReadCounter.table","NW_015090842.1:5825310",16,40,24
"ATMIN","s1324_S_LS_02_ASEReadCounter.table","NW_015090842.1:5825406",18,35,17
"ATMIN","s1324_S_LS_02_ASEReadCounter.table","NW_015090842.1:5825415",19,33,14
"ATMIN","s1324_S_LS_02_ASEReadCounter.table","NW_015090842.1:5825438",20,37,17
"ATMIN","s1324_S_LS_02_ASEReadCounter.table","NW_015090842.1:5825485",18,35,17
"ATMIN","s1324_S_LS_02_ASEReadCounter.table","NW_015090842.1:5825524",20,45,25
"ATMIN","s1324_S_LS_02_ASEReadCounter.table","NW_015090842.1:5825557",25,49,24
"ATMIN","s1324_S_LS_02_ASEReadCounter.table","NW_015090842.1:5825571",23,48,25
"ATMIN","s1324_S_LS_02_ASEReadCounter.table","NW_015090842.1:5825579",23,48,25
"ATMIN","s1324_S_LS_02_ASEReadCounter.table","NW_015090842.1:5825590",19,40,21
"ATMIN","s1324_S_LS_02_ASEReadCounter.table","NW_015090842.1:5825689",27,55,28
"ATMIN","s1324_S_LS_02_ASEReadCounter.table","NW_015090842.1:5825703",28,55,27
"ATMIN","s1324_S_LS_02_ASEReadCounter.table","NW_015090842.1:5825787",24,53,29
"ATMIN","s1324_S_LS_02_ASEReadCounter.table","NW_015090842.1:5825833",30,61,31
"ATMIN","s1324_S_LS_02_ASEReadCounter.table","NW_015090842.1:5825841",24,52,28
"ATMIN","s1324_S_LS_02_ASEReadCounter.table","NW_015090842.1:5825895",28,61,33
"ATMIN","s1324_S_LS_02_ASEReadCounter.table","NW_015090842.1:5825984",23,57,34
"ATMIN","s1324_S_LS_02_ASEReadCounter.table","NW_015090842.1:5826162",31,59,28
"ATMIN","s1324_S_LS_02_ASEReadCounter.table","NW_015090842.1:5826194",34,62,28
"ATMIN","s1324_S_LS_02_ASEReadCounter.table","NW_015090842.1:5826235",40,63,23
"ATMIN","s1324_S_LS_02_ASEReadCounter.table","NW_015090842.1:5826245",40,61,21
"ATMIN","s1324_S_LS_02_ASEReadCounter.table","NW_015090842.1:5826335",14,40,26
"ATMIN","s1324_S_LS_02_ASEReadCounter.table","NW_015090842.1:5826417",35,67,32
"ATMIN","s1324_S_LS_02_ASEReadCounter.table","NW_015090842.1:5826431",24,70,46
"ATMIN","s1324_S_LS_02_ASEReadCounter.table","NW_015090842.1:5826438",31,66,35
"ATMIN","s1324_S_LS_02_ASEReadCounter.table","NW_015090842.1:5826463",45,95,50
"ATMIN","s1324_S_LS_02_ASEReadCounter.table","NW_015090842.1:5826502",44,97,53
"ATMIN","s1324_S_LS_02_ASEReadCounter.table","NW_015090842.1:5826511",45,97,52
"ATMIN","s1324_S_LS_02_ASEReadCounter.table","NW_015090842.1:5826659",36,78,42
"ATMIN","s1324_S_LS_02_ASEReadCounter.table","NW_015090842.1:5826701",35,85,50
"ATMIN","s1324_S_LS_02_ASEReadCounter.table","NW_015090842.1:5826702",35,82,47
"ATMIN","s1324_S_LS_02_ASEReadCounter.table","NW_015090842.1:5826732",40,95,55
"ATMIN","s1324_S_LS_02_ASEReadCounter.table","NW_015090842.1:5826745",45,99,54
"ATMIN","s1324_S_LS_02_ASEReadCounter.table","NW_015090842.1:5826835",48,104,56
"ATMIN","s1324_S_LS_02_ASEReadCounter.table","NW_015090842.1:5826910",38,90,52
"ATMIN","s1324_S_LS_02_ASEReadCounter.table","NW_015090842.1:5826942",35,106,71
"ATMIN","s1324_S_LS_02_ASEReadCounter.table","NW_015090842.1:5827193",62,121,59
"ATMIN","s1324_S_LS_02_ASEReadCounter.table","NW_015090842.1:5827196",59,123,64
"ATMIN","s1324_S_LS_02_ASEReadCounter.table","NW_015090842.1:5827269",72,149,77
"ATMIN","s1324_S_LS_02_ASEReadCounter.table","NW_015090842.1:5827315",59,117,58
"ATMIN","s1324_S_LS_02_ASEReadCounter.table","NW_015090842.1:5827316",60,121,61
"ATMIN","s1324_S_LS_02_ASEReadCounter.table","NW_015090842.1:5827333",55,116,61
"PPP1R3E","s1324_S_LS_02_ASEReadCounter.table","NW_015090842.1:5837733",6,8,2
"PPP1R3E","s1324_S_LS_02_ASEReadCounter.table","NW_015090842.1:5837947",3,5,2
"PKD1L2","s1324_S_LS_02_ASEReadCounter.table","NW_015090842.1:5867509",1,1,0
"PKD1L2","s1324_S_LS_02_ASEReadCounter.table","NW_015090842.1:5867660",1,1,0
"PKD1L2","s1324_S_LS_02_ASEReadCounter.table","NW_015090842.1:5867675",1,1,0
"PKD1L2","s1324_S_LS_02_ASEReadCounter.table","NW_015090842.1:5867788",1,1,0
"PKD1L2","s1324_S_LS_02_ASEReadCounter.table","NW_015090842.1:5867843",1,1,0
"BCO1","s1324_S_LS_02_ASEReadCounter.table","NW_015090842.1:5915610",2,2,0
"BCO1","s1324_S_LS_02_ASEReadCounter.table","NW_015090842.1:5915646",1,1,0
"BCO1","s1324_S_LS_02_ASEReadCounter.table","NW_015090842.1:5917912",1,4,3
"BCO1","s1324_S_LS_02_ASEReadCounter.table","NW_015090842.1:5917941",3,6,3
"BCO1","s1324_S_LS_02_ASEReadCounter.table","NW_015090842.1:5917971",4,6,2
"BCO1","s1324_S_LS_02_ASEReadCounter.table","NW_015090842.1:5921679",3,7,4
"BCO1","s1324_S_LS_02_ASEReadCounter.table","NW_015090842.1:5921726",5,8,3
"BCO1","s1324_S_LS_02_ASEReadCounter.table","NW_015090842.1:5925669",3,5,2
"BCO1","s1324_S_LS_02_ASEReadCounter.table","NW_015090842.1:5925753",2,6,4
"BCO1","s1324_S_LS_02_ASEReadCounter.table","NW_015090842.1:5926937",8,12,4
"BCO1","s1324_S_LS_02_ASEReadCounter.table","NW_015090842.1:5927921",8,8,0
"BCO1","s1324_S_LS_02_ASEReadCounter.table","NW_015090842.1:5927948",6,6,0
"BCO1","s1324_S_LS_02_ASEReadCounter.table","NW_015090842.1:5927968",5,5,0
"BCO1","s1324_S_LS_02_ASEReadCounter.table","NW_015090842.1:5928052",3,3,0
"BCO1","s1324_S_LS_02_ASEReadCounter.table","NW_015090842.1:5932726",14,17,3
"BCO1","s1324_S_LS_02_ASEReadCounter.table","NW_015090842.1:5932801",8,8,0
"BCO1","s1324_S_LS_02_ASEReadCounter.table","NW_015090842.1:5934558",9,14,5
"BCO1","s1324_S_LS_02_ASEReadCounter.table","NW_015090842.1:5934575",9,13,4
"BCO1","s1324_S_LS_02_ASEReadCounter.table","NW_015090842.1:5934608",7,12,5
"BCO1","s1324_S_LS_02_ASEReadCounter.table","NW_015090842.1:5934647",8,12,4
"BCO1","s1324_S_LS_02_ASEReadCounter.table","NW_015090842.1:5934725",13,21,8
"BCO1","s1324_S_LS_02_ASEReadCounter.table","NW_015090842.1:5934726",13,21,8
"BCO1","s1324_S_LS_02_ASEReadCounter.table","NW_015090842.1:5934733",15,24,9
"BCO1","s1324_S_LS_02_ASEReadCounter.table","NW_015090842.1:5934821",18,21,3
"BCO1","s1324_S_LS_02_ASEReadCounter.table","NW_015090842.1:5934826",16,19,3
"BCO1","s1324_S_LS_02_ASEReadCounter.table","NW_015090842.1:5934844",9,12,3
"BCO1","s1324_S_LS_02_ASEReadCounter.table","NW_015090842.1:5934958",14,24,10
"BCO1","s1324_S_LS_02_ASEReadCounter.table","NW_015090842.1:5934976",12,21,9
"GAN","s1324_S_LS_02_ASEReadCounter.table","NW_015090842.1:5953759",4,10,6
"GAN","s1324_S_LS_02_ASEReadCounter.table","NW_015090842.1:5957502",11,31,20
"GAN","s1324_S_LS_02_ASEReadCounter.table","NW_015090842.1:5957578",12,28,16
"GAN","s1324_S_LS_02_ASEReadCounter.table","NW_015090842.1:5965028",16,33,17
"GAN","s1324_S_LS_02_ASEReadCounter.table","NW_015090842.1:5966047",9,40,31
"GAN","s1324_S_LS_02_ASEReadCounter.table","NW_015090842.1:5966126",7,32,25
"GAN","s1324_S_LS_02_ASEReadCounter.table","NW_015090842.1:5966127",5,31,26
"GAN","s1324_S_LS_02_ASEReadCounter.table","NW_015090842.1:5966162",17,45,28
"GAN","s1324_S_LS_02_ASEReadCounter.table","NW_015090842.1:5966483",49,121,72
"CMIP","s1324_S_LS_02_ASEReadCounter.table","NW_015090842.1:6109159",12,19,7
"CMIP","s1324_S_LS_02_ASEReadCounter.table","NW_015090842.1:6109166",10,16,6
"CMIP","s1324_S_LS_02_ASEReadCounter.table","NW_015090842.1:6114641",21,36,15
"CMIP","s1324_S_LS_02_ASEReadCounter.table","NW_015090842.1:6114751",12,27,15
"CMIP","s1324_S_LS_02_ASEReadCounter.table","NW_015090842.1:6114824",16,33,17
"CMIP","s1324_S_LS_02_ASEReadCounter.table","NW_015090842.1:6128998",29,56,27
"CMIP","s1324_S_LS_02_ASEReadCounter.table","NW_015090842.1:6130562",47,108,61
"CMIP","s1324_S_LS_02_ASEReadCounter.table","NW_015090842.1:6132522",50,99,49
"CMIP","s1324_S_LS_02_ASEReadCounter.table","NW_015090842.1:6134088",46,104,58
"CMIP","s1324_S_LS_02_ASEReadCounter.table","NW_015090842.1:6138265",76,225,149
"CMIP","s1324_S_LS_02_ASEReadCounter.table","NW_015090842.1:6138300",75,224,149
"CMIP","s1324_S_LS_02_ASEReadCounter.table","NW_015090842.1:6138342",63,182,119
"CMIP","s1324_S_LS_02_ASEReadCounter.table","NW_015090842.1:6138343",64,183,119
"CMIP","s1324_S_LS_02_ASEReadCounter.table","NW_015090842.1:6138345",63,183,120
"CMIP","s1324_S_LS_02_ASEReadCounter.table","NW_015090842.1:6138647",59,115,56
"CMIP","s1324_S_LS_02_ASEReadCounter.table","NW_015090842.1:6138745",61,144,83
"CMIP","s1324_S_LS_02_ASEReadCounter.table","NW_015090842.1:6138832",11,74,63
"CMIP","s1324_S_LS_02_ASEReadCounter.table","NW_015090842.1:6138967",64,156,92
"CMIP","s1324_S_LS_02_ASEReadCounter.table","NW_015090842.1:6139131",36,90,54
"CMIP","s1324_S_LS_02_ASEReadCounter.table","NW_015090842.1:6139163",19,66,47
"CMIP","s1324_S_LS_02_ASEReadCounter.table","NW_015090842.1:6139360",50,74,24
"CMIP","s1324_S_LS_02_ASEReadCounter.table","NW_015090842.1:6139572",19,46,27
"CMIP","s1324_S_LS_02_ASEReadCounter.table","NW_015090842.1:6139773",79,80,1
"PLCG2","s1324_S_LS_02_ASEReadCounter.table","NW_015090842.1:6179613",1,3,2
"PLCG2","s1324_S_LS_02_ASEReadCounter.table","NW_015090842.1:6179658",3,4,1
"PLCG2","s1324_S_LS_02_ASEReadCounter.table","NW_015090842.1:6203766",1,1,0
"PLCG2","s1324_S_LS_02_ASEReadCounter.table","NW_015090842.1:6203775",1,1,0
"PLCG2","s1324_S_LS_02_ASEReadCounter.table","NW_015090842.1:6203787",1,1,0
"PLCG2","s1324_S_LS_02_ASEReadCounter.table","NW_015090842.1:6205047",1,4,3
"PLCG2","s1324_S_LS_02_ASEReadCounter.table","NW_015090842.1:6208541",0,2,2
"PLCG2","s1324_S_LS_02_ASEReadCounter.table","NW_015090842.1:6209741",1,3,2
"PLCG2","s1324_S_LS_02_ASEReadCounter.table","NW_015090842.1:6209798",2,4,2
"PLCG2","s1324_S_LS_02_ASEReadCounter.table","NW_015090842.1:6209816",3,4,1
"PLCG2","s1324_S_LS_02_ASEReadCounter.table","NW_015090842.1:6217547",0,10,10
"PLCG2","s1324_S_LS_02_ASEReadCounter.table","NW_015090842.1:6218641",0,4,4
"PLCG2","s1324_S_LS_02_ASEReadCounter.table","NW_015090842.1:6220552",1,8,7
"PLCG2","s1324_S_LS_02_ASEReadCounter.table","NW_015090842.1:6221969",1,5,4
"PLCG2","s1324_S_LS_02_ASEReadCounter.table","NW_015090842.1:6228672",2,7,5
"PLCG2","s1324_S_LS_02_ASEReadCounter.table","NW_015090842.1:6228694",2,4,2
"PLCG2","s1324_S_LS_02_ASEReadCounter.table","NW_015090842.1:6228722",2,4,2
"PLCG2","s1324_S_LS_02_ASEReadCounter.table","NW_015090842.1:6228747",1,3,2
"PLCG2","s1324_S_LS_02_ASEReadCounter.table","NW_015090842.1:6228835",1,7,6
"PLCG2","s1324_S_LS_02_ASEReadCounter.table","NW_015090842.1:6228841",1,7,6
"PLCG2","s1324_S_LS_02_ASEReadCounter.table","NW_015090842.1:6228865",0,6,6
"PLCG2","s1324_S_LS_02_ASEReadCounter.table","NW_015090842.1:6228917",1,8,7
"PLCG2","s1324_S_LS_02_ASEReadCounter.table","NW_015090842.1:6228926",1,8,7
"PLCG2","s1324_S_LS_02_ASEReadCounter.table","NW_015090842.1:6228954",1,7,6
"PLCG2","s1324_S_LS_02_ASEReadCounter.table","NW_015090842.1:6229002",1,8,7
"PLCG2","s1324_S_LS_02_ASEReadCounter.table","NW_015090842.1:6229006",1,8,7
"PLCG2","s1324_S_LS_02_ASEReadCounter.table","NW_015090842.1:6229081",0,6,6
"PLCG2","s1324_S_LS_02_ASEReadCounter.table","NW_015090842.1:6229097",0,4,4
"PLCG2","s1324_S_LS_02_ASEReadCounter.table","NW_015090842.1:6229160",0,1,1
"PLCG2","s1324_S_LS_02_ASEReadCounter.table","NW_015090842.1:6229213",0,1,1
"PLCG2","s1324_S_LS_02_ASEReadCounter.table","NW_015090842.1:6229231",1,5,4
"PLCG2","s1324_S_LS_02_ASEReadCounter.table","NW_015090842.1:6229663",0,2,2
"PLCG2","s1324_S_LS_02_ASEReadCounter.table","NW_015090842.1:6229892",0,1,1
"PLCG2","s1324_S_LS_02_ASEReadCounter.table","NW_015090842.1:6230248",1,1,0
"PLCG2","s1324_S_LS_02_ASEReadCounter.table","NW_015090842.1:6230255",1,1,0
"PLCG2","s1324_S_LS_02_ASEReadCounter.table","NW_015090842.1:6230296",1,1,0
"PLCG2","s1324_S_LS_02_ASEReadCounter.table","NW_015090842.1:6230349",2,2,0
"PLCG2","s1324_S_LS_02_ASEReadCounter.table","NW_015090842.1:6230381",2,3,1
"PLCG2","s1324_S_LS_02_ASEReadCounter.table","NW_015090842.1:6230408",2,3,1
"PLCG2","s1324_S_LS_02_ASEReadCounter.table","NW_015090842.1:6230439",1,2,1
"PLCG2","s1324_S_LS_02_ASEReadCounter.table","NW_015090842.1:6230757",0,1,1
"PLCG2","s1324_S_LS_02_ASEReadCounter.table","NW_015090842.1:6230758",0,1,1
"PLCG2","s1324_S_LS_02_ASEReadCounter.table","NW_015090842.1:6230898",0,1,1
"PLCG2","s1324_S_LS_02_ASEReadCounter.table","NW_015090842.1:6230976",1,4,3
"PLCG2","s1324_S_LS_02_ASEReadCounter.table","NW_015090842.1:6231078",0,2,2
"PLCG2","s1324_S_LS_02_ASEReadCounter.table","NW_015090842.1:6231138",3,9,6
"PLCG2","s1324_S_LS_02_ASEReadCounter.table","NW_015090842.1:6231177",4,8,4
"PLCG2","s1324_S_LS_02_ASEReadCounter.table","NW_015090842.1:6231263",5,7,2
"PLCG2","s1324_S_LS_02_ASEReadCounter.table","NW_015090842.1:6231309",3,5,2
"SDR42E1","s1324_S_LS_02_ASEReadCounter.table","NW_015090842.1:6235292",1,5,4
"SDR42E1","s1324_S_LS_02_ASEReadCounter.table","NW_015090842.1:6235315",1,6,5
"SDR42E1","s1324_S_LS_02_ASEReadCounter.table","NW_015090842.1:6235348",4,14,10
"SDR42E1","s1324_S_LS_02_ASEReadCounter.table","NW_015090842.1:6235355",4,14,10
"SDR42E1","s1324_S_LS_02_ASEReadCounter.table","NW_015090842.1:6235417",4,17,13
"SDR42E1","s1324_S_LS_02_ASEReadCounter.table","NW_015090842.1:6235526",18,18,0
"SDR42E1","s1324_S_LS_02_ASEReadCounter.table","NW_015090842.1:6235558",2,14,12
"SDR42E1","s1324_S_LS_02_ASEReadCounter.table","NW_015090842.1:6235603",10,10,0
"SDR42E1","s1324_S_LS_02_ASEReadCounter.table","NW_015090842.1:6235741",4,11,7
"SDR42E1","s1324_S_LS_02_ASEReadCounter.table","NW_015090842.1:6235777",2,12,10
"SDR42E1","s1324_S_LS_02_ASEReadCounter.table","NW_015090842.1:6235806",4,19,15
"SDR42E1","s1324_S_LS_02_ASEReadCounter.table","NW_015090842.1:6235809",4,19,15
"SDR42E1","s1324_S_LS_02_ASEReadCounter.table","NW_015090842.1:6235816",4,19,15
"SDR42E1","s1324_S_LS_02_ASEReadCounter.table","NW_015090842.1:6235914",2,6,4
"SDR42E1","s1324_S_LS_02_ASEReadCounter.table","NW_015090842.1:6235935",3,6,3
"SDR42E1","s1324_S_LS_02_ASEReadCounter.table","NW_015090842.1:6235957",3,5,2
"SDR42E1","s1324_S_LS_02_ASEReadCounter.table","NW_015090842.1:6236040",2,6,4
"SDR42E1","s1324_S_LS_02_ASEReadCounter.table","NW_015090842.1:6236260",3,6,3
"SDR42E1","s1324_S_LS_02_ASEReadCounter.table","NW_015090842.1:6236281",3,7,4
"SDR42E1","s1324_S_LS_02_ASEReadCounter.table","NW_015090842.1:6236305",2,9,7
"SDR42E1","s1324_S_LS_02_ASEReadCounter.table","NW_015090842.1:6236458",1,7,6
"SDR42E1","s1324_S_LS_02_ASEReadCounter.table","NW_015090842.1:6236476",1,10,9
"SDR42E1","s1324_S_LS_02_ASEReadCounter.table","NW_015090842.1:6236608",3,10,7
"SDR42E1","s1324_S_LS_02_ASEReadCounter.table","NW_015090842.1:6238244",3,6,3
"SDR42E1","s1324_S_LS_02_ASEReadCounter.table","NW_015090842.1:6238829",0,2,2
"HSD17B2","s1324_S_LS_02_ASEReadCounter.table","NW_015090842.1:6257829",0,2,2
"HSD17B2","s1324_S_LS_02_ASEReadCounter.table","NW_015090842.1:6266918",0,1,1
"HSD17B2","s1324_S_LS_02_ASEReadCounter.table","NW_015090842.1:6267196",0,2,2
"HSD17B2","s1324_S_LS_02_ASEReadCounter.table","NW_015090842.1:6267273",0,1,1
"HSD17B2","s1324_S_LS_02_ASEReadCounter.table","NW_015090842.1:6267358",0,2,2
"HSD17B2","s1324_S_LS_02_ASEReadCounter.table","NW_015090842.1:6267674",0,1,1
"HSD17B2","s1324_S_LS_02_ASEReadCounter.table","NW_015090842.1:6267913",0,1,1
"HSD17B2","s1324_S_LS_02_ASEReadCounter.table","NW_015090842.1:6268098",0,1,1
"ARY2","s1324_S_LS_02_ASEReadCounter.table","NW_015090842.1:6303922",14,20,6
"ARY2","s1324_S_LS_02_ASEReadCounter.table","NW_015090842.1:6303954",14,20,6
"ARY2","s1324_S_LS_02_ASEReadCounter.table","NW_015090842.1:6303979",12,21,9
"ARY2","s1324_S_LS_02_ASEReadCounter.table","NW_015090842.1:6305848",17,28,11
"ARY2","s1324_S_LS_02_ASEReadCounter.table","NW_015090842.1:6305856",14,25,11
"ARY2","s1324_S_LS_02_ASEReadCounter.table","NW_015090842.1:6305857",14,25,11
"ARY2","s1324_S_LS_02_ASEReadCounter.table","NW_015090842.1:6306017",22,35,13
"ARY2","s1324_S_LS_02_ASEReadCounter.table","NW_015090842.1:6306052",15,22,7
"ARY2","s1324_S_LS_02_ASEReadCounter.table","NW_015090842.1:6306094",15,23,8
"ARY2","s1324_S_LS_02_ASEReadCounter.table","NW_015090842.1:6306100",16,24,8
"ARY2","s1324_S_LS_02_ASEReadCounter.table","NW_015090842.1:6306146",16,23,7
"ARY2","s1324_S_LS_02_ASEReadCounter.table","NW_015090842.1:6306147",16,23,7
"ARY2","s1324_S_LS_02_ASEReadCounter.table","NW_015090842.1:6306390",25,37,12
"ARY2","s1324_S_LS_02_ASEReadCounter.table","NW_015090842.1:6306567",15,23,8
"ARY2","s1324_S_LS_02_ASEReadCounter.table","NW_015090842.1:6306705",23,27,4
"ARY2","s1324_S_LS_02_ASEReadCounter.table","NW_015090842.1:6306713",23,23,0
"ARY2","s1324_S_LS_02_ASEReadCounter.table","NW_015090842.1:6306773",16,21,5
"ARY2","s1324_S_LS_02_ASEReadCounter.table","NW_015090842.1:6307039",27,32,5
"ARY2","s1324_S_LS_02_ASEReadCounter.table","NW_015090842.1:6307043",26,33,7
"ARY2","s1324_S_LS_02_ASEReadCounter.table","NW_015090842.1:6307093",22,28,6
"ARY2","s1324_S_LS_02_ASEReadCounter.table","NW_015090842.1:6307138",15,24,9
"ARY2","s1324_S_LS_02_ASEReadCounter.table","NW_015090842.1:6307157",20,29,9
"ARY2","s1324_S_LS_02_ASEReadCounter.table","NW_015090842.1:6307187",25,37,12
"ARY2","s1324_S_LS_02_ASEReadCounter.table","NW_015090842.1:6307278",19,26,7
"ARY2","s1324_S_LS_02_ASEReadCounter.table","NW_015090842.1:6307305",19,29,10
"ARY2","s1324_S_LS_02_ASEReadCounter.table","NW_015090842.1:6307318",23,33,10
"ARY2","s1324_S_LS_02_ASEReadCounter.table","NW_015090842.1:6307429",29,47,18
"ARY2","s1324_S_LS_02_ASEReadCounter.table","NW_015090842.1:6307487",31,43,12
"ARY2","s1324_S_LS_02_ASEReadCounter.table","NW_015090842.1:6307670",20,25,5
"ARYL","s1324_S_LS_02_ASEReadCounter.table","NW_015090842.1:6313360",2,3,1
"ARYL","s1324_S_LS_02_ASEReadCounter.table","NW_015090842.1:6313377",3,5,2
"ARYL","s1324_S_LS_02_ASEReadCounter.table","NW_015090842.1:6313767",1,1,0
"ARY1","s1324_S_LS_02_ASEReadCounter.table","NW_015090842.1:6313909",2,2,0
"ARY1","s1324_S_LS_02_ASEReadCounter.table","NW_015090842.1:6314296",3,6,3
"ARY1","s1324_S_LS_02_ASEReadCounter.table","NW_015090842.1:6314541",2,5,3
"ARY1","s1324_S_LS_02_ASEReadCounter.table","NW_015090842.1:6314597",1,4,3
"ARY1","s1324_S_LS_02_ASEReadCounter.table","NW_015090842.1:6314750",7,11,4
"ARY1","s1324_S_LS_02_ASEReadCounter.table","NW_015090842.1:6314794",5,8,3
"ARY1","s1324_S_LS_02_ASEReadCounter.table","NW_015090842.1:6314827",3,6,3
"ARY1","s1324_S_LS_02_ASEReadCounter.table","NW_015090842.1:6314843",5,9,4
"ARY1","s1324_S_LS_02_ASEReadCounter.table","NW_015090842.1:6314859",5,10,5
"ARY1","s1324_S_LS_02_ASEReadCounter.table","NW_015090842.1:6314886",5,11,6
"ARY1","s1324_S_LS_02_ASEReadCounter.table","NW_015090842.1:6314943",11,11,0
"ARY1","s1324_S_LS_02_ASEReadCounter.table","NW_015090842.1:6314949",12,12,0
"ARY1","s1324_S_LS_02_ASEReadCounter.table","NW_015090842.1:6315022",9,11,2
"ARY1","s1324_S_LS_02_ASEReadCounter.table","NW_015090842.1:6315026",8,10,2
"ARY1","s1324_S_LS_02_ASEReadCounter.table","NW_015090842.1:6315043",7,8,1
"ARY1","s1324_S_LS_02_ASEReadCounter.table","NW_015090842.1:6315065",6,7,1
"ARY1","s1324_S_LS_02_ASEReadCounter.table","NW_015090842.1:6315409",7,10,3
"ARY1","s1324_S_LS_02_ASEReadCounter.table","NW_015090842.1:6315479",6,6,0
"ARY1","s1324_S_LS_02_ASEReadCounter.table","NW_015090842.1:6318342",13,19,6
"ARY1","s1324_S_LS_02_ASEReadCounter.table","NW_015090842.1:6318427",11,14,3
"ARY1","s1324_S_LS_02_ASEReadCounter.table","NW_015090842.1:6318603",6,14,8
"ARY1","s1324_S_LS_02_ASEReadCounter.table","NW_015090842.1:6318708",10,14,4
"ARY1","s1324_S_LS_02_ASEReadCounter.table","NW_015090842.1:6318858",8,14,6
"ARY1","s1324_S_LS_02_ASEReadCounter.table","NW_015090842.1:6318952",12,24,12
"MPHOSPH6","s1324_S_LS_02_ASEReadCounter.table","NW_015090842.1:6324063",64,115,51
"MPHOSPH6","s1324_S_LS_02_ASEReadCounter.table","NW_015090842.1:6324174",101,210,109
"MPHOSPH6","s1324_S_LS_02_ASEReadCounter.table","NW_015090842.1:6324270",105,241,136
"MPHOSPH6","s1324_S_LS_02_ASEReadCounter.table","NW_015090842.1:6324762",97,193,96
"MPHOSPH6","s1324_S_LS_02_ASEReadCounter.table","NW_015090842.1:6324772",98,184,86
"MPHOSPH6","s1324_S_LS_02_ASEReadCounter.table","NW_015090842.1:6324780",96,178,82
"MPHOSPH6","s1324_S_LS_02_ASEReadCounter.table","NW_015090842.1:6324902",111,212,101
"MPHOSPH6","s1324_S_LS_02_ASEReadCounter.table","NW_015090842.1:6324910",200,200,0
"MPHOSPH6","s1324_S_LS_02_ASEReadCounter.table","NW_015090842.1:6325066",94,188,94
"MPHOSPH6","s1324_S_LS_02_ASEReadCounter.table","NW_015090842.1:6325089",111,220,109
"MPHOSPH6","s1324_S_LS_02_ASEReadCounter.table","NW_015090842.1:6325298",99,220,121
"MPHOSPH6","s1324_S_LS_02_ASEReadCounter.table","NW_015090842.1:6325877",75,171,96
"MPHOSPH6","s1324_S_LS_02_ASEReadCounter.table","NW_015090842.1:6326976",55,139,84
"CDH13","s1324_S_LS_02_ASEReadCounter.table","NW_015090842.1:6662283",10,16,6
"CDH13","s1324_S_LS_02_ASEReadCounter.table","NW_015090842.1:6693665",5,10,5
"CDH13","s1324_S_LS_02_ASEReadCounter.table","NW_015090842.1:6693697",7,12,5
"CDH13","s1324_S_LS_02_ASEReadCounter.table","NW_015090842.1:6693712",6,9,3
"CDH13","s1324_S_LS_02_ASEReadCounter.table","NW_015090842.1:6693723",6,11,5
"CDH13","s1324_S_LS_02_ASEReadCounter.table","NW_015090842.1:6693738",6,13,7
"CDH13","s1324_S_LS_02_ASEReadCounter.table","NW_015090842.1:6823730",11,23,12
"CDH13","s1324_S_LS_02_ASEReadCounter.table","NW_015090842.1:6889713",9,19,10
"CDH13","s1324_S_LS_02_ASEReadCounter.table","NW_015090842.1:6955167",20,40,20
"MLYCD","s1324_S_LS_02_ASEReadCounter.table","NW_015090842.1:7150054",56,107,51
"MLYCD","s1324_S_LS_02_ASEReadCounter.table","NW_015090842.1:7150131",117,214,97
"MLYCD","s1324_S_LS_02_ASEReadCounter.table","NW_015090842.1:7150585",80,157,77
"MLYCD","s1324_S_LS_02_ASEReadCounter.table","NW_015090842.1:7150686",47,101,54
"MLYCD","s1324_S_LS_02_ASEReadCounter.table","NW_015090842.1:7150696",61,121,60
"MLYCD","s1324_S_LS_02_ASEReadCounter.table","NW_015090842.1:7150698",122,122,0
"MLYCD","s1324_S_LS_02_ASEReadCounter.table","NW_015090842.1:7150869",63,113,50
"MLYCD","s1324_S_LS_02_ASEReadCounter.table","NW_015090842.1:7151100",59,100,41
"MLYCD","s1324_S_LS_02_ASEReadCounter.table","NW_015090842.1:7151127",61,100,39
"MLYCD","s1324_S_LS_02_ASEReadCounter.table","NW_015090842.1:7157538",26,54,28
"MLYCD","s1324_S_LS_02_ASEReadCounter.table","NW_015090842.1:7167662",19,27,8
"MLYCD","s1324_S_LS_02_ASEReadCounter.table","NW_015090842.1:7167675",19,28,9
"MLYCD","s1324_S_LS_02_ASEReadCounter.table","NW_015090842.1:7167710",19,30,11
"MLYCD","s1324_S_LS_02_ASEReadCounter.table","NW_015090842.1:7167781",10,19,9
"MLYCD","s1324_S_LS_02_ASEReadCounter.table","NW_015090842.1:7167803",10,18,8
"MLYCD","s1324_S_LS_02_ASEReadCounter.table","NW_015090842.1:7167812",8,18,10
"MLYCD","s1324_S_LS_02_ASEReadCounter.table","NW_015090842.1:7167845",11,20,9
"MLYCD","s1324_S_LS_02_ASEReadCounter.table","NW_015090842.1:7167862",10,18,8
"MLYCD","s1324_S_LS_02_ASEReadCounter.table","NW_015090842.1:7167929",5,11,6
"MLYCD","s1324_S_LS_02_ASEReadCounter.table","NW_015090842.1:7167995",7,11,4
"MLYCD","s1324_S_LS_02_ASEReadCounter.table","NW_015090842.1:7168005",7,11,4
"MLYCD","s1324_S_LS_02_ASEReadCounter.table","NW_015090842.1:7168037",5,10,5
"HSBP1","s1324_S_LS_02_ASEReadCounter.table","NW_015090842.1:7245192",522,901,379
"HSBP1","s1324_S_LS_02_ASEReadCounter.table","NW_015090842.1:7245226",590,1053,463
"HSBP1","s1324_S_LS_02_ASEReadCounter.table","NW_015090842.1:7245257",541,951,410
"HSBP1","s1324_S_LS_02_ASEReadCounter.table","NW_015090842.1:7245296",494,982,488
"HSBP1","s1324_S_LS_02_ASEReadCounter.table","NW_015090842.1:7245389",706,1246,540
"HSBP1","s1324_S_LS_02_ASEReadCounter.table","NW_015090842.1:7245400",727,1219,492
"HSBP1","s1324_S_LS_02_ASEReadCounter.table","NW_015090842.1:7245445",680,1203,523
"HSBP1","s1324_S_LS_02_ASEReadCounter.table","NW_015090842.1:7245495",646,1141,495
"HSBP1","s1324_S_LS_02_ASEReadCounter.table","NW_015090842.1:7245515",734,1275,541
"HSBP1","s1324_S_LS_02_ASEReadCounter.table","NW_015090842.1:7245733",392,745,353
"HSBP1","s1324_S_LS_02_ASEReadCounter.table","NW_015090842.1:7245771",423,757,334
"HSBP1","s1324_S_LS_02_ASEReadCounter.table","NW_015090842.1:7245813",414,747,333
"HSBP1","s1324_S_LS_02_ASEReadCounter.table","NW_015090842.1:7245926",436,802,366
"HSBP1","s1324_S_LS_02_ASEReadCounter.table","NW_015090842.1:7245927",438,799,361
"HSBP1","s1324_S_LS_02_ASEReadCounter.table","NW_015090842.1:7245933",416,761,345
"HSBP1","s1324_S_LS_02_ASEReadCounter.table","NW_015090842.1:7246002",333,615,282
"HSBP1","s1324_S_LS_02_ASEReadCounter.table","NW_015090842.1:7246094",421,721,300
"HSBP1","s1324_S_LS_02_ASEReadCounter.table","NW_015090842.1:7246167",421,712,291
"HSBP1","s1324_S_LS_02_ASEReadCounter.table","NW_015090842.1:7246183",402,701,299
"HSBP1","s1324_S_LS_02_ASEReadCounter.table","NW_015090842.1:7247285",56,74,18
"HSBP1","s1324_S_LS_02_ASEReadCounter.table","NW_015090842.1:7247651",442,921,479
"HSBP1","s1324_S_LS_02_ASEReadCounter.table","NW_015090842.1:7247657",438,909,471
"HSBP1","s1324_S_LS_02_ASEReadCounter.table","NW_015090842.1:7248520",341,625,284
"HSBP1","s1324_S_LS_02_ASEReadCounter.table","NW_015090842.1:7248535",288,511,223
"KCNG4","s1324_S_LS_02_ASEReadCounter.table","NW_015090842.1:7282481",2,2,0
"KCNG4","s1324_S_LS_02_ASEReadCounter.table","NW_015090842.1:7282500",3,3,0
"KCNG4","s1324_S_LS_02_ASEReadCounter.table","NW_015090842.1:7282542",3,3,0
"KCNG4","s1324_S_LS_02_ASEReadCounter.table","NW_015090842.1:7282579",2,2,0
"KCNG4","s1324_S_LS_02_ASEReadCounter.table","NW_015090842.1:7282630",1,1,0
"KCNG4","s1324_S_LS_02_ASEReadCounter.table","NW_015090842.1:7282760",1,1,0
"KCNG4","s1324_S_LS_02_ASEReadCounter.table","NW_015090842.1:7283056",2,3,1
"KCNG4","s1324_S_LS_02_ASEReadCounter.table","NW_015090842.1:7283245",1,1,0
"KCNG4","s1324_S_LS_02_ASEReadCounter.table","NW_015090842.1:7299491",0,1,1
"ATP2C2","s1324_S_LS_02_ASEReadCounter.table","NW_015090842.1:7413747",3,6,3
"TLDC1","s1324_S_LS_02_ASEReadCounter.table","NW_015090842.1:7421997",36,55,19
"COTL1","s1324_S_LS_02_ASEReadCounter.table","NW_015090842.1:7490707",898,1793,895
"COTL1","s1324_S_LS_02_ASEReadCounter.table","NW_015090842.1:7490708",900,1798,898
"COTL1","s1324_S_LS_02_ASEReadCounter.table","NW_015090842.1:7490711",911,1821,910
"COTL1","s1324_S_LS_02_ASEReadCounter.table","NW_015090842.1:7490739",886,1821,935
"COTL1","s1324_S_LS_02_ASEReadCounter.table","NW_015090842.1:7490785",818,1668,850
"COTL1","s1324_S_LS_02_ASEReadCounter.table","NW_015090842.1:7490820",73,1056,983
"COTL1","s1324_S_LS_02_ASEReadCounter.table","NW_015090842.1:7490846",869,1681,812
"COTL1","s1324_S_LS_02_ASEReadCounter.table","NW_015090842.1:7505571",1,2,1
"COTL1","s1324_S_LS_02_ASEReadCounter.table","NW_015090842.1:7505672",1,1,0
"KLHL36","s1324_S_LS_02_ASEReadCounter.table","NW_015090842.1:7526337",49,49,0
"KLHL36","s1324_S_LS_02_ASEReadCounter.table","NW_015090842.1:7537681",147,147,0
"USP10","s1324_S_LS_02_ASEReadCounter.table","NW_015090842.1:7572213",34,65,31
"USP10","s1324_S_LS_02_ASEReadCounter.table","NW_015090842.1:7572358",46,46,0
"CRISPLD2","s1324_S_LS_02_ASEReadCounter.table","NW_015090842.1:7619796",0,1,1
"CRISPLD2","s1324_S_LS_02_ASEReadCounter.table","NW_015090842.1:7630779",10,10,0
"CRISPLD2","s1324_S_LS_02_ASEReadCounter.table","NW_015090842.1:7633611",10,10,0
"CRISPLD2","s1324_S_LS_02_ASEReadCounter.table","NW_015090842.1:7633787",3,11,8
"CRISPLD2","s1324_S_LS_02_ASEReadCounter.table","NW_015090842.1:7634023",4,5,1
"CRISPLD2","s1324_S_LS_02_ASEReadCounter.table","NW_015090842.1:7634620",5,5,0
"CRISPLD2","s1324_S_LS_02_ASEReadCounter.table","NW_015090842.1:7636315",0,3,3
"MTHFSD","s1324_S_LS_02_ASEReadCounter.table","NW_015090842.1:8152578",9,25,16
"DUSP15","s1324_S_LS_02_ASEReadCounter.table","NW_015090842.1:8422840",2,2,0
"EMC8","s1324_S_LS_02_ASEReadCounter.table","NW_015090842.1:8452385",29,59,30
"GINS2","s1324_S_LS_02_ASEReadCounter.table","NW_015090842.1:8467469",23,23,0
"GINS2","s1324_S_LS_02_ASEReadCounter.table","NW_015090842.1:8470290",34,74,40
"GINS2","s1324_S_LS_02_ASEReadCounter.table","NW_015090842.1:8470305",34,68,34
"GINS2","s1324_S_LS_02_ASEReadCounter.table","NW_015090842.1:8470376",37,72,35
"GINS2","s1324_S_LS_02_ASEReadCounter.table","NW_015090842.1:8471057",5,17,12
"GSE1","s1324_S_LS_02_ASEReadCounter.table","NW_015090842.1:8483570",4,4,0
"KIAA0513","s1324_S_LS_02_ASEReadCounter.table","NW_015090842.1:8674736",115,116,1
"KIAA0513","s1324_S_LS_02_ASEReadCounter.table","NW_015090842.1:8693655",13,13,0
"ZCCHC14","s1324_S_LS_02_ASEReadCounter.table","NW_015090842.1:8750189",113,113,0
"JPH3","s1324_S_LS_02_ASEReadCounter.table","NW_015090842.1:8872294",61,104,43
"KLHDC4","s1324_S_LS_02_ASEReadCounter.table","NW_015090842.1:8891175",165,274,109
"KLHDC4","s1324_S_LS_02_ASEReadCounter.table","NW_015090842.1:8905251",28,50,22
"KLHDC4","s1324_S_LS_02_ASEReadCounter.table","NW_015090842.1:8919630",6,8,2
"SLC7A5","s1324_S_LS_02_ASEReadCounter.table","NW_015090842.1:8940382",219,219,0
"SLC7A5","s1324_S_LS_02_ASEReadCounter.table","NW_015090842.1:8941818",169,169,0
"SLC7A5","s1324_S_LS_02_ASEReadCounter.table","NW_015090842.1:8944655",64,64,0
"CA5A","s1324_S_LS_02_ASEReadCounter.table","NW_015090842.1:8989479",94,146,52
"CA5A","s1324_S_LS_02_ASEReadCounter.table","NW_015090842.1:8989562",119,195,76
"CA5A","s1324_S_LS_02_ASEReadCounter.table","NW_015090842.1:8989609",120,206,86
"CA5A","s1324_S_LS_02_ASEReadCounter.table","NW_015090842.1:8989693",149,267,118
"CA5A","s1324_S_LS_02_ASEReadCounter.table","NW_015090842.1:8989702",152,260,108
"CA5A","s1324_S_LS_02_ASEReadCounter.table","NW_015090842.1:8989746",171,291,120
"CA5A","s1324_S_LS_02_ASEReadCounter.table","NW_015090842.1:8989880",109,194,85
"CA5A","s1324_S_LS_02_ASEReadCounter.table","NW_015090842.1:8989885",105,196,91
"CA5A","s1324_S_LS_02_ASEReadCounter.table","NW_015090842.1:8989929",108,211,103
"CA5A","s1324_S_LS_02_ASEReadCounter.table","NW_015090842.1:8990002",93,187,94
"CA5A","s1324_S_LS_02_ASEReadCounter.table","NW_015090842.1:8990004",93,190,97
"CA5A","s1324_S_LS_02_ASEReadCounter.table","NW_015090842.1:8990005",92,190,98
"CA5A","s1324_S_LS_02_ASEReadCounter.table","NW_015090842.1:8990017",93,178,85
"CA5A","s1324_S_LS_02_ASEReadCounter.table","NW_015090842.1:8990043",76,149,73
"CA5A","s1324_S_LS_02_ASEReadCounter.table","NW_015090842.1:8990080",67,138,71
"CA5A","s1324_S_LS_02_ASEReadCounter.table","NW_015090842.1:8990084",69,143,74
"CA5A","s1324_S_LS_02_ASEReadCounter.table","NW_015090842.1:8990090",76,147,71
"CA5A","s1324_S_LS_02_ASEReadCounter.table","NW_015090842.1:8990095",72,146,74
"CA5A","s1324_S_LS_02_ASEReadCounter.table","NW_015090842.1:8990111",63,134,71
"CA5A","s1324_S_LS_02_ASEReadCounter.table","NW_015090842.1:8990112",63,133,70
"CA5A","s1324_S_LS_02_ASEReadCounter.table","NW_015090842.1:8990115",67,138,71
"CA5A","s1324_S_LS_02_ASEReadCounter.table","NW_015090842.1:8990166",53,101,48
"CA5A","s1324_S_LS_02_ASEReadCounter.table","NW_015090842.1:8990169",64,114,50
"CA5A","s1324_S_LS_02_ASEReadCounter.table","NW_015090842.1:8990222",55,107,52
"CA5A","s1324_S_LS_02_ASEReadCounter.table","NW_015090842.1:8990289",59,115,56
"CA5A","s1324_S_LS_02_ASEReadCounter.table","NW_015090842.1:8990314",65,125,60
"CA5A","s1324_S_LS_02_ASEReadCounter.table","NW_015090842.1:8990361",65,127,62
"CA5A","s1324_S_LS_02_ASEReadCounter.table","NW_015090842.1:8990368",67,123,56
"CA5A","s1324_S_LS_02_ASEReadCounter.table","NW_015090842.1:8990429",61,107,46
"CA5A","s1324_S_LS_02_ASEReadCounter.table","NW_015090842.1:8990466",53,96,43
"CA5A","s1324_S_LS_02_ASEReadCounter.table","NW_015090842.1:8990663",50,90,40
"CA5A","s1324_S_LS_02_ASEReadCounter.table","NW_015090842.1:8990797",49,78,29
"CA5A","s1324_S_LS_02_ASEReadCounter.table","NW_015090842.1:8990836",46,65,19
"CA5A","s1324_S_LS_02_ASEReadCounter.table","NW_015090842.1:8990842",48,69,21
"CA5A","s1324_S_LS_02_ASEReadCounter.table","NW_015090842.1:8990851",47,67,20
"CA5A","s1324_S_LS_02_ASEReadCounter.table","NW_015090842.1:8990918",34,62,28
"CA5A","s1324_S_LS_02_ASEReadCounter.table","NW_015090842.1:8990921",33,65,32
"CA5A","s1324_S_LS_02_ASEReadCounter.table","NW_015090842.1:8990942",45,82,37
"CA5A","s1324_S_LS_02_ASEReadCounter.table","NW_015090842.1:8991001",54,102,48
"CA5A","s1324_S_LS_02_ASEReadCounter.table","NW_015090842.1:8991038",51,92,41
"CA5A","s1324_S_LS_02_ASEReadCounter.table","NW_015090842.1:8991149",57,105,48
"CA5A","s1324_S_LS_02_ASEReadCounter.table","NW_015090842.1:8991176",54,93,39
"CA5A","s1324_S_LS_02_ASEReadCounter.table","NW_015090842.1:8991241",60,103,43
"CA5A","s1324_S_LS_02_ASEReadCounter.table","NW_015090842.1:8991262",56,94,38
"CA5A","s1324_S_LS_02_ASEReadCounter.table","NW_015090842.1:8991316",61,63,2
"CA5A","s1324_S_LS_02_ASEReadCounter.table","NW_015090842.1:8991319",59,61,2
"CA5A","s1324_S_LS_02_ASEReadCounter.table","NW_015090842.1:8991330",49,51,2
"CA5A","s1324_S_LS_02_ASEReadCounter.table","NW_015090842.1:8991334",48,50,2
"CA5A","s1324_S_LS_02_ASEReadCounter.table","NW_015090842.1:8991362",49,72,23
"CA5A","s1324_S_LS_02_ASEReadCounter.table","NW_015090842.1:8991368",50,72,22
"CA5A","s1324_S_LS_02_ASEReadCounter.table","NW_015090842.1:8991390",54,78,24
"CA5A","s1324_S_LS_02_ASEReadCounter.table","NW_015090842.1:8991395",51,74,23
"CA5A","s1324_S_LS_02_ASEReadCounter.table","NW_015090842.1:8991422",47,74,27
"CA5A","s1324_S_LS_02_ASEReadCounter.table","NW_015090842.1:8991467",45,68,23
"CA5A","s1324_S_LS_02_ASEReadCounter.table","NW_015090842.1:8991576",26,54,28
"CA5A","s1324_S_LS_02_ASEReadCounter.table","NW_015090842.1:8991587",30,60,30
"CA5A","s1324_S_LS_02_ASEReadCounter.table","NW_015090842.1:8991655",41,70,29
"CA5A","s1324_S_LS_02_ASEReadCounter.table","NW_015090842.1:8991717",34,63,29
"CA5A","s1324_S_LS_02_ASEReadCounter.table","NW_015090842.1:8991726",33,63,30
"CA5A","s1324_S_LS_02_ASEReadCounter.table","NW_015090842.1:8991799",34,54,20
"CA5A","s1324_S_LS_02_ASEReadCounter.table","NW_015090842.1:8991809",35,57,22
"CA5A","s1324_S_LS_02_ASEReadCounter.table","NW_015090842.1:8991848",38,68,30
"CA5A","s1324_S_LS_02_ASEReadCounter.table","NW_015090842.1:8991849",38,66,28
"CA5A","s1324_S_LS_02_ASEReadCounter.table","NW_015090842.1:8991927",41,67,26
"CA5A","s1324_S_LS_02_ASEReadCounter.table","NW_015090842.1:8991941",39,67,28
"CA5A","s1324_S_LS_02_ASEReadCounter.table","NW_015090842.1:8992121",36,64,28
"CA5A","s1324_S_LS_02_ASEReadCounter.table","NW_015090842.1:8992224",22,52,30
"CA5A","s1324_S_LS_02_ASEReadCounter.table","NW_015090842.1:9002570",20,29,9
"CA5A","s1324_S_LS_02_ASEReadCounter.table","NW_015090842.1:9002600",19,30,11
"CA5A","s1324_S_LS_02_ASEReadCounter.table","NW_015090842.1:9004312",10,18,8
"CA5A","s1324_S_LS_02_ASEReadCounter.table","NW_015090842.1:9004506",2,2,0
"CA5A","s1324_S_LS_02_ASEReadCounter.table","NW_015090842.1:9004523",2,2,0
"CA5A","s1324_S_LS_02_ASEReadCounter.table","NW_015090842.1:9004530",2,2,0
"CA5A","s1324_S_LS_02_ASEReadCounter.table","NW_015090842.1:9004556",2,3,1
"CA5A","s1324_S_LS_02_ASEReadCounter.table","NW_015090842.1:9004620",4,6,2
"CA5A","s1324_S_LS_02_ASEReadCounter.table","NW_015090842.1:9005116",3,4,1
"CA5A","s1324_S_LS_02_ASEReadCounter.table","NW_015090842.1:9005120",3,4,1
"CA5A","s1324_S_LS_02_ASEReadCounter.table","NW_015090842.1:9005140",4,5,1
"CA5A","s1324_S_LS_02_ASEReadCounter.table","NW_015090842.1:9005152",2,4,2
"CA5A","s1324_S_LS_02_ASEReadCounter.table","NW_015090842.1:9011011",1,1,0
"BANP","s1324_S_LS_02_ASEReadCounter.table","NW_015090842.1:9033407",6,9,3
"BANP","s1324_S_LS_02_ASEReadCounter.table","NW_015090842.1:9033409",6,10,4
"BANP","s1324_S_LS_02_ASEReadCounter.table","NW_015090842.1:9033420",4,8,4
"BANP","s1324_S_LS_02_ASEReadCounter.table","NW_015090842.1:9055284",9,20,11
"ZC3H18","s1324_S_LS_02_ASEReadCounter.table","NW_015090842.1:9528933",19,44,25
"MVD","s1324_S_LS_02_ASEReadCounter.table","NW_015090842.1:9550690",64,64,0
"MVD","s1324_S_LS_02_ASEReadCounter.table","NW_015090842.1:9550691",64,64,0
"MVD","s1324_S_LS_02_ASEReadCounter.table","NW_015090842.1:9550699",71,71,0
"MVD","s1324_S_LS_02_ASEReadCounter.table","NW_015090842.1:9550701",71,71,0
"MVD","s1324_S_LS_02_ASEReadCounter.table","NW_015090842.1:9552202",96,96,0
"MVD","s1324_S_LS_02_ASEReadCounter.table","NW_015090842.1:9552223",92,92,0
"MVD","s1324_S_LS_02_ASEReadCounter.table","NW_015090842.1:9552533",58,58,0
"MVD","s1324_S_LS_02_ASEReadCounter.table","NW_015090842.1:9552644",21,45,24
"PIEZO1","s1324_S_LS_02_ASEReadCounter.table","NW_015090842.1:9577447",2,6,4
"PIEZO1","s1324_S_LS_02_ASEReadCounter.table","NW_015090842.1:9579101",4,9,5
"PIEZO1","s1324_S_LS_02_ASEReadCounter.table","NW_015090842.1:9582630",2,5,3
"PIEZO1","s1324_S_LS_02_ASEReadCounter.table","NW_015090842.1:9582976",2,3,1
"PIEZO1","s1324_S_LS_02_ASEReadCounter.table","NW_015090842.1:9583326",1,1,0
"CDT1","s1324_S_LS_02_ASEReadCounter.table","NW_015090842.1:9596711",3,4,1
"CDT1","s1324_S_LS_02_ASEReadCounter.table","NW_015090842.1:9597033",14,14,0
"CDT1","s1324_S_LS_02_ASEReadCounter.table","NW_015090842.1:9597756",5,14,9
"CDT1","s1324_S_LS_02_ASEReadCounter.table","NW_015090842.1:9598873",25,25,0
"ACSF3","s1324_S_LS_02_ASEReadCounter.table","NW_015090842.1:9776737",7,13,6
"ACSF3","s1324_S_LS_02_ASEReadCounter.table","NW_015090842.1:9809639",94,94,0
"ACSF3","s1324_S_LS_02_ASEReadCounter.table","NW_015090842.1:9834743",65,107,42
"ACSF3","s1324_S_LS_02_ASEReadCounter.table","NW_015090842.1:9834762",106,106,0
"ACSF3","s1324_S_LS_02_ASEReadCounter.table","NW_015090842.1:9834852",64,116,52
"ACSF3","s1324_S_LS_02_ASEReadCounter.table","NW_015090842.1:9834861",55,106,51
"ACSF3","s1324_S_LS_02_ASEReadCounter.table","NW_015090842.1:9839359",45,86,41
"ACSF3","s1324_S_LS_02_ASEReadCounter.table","NW_015090842.1:9839378",43,84,41
"ACSF3","s1324_S_LS_02_ASEReadCounter.table","NW_015090842.1:9839455",45,82,37
"ACSF3","s1324_S_LS_02_ASEReadCounter.table","NW_015090842.1:9839457",45,80,35
"ACSF3","s1324_S_LS_02_ASEReadCounter.table","NW_015090842.1:9839489",35,68,33
"ACSF3","s1324_S_LS_02_ASEReadCounter.table","NW_015090842.1:9839500",28,60,32
"ACSF3","s1324_S_LS_02_ASEReadCounter.table","NW_015090842.1:9839501",28,61,33
"ACSF3","s1324_S_LS_02_ASEReadCounter.table","NW_015090842.1:9839504",33,63,30
"ACSF3","s1324_S_LS_02_ASEReadCounter.table","NW_015090842.1:9839512",30,51,21
"ACSF3","s1324_S_LS_02_ASEReadCounter.table","NW_015090842.1:9839527",20,36,16
"ACSF3","s1324_S_LS_02_ASEReadCounter.table","NW_015090842.1:9839533",10,27,17
"ACSF3","s1324_S_LS_02_ASEReadCounter.table","NW_015090842.1:9839535",11,26,15
"ACSF3","s1324_S_LS_02_ASEReadCounter.table","NW_015090842.1:9839545",9,23,14
"ACSF3","s1324_S_LS_02_ASEReadCounter.table","NW_015090842.1:9839550",9,23,14
"ACSF3","s1324_S_LS_02_ASEReadCounter.table","NW_015090842.1:9839551",9,22,13
"CDH15","s1324_S_LS_02_ASEReadCounter.table","NW_015090842.1:9849473",2,2,0
"CDH15","s1324_S_LS_02_ASEReadCounter.table","NW_015090842.1:9850141",0,1,1
"CDH15","s1324_S_LS_02_ASEReadCounter.table","NW_015090842.1:9850386",0,2,2
"CDH15","s1324_S_LS_02_ASEReadCounter.table","NW_015090842.1:9850432",0,2,2
"CDH15","s1324_S_LS_02_ASEReadCounter.table","NW_015090842.1:9850609",1,1,0
"SLC22A31","s1324_S_LS_02_ASEReadCounter.table","NW_015090842.1:9850797",0,1,1
"SLC22A31","s1324_S_LS_02_ASEReadCounter.table","NW_015090842.1:9850818",0,1,1
"SLC22A31","s1324_S_LS_02_ASEReadCounter.table","NW_015090842.1:9850929",0,1,1
"SLC22A31","s1324_S_LS_02_ASEReadCounter.table","NW_015090842.1:9850936",0,1,1
"SLC22A31","s1324_S_LS_02_ASEReadCounter.table","NW_015090842.1:9850940",0,1,1
"SLC22A31","s1324_S_LS_02_ASEReadCounter.table","NW_015090842.1:9850948",0,1,1
"SLC22A31","s1324_S_LS_02_ASEReadCounter.table","NW_015090842.1:9850961",0,1,1
"SLC22A31","s1324_S_LS_02_ASEReadCounter.table","NW_015090842.1:9851130",3,8,5
"SLC22A31","s1324_S_LS_02_ASEReadCounter.table","NW_015090842.1:9851139",3,8,5
"SLC22A31","s1324_S_LS_02_ASEReadCounter.table","NW_015090842.1:9851265",9,16,7
"SLC22A31","s1324_S_LS_02_ASEReadCounter.table","NW_015090842.1:9851302",7,14,7
"SLC22A31","s1324_S_LS_02_ASEReadCounter.table","NW_015090842.1:9851303",8,15,7
"SLC22A31","s1324_S_LS_02_ASEReadCounter.table","NW_015090842.1:9851305",8,15,7
"SLC22A31","s1324_S_LS_02_ASEReadCounter.table","NW_015090842.1:9851343",7,11,4
"SLC22A31","s1324_S_LS_02_ASEReadCounter.table","NW_015090842.1:9851344",7,11,4
"SLC22A31","s1324_S_LS_02_ASEReadCounter.table","NW_015090842.1:9851381",13,20,7
"SLC22A31","s1324_S_LS_02_ASEReadCounter.table","NW_015090842.1:9851421",16,24,8
"SLC22A31","s1324_S_LS_02_ASEReadCounter.table","NW_015090842.1:9851526",10,15,5
"SLC22A31","s1324_S_LS_02_ASEReadCounter.table","NW_015090842.1:9851589",11,23,12
"SLC22A31","s1324_S_LS_02_ASEReadCounter.table","NW_015090842.1:9851712",16,27,11
"SLC22A31","s1324_S_LS_02_ASEReadCounter.table","NW_015090842.1:9851899",12,19,7
"SLC22A31","s1324_S_LS_02_ASEReadCounter.table","NW_015090842.1:9852139",10,21,11
"SLC22A31","s1324_S_LS_02_ASEReadCounter.table","NW_015090842.1:9852380",8,17,9
"SLC22A31","s1324_S_LS_02_ASEReadCounter.table","NW_015090842.1:9852431",4,16,12
"SLC22A31","s1324_S_LS_02_ASEReadCounter.table","NW_015090842.1:9852630",3,14,11
"SLC22A31","s1324_S_LS_02_ASEReadCounter.table","NW_015090842.1:9852711",6,13,7
"SLC22A31","s1324_S_LS_02_ASEReadCounter.table","NW_015090842.1:9852742",5,10,5
"SLC22A31","s1324_S_LS_02_ASEReadCounter.table","NW_015090842.1:9853099",6,12,6
"SLC22A31","s1324_S_LS_02_ASEReadCounter.table","NW_015090842.1:9853102",6,13,7
"SLC22A31","s1324_S_LS_02_ASEReadCounter.table","NW_015090842.1:9853421",4,5,1
"SLC22A31","s1324_S_LS_02_ASEReadCounter.table","NW_015090842.1:9853457",4,5,1
"SLC22A31","s1324_S_LS_02_ASEReadCounter.table","NW_015090842.1:9853502",3,3,0
"ANKRD11","s1324_S_LS_02_ASEReadCounter.table","NW_015090842.1:9858863",15,34,19
"ANKRD11","s1324_S_LS_02_ASEReadCounter.table","NW_015090842.1:9859101",145,311,166
"ANKRD11","s1324_S_LS_02_ASEReadCounter.table","NW_015090842.1:9859352",199,386,187
"ANKRD11","s1324_S_LS_02_ASEReadCounter.table","NW_015090842.1:9859381",37,179,142
"ANKRD11","s1324_S_LS_02_ASEReadCounter.table","NW_015090842.1:9859527",68,186,118
"ANKRD11","s1324_S_LS_02_ASEReadCounter.table","NW_015090842.1:9859529",69,191,122
"ANKRD11","s1324_S_LS_02_ASEReadCounter.table","NW_015090842.1:9859679",165,367,202
"ANKRD11","s1324_S_LS_02_ASEReadCounter.table","NW_015090842.1:9861097",121,224,103
"ANKRD11","s1324_S_LS_02_ASEReadCounter.table","NW_015090842.1:9862571",79,147,68
"ANKRD11","s1324_S_LS_02_ASEReadCounter.table","NW_015090842.1:9866071",0,74,74
"ANKRD11","s1324_S_LS_02_ASEReadCounter.table","NW_015090842.1:9866200",0,69,69
"ANKRD11","s1324_S_LS_02_ASEReadCounter.table","NW_015090842.1:9867391",26,44,18
"ANKRD11","s1324_S_LS_02_ASEReadCounter.table","NW_015090842.1:9867472",36,67,31
"ANKRD11","s1324_S_LS_02_ASEReadCounter.table","NW_015090842.1:9867559",42,78,36
"ANKRD11","s1324_S_LS_02_ASEReadCounter.table","NW_015090842.1:9867934",50,97,47
"ANKRD11","s1324_S_LS_02_ASEReadCounter.table","NW_015090842.1:9868093",38,82,44
"ANKRD11","s1324_S_LS_02_ASEReadCounter.table","NW_015090842.1:9868222",33,76,43
"ANKRD11","s1324_S_LS_02_ASEReadCounter.table","NW_015090842.1:9868327",52,93,41
"ANKRD11","s1324_S_LS_02_ASEReadCounter.table","NW_015090842.1:9868414",58,114,56
"ANKRD11","s1324_S_LS_02_ASEReadCounter.table","NW_015090842.1:9868441",50,102,52
"ANKRD11","s1324_S_LS_02_ASEReadCounter.table","NW_015090842.1:9868444",51,108,57
"ANKRD11","s1324_S_LS_02_ASEReadCounter.table","NW_015090842.1:9868519",70,132,62
"ANKRD11","s1324_S_LS_02_ASEReadCounter.table","NW_015090842.1:9868609",70,141,71
"ANKRD11","s1324_S_LS_02_ASEReadCounter.table","NW_015090842.1:9868666",76,163,87
"ANKRD11","s1324_S_LS_02_ASEReadCounter.table","NW_015090842.1:9869431",158,295,137
"ANKRD11","s1324_S_LS_02_ASEReadCounter.table","NW_015090842.1:9869578",247,467,220
"ANKRD11","s1324_S_LS_02_ASEReadCounter.table","NW_015090842.1:9869734",260,497,237
"ANKRD11","s1324_S_LS_02_ASEReadCounter.table","NW_015090842.1:9870070",230,489,259
"ANKRD11","s1324_S_LS_02_ASEReadCounter.table","NW_015090842.1:9870349",239,496,257
"ANKRD11","s1324_S_LS_02_ASEReadCounter.table","NW_015090842.1:9870604",293,556,263
"ANKRD11","s1324_S_LS_02_ASEReadCounter.table","NW_015090842.1:9870613",312,580,268
"ANKRD11","s1324_S_LS_02_ASEReadCounter.table","NW_015090842.1:9870685",338,681,343
"ANKRD11","s1324_S_LS_02_ASEReadCounter.table","NW_015090842.1:9870847",285,594,309
"ANKRD11","s1324_S_LS_02_ASEReadCounter.table","NW_015090842.1:9871103",200,394,194
"ANKRD11","s1324_S_LS_02_ASEReadCounter.table","NW_015090842.1:9871165",204,441,237
"ANKRD11","s1324_S_LS_02_ASEReadCounter.table","NW_015090842.1:9871820",49,103,54
"ANKRD11","s1324_S_LS_02_ASEReadCounter.table","NW_015090842.1:9871994",82,82,0
"ANKRD11","s1324_S_LS_02_ASEReadCounter.table","NW_015090842.1:9872118",43,94,51
"SPG7","s1324_S_LS_02_ASEReadCounter.table","NW_015090842.1:10051190",72,180,108
"SPG7","s1324_S_LS_02_ASEReadCounter.table","NW_015090842.1:10051218",90,212,122
"SPG7","s1324_S_LS_02_ASEReadCounter.table","NW_015090842.1:10052348",123,245,122
"SPG7","s1324_S_LS_02_ASEReadCounter.table","NW_015090842.1:10052366",119,250,131
"SPG7","s1324_S_LS_02_ASEReadCounter.table","NW_015090842.1:10065173",173,323,150
"SPG7","s1324_S_LS_02_ASEReadCounter.table","NW_015090842.1:10065215",158,314,156
"SPG7","s1324_S_LS_02_ASEReadCounter.table","NW_015090842.1:10066301",119,258,139
"SPG7","s1324_S_LS_02_ASEReadCounter.table","NW_015090842.1:10066365",130,272,142
"SPG7","s1324_S_LS_02_ASEReadCounter.table","NW_015090842.1:10069752",158,326,168
"SPG7","s1324_S_LS_02_ASEReadCounter.table","NW_015090842.1:10069800",165,364,199
"SPG7","s1324_S_LS_02_ASEReadCounter.table","NW_015090842.1:10071192",186,415,229
"SPG7","s1324_S_LS_02_ASEReadCounter.table","NW_015090842.1:10071204",189,396,207
"SPG7","s1324_S_LS_02_ASEReadCounter.table","NW_015090842.1:10071219",186,384,198
"SPG7","s1324_S_LS_02_ASEReadCounter.table","NW_015090842.1:10071967",181,395,214
"SPG7","s1324_S_LS_02_ASEReadCounter.table","NW_015090842.1:10075109",348,674,326
"SPG7","s1324_S_LS_02_ASEReadCounter.table","NW_015090842.1:10075114",355,683,328
"SPG7","s1324_S_LS_02_ASEReadCounter.table","NW_015090842.1:10075198",294,540,246
"SPG7","s1324_S_LS_02_ASEReadCounter.table","NW_015090842.1:10075487",244,465,221
"SPG7","s1324_S_LS_02_ASEReadCounter.table","NW_015090842.1:10075488",244,465,221
"SPG7","s1324_S_LS_02_ASEReadCounter.table","NW_015090842.1:10075548",161,325,164
"RPL13","s1324_S_LS_02_ASEReadCounter.table","NW_015090842.1:10076979",1,6,5
"RPL13","s1324_S_LS_02_ASEReadCounter.table","NW_015090842.1:10077387",498,1191,693
"RPL13","s1324_S_LS_02_ASEReadCounter.table","NW_015090842.1:10077978",796,1731,935
"RPL13","s1324_S_LS_02_ASEReadCounter.table","NW_015090842.1:10077992",798,1687,889
"CPNE7","s1324_S_LS_02_ASEReadCounter.table","NW_015090842.1:10084001",30,50,20
"CPNE7","s1324_S_LS_02_ASEReadCounter.table","NW_015090842.1:10084856",18,31,13
"CPNE7","s1324_S_LS_02_ASEReadCounter.table","NW_015090842.1:10084872",22,31,9
"CPNE7","s1324_S_LS_02_ASEReadCounter.table","NW_015090842.1:10084892",27,37,10
"CPNE7","s1324_S_LS_02_ASEReadCounter.table","NW_015090842.1:10084921",28,45,17
"CPNE7","s1324_S_LS_02_ASEReadCounter.table","NW_015090842.1:10084935",29,45,16
"CPNE7","s1324_S_LS_02_ASEReadCounter.table","NW_015090842.1:10085000",43,70,27
"CPNE7","s1324_S_LS_02_ASEReadCounter.table","NW_015090842.1:10085089",31,59,28
"CPNE7","s1324_S_LS_02_ASEReadCounter.table","NW_015090842.1:10085096",30,56,26
"CPNE7","s1324_S_LS_02_ASEReadCounter.table","NW_015090842.1:10085126",26,55,29
"CPNE7","s1324_S_LS_02_ASEReadCounter.table","NW_015090842.1:10085180",41,70,29
"CPNE7","s1324_S_LS_02_ASEReadCounter.table","NW_015090842.1:10085201",40,66,26
"CPNE7","s1324_S_LS_02_ASEReadCounter.table","NW_015090842.1:10088134",58,117,59
"CPNE7","s1324_S_LS_02_ASEReadCounter.table","NW_015090842.1:10088146",53,106,53
"CPNE7","s1324_S_LS_02_ASEReadCounter.table","NW_015090842.1:10088940",97,175,78
"CPNE7","s1324_S_LS_02_ASEReadCounter.table","NW_015090842.1:10088965",85,159,74
"CPNE7","s1324_S_LS_02_ASEReadCounter.table","NW_015090842.1:10088967",85,161,76
"CPNE7","s1324_S_LS_02_ASEReadCounter.table","NW_015090842.1:10088973",86,161,75
"CPNE7","s1324_S_LS_02_ASEReadCounter.table","NW_015090842.1:10090924",129,253,124
"CPNE7","s1324_S_LS_02_ASEReadCounter.table","NW_015090842.1:10090930",131,249,118
"CPNE7","s1324_S_LS_02_ASEReadCounter.table","NW_015090842.1:10091075",117,237,120
"CPNE7","s1324_S_LS_02_ASEReadCounter.table","NW_015090842.1:10091389",151,282,131
"CPNE7","s1324_S_LS_02_ASEReadCounter.table","NW_015090842.1:10091407",167,299,132
"CPNE7","s1324_S_LS_02_ASEReadCounter.table","NW_015090842.1:10091530",160,315,155
"CPNE7","s1324_S_LS_02_ASEReadCounter.table","NW_015090842.1:10091875",171,331,160
"CPNE7","s1324_S_LS_02_ASEReadCounter.table","NW_015090842.1:10091983",146,262,116
"CPNE7","s1324_S_LS_02_ASEReadCounter.table","NW_015090842.1:10091997",157,280,123
"CPNE7","s1324_S_LS_02_ASEReadCounter.table","NW_015090842.1:10092038",104,188,84
"CPNE7","s1324_S_LS_02_ASEReadCounter.table","NW_015090842.1:10092140",121,231,110
"CPNE7","s1324_S_LS_02_ASEReadCounter.table","NW_015090842.1:10092183",94,171,77
"CPNE7","s1324_S_LS_02_ASEReadCounter.table","NW_015090842.1:10092201",79,149,70
"CPNE7","s1324_S_LS_02_ASEReadCounter.table","NW_015090842.1:10092230",50,99,49
"CPNE7","s1324_S_LS_02_ASEReadCounter.table","NW_015090842.1:10092246",27,60,33
"LOC106888185","s1324_S_LS_02_ASEReadCounter.table","NW_015090842.1:10094965",0,1,1
"LOC106888185","s1324_S_LS_02_ASEReadCounter.table","NW_015090842.1:10094966",0,1,1
"LOC106888185","s1324_S_LS_02_ASEReadCounter.table","NW_015090842.1:10094985",0,1,1
"LOC106888185","s1324_S_LS_02_ASEReadCounter.table","NW_015090842.1:10095130",0,1,1
"LOC106888185","s1324_S_LS_02_ASEReadCounter.table","NW_015090842.1:10095265",6,13,7
"LOC106888185","s1324_S_LS_02_ASEReadCounter.table","NW_015090842.1:10095586",7,10,3
"LOC106888185","s1324_S_LS_02_ASEReadCounter.table","NW_015090842.1:10095593",7,12,5
"LOC106888185","s1324_S_LS_02_ASEReadCounter.table","NW_015090842.1:10095616",4,11,7
"LOC106888185","s1324_S_LS_02_ASEReadCounter.table","NW_015090842.1:10095662",5,15,10
"LOC106888185","s1324_S_LS_02_ASEReadCounter.table","NW_015090842.1:10095674",4,14,10
"LOC106888185","s1324_S_LS_02_ASEReadCounter.table","NW_015090842.1:10095786",2,9,7
"LOC106888185","s1324_S_LS_02_ASEReadCounter.table","NW_015090842.1:10095831",4,8,4
"LOC106888185","s1324_S_LS_02_ASEReadCounter.table","NW_015090842.1:10096230",4,12,8
"LOC106888185","s1324_S_LS_02_ASEReadCounter.table","NW_015090842.1:10096249",4,13,9
"LOC106888185","s1324_S_LS_02_ASEReadCounter.table","NW_015090842.1:10096272",3,12,9
"LOC106888185","s1324_S_LS_02_ASEReadCounter.table","NW_015090842.1:10096288",2,10,8
"LOC106888185","s1324_S_LS_02_ASEReadCounter.table","NW_015090842.1:10097248",1,8,7
"LOC106888185","s1324_S_LS_02_ASEReadCounter.table","NW_015090842.1:10097265",2,11,9
"LOC106888185","s1324_S_LS_02_ASEReadCounter.table","NW_015090842.1:10097446",1,3,2
"DPEP1","s1324_S_LS_02_ASEReadCounter.table","NW_015090842.1:10098017",0,1,1
"DPEP1","s1324_S_LS_02_ASEReadCounter.table","NW_015090842.1:10101072",0,2,2
"DPEP1","s1324_S_LS_02_ASEReadCounter.table","NW_015090842.1:10101199",0,1,1
"DPEP1","s1324_S_LS_02_ASEReadCounter.table","NW_015090842.1:10101483",0,2,2
"DPEP1","s1324_S_LS_02_ASEReadCounter.table","NW_015090842.1:10101497",0,2,2
"DPEP1","s1324_S_LS_02_ASEReadCounter.table","NW_015090842.1:10101525",0,2,2
"DPEP1","s1324_S_LS_02_ASEReadCounter.table","NW_015090842.1:10101875",1,1,0
"DPEP1","s1324_S_LS_02_ASEReadCounter.table","NW_015090842.1:10101913",1,1,0
"DPEP1","s1324_S_LS_02_ASEReadCounter.table","NW_015090842.1:10101996",1,3,2
"DPEP1","s1324_S_LS_02_ASEReadCounter.table","NW_015090842.1:10102014",1,3,2
"DPEP1","s1324_S_LS_02_ASEReadCounter.table","NW_015090842.1:10102035",1,2,1
"DPEP1","s1324_S_LS_02_ASEReadCounter.table","NW_015090842.1:10102076",0,1,1
"DPEP1","s1324_S_LS_02_ASEReadCounter.table","NW_015090842.1:10102077",0,1,1
"CHMP1A","s1324_S_LS_02_ASEReadCounter.table","NW_015090842.1:10102901",83,189,106
"CHMP1A","s1324_S_LS_02_ASEReadCounter.table","NW_015090842.1:10102961",63,202,139
"CHMP1A","s1324_S_LS_02_ASEReadCounter.table","NW_015090842.1:10102996",66,201,135
"CHMP1A","s1324_S_LS_02_ASEReadCounter.table","NW_015090842.1:10103004",70,205,135
"CHMP1A","s1324_S_LS_02_ASEReadCounter.table","NW_015090842.1:10103006",71,208,137
"CHMP1A","s1324_S_LS_02_ASEReadCounter.table","NW_015090842.1:10103052",100,247,147
"CHMP1A","s1324_S_LS_02_ASEReadCounter.table","NW_015090842.1:10103095",99,254,155
"CHMP1A","s1324_S_LS_02_ASEReadCounter.table","NW_015090842.1:10103096",99,253,154
"CHMP1A","s1324_S_LS_02_ASEReadCounter.table","NW_015090842.1:10103152",89,194,105
"CHMP1A","s1324_S_LS_02_ASEReadCounter.table","NW_015090842.1:10103334",39,121,82
"CHMP1A","s1324_S_LS_02_ASEReadCounter.table","NW_015090842.1:10103373",20,101,81
"CHMP1A","s1324_S_LS_02_ASEReadCounter.table","NW_015090842.1:10103408",50,134,84
"CHMP1A","s1324_S_LS_02_ASEReadCounter.table","NW_015090842.1:10103412",54,131,77
"CHMP1A","s1324_S_LS_02_ASEReadCounter.table","NW_015090842.1:10103512",79,173,94
"CHMP1A","s1324_S_LS_02_ASEReadCounter.table","NW_015090842.1:10103513",79,174,95
"CHMP1A","s1324_S_LS_02_ASEReadCounter.table","NW_015090842.1:10103583",46,112,66
"CHMP1A","s1324_S_LS_02_ASEReadCounter.table","NW_015090842.1:10103614",47,113,66
"CHMP1A","s1324_S_LS_02_ASEReadCounter.table","NW_015090842.1:10103657",51,121,70
"CHMP1A","s1324_S_LS_02_ASEReadCounter.table","NW_015090842.1:10103669",51,117,66
"CHMP1A","s1324_S_LS_02_ASEReadCounter.table","NW_015090842.1:10103674",50,107,57
"CHMP1A","s1324_S_LS_02_ASEReadCounter.table","NW_015090842.1:10103677",49,105,56
"CHMP1A","s1324_S_LS_02_ASEReadCounter.table","NW_015090842.1:10103729",79,142,63
"CHMP1A","s1324_S_LS_02_ASEReadCounter.table","NW_015090842.1:10103758",70,128,58
"CHMP1A","s1324_S_LS_02_ASEReadCounter.table","NW_015090842.1:10103761",66,124,58
"CHMP1A","s1324_S_LS_02_ASEReadCounter.table","NW_015090842.1:10103788",66,137,71
"CHMP1A","s1324_S_LS_02_ASEReadCounter.table","NW_015090842.1:10103789",68,139,71
"CHMP1A","s1324_S_LS_02_ASEReadCounter.table","NW_015090842.1:10103790",68,139,71
"CHMP1A","s1324_S_LS_02_ASEReadCounter.table","NW_015090842.1:10103950",86,152,66
"CHMP1A","s1324_S_LS_02_ASEReadCounter.table","NW_015090842.1:10104335",60,117,57
"CHMP1A","s1324_S_LS_02_ASEReadCounter.table","NW_015090842.1:10104429",71,142,71
"CHMP1A","s1324_S_LS_02_ASEReadCounter.table","NW_015090842.1:10104532",65,141,76
"CHMP1A","s1324_S_LS_02_ASEReadCounter.table","NW_015090842.1:10104633",59,113,54
"CHMP1A","s1324_S_LS_02_ASEReadCounter.table","NW_015090842.1:10104759",54,108,54
"CHMP1A","s1324_S_LS_02_ASEReadCounter.table","NW_015090842.1:10104794",60,114,54
"CHMP1A","s1324_S_LS_02_ASEReadCounter.table","NW_015090842.1:10104844",36,79,43
"CHMP1A","s1324_S_LS_02_ASEReadCounter.table","NW_015090842.1:10106290",48,98,50
"CHMP1A","s1324_S_LS_02_ASEReadCounter.table","NW_015090842.1:10106335",59,123,64
"CHMP1A","s1324_S_LS_02_ASEReadCounter.table","NW_015090842.1:10106383",69,153,84
"CHMP1A","s1324_S_LS_02_ASEReadCounter.table","NW_015090842.1:10106747",52,130,78
"CHMP1A","s1324_S_LS_02_ASEReadCounter.table","NW_015090842.1:10107404",41,98,57
"CHMP1A","s1324_S_LS_02_ASEReadCounter.table","NW_015090842.1:10107410",45,97,52
"CHMP1A","s1324_S_LS_02_ASEReadCounter.table","NW_015090842.1:10107876",41,92,51
"CDK10","s1324_S_LS_02_ASEReadCounter.table","NW_015090842.1:10109030",5,9,4
"CDK10","s1324_S_LS_02_ASEReadCounter.table","NW_015090842.1:10109963",45,102,57
"CDK10","s1324_S_LS_02_ASEReadCounter.table","NW_015090842.1:10110887",46,115,69
"CDK10","s1324_S_LS_02_ASEReadCounter.table","NW_015090842.1:10111254",32,77,45
"CDK10","s1324_S_LS_02_ASEReadCounter.table","NW_015090842.1:10111380",29,103,74
"CDK10","s1324_S_LS_02_ASEReadCounter.table","NW_015090842.1:10111395",32,106,74
"CDK10","s1324_S_LS_02_ASEReadCounter.table","NW_015090842.1:10111437",19,99,80
"CDK10","s1324_S_LS_02_ASEReadCounter.table","NW_015090842.1:10111798",41,114,73
"CDK10","s1324_S_LS_02_ASEReadCounter.table","NW_015090842.1:10111840",43,129,86
"CDK10","s1324_S_LS_02_ASEReadCounter.table","NW_015090842.1:10112031",43,160,117
"CDK10","s1324_S_LS_02_ASEReadCounter.table","NW_015090842.1:10112285",57,160,103
"CDK10","s1324_S_LS_02_ASEReadCounter.table","NW_015090842.1:10112398",55,181,126
"CDK10","s1324_S_LS_02_ASEReadCounter.table","NW_015090842.1:10112455",41,154,113
"CDK10","s1324_S_LS_02_ASEReadCounter.table","NW_015090842.1:10112461",35,139,104
"CDK10","s1324_S_LS_02_ASEReadCounter.table","NW_015090842.1:10112497",39,132,93
"CDK10","s1324_S_LS_02_ASEReadCounter.table","NW_015090842.1:10112508",33,130,97
"CDK10","s1324_S_LS_02_ASEReadCounter.table","NW_015090842.1:10112518",32,117,85
"CDK10","s1324_S_LS_02_ASEReadCounter.table","NW_015090842.1:10112540",12,97,85
"CDK10","s1324_S_LS_02_ASEReadCounter.table","NW_015090842.1:10112556",37,121,84
"CDK10","s1324_S_LS_02_ASEReadCounter.table","NW_015090842.1:10112561",38,132,94
"CDK10","s1324_S_LS_02_ASEReadCounter.table","NW_015090842.1:10112596",48,147,99
"CDK10","s1324_S_LS_02_ASEReadCounter.table","NW_015090842.1:10112630",41,134,93
"CDK10","s1324_S_LS_02_ASEReadCounter.table","NW_015090842.1:10112656",37,121,84
"CDK10","s1324_S_LS_02_ASEReadCounter.table","NW_015090842.1:10112665",33,105,72
"CDK10","s1324_S_LS_02_ASEReadCounter.table","NW_015090842.1:10112668",32,106,74
"CDK10","s1324_S_LS_02_ASEReadCounter.table","NW_015090842.1:10112781",20,53,33
"CDK10","s1324_S_LS_02_ASEReadCounter.table","NW_015090842.1:10112782",20,54,34
"CDK10","s1324_S_LS_02_ASEReadCounter.table","NW_015090842.1:10112795",20,48,28
"CDK10","s1324_S_LS_02_ASEReadCounter.table","NW_015090842.1:10112841",12,23,11
"CDK10","s1324_S_LS_02_ASEReadCounter.table","NW_015090842.1:10112861",7,16,9
"SPATA2L","s1324_S_LS_02_ASEReadCounter.table","NW_015090842.1:10113212",27,58,31
"SPATA2L","s1324_S_LS_02_ASEReadCounter.table","NW_015090842.1:10113280",45,104,59
"SPATA2L","s1324_S_LS_02_ASEReadCounter.table","NW_015090842.1:10113296",42,101,59
"SPATA2L","s1324_S_LS_02_ASEReadCounter.table","NW_015090842.1:10113321",52,108,56
"SPATA2L","s1324_S_LS_02_ASEReadCounter.table","NW_015090842.1:10113332",51,118,67
"SPATA2L","s1324_S_LS_02_ASEReadCounter.table","NW_015090842.1:10113380",52,132,80
"SPATA2L","s1324_S_LS_02_ASEReadCounter.table","NW_015090842.1:10113381",52,133,81
"SPATA2L","s1324_S_LS_02_ASEReadCounter.table","NW_015090842.1:10113412",58,143,85
"SPATA2L","s1324_S_LS_02_ASEReadCounter.table","NW_015090842.1:10113421",58,145,87
"SPATA2L","s1324_S_LS_02_ASEReadCounter.table","NW_015090842.1:10113465",44,120,76
"SPATA2L","s1324_S_LS_02_ASEReadCounter.table","NW_015090842.1:10113535",75,148,73
"SPATA2L","s1324_S_LS_02_ASEReadCounter.table","NW_015090842.1:10113645",71,177,106
"SPATA2L","s1324_S_LS_02_ASEReadCounter.table","NW_015090842.1:10113682",90,215,125
"SPATA2L","s1324_S_LS_02_ASEReadCounter.table","NW_015090842.1:10113696",79,192,113
"SPATA2L","s1324_S_LS_02_ASEReadCounter.table","NW_015090842.1:10113727",79,198,119
"SPATA2L","s1324_S_LS_02_ASEReadCounter.table","NW_015090842.1:10113729",82,197,115
"SPATA2L","s1324_S_LS_02_ASEReadCounter.table","NW_015090842.1:10113799",103,211,108
"SPATA2L","s1324_S_LS_02_ASEReadCounter.table","NW_015090842.1:10113809",110,227,117
"SPATA2L","s1324_S_LS_02_ASEReadCounter.table","NW_015090842.1:10113827",102,209,107
"SPATA2L","s1324_S_LS_02_ASEReadCounter.table","NW_015090842.1:10113831",95,201,106
"SPATA2L","s1324_S_LS_02_ASEReadCounter.table","NW_015090842.1:10113894",78,178,100
"SPATA2L","s1324_S_LS_02_ASEReadCounter.table","NW_015090842.1:10113905",68,158,90
"SPATA2L","s1324_S_LS_02_ASEReadCounter.table","NW_015090842.1:10113914",66,148,82
"SPATA2L","s1324_S_LS_02_ASEReadCounter.table","NW_015090842.1:10113920",71,165,94
"SPATA2L","s1324_S_LS_02_ASEReadCounter.table","NW_015090842.1:10113937",84,184,100
"SPATA2L","s1324_S_LS_02_ASEReadCounter.table","NW_015090842.1:10113971",67,155,88
"SPATA2L","s1324_S_LS_02_ASEReadCounter.table","NW_015090842.1:10113976",58,158,100
"SPATA2L","s1324_S_LS_02_ASEReadCounter.table","NW_015090842.1:10113985",67,155,88
"SPATA2L","s1324_S_LS_02_ASEReadCounter.table","NW_015090842.1:10113994",80,172,92
"SPATA2L","s1324_S_LS_02_ASEReadCounter.table","NW_015090842.1:10114063",67,145,78
"SPATA2L","s1324_S_LS_02_ASEReadCounter.table","NW_015090842.1:10114066",63,142,79
"SPATA2L","s1324_S_LS_02_ASEReadCounter.table","NW_015090842.1:10114069",66,150,84
"SPATA2L","s1324_S_LS_02_ASEReadCounter.table","NW_015090842.1:10114159",52,118,66
"SPATA2L","s1324_S_LS_02_ASEReadCounter.table","NW_015090842.1:10114262",135,135,0
"SPATA2L","s1324_S_LS_02_ASEReadCounter.table","NW_015090842.1:10114470",45,100,55
"SPATA2L","s1324_S_LS_02_ASEReadCounter.table","NW_015090842.1:10114524",30,72,42
"VPS9D1","s1324_S_LS_02_ASEReadCounter.table","NW_015090842.1:10116377",37,80,43
"VPS9D1","s1324_S_LS_02_ASEReadCounter.table","NW_015090842.1:10116415",45,103,58
"VPS9D1","s1324_S_LS_02_ASEReadCounter.table","NW_015090842.1:10116607",44,90,46
"VPS9D1","s1324_S_LS_02_ASEReadCounter.table","NW_015090842.1:10116821",32,71,39
"VPS9D1","s1324_S_LS_02_ASEReadCounter.table","NW_015090842.1:10116825",27,63,36
"VPS9D1","s1324_S_LS_02_ASEReadCounter.table","NW_015090842.1:10116882",27,62,35
"VPS9D1","s1324_S_LS_02_ASEReadCounter.table","NW_015090842.1:10116933",26,66,40
"VPS9D1","s1324_S_LS_02_ASEReadCounter.table","NW_015090842.1:10116942",26,70,44
"VPS9D1","s1324_S_LS_02_ASEReadCounter.table","NW_015090842.1:10117152",22,60,38
"VPS9D1","s1324_S_LS_02_ASEReadCounter.table","NW_015090842.1:10117480",12,38,26
"VPS9D1","s1324_S_LS_02_ASEReadCounter.table","NW_015090842.1:10117497",12,33,21
"VPS9D1","s1324_S_LS_02_ASEReadCounter.table","NW_015090842.1:10117499",10,32,22
"VPS9D1","s1324_S_LS_02_ASEReadCounter.table","NW_015090842.1:10117516",22,46,24
"VPS9D1","s1324_S_LS_02_ASEReadCounter.table","NW_015090842.1:10117525",23,48,25
"VPS9D1","s1324_S_LS_02_ASEReadCounter.table","NW_015090842.1:10117579",27,61,34
"VPS9D1","s1324_S_LS_02_ASEReadCounter.table","NW_015090842.1:10117627",23,54,31
"VPS9D1","s1324_S_LS_02_ASEReadCounter.table","NW_015090842.1:10117678",15,48,33
"VPS9D1","s1324_S_LS_02_ASEReadCounter.table","NW_015090842.1:10117773",36,74,38
"VPS9D1","s1324_S_LS_02_ASEReadCounter.table","NW_015090842.1:10117937",26,66,40
"VPS9D1","s1324_S_LS_02_ASEReadCounter.table","NW_015090842.1:10117961",25,67,42
"VPS9D1","s1324_S_LS_02_ASEReadCounter.table","NW_015090842.1:10118236",22,69,47
"VPS9D1","s1324_S_LS_02_ASEReadCounter.table","NW_015090842.1:10118414",17,61,44
"VPS9D1","s1324_S_LS_02_ASEReadCounter.table","NW_015090842.1:10118973",32,88,56
"VPS9D1","s1324_S_LS_02_ASEReadCounter.table","NW_015090842.1:10119500",18,45,27
"ZNF276","s1324_S_LS_02_ASEReadCounter.table","NW_015090842.1:10121760",2,4,2
"ZNF276","s1324_S_LS_02_ASEReadCounter.table","NW_015090842.1:10121769",2,5,3
"ZNF276","s1324_S_LS_02_ASEReadCounter.table","NW_015090842.1:10121802",3,9,6
"ZNF276","s1324_S_LS_02_ASEReadCounter.table","NW_015090842.1:10121971",8,14,6
"ZNF276","s1324_S_LS_02_ASEReadCounter.table","NW_015090842.1:10122161",18,18,0
"ZNF276","s1324_S_LS_02_ASEReadCounter.table","NW_015090842.1:10122164",17,17,0
"ZNF276","s1324_S_LS_02_ASEReadCounter.table","NW_015090842.1:10122184",13,13,0
"ZNF276","s1324_S_LS_02_ASEReadCounter.table","NW_015090842.1:10122883",13,20,7
"ZNF276","s1324_S_LS_02_ASEReadCounter.table","NW_015090842.1:10122997",13,21,8
"ZNF276","s1324_S_LS_02_ASEReadCounter.table","NW_015090842.1:10123069",8,17,9
"ZNF276","s1324_S_LS_02_ASEReadCounter.table","NW_015090842.1:10123207",15,32,17
"ZNF276","s1324_S_LS_02_ASEReadCounter.table","NW_015090842.1:10125787",18,45,27
"ZNF276","s1324_S_LS_02_ASEReadCounter.table","NW_015090842.1:10126309",22,48,26
"ZNF276","s1324_S_LS_02_ASEReadCounter.table","NW_015090842.1:10126348",24,49,25
"ZNF276","s1324_S_LS_02_ASEReadCounter.table","NW_015090842.1:10126978",33,62,29
"ZNF276","s1324_S_LS_02_ASEReadCounter.table","NW_015090842.1:10126991",33,58,25
"ZNF276","s1324_S_LS_02_ASEReadCounter.table","NW_015090842.1:10127023",33,65,32
"ZNF276","s1324_S_LS_02_ASEReadCounter.table","NW_015090842.1:10127063",25,53,28
"ZNF276","s1324_S_LS_02_ASEReadCounter.table","NW_015090842.1:10127373",21,48,27
"ZNF276","s1324_S_LS_02_ASEReadCounter.table","NW_015090842.1:10127931",33,56,23
"ZNF276","s1324_S_LS_02_ASEReadCounter.table","NW_015090842.1:10128070",29,64,35
"ZNF276","s1324_S_LS_02_ASEReadCounter.table","NW_015090842.1:10128102",31,58,27
"ZNF276","s1324_S_LS_02_ASEReadCounter.table","NW_015090842.1:10128356",28,57,29
"ZNF276","s1324_S_LS_02_ASEReadCounter.table","NW_015090842.1:10128497",20,40,20
"FANCA","s1324_S_LS_02_ASEReadCounter.table","NW_015090842.1:10128743",1,2,1
"FANCA","s1324_S_LS_02_ASEReadCounter.table","NW_015090842.1:10128822",1,2,1
"FANCA","s1324_S_LS_02_ASEReadCounter.table","NW_015090842.1:10129383",2,5,3
"FANCA","s1324_S_LS_02_ASEReadCounter.table","NW_015090842.1:10129390",2,5,3
"FANCA","s1324_S_LS_02_ASEReadCounter.table","NW_015090842.1:10129422",0,3,3
"FANCA","s1324_S_LS_02_ASEReadCounter.table","NW_015090842.1:10130399",2,5,3
"FANCA","s1324_S_LS_02_ASEReadCounter.table","NW_015090842.1:10130857",3,4,1
"FANCA","s1324_S_LS_02_ASEReadCounter.table","NW_015090842.1:10130878",2,3,1
"FANCA","s1324_S_LS_02_ASEReadCounter.table","NW_015090842.1:10133530",0,2,2
"FANCA","s1324_S_LS_02_ASEReadCounter.table","NW_015090842.1:10133533",0,2,2
"FANCA","s1324_S_LS_02_ASEReadCounter.table","NW_015090842.1:10133536",0,2,2
"FANCA","s1324_S_LS_02_ASEReadCounter.table","NW_015090842.1:10133601",0,2,2
"FANCA","s1324_S_LS_02_ASEReadCounter.table","NW_015090842.1:10134492",0,2,2
"FANCA","s1324_S_LS_02_ASEReadCounter.table","NW_015090842.1:10136999",0,1,1
"FANCA","s1324_S_LS_02_ASEReadCounter.table","NW_015090842.1:10137019",1,2,1
"FANCA","s1324_S_LS_02_ASEReadCounter.table","NW_015090842.1:10137673",2,3,1
"FANCA","s1324_S_LS_02_ASEReadCounter.table","NW_015090842.1:10138618",0,1,1
"FANCA","s1324_S_LS_02_ASEReadCounter.table","NW_015090842.1:10139140",1,1,0
"SPIRE2","s1324_S_LS_02_ASEReadCounter.table","NW_015090842.1:10172284",12,29,17
"SPIRE2","s1324_S_LS_02_ASEReadCounter.table","NW_015090842.1:10175262",29,50,21
"SPIRE2","s1324_S_LS_02_ASEReadCounter.table","NW_015090842.1:10175352",15,30,15
"SPIRE2","s1324_S_LS_02_ASEReadCounter.table","NW_015090842.1:10175400",57,114,57
"SPIRE2","s1324_S_LS_02_ASEReadCounter.table","NW_015090842.1:10175418",61,120,59
"SPIRE2","s1324_S_LS_02_ASEReadCounter.table","NW_015090842.1:10175704",65,135,70
"SPIRE2","s1324_S_LS_02_ASEReadCounter.table","NW_015090842.1:10176115",81,189,108
"SPIRE2","s1324_S_LS_02_ASEReadCounter.table","NW_015090842.1:10176561",83,207,124
"SPIRE2","s1324_S_LS_02_ASEReadCounter.table","NW_015090842.1:10176817",96,189,93
"SPIRE2","s1324_S_LS_02_ASEReadCounter.table","NW_015090842.1:10177084",42,121,79
"SPIRE2","s1324_S_LS_02_ASEReadCounter.table","NW_015090842.1:10177838",95,217,122
"SPIRE2","s1324_S_LS_02_ASEReadCounter.table","NW_015090842.1:10178000",95,200,105
"SPIRE2","s1324_S_LS_02_ASEReadCounter.table","NW_015090842.1:10178164",108,250,142
"SPIRE2","s1324_S_LS_02_ASEReadCounter.table","NW_015090842.1:10178216",128,288,160
"SPIRE2","s1324_S_LS_02_ASEReadCounter.table","NW_015090842.1:10178303",105,211,106
"SPIRE2","s1324_S_LS_02_ASEReadCounter.table","NW_015090842.1:10178403",100,228,128
"SPIRE2","s1324_S_LS_02_ASEReadCounter.table","NW_015090842.1:10178409",99,217,118
"SPIRE2","s1324_S_LS_02_ASEReadCounter.table","NW_015090842.1:10178524",98,208,110
"SPIRE2","s1324_S_LS_02_ASEReadCounter.table","NW_015090842.1:10178526",100,213,113
"SPIRE2","s1324_S_LS_02_ASEReadCounter.table","NW_015090842.1:10178531",101,208,107
"SPIRE2","s1324_S_LS_02_ASEReadCounter.table","NW_015090842.1:10178565",92,197,105
"SPIRE2","s1324_S_LS_02_ASEReadCounter.table","NW_015090842.1:10178587",87,181,94
"SPIRE2","s1324_S_LS_02_ASEReadCounter.table","NW_015090842.1:10178640",60,129,69
"SPIRE2","s1324_S_LS_02_ASEReadCounter.table","NW_015090842.1:10178651",68,143,75
"SPIRE2","s1324_S_LS_02_ASEReadCounter.table","NW_015090842.1:10178682",60,117,57
"TCF25","s1324_S_LS_02_ASEReadCounter.table","NW_015090842.1:10180912",39,75,36
"TCF25","s1324_S_LS_02_ASEReadCounter.table","NW_015090842.1:10180924",41,76,35
"TCF25","s1324_S_LS_02_ASEReadCounter.table","NW_015090842.1:10180931",42,77,35
"TCF25","s1324_S_LS_02_ASEReadCounter.table","NW_015090842.1:10185332",120,230,110
"TCF25","s1324_S_LS_02_ASEReadCounter.table","NW_015090842.1:10196561",109,190,81
"TCF25","s1324_S_LS_02_ASEReadCounter.table","NW_015090842.1:10197399",251,251,0
"MC1R","s1324_S_LS_02_ASEReadCounter.table","NW_015090842.1:10201853",0,1,1
"TUBB3","s1324_S_LS_02_ASEReadCounter.table","NW_015090842.1:10205322",0,366,366
"GAS8","s1324_S_LS_02_ASEReadCounter.table","NW_015090842.1:10228982",26,50,24
"GAS8","s1324_S_LS_02_ASEReadCounter.table","NW_015090842.1:10229832",25,54,29
"GAS8","s1324_S_LS_02_ASEReadCounter.table","NW_015090842.1:10232901",40,75,35
"GAS8","s1324_S_LS_02_ASEReadCounter.table","NW_015090842.1:10232928",48,85,37
"GAS8","s1324_S_LS_02_ASEReadCounter.table","NW_015090842.1:10232967",43,86,43
"GAS8","s1324_S_LS_02_ASEReadCounter.table","NW_015090842.1:10233032",36,71,35
"GAS8","s1324_S_LS_02_ASEReadCounter.table","NW_015090842.1:10233057",36,58,22
"GAS8","s1324_S_LS_02_ASEReadCounter.table","NW_015090842.1:10233058",36,58,22
"GAS8","s1324_S_LS_02_ASEReadCounter.table","NW_015090842.1:10233176",34,58,24
"GAS8","s1324_S_LS_02_ASEReadCounter.table","NW_015090842.1:10233196",28,48,20
"GAS8","s1324_S_LS_02_ASEReadCounter.table","NW_015090842.1:10233252",21,37,16
"GAS8","s1324_S_LS_02_ASEReadCounter.table","NW_015090842.1:10233303",7,14,7
"LOC106888094","s1324_S_LS_02_ASEReadCounter.table","NW_015090842.1:10233334",1,9,8
"LOC106888094","s1324_S_LS_02_ASEReadCounter.table","NW_015090842.1:10233362",4,15,11
"LOC106888094","s1324_S_LS_02_ASEReadCounter.table","NW_015090842.1:10233373",4,16,12
"LOC106888094","s1324_S_LS_02_ASEReadCounter.table","NW_015090842.1:10233388",6,19,13
"LOC106888094","s1324_S_LS_02_ASEReadCounter.table","NW_015090842.1:10233402",7,21,14
"LOC106888094","s1324_S_LS_02_ASEReadCounter.table","NW_015090842.1:10233465",10,19,9
"LOC106888094","s1324_S_LS_02_ASEReadCounter.table","NW_015090842.1:10233803",8,29,21
"LOC106888094","s1324_S_LS_02_ASEReadCounter.table","NW_015090842.1:10233815",8,27,19
"LOC106888094","s1324_S_LS_02_ASEReadCounter.table","NW_015090842.1:10235484",0,1,1
"LOC106888094","s1324_S_LS_02_ASEReadCounter.table","NW_015090842.1:10235611",2,3,1
"LOC106888094","s1324_S_LS_02_ASEReadCounter.table","NW_015090842.1:10235977",1,1,0
"LOC106888094","s1324_S_LS_02_ASEReadCounter.table","NW_015090842.1:10236380",0,1,1
"LOC106888094","s1324_S_LS_02_ASEReadCounter.table","NW_015090842.1:10236388",0,1,1
"LOC106888094","s1324_S_LS_02_ASEReadCounter.table","NW_015090842.1:10236425",0,1,1
"LOC106888094","s1324_S_LS_02_ASEReadCounter.table","NW_015090842.1:10236426",0,1,1
"LOC106888094","s1324_S_LS_02_ASEReadCounter.table","NW_015090842.1:10236603",0,1,1
"LOC106888173","s1324_S_LS_02_ASEReadCounter.table","NW_015090842.1:10239596",0,7,7
"LOC106888173","s1324_S_LS_02_ASEReadCounter.table","NW_015090842.1:10240036",3,17,14
"LOC106888173","s1324_S_LS_02_ASEReadCounter.table","NW_015090842.1:10240095",6,20,14
"LOC106888173","s1324_S_LS_02_ASEReadCounter.table","NW_015090842.1:10240280",5,23,18
"LOC106888173","s1324_S_LS_02_ASEReadCounter.table","NW_015090842.1:10240557",15,31,16
"LOC106888173","s1324_S_LS_02_ASEReadCounter.table","NW_015090842.1:10240603",9,25,16
"LOC106888173","s1324_S_LS_02_ASEReadCounter.table","NW_015090842.1:10240609",9,28,19
"LOC106888173","s1324_S_LS_02_ASEReadCounter.table","NW_015090842.1:10240924",6,30,24
"LOC106888173","s1324_S_LS_02_ASEReadCounter.table","NW_015090842.1:10241037",4,38,34
"LOC106888173","s1324_S_LS_02_ASEReadCounter.table","NW_015090842.1:10241046",7,39,32
"LOC106888173","s1324_S_LS_02_ASEReadCounter.table","NW_015090842.1:10241058",6,36,30
"LOC106888173","s1324_S_LS_02_ASEReadCounter.table","NW_015090842.1:10241064",7,36,29
"LOC106888173","s1324_S_LS_02_ASEReadCounter.table","NW_015090842.1:10241163",9,32,23
"LOC106888173","s1324_S_LS_02_ASEReadCounter.table","NW_015090842.1:10241803",6,43,37
"LOC106888173","s1324_S_LS_02_ASEReadCounter.table","NW_015090842.1:10241827",8,43,35
"LOC106888173","s1324_S_LS_02_ASEReadCounter.table","NW_015090842.1:10241869",13,47,34
"LOC106888173","s1324_S_LS_02_ASEReadCounter.table","NW_015090842.1:10242079",9,29,20
"LOC106888173","s1324_S_LS_02_ASEReadCounter.table","NW_015090842.1:10242103",9,28,19
"LOC106888173","s1324_S_LS_02_ASEReadCounter.table","NW_015090842.1:10242157",9,31,22
"LOC106888173","s1324_S_LS_02_ASEReadCounter.table","NW_015090842.1:10242455",7,34,27
"LOC106888173","s1324_S_LS_02_ASEReadCounter.table","NW_015090842.1:10242481",9,39,30
"LOC106888173","s1324_S_LS_02_ASEReadCounter.table","NW_015090842.1:10242590",10,31,21
"LOC106888173","s1324_S_LS_02_ASEReadCounter.table","NW_015090842.1:10242794",6,36,30
"LOC106888173","s1324_S_LS_02_ASEReadCounter.table","NW_015090842.1:10242909",11,39,28
"LOC106888173","s1324_S_LS_02_ASEReadCounter.table","NW_015090842.1:10243094",14,34,20
"LOC106888173","s1324_S_LS_02_ASEReadCounter.table","NW_015090842.1:10243133",12,27,15
"LOC106888173","s1324_S_LS_02_ASEReadCounter.table","NW_015090842.1:10243273",18,51,33
"LOC106888173","s1324_S_LS_02_ASEReadCounter.table","NW_015090842.1:10243278",16,49,33
"LOC106888173","s1324_S_LS_02_ASEReadCounter.table","NW_015090842.1:10243281",16,50,34
"LOC106888173","s1324_S_LS_02_ASEReadCounter.table","NW_015090842.1:10243347",24,24,0
"LOC106888173","s1324_S_LS_02_ASEReadCounter.table","NW_015090842.1:10243353",11,24,13
"LOC106888173","s1324_S_LS_02_ASEReadCounter.table","NW_015090842.1:10243363",7,16,9
"LOC106888173","s1324_S_LS_02_ASEReadCounter.table","NW_015090842.1:10243365",7,17,10
"LOC106888173","s1324_S_LS_02_ASEReadCounter.table","NW_015090842.1:10243529",22,35,13
"LOC106888173","s1324_S_LS_02_ASEReadCounter.table","NW_015090842.1:10243566",22,45,23
"LOC106888173","s1324_S_LS_02_ASEReadCounter.table","NW_015090842.1:10243605",16,42,26
"LOC106888173","s1324_S_LS_02_ASEReadCounter.table","NW_015090842.1:10243614",12,37,25
"LOC106888173","s1324_S_LS_02_ASEReadCounter.table","NW_015090842.1:10243615",12,37,25
"LOC106888173","s1324_S_LS_02_ASEReadCounter.table","NW_015090842.1:10243640",9,33,24
"LOC106888173","s1324_S_LS_02_ASEReadCounter.table","NW_015090842.1:10243680",10,26,16
"LOC106888173","s1324_S_LS_02_ASEReadCounter.table","NW_015090842.1:10243742",11,30,19
"LOC106888173","s1324_S_LS_02_ASEReadCounter.table","NW_015090842.1:10243804",11,27,16
"LOC106888173","s1324_S_LS_02_ASEReadCounter.table","NW_015090842.1:10243913",4,11,7
"LOC106888173","s1324_S_LS_02_ASEReadCounter.table","NW_015090842.1:10243921",4,10,6
"LOC106888384","s1324_S_LS_02_ASEReadCounter.table","NW_015090842.1:10250743",1,1,0
"LOC106888384","s1324_S_LS_02_ASEReadCounter.table","NW_015090842.1:10250771",1,1,0
"LOC106888384","s1324_S_LS_02_ASEReadCounter.table","NW_015090842.1:10251354",0,2,2
"LOC106888384","s1324_S_LS_02_ASEReadCounter.table","NW_015090842.1:10251358",0,2,2
"LOC106888384","s1324_S_LS_02_ASEReadCounter.table","NW_015090842.1:10251369",0,2,2
"LOC106888384","s1324_S_LS_02_ASEReadCounter.table","NW_015090842.1:10251370",0,2,2
"LOC106888384","s1324_S_LS_02_ASEReadCounter.table","NW_015090842.1:10251375",0,2,2
"LOC106888384","s1324_S_LS_02_ASEReadCounter.table","NW_015090842.1:10251388",0,1,1
"LOC106888384","s1324_S_LS_02_ASEReadCounter.table","NW_015090842.1:10251390",0,1,1
"LOC106888384","s1324_S_LS_02_ASEReadCounter.table","NW_015090842.1:10251393",0,1,1
"LOC106888384","s1324_S_LS_02_ASEReadCounter.table","NW_015090842.1:10251399",0,1,1
"LOC106888384","s1324_S_LS_02_ASEReadCounter.table","NW_015090842.1:10251492",1,1,0
"LOC106888384","s1324_S_LS_02_ASEReadCounter.table","NW_015090842.1:10253165",1,1,0
"LOC106888384","s1324_S_LS_02_ASEReadCounter.table","NW_015090842.1:10254028",0,1,1
"LOC106888384","s1324_S_LS_02_ASEReadCounter.table","NW_015090842.1:10254227",0,1,1
"LOC106888384","s1324_S_LS_02_ASEReadCounter.table","NW_015090842.1:10254233",0,1,1
"LOC106888384","s1324_S_LS_02_ASEReadCounter.table","NW_015090842.1:10254263",0,1,1
"LOC106888384","s1324_S_LS_02_ASEReadCounter.table","NW_015090842.1:10254293",1,1,0
"LOC106888384","s1324_S_LS_02_ASEReadCounter.table","NW_015090842.1:10254570",1,1,0
"LOC106888384","s1324_S_LS_02_ASEReadCounter.table","NW_015090842.1:10254647",1,1,0
"LOC106888384","s1324_S_LS_02_ASEReadCounter.table","NW_015090842.1:10254975",0,1,1
"LOC106888384","s1324_S_LS_02_ASEReadCounter.table","NW_015090842.1:10255077",0,1,1
"LOC106888384","s1324_S_LS_02_ASEReadCounter.table","NW_015090842.1:10255117",0,1,1
"LOC106888384","s1324_S_LS_02_ASEReadCounter.table","NW_015090842.1:10255138",0,1,1
"LOC106888384","s1324_S_LS_02_ASEReadCounter.table","NW_015090842.1:10255139",0,1,1
"LOC106888384","s1324_S_LS_02_ASEReadCounter.table","NW_015090842.1:10255306",0,1,1
"LOC106888384","s1324_S_LS_02_ASEReadCounter.table","NW_015090842.1:10255340",0,1,1
"LOC106888384","s1324_S_LS_02_ASEReadCounter.table","NW_015090842.1:10255410",1,1,0
"LOC106888384","s1324_S_LS_02_ASEReadCounter.table","NW_015090842.1:10255449",1,1,0
"LOC106888384","s1324_S_LS_02_ASEReadCounter.table","NW_015090842.1:10255496",0,1,1
"LOC106888384","s1324_S_LS_02_ASEReadCounter.table","NW_015090842.1:10255505",0,1,1
"LOC106888384","s1324_S_LS_02_ASEReadCounter.table","NW_015090842.1:10255531",0,1,1
"LOC106888384","s1324_S_LS_02_ASEReadCounter.table","NW_015090842.1:10255608",1,2,1
"LOC106888384","s1324_S_LS_02_ASEReadCounter.table","NW_015090842.1:10255614",1,2,1
"LOC106888384","s1324_S_LS_02_ASEReadCounter.table","NW_015090842.1:10255704",3,3,0
"LOC106888384","s1324_S_LS_02_ASEReadCounter.table","NW_015090842.1:10255731",3,3,0
"LOC106888384","s1324_S_LS_02_ASEReadCounter.table","NW_015090842.1:10255771",3,3,0
"TANGO6","s1324_S_LS_02_ASEReadCounter.table","NW_015090842.1:10257782",3,7,4
"TANGO6","s1324_S_LS_02_ASEReadCounter.table","NW_015090842.1:10258162",5,15,10
"TANGO6","s1324_S_LS_02_ASEReadCounter.table","NW_015090842.1:10258185",8,19,11
"TANGO6","s1324_S_LS_02_ASEReadCounter.table","NW_015090842.1:10259267",12,16,4
"TANGO6","s1324_S_LS_02_ASEReadCounter.table","NW_015090842.1:10260250",18,35,17
"TANGO6","s1324_S_LS_02_ASEReadCounter.table","NW_015090842.1:10260979",20,30,10
"TANGO6","s1324_S_LS_02_ASEReadCounter.table","NW_015090842.1:10261599",19,29,10
"TANGO6","s1324_S_LS_02_ASEReadCounter.table","NW_015090842.1:10268425",39,55,16
"TANGO6","s1324_S_LS_02_ASEReadCounter.table","NW_015090842.1:10269831",34,54,20
"TANGO6","s1324_S_LS_02_ASEReadCounter.table","NW_015090842.1:10270813",26,44,18
"TANGO6","s1324_S_LS_02_ASEReadCounter.table","NW_015090842.1:10273952",24,38,14
"TANGO6","s1324_S_LS_02_ASEReadCounter.table","NW_015090842.1:10273970",28,44,16
"TANGO6","s1324_S_LS_02_ASEReadCounter.table","NW_015090842.1:10274018",25,36,11
"TANGO6","s1324_S_LS_02_ASEReadCounter.table","NW_015090842.1:10275974",20,34,14
"TANGO6","s1324_S_LS_02_ASEReadCounter.table","NW_015090842.1:10275976",21,35,14
"TANGO6","s1324_S_LS_02_ASEReadCounter.table","NW_015090842.1:10276123",31,44,13
"TANGO6","s1324_S_LS_02_ASEReadCounter.table","NW_015090842.1:10276271",28,43,15
"TANGO6","s1324_S_LS_02_ASEReadCounter.table","NW_015090842.1:10276272",28,43,15
"TANGO6","s1324_S_LS_02_ASEReadCounter.table","NW_015090842.1:10276275",28,43,15
"TANGO6","s1324_S_LS_02_ASEReadCounter.table","NW_015090842.1:10276278",28,43,15
"TANGO6","s1324_S_LS_02_ASEReadCounter.table","NW_015090842.1:10276368",29,37,8
"TANGO6","s1324_S_LS_02_ASEReadCounter.table","NW_015090842.1:10276373",28,39,11
"TANGO6","s1324_S_LS_02_ASEReadCounter.table","NW_015090842.1:10276630",32,48,16
"TANGO6","s1324_S_LS_02_ASEReadCounter.table","NW_015090842.1:10281498",44,59,15
"TANGO6","s1324_S_LS_02_ASEReadCounter.table","NW_015090842.1:10282842",43,61,18
"TANGO6","s1324_S_LS_02_ASEReadCounter.table","NW_015090842.1:10282863",39,50,11
"TANGO6","s1324_S_LS_02_ASEReadCounter.table","NW_015090842.1:10282869",39,50,11
"TANGO6","s1324_S_LS_02_ASEReadCounter.table","NW_015090842.1:10282903",40,64,24
"TANGO6","s1324_S_LS_02_ASEReadCounter.table","NW_015090842.1:10283757",43,65,22
"TANGO6","s1324_S_LS_02_ASEReadCounter.table","NW_015090842.1:10283785",43,69,26
"HAS3","s1324_S_LS_02_ASEReadCounter.table","NW_015090842.1:10288364",2,2,0
"HAS3","s1324_S_LS_02_ASEReadCounter.table","NW_015090842.1:10288405",1,1,0
"HAS3","s1324_S_LS_02_ASEReadCounter.table","NW_015090842.1:10289708",1,2,1
"HAS3","s1324_S_LS_02_ASEReadCounter.table","NW_015090842.1:10290561",0,1,1
"HAS3","s1324_S_LS_02_ASEReadCounter.table","NW_015090842.1:10290609",0,2,2
"HAS3","s1324_S_LS_02_ASEReadCounter.table","NW_015090842.1:10290666",0,2,2
"HAS3","s1324_S_LS_02_ASEReadCounter.table","NW_015090842.1:10290723",0,4,4
"HAS3","s1324_S_LS_02_ASEReadCounter.table","NW_015090842.1:10290927",4,8,4
"HAS3","s1324_S_LS_02_ASEReadCounter.table","NW_015090842.1:10291004",5,13,8
"CHTF8","s1324_S_LS_02_ASEReadCounter.table","NW_015090842.1:10291319",5,8,3
"CHTF8","s1324_S_LS_02_ASEReadCounter.table","NW_015090842.1:10291342",7,9,2
"CHTF8","s1324_S_LS_02_ASEReadCounter.table","NW_015090842.1:10291491",10,16,6
"CHTF8","s1324_S_LS_02_ASEReadCounter.table","NW_015090842.1:10291520",13,17,4
"CHTF8","s1324_S_LS_02_ASEReadCounter.table","NW_015090842.1:10291593",17,24,7
"CHTF8","s1324_S_LS_02_ASEReadCounter.table","NW_015090842.1:10291600",17,26,9
"CHTF8","s1324_S_LS_02_ASEReadCounter.table","NW_015090842.1:10291609",16,26,10
"CHTF8","s1324_S_LS_02_ASEReadCounter.table","NW_015090842.1:10291639",12,23,11
"CHTF8","s1324_S_LS_02_ASEReadCounter.table","NW_015090842.1:10291641",12,24,12
"CHTF8","s1324_S_LS_02_ASEReadCounter.table","NW_015090842.1:10291648",13,24,11
"CHTF8","s1324_S_LS_02_ASEReadCounter.table","NW_015090842.1:10291656",12,22,10
"CHTF8","s1324_S_LS_02_ASEReadCounter.table","NW_015090842.1:10291675",13,26,13
"CHTF8","s1324_S_LS_02_ASEReadCounter.table","NW_015090842.1:10291696",12,25,13
"CHTF8","s1324_S_LS_02_ASEReadCounter.table","NW_015090842.1:10291714",12,23,11
"CHTF8","s1324_S_LS_02_ASEReadCounter.table","NW_015090842.1:10291732",13,31,18
"CHTF8","s1324_S_LS_02_ASEReadCounter.table","NW_015090842.1:10291755",10,27,17
"CHTF8","s1324_S_LS_02_ASEReadCounter.table","NW_015090842.1:10291756",10,26,16
"CHTF8","s1324_S_LS_02_ASEReadCounter.table","NW_015090842.1:10291758",10,28,18
"CHTF8","s1324_S_LS_02_ASEReadCounter.table","NW_015090842.1:10291792",16,33,17
"CHTF8","s1324_S_LS_02_ASEReadCounter.table","NW_015090842.1:10291895",17,30,13
"CHTF8","s1324_S_LS_02_ASEReadCounter.table","NW_015090842.1:10292132",13,21,8
"CHTF8","s1324_S_LS_02_ASEReadCounter.table","NW_015090842.1:10292314",9,25,16
"CHTF8","s1324_S_LS_02_ASEReadCounter.table","NW_015090842.1:10292317",9,24,15
"CHTF8","s1324_S_LS_02_ASEReadCounter.table","NW_015090842.1:10292928",1,3,2
"UTP4","s1324_S_LS_02_ASEReadCounter.table","NW_015090842.1:10293146",10,21,11
"UTP4","s1324_S_LS_02_ASEReadCounter.table","NW_015090842.1:10293151",9,18,9
"UTP4","s1324_S_LS_02_ASEReadCounter.table","NW_015090842.1:10293191",3,8,5
"UTP4","s1324_S_LS_02_ASEReadCounter.table","NW_015090842.1:10293362",13,22,9
"UTP4","s1324_S_LS_02_ASEReadCounter.table","NW_015090842.1:10293430",16,32,16
"UTP4","s1324_S_LS_02_ASEReadCounter.table","NW_015090842.1:10293625",11,24,13
"UTP4","s1324_S_LS_02_ASEReadCounter.table","NW_015090842.1:10293684",10,23,13
"UTP4","s1324_S_LS_02_ASEReadCounter.table","NW_015090842.1:10294093",13,19,6
"UTP4","s1324_S_LS_02_ASEReadCounter.table","NW_015090842.1:10294568",8,28,20
"UTP4","s1324_S_LS_02_ASEReadCounter.table","NW_015090842.1:10294622",9,29,20
"UTP4","s1324_S_LS_02_ASEReadCounter.table","NW_015090842.1:10294632",8,29,21
"UTP4","s1324_S_LS_02_ASEReadCounter.table","NW_015090842.1:10295238",9,24,15
"UTP4","s1324_S_LS_02_ASEReadCounter.table","NW_015090842.1:10295880",10,33,23
"UTP4","s1324_S_LS_02_ASEReadCounter.table","NW_015090842.1:10295884",11,33,22
"UTP4","s1324_S_LS_02_ASEReadCounter.table","NW_015090842.1:10295903",11,31,20
"UTP4","s1324_S_LS_02_ASEReadCounter.table","NW_015090842.1:10295906",12,31,19
"UTP4","s1324_S_LS_02_ASEReadCounter.table","NW_015090842.1:10295915",14,38,24
"UTP4","s1324_S_LS_02_ASEReadCounter.table","NW_015090842.1:10295938",11,31,20
"UTP4","s1324_S_LS_02_ASEReadCounter.table","NW_015090842.1:10296175",14,32,18
"UTP4","s1324_S_LS_02_ASEReadCounter.table","NW_015090842.1:10296660",24,49,25
"UTP4","s1324_S_LS_02_ASEReadCounter.table","NW_015090842.1:10296679",23,50,27
"UTP4","s1324_S_LS_02_ASEReadCounter.table","NW_015090842.1:10297193",26,68,42
"UTP4","s1324_S_LS_02_ASEReadCounter.table","NW_015090842.1:10297220",28,75,47
"UTP4","s1324_S_LS_02_ASEReadCounter.table","NW_015090842.1:10297307",32,76,44
"UTP4","s1324_S_LS_02_ASEReadCounter.table","NW_015090842.1:10297558",47,92,45
"UTP4","s1324_S_LS_02_ASEReadCounter.table","NW_015090842.1:10297943",28,70,42
"UTP4","s1324_S_LS_02_ASEReadCounter.table","NW_015090842.1:10297979",30,74,44
"UTP4","s1324_S_LS_02_ASEReadCounter.table","NW_015090842.1:10298022",28,60,32
"UTP4","s1324_S_LS_02_ASEReadCounter.table","NW_015090842.1:10298079",5,12,7
"UTP4","s1324_S_LS_02_ASEReadCounter.table","NW_015090842.1:10298081",4,11,7
"UTP4","s1324_S_LS_02_ASEReadCounter.table","NW_015090842.1:10298082",4,10,6
"SNTB2","s1324_S_LS_02_ASEReadCounter.table","NW_015090842.1:10303506",5,6,1
"SNTB2","s1324_S_LS_02_ASEReadCounter.table","NW_015090842.1:10303524",6,8,2
"SNTB2","s1324_S_LS_02_ASEReadCounter.table","NW_015090842.1:10304059",6,12,6
"SNTB2","s1324_S_LS_02_ASEReadCounter.table","NW_015090842.1:10304089",7,12,5
"SNTB2","s1324_S_LS_02_ASEReadCounter.table","NW_015090842.1:10304167",6,9,3
"SNTB2","s1324_S_LS_02_ASEReadCounter.table","NW_015090842.1:10304176",6,9,3
"SNTB2","s1324_S_LS_02_ASEReadCounter.table","NW_015090842.1:10305069",4,6,2
"SNTB2","s1324_S_LS_02_ASEReadCounter.table","NW_015090842.1:10305099",3,6,3
"SNTB2","s1324_S_LS_02_ASEReadCounter.table","NW_015090842.1:10305451",3,6,3
"SNTB2","s1324_S_LS_02_ASEReadCounter.table","NW_015090842.1:10305547",4,8,4
"SNTB2","s1324_S_LS_02_ASEReadCounter.table","NW_015090842.1:10305847",1,4,3
"SNTB2","s1324_S_LS_02_ASEReadCounter.table","NW_015090842.1:10305911",7,8,1
"SNTB2","s1324_S_LS_02_ASEReadCounter.table","NW_015090842.1:10306173",4,7,3
"SNTB2","s1324_S_LS_02_ASEReadCounter.table","NW_015090842.1:10306275",5,10,5
"SNTB2","s1324_S_LS_02_ASEReadCounter.table","NW_015090842.1:10306457",7,12,5
"SNTB2","s1324_S_LS_02_ASEReadCounter.table","NW_015090842.1:10306496",4,9,5
"SNTB2","s1324_S_LS_02_ASEReadCounter.table","NW_015090842.1:10306499",4,8,4
"VPS4A","s1324_S_LS_02_ASEReadCounter.table","NW_015090842.1:10308566",74,170,96
"VPS4A","s1324_S_LS_02_ASEReadCounter.table","NW_015090842.1:10308573",79,175,96
"VPS4A","s1324_S_LS_02_ASEReadCounter.table","NW_015090842.1:10308856",106,238,132
"VPS4A","s1324_S_LS_02_ASEReadCounter.table","NW_015090842.1:10309056",134,274,140
"VPS4A","s1324_S_LS_02_ASEReadCounter.table","NW_015090842.1:10309089",154,308,154
"VPS4A","s1324_S_LS_02_ASEReadCounter.table","NW_015090842.1:10309392",169,303,134
"VPS4A","s1324_S_LS_02_ASEReadCounter.table","NW_015090842.1:10309413",175,318,143
"VPS4A","s1324_S_LS_02_ASEReadCounter.table","NW_015090842.1:10309467",174,366,192
"VPS4A","s1324_S_LS_02_ASEReadCounter.table","NW_015090842.1:10310230",195,414,219
"VPS4A","s1324_S_LS_02_ASEReadCounter.table","NW_015090842.1:10310425",198,397,199
"VPS4A","s1324_S_LS_02_ASEReadCounter.table","NW_015090842.1:10310639",210,413,203
"VPS4A","s1324_S_LS_02_ASEReadCounter.table","NW_015090842.1:10310640",408,408,0
"VPS4A","s1324_S_LS_02_ASEReadCounter.table","NW_015090842.1:10310687",250,487,237
"VPS4A","s1324_S_LS_02_ASEReadCounter.table","NW_015090842.1:10310734",202,403,201
"VPS4A","s1324_S_LS_02_ASEReadCounter.table","NW_015090842.1:10310737",198,402,204
"VPS4A","s1324_S_LS_02_ASEReadCounter.table","NW_015090842.1:10310746",193,402,209
"VPS4A","s1324_S_LS_02_ASEReadCounter.table","NW_015090842.1:10310767",188,391,203
"VPS4A","s1324_S_LS_02_ASEReadCounter.table","NW_015090842.1:10310995",195,411,216
"VPS4A","s1324_S_LS_02_ASEReadCounter.table","NW_015090842.1:10311004",193,391,198
"VPS4A","s1324_S_LS_02_ASEReadCounter.table","NW_015090842.1:10311007",199,409,210
"VPS4A","s1324_S_LS_02_ASEReadCounter.table","NW_015090842.1:10311013",212,418,206
"VPS4A","s1324_S_LS_02_ASEReadCounter.table","NW_015090842.1:10311022",196,392,196
"VPS4A","s1324_S_LS_02_ASEReadCounter.table","NW_015090842.1:10311023",197,394,197
"VPS4A","s1324_S_LS_02_ASEReadCounter.table","NW_015090842.1:10311426",208,453,245
"VPS4A","s1324_S_LS_02_ASEReadCounter.table","NW_015090842.1:10311489",0,13,13
"VPS4A","s1324_S_LS_02_ASEReadCounter.table","NW_015090842.1:10311490",2,8,6
"VPS4A","s1324_S_LS_02_ASEReadCounter.table","NW_015090842.1:10311525",12,23,11
"VPS4A","s1324_S_LS_02_ASEReadCounter.table","NW_015090842.1:10311529",14,30,16
"VPS4A","s1324_S_LS_02_ASEReadCounter.table","NW_015090842.1:10311530",14,32,18
"VPS4A","s1324_S_LS_02_ASEReadCounter.table","NW_015090842.1:10311552",40,67,27
"VPS4A","s1324_S_LS_02_ASEReadCounter.table","NW_015090842.1:10311689",45,76,31
"VPS4A","s1324_S_LS_02_ASEReadCounter.table","NW_015090842.1:10311700",65,98,33
"VPS4A","s1324_S_LS_02_ASEReadCounter.table","NW_015090842.1:10311701",64,96,32
"VPS4A","s1324_S_LS_02_ASEReadCounter.table","NW_015090842.1:10311703",63,94,31
"COG8","s1324_S_LS_02_ASEReadCounter.table","NW_015090842.1:10313487",26,49,23
"COG8","s1324_S_LS_02_ASEReadCounter.table","NW_015090842.1:10313559",31,62,31
"COG8","s1324_S_LS_02_ASEReadCounter.table","NW_015090842.1:10313579",27,57,30
"COG8","s1324_S_LS_02_ASEReadCounter.table","NW_015090842.1:10313665",29,57,28
"COG8","s1324_S_LS_02_ASEReadCounter.table","NW_015090842.1:10313681",33,62,29
"COG8","s1324_S_LS_02_ASEReadCounter.table","NW_015090842.1:10313768",42,74,32
"COG8","s1324_S_LS_02_ASEReadCounter.table","NW_015090842.1:10313775",43,76,33
"COG8","s1324_S_LS_02_ASEReadCounter.table","NW_015090842.1:10313811",36,59,23
"COG8","s1324_S_LS_02_ASEReadCounter.table","NW_015090842.1:10313858",26,44,18
"COG8","s1324_S_LS_02_ASEReadCounter.table","NW_015090842.1:10313859",43,43,0
"COG8","s1324_S_LS_02_ASEReadCounter.table","NW_015090842.1:10314100",40,60,20
"COG8","s1324_S_LS_02_ASEReadCounter.table","NW_015090842.1:10314213",49,81,32
"COG8","s1324_S_LS_02_ASEReadCounter.table","NW_015090842.1:10315093",37,62,25
"COG8","s1324_S_LS_02_ASEReadCounter.table","NW_015090842.1:10315162",23,45,22
"COG8","s1324_S_LS_02_ASEReadCounter.table","NW_015090842.1:10315285",34,65,31
"COG8","s1324_S_LS_02_ASEReadCounter.table","NW_015090842.1:10315360",23,54,31
"COG8","s1324_S_LS_02_ASEReadCounter.table","NW_015090842.1:10315369",24,58,34
"COG8","s1324_S_LS_02_ASEReadCounter.table","NW_015090842.1:10315508",13,33,20
"COG8","s1324_S_LS_02_ASEReadCounter.table","NW_015090842.1:10315624",22,52,30
"COG8","s1324_S_LS_02_ASEReadCounter.table","NW_015090842.1:10315693",16,37,21
"COG8","s1324_S_LS_02_ASEReadCounter.table","NW_015090842.1:10315698",18,40,22
"COG8","s1324_S_LS_02_ASEReadCounter.table","NW_015090842.1:10315768",13,32,19
"COG8","s1324_S_LS_02_ASEReadCounter.table","NW_015090842.1:10315769",13,32,19
"COG8","s1324_S_LS_02_ASEReadCounter.table","NW_015090842.1:10315784",15,36,21
"COG8","s1324_S_LS_02_ASEReadCounter.table","NW_015090842.1:10316093",15,31,16
"COG8","s1324_S_LS_02_ASEReadCounter.table","NW_015090842.1:10316133",14,34,20
"NIP7","s1324_S_LS_02_ASEReadCounter.table","NW_015090842.1:10316759",17,37,20
"NIP7","s1324_S_LS_02_ASEReadCounter.table","NW_015090842.1:10316967",115,239,124
"NIP7","s1324_S_LS_02_ASEReadCounter.table","NW_015090842.1:10316995",143,284,141
"NIP7","s1324_S_LS_02_ASEReadCounter.table","NW_015090842.1:10317240",205,407,202
"NIP7","s1324_S_LS_02_ASEReadCounter.table","NW_015090842.1:10317247",201,402,201
"NIP7","s1324_S_LS_02_ASEReadCounter.table","NW_015090842.1:10317264",208,394,186
"NIP7","s1324_S_LS_02_ASEReadCounter.table","NW_015090842.1:10317433",207,439,232
"NIP7","s1324_S_LS_02_ASEReadCounter.table","NW_015090842.1:10317738",173,383,210
"NIP7","s1324_S_LS_02_ASEReadCounter.table","NW_015090842.1:10317769",182,399,217
"NIP7","s1324_S_LS_02_ASEReadCounter.table","NW_015090842.1:10317808",118,274,156
"NIP7","s1324_S_LS_02_ASEReadCounter.table","NW_015090842.1:10317870",70,179,109
"NIP7","s1324_S_LS_02_ASEReadCounter.table","NW_015090842.1:10317871",70,175,105
"NIP7","s1324_S_LS_02_ASEReadCounter.table","NW_015090842.1:10317898",42,112,70
"NIP7","s1324_S_LS_02_ASEReadCounter.table","NW_015090842.1:10317911",41,102,61
"TMED6","s1324_S_LS_02_ASEReadCounter.table","NW_015090842.1:10318514",1,1,0
"TERF2","s1324_S_LS_02_ASEReadCounter.table","NW_015090842.1:10321768",26,72,46
"TERF2","s1324_S_LS_02_ASEReadCounter.table","NW_015090842.1:10321777",25,71,46
"TERF2","s1324_S_LS_02_ASEReadCounter.table","NW_015090842.1:10321805",24,72,48
"TERF2","s1324_S_LS_02_ASEReadCounter.table","NW_015090842.1:10321878",48,102,54
"TERF2","s1324_S_LS_02_ASEReadCounter.table","NW_015090842.1:10321893",41,96,55
"TERF2","s1324_S_LS_02_ASEReadCounter.table","NW_015090842.1:10321897",40,88,48
"TERF2","s1324_S_LS_02_ASEReadCounter.table","NW_015090842.1:10321908",35,77,42
"TERF2","s1324_S_LS_02_ASEReadCounter.table","NW_015090842.1:10322001",59,122,63
"TERF2","s1324_S_LS_02_ASEReadCounter.table","NW_015090842.1:10322035",44,97,53
"TERF2","s1324_S_LS_02_ASEReadCounter.table","NW_015090842.1:10322051",43,101,58
"TERF2","s1324_S_LS_02_ASEReadCounter.table","NW_015090842.1:10322137",39,81,42
"TERF2","s1324_S_LS_02_ASEReadCounter.table","NW_015090842.1:10322144",46,86,40
"TERF2","s1324_S_LS_02_ASEReadCounter.table","NW_015090842.1:10322388",23,86,63
"TERF2","s1324_S_LS_02_ASEReadCounter.table","NW_015090842.1:10322396",24,81,57
"TERF2","s1324_S_LS_02_ASEReadCounter.table","NW_015090842.1:10322502",52,120,68
"TERF2","s1324_S_LS_02_ASEReadCounter.table","NW_015090842.1:10322504",52,122,70
"TERF2","s1324_S_LS_02_ASEReadCounter.table","NW_015090842.1:10322510",48,123,75
"TERF2","s1324_S_LS_02_ASEReadCounter.table","NW_015090842.1:10323580",44,104,60
"TERF2","s1324_S_LS_02_ASEReadCounter.table","NW_015090842.1:10324314",32,92,60
"TERF2","s1324_S_LS_02_ASEReadCounter.table","NW_015090842.1:10326832",26,72,46
"TERF2","s1324_S_LS_02_ASEReadCounter.table","NW_015090842.1:10327787",27,45,18
"TERF2","s1324_S_LS_02_ASEReadCounter.table","NW_015090842.1:10328588",20,51,31
"TERF2","s1324_S_LS_02_ASEReadCounter.table","NW_015090842.1:10328644",18,41,23
"TERF2","s1324_S_LS_02_ASEReadCounter.table","NW_015090842.1:10329813",9,25,16
"TERF2","s1324_S_LS_02_ASEReadCounter.table","NW_015090842.1:10330749",11,31,20
"TERF2","s1324_S_LS_02_ASEReadCounter.table","NW_015090842.1:10330789",10,31,21
"CYB5B","s1324_S_LS_02_ASEReadCounter.table","NW_015090842.1:10336595",1,7,6
"CYB5B","s1324_S_LS_02_ASEReadCounter.table","NW_015090842.1:10336667",39,94,55
"CYB5B","s1324_S_LS_02_ASEReadCounter.table","NW_015090842.1:10336689",59,129,70
"CYB5B","s1324_S_LS_02_ASEReadCounter.table","NW_015090842.1:10336728",81,185,104
"CYB5B","s1324_S_LS_02_ASEReadCounter.table","NW_015090842.1:10345068",83,182,99
"CYB5B","s1324_S_LS_02_ASEReadCounter.table","NW_015090842.1:10348800",129,260,131
"CYB5B","s1324_S_LS_02_ASEReadCounter.table","NW_015090842.1:10349046",110,260,150
"CYB5B","s1324_S_LS_02_ASEReadCounter.table","NW_015090842.1:10349119",68,202,134
"CYB5B","s1324_S_LS_02_ASEReadCounter.table","NW_015090842.1:10349146",36,172,136
"CYB5B","s1324_S_LS_02_ASEReadCounter.table","NW_015090842.1:10349157",63,196,133
"CYB5B","s1324_S_LS_02_ASEReadCounter.table","NW_015090842.1:10349263",221,221,0
