"gene","id","snp","ref_count","total_count","alt_count"
"CENPN","s1633_S_PIT_01_ASEReadCounter.table","NW_015090842.1:5801612",0,2,2
"CENPN","s1633_S_PIT_01_ASEReadCounter.table","NW_015090842.1:5801618",0,3,3
"CENPN","s1633_S_PIT_01_ASEReadCounter.table","NW_015090842.1:5801623",0,3,3
"CENPN","s1633_S_PIT_01_ASEReadCounter.table","NW_015090842.1:5801631",0,3,3
"CENPN","s1633_S_PIT_01_ASEReadCounter.table","NW_015090842.1:5801632",0,2,2
"CENPN","s1633_S_PIT_01_ASEReadCounter.table","NW_015090842.1:5801655",2,6,4
"CENPN","s1633_S_PIT_01_ASEReadCounter.table","NW_015090842.1:5801670",2,5,3
"CENPN","s1633_S_PIT_01_ASEReadCounter.table","NW_015090842.1:5801674",2,6,4
"CENPN","s1633_S_PIT_01_ASEReadCounter.table","NW_015090842.1:5801692",3,6,3
"CENPN","s1633_S_PIT_01_ASEReadCounter.table","NW_015090842.1:5802008",7,11,4
"CENPN","s1633_S_PIT_01_ASEReadCounter.table","NW_015090842.1:5802012",7,10,3
"CENPN","s1633_S_PIT_01_ASEReadCounter.table","NW_015090842.1:5802087",6,10,4
"CENPN","s1633_S_PIT_01_ASEReadCounter.table","NW_015090842.1:5810113",2,2,0
"CENPN","s1633_S_PIT_01_ASEReadCounter.table","NW_015090842.1:5810147",3,3,0
"CENPN","s1633_S_PIT_01_ASEReadCounter.table","NW_015090842.1:5810148",3,3,0
"ATMIN","s1633_S_PIT_01_ASEReadCounter.table","NW_015090842.1:5818789",14,18,4
"ATMIN","s1633_S_PIT_01_ASEReadCounter.table","NW_015090842.1:5819958",13,30,17
"ATMIN","s1633_S_PIT_01_ASEReadCounter.table","NW_015090842.1:5820004",10,29,19
"ATMIN","s1633_S_PIT_01_ASEReadCounter.table","NW_015090842.1:5820217",15,26,11
"ATMIN","s1633_S_PIT_01_ASEReadCounter.table","NW_015090842.1:5820250",17,31,14
"ATMIN","s1633_S_PIT_01_ASEReadCounter.table","NW_015090842.1:5820298",15,27,12
"ATMIN","s1633_S_PIT_01_ASEReadCounter.table","NW_015090842.1:5820417",11,16,5
"ATMIN","s1633_S_PIT_01_ASEReadCounter.table","NW_015090842.1:5820421",11,16,5
"ATMIN","s1633_S_PIT_01_ASEReadCounter.table","NW_015090842.1:5820448",10,18,8
"ATMIN","s1633_S_PIT_01_ASEReadCounter.table","NW_015090842.1:5820457",9,17,8
"ATMIN","s1633_S_PIT_01_ASEReadCounter.table","NW_015090842.1:5820510",9,22,13
"ATMIN","s1633_S_PIT_01_ASEReadCounter.table","NW_015090842.1:5820673",10,20,10
"ATMIN","s1633_S_PIT_01_ASEReadCounter.table","NW_015090842.1:5820754",10,18,8
"ATMIN","s1633_S_PIT_01_ASEReadCounter.table","NW_015090842.1:5820820",12,24,12
"ATMIN","s1633_S_PIT_01_ASEReadCounter.table","NW_015090842.1:5820865",9,25,16
"ATMIN","s1633_S_PIT_01_ASEReadCounter.table","NW_015090842.1:5820889",5,21,16
"ATMIN","s1633_S_PIT_01_ASEReadCounter.table","NW_015090842.1:5820891",6,22,16
"ATMIN","s1633_S_PIT_01_ASEReadCounter.table","NW_015090842.1:5820997",10,24,14
"ATMIN","s1633_S_PIT_01_ASEReadCounter.table","NW_015090842.1:5821063",13,20,7
"ATMIN","s1633_S_PIT_01_ASEReadCounter.table","NW_015090842.1:5821132",12,20,8
"ATMIN","s1633_S_PIT_01_ASEReadCounter.table","NW_015090842.1:5821645",11,20,9
"ATMIN","s1633_S_PIT_01_ASEReadCounter.table","NW_015090842.1:5825066",10,25,15
"ATMIN","s1633_S_PIT_01_ASEReadCounter.table","NW_015090842.1:5825106",9,20,11
"ATMIN","s1633_S_PIT_01_ASEReadCounter.table","NW_015090842.1:5825122",8,17,9
"ATMIN","s1633_S_PIT_01_ASEReadCounter.table","NW_015090842.1:5825178",12,27,15
"ATMIN","s1633_S_PIT_01_ASEReadCounter.table","NW_015090842.1:5825194",13,27,14
"ATMIN","s1633_S_PIT_01_ASEReadCounter.table","NW_015090842.1:5825195",12,28,16
"ATMIN","s1633_S_PIT_01_ASEReadCounter.table","NW_015090842.1:5825220",15,34,19
"ATMIN","s1633_S_PIT_01_ASEReadCounter.table","NW_015090842.1:5825240",15,33,18
"ATMIN","s1633_S_PIT_01_ASEReadCounter.table","NW_015090842.1:5825303",17,39,22
"ATMIN","s1633_S_PIT_01_ASEReadCounter.table","NW_015090842.1:5825304",18,39,21
"ATMIN","s1633_S_PIT_01_ASEReadCounter.table","NW_015090842.1:5825310",17,38,21
"ATMIN","s1633_S_PIT_01_ASEReadCounter.table","NW_015090842.1:5825406",17,37,20
"ATMIN","s1633_S_PIT_01_ASEReadCounter.table","NW_015090842.1:5825415",16,33,17
"ATMIN","s1633_S_PIT_01_ASEReadCounter.table","NW_015090842.1:5825438",14,35,21
"ATMIN","s1633_S_PIT_01_ASEReadCounter.table","NW_015090842.1:5825485",11,31,20
"ATMIN","s1633_S_PIT_01_ASEReadCounter.table","NW_015090842.1:5825524",9,25,16
"ATMIN","s1633_S_PIT_01_ASEReadCounter.table","NW_015090842.1:5825557",9,26,17
"ATMIN","s1633_S_PIT_01_ASEReadCounter.table","NW_015090842.1:5825571",10,28,18
"ATMIN","s1633_S_PIT_01_ASEReadCounter.table","NW_015090842.1:5825579",10,24,14
"ATMIN","s1633_S_PIT_01_ASEReadCounter.table","NW_015090842.1:5825590",10,22,12
"ATMIN","s1633_S_PIT_01_ASEReadCounter.table","NW_015090842.1:5825689",18,38,20
"ATMIN","s1633_S_PIT_01_ASEReadCounter.table","NW_015090842.1:5825703",23,43,20
"ATMIN","s1633_S_PIT_01_ASEReadCounter.table","NW_015090842.1:5825787",19,34,15
"ATMIN","s1633_S_PIT_01_ASEReadCounter.table","NW_015090842.1:5825833",18,40,22
"ATMIN","s1633_S_PIT_01_ASEReadCounter.table","NW_015090842.1:5825841",12,31,19
"ATMIN","s1633_S_PIT_01_ASEReadCounter.table","NW_015090842.1:5825895",15,33,18
"ATMIN","s1633_S_PIT_01_ASEReadCounter.table","NW_015090842.1:5825984",10,33,23
"ATMIN","s1633_S_PIT_01_ASEReadCounter.table","NW_015090842.1:5826162",25,42,17
"ATMIN","s1633_S_PIT_01_ASEReadCounter.table","NW_015090842.1:5826194",29,50,21
"ATMIN","s1633_S_PIT_01_ASEReadCounter.table","NW_015090842.1:5826235",27,41,14
"ATMIN","s1633_S_PIT_01_ASEReadCounter.table","NW_015090842.1:5826245",26,39,13
"ATMIN","s1633_S_PIT_01_ASEReadCounter.table","NW_015090842.1:5826335",8,24,16
"ATMIN","s1633_S_PIT_01_ASEReadCounter.table","NW_015090842.1:5826417",18,31,13
"ATMIN","s1633_S_PIT_01_ASEReadCounter.table","NW_015090842.1:5826431",14,33,19
"ATMIN","s1633_S_PIT_01_ASEReadCounter.table","NW_015090842.1:5826438",16,31,15
"ATMIN","s1633_S_PIT_01_ASEReadCounter.table","NW_015090842.1:5826463",19,42,23
"ATMIN","s1633_S_PIT_01_ASEReadCounter.table","NW_015090842.1:5826502",22,47,25
"ATMIN","s1633_S_PIT_01_ASEReadCounter.table","NW_015090842.1:5826511",23,51,28
"ATMIN","s1633_S_PIT_01_ASEReadCounter.table","NW_015090842.1:5826659",16,34,18
"ATMIN","s1633_S_PIT_01_ASEReadCounter.table","NW_015090842.1:5826701",18,35,17
"ATMIN","s1633_S_PIT_01_ASEReadCounter.table","NW_015090842.1:5826702",18,36,18
"ATMIN","s1633_S_PIT_01_ASEReadCounter.table","NW_015090842.1:5826732",21,39,18
"ATMIN","s1633_S_PIT_01_ASEReadCounter.table","NW_015090842.1:5826745",15,34,19
"ATMIN","s1633_S_PIT_01_ASEReadCounter.table","NW_015090842.1:5826835",22,36,14
"ATMIN","s1633_S_PIT_01_ASEReadCounter.table","NW_015090842.1:5826910",19,32,13
"ATMIN","s1633_S_PIT_01_ASEReadCounter.table","NW_015090842.1:5826942",11,25,14
"ATMIN","s1633_S_PIT_01_ASEReadCounter.table","NW_015090842.1:5827193",22,39,17
"ATMIN","s1633_S_PIT_01_ASEReadCounter.table","NW_015090842.1:5827196",22,39,17
"ATMIN","s1633_S_PIT_01_ASEReadCounter.table","NW_015090842.1:5827269",15,29,14
"ATMIN","s1633_S_PIT_01_ASEReadCounter.table","NW_015090842.1:5827315",9,20,11
"ATMIN","s1633_S_PIT_01_ASEReadCounter.table","NW_015090842.1:5827316",9,21,12
"ATMIN","s1633_S_PIT_01_ASEReadCounter.table","NW_015090842.1:5827333",8,20,12
"PPP1R3E","s1633_S_PIT_01_ASEReadCounter.table","NW_015090842.1:5837733",14,25,11
"PPP1R3E","s1633_S_PIT_01_ASEReadCounter.table","NW_015090842.1:5837947",5,9,4
"PKD1L2","s1633_S_PIT_01_ASEReadCounter.table","NW_015090842.1:5867509",0,1,1
"PKD1L2","s1633_S_PIT_01_ASEReadCounter.table","NW_015090842.1:5867597",0,1,1
"PKD1L2","s1633_S_PIT_01_ASEReadCounter.table","NW_015090842.1:5867600",0,1,1
"PKD1L2","s1633_S_PIT_01_ASEReadCounter.table","NW_015090842.1:5867660",0,1,1
"PKD1L2","s1633_S_PIT_01_ASEReadCounter.table","NW_015090842.1:5867675",0,1,1
"PKD1L2","s1633_S_PIT_01_ASEReadCounter.table","NW_015090842.1:5867788",1,1,0
"BCO1","s1633_S_PIT_01_ASEReadCounter.table","NW_015090842.1:5915610",1,2,1
"BCO1","s1633_S_PIT_01_ASEReadCounter.table","NW_015090842.1:5915646",1,1,0
"BCO1","s1633_S_PIT_01_ASEReadCounter.table","NW_015090842.1:5917836",2,4,2
"BCO1","s1633_S_PIT_01_ASEReadCounter.table","NW_015090842.1:5917912",18,26,8
"BCO1","s1633_S_PIT_01_ASEReadCounter.table","NW_015090842.1:5917941",19,29,10
"BCO1","s1633_S_PIT_01_ASEReadCounter.table","NW_015090842.1:5917971",22,32,10
"BCO1","s1633_S_PIT_01_ASEReadCounter.table","NW_015090842.1:5921679",23,35,12
"BCO1","s1633_S_PIT_01_ASEReadCounter.table","NW_015090842.1:5921726",25,39,14
"BCO1","s1633_S_PIT_01_ASEReadCounter.table","NW_015090842.1:5925669",16,21,5
"BCO1","s1633_S_PIT_01_ASEReadCounter.table","NW_015090842.1:5925753",18,23,5
"BCO1","s1633_S_PIT_01_ASEReadCounter.table","NW_015090842.1:5926937",17,20,3
"BCO1","s1633_S_PIT_01_ASEReadCounter.table","NW_015090842.1:5927921",16,22,6
"BCO1","s1633_S_PIT_01_ASEReadCounter.table","NW_015090842.1:5927948",17,23,6
"BCO1","s1633_S_PIT_01_ASEReadCounter.table","NW_015090842.1:5927968",13,18,5
"BCO1","s1633_S_PIT_01_ASEReadCounter.table","NW_015090842.1:5928052",15,19,4
"BCO1","s1633_S_PIT_01_ASEReadCounter.table","NW_015090842.1:5932726",19,33,14
"BCO1","s1633_S_PIT_01_ASEReadCounter.table","NW_015090842.1:5932801",16,24,8
"BCO1","s1633_S_PIT_01_ASEReadCounter.table","NW_015090842.1:5934558",15,26,11
"BCO1","s1633_S_PIT_01_ASEReadCounter.table","NW_015090842.1:5934575",13,27,14
"BCO1","s1633_S_PIT_01_ASEReadCounter.table","NW_015090842.1:5934608",16,31,15
"BCO1","s1633_S_PIT_01_ASEReadCounter.table","NW_015090842.1:5934647",21,35,14
"BCO1","s1633_S_PIT_01_ASEReadCounter.table","NW_015090842.1:5934725",15,21,6
"BCO1","s1633_S_PIT_01_ASEReadCounter.table","NW_015090842.1:5934726",15,23,8
"BCO1","s1633_S_PIT_01_ASEReadCounter.table","NW_015090842.1:5934733",12,18,6
"BCO1","s1633_S_PIT_01_ASEReadCounter.table","NW_015090842.1:5934821",11,15,4
"BCO1","s1633_S_PIT_01_ASEReadCounter.table","NW_015090842.1:5934826",11,14,3
"BCO1","s1633_S_PIT_01_ASEReadCounter.table","NW_015090842.1:5934844",9,9,0
"BCO1","s1633_S_PIT_01_ASEReadCounter.table","NW_015090842.1:5934958",12,15,3
"BCO1","s1633_S_PIT_01_ASEReadCounter.table","NW_015090842.1:5934976",12,16,4
"GAN","s1633_S_PIT_01_ASEReadCounter.table","NW_015090842.1:5953759",5,10,5
"GAN","s1633_S_PIT_01_ASEReadCounter.table","NW_015090842.1:5957502",5,11,6
"GAN","s1633_S_PIT_01_ASEReadCounter.table","NW_015090842.1:5957578",10,14,4
"GAN","s1633_S_PIT_01_ASEReadCounter.table","NW_015090842.1:5965028",3,3,0
"GAN","s1633_S_PIT_01_ASEReadCounter.table","NW_015090842.1:5966047",4,5,1
"GAN","s1633_S_PIT_01_ASEReadCounter.table","NW_015090842.1:5966126",6,11,5
"GAN","s1633_S_PIT_01_ASEReadCounter.table","NW_015090842.1:5966127",6,11,5
"GAN","s1633_S_PIT_01_ASEReadCounter.table","NW_015090842.1:5966162",7,13,6
"GAN","s1633_S_PIT_01_ASEReadCounter.table","NW_015090842.1:5966483",4,6,2
"CMIP","s1633_S_PIT_01_ASEReadCounter.table","NW_015090842.1:6109159",25,39,14
"CMIP","s1633_S_PIT_01_ASEReadCounter.table","NW_015090842.1:6109166",24,39,15
"CMIP","s1633_S_PIT_01_ASEReadCounter.table","NW_015090842.1:6114641",31,56,25
"CMIP","s1633_S_PIT_01_ASEReadCounter.table","NW_015090842.1:6114751",16,37,21
"CMIP","s1633_S_PIT_01_ASEReadCounter.table","NW_015090842.1:6114824",22,42,20
"CMIP","s1633_S_PIT_01_ASEReadCounter.table","NW_015090842.1:6128998",35,55,20
"CMIP","s1633_S_PIT_01_ASEReadCounter.table","NW_015090842.1:6130562",49,93,44
"CMIP","s1633_S_PIT_01_ASEReadCounter.table","NW_015090842.1:6132522",33,67,34
"CMIP","s1633_S_PIT_01_ASEReadCounter.table","NW_015090842.1:6134088",28,70,42
"CMIP","s1633_S_PIT_01_ASEReadCounter.table","NW_015090842.1:6138265",28,78,50
"CMIP","s1633_S_PIT_01_ASEReadCounter.table","NW_015090842.1:6138300",28,74,46
"CMIP","s1633_S_PIT_01_ASEReadCounter.table","NW_015090842.1:6138342",27,67,40
"CMIP","s1633_S_PIT_01_ASEReadCounter.table","NW_015090842.1:6138343",25,64,39
"CMIP","s1633_S_PIT_01_ASEReadCounter.table","NW_015090842.1:6138345",27,73,46
"CMIP","s1633_S_PIT_01_ASEReadCounter.table","NW_015090842.1:6138647",27,59,32
"CMIP","s1633_S_PIT_01_ASEReadCounter.table","NW_015090842.1:6138745",43,82,39
"CMIP","s1633_S_PIT_01_ASEReadCounter.table","NW_015090842.1:6138832",8,37,29
"CMIP","s1633_S_PIT_01_ASEReadCounter.table","NW_015090842.1:6138967",30,71,41
"CMIP","s1633_S_PIT_01_ASEReadCounter.table","NW_015090842.1:6139131",22,45,23
"CMIP","s1633_S_PIT_01_ASEReadCounter.table","NW_015090842.1:6139163",7,31,24
"CMIP","s1633_S_PIT_01_ASEReadCounter.table","NW_015090842.1:6139360",12,22,10
"CMIP","s1633_S_PIT_01_ASEReadCounter.table","NW_015090842.1:6139572",4,10,6
"CMIP","s1633_S_PIT_01_ASEReadCounter.table","NW_015090842.1:6139773",27,27,0
"PLCG2","s1633_S_PIT_01_ASEReadCounter.table","NW_015090842.1:6179613",3,6,3
"PLCG2","s1633_S_PIT_01_ASEReadCounter.table","NW_015090842.1:6179658",9,17,8
"PLCG2","s1633_S_PIT_01_ASEReadCounter.table","NW_015090842.1:6203766",16,36,20
"PLCG2","s1633_S_PIT_01_ASEReadCounter.table","NW_015090842.1:6203775",17,36,19
"PLCG2","s1633_S_PIT_01_ASEReadCounter.table","NW_015090842.1:6203787",15,33,18
"PLCG2","s1633_S_PIT_01_ASEReadCounter.table","NW_015090842.1:6205047",12,30,18
"PLCG2","s1633_S_PIT_01_ASEReadCounter.table","NW_015090842.1:6208541",17,33,16
"PLCG2","s1633_S_PIT_01_ASEReadCounter.table","NW_015090842.1:6209741",11,24,13
"PLCG2","s1633_S_PIT_01_ASEReadCounter.table","NW_015090842.1:6209798",12,26,14
"PLCG2","s1633_S_PIT_01_ASEReadCounter.table","NW_015090842.1:6209816",13,28,15
"PLCG2","s1633_S_PIT_01_ASEReadCounter.table","NW_015090842.1:6217547",23,51,28
"PLCG2","s1633_S_PIT_01_ASEReadCounter.table","NW_015090842.1:6218641",7,31,24
"PLCG2","s1633_S_PIT_01_ASEReadCounter.table","NW_015090842.1:6220552",10,30,20
"PLCG2","s1633_S_PIT_01_ASEReadCounter.table","NW_015090842.1:6221969",19,39,20
"PLCG2","s1633_S_PIT_01_ASEReadCounter.table","NW_015090842.1:6228672",13,36,23
"PLCG2","s1633_S_PIT_01_ASEReadCounter.table","NW_015090842.1:6228694",17,36,19
"PLCG2","s1633_S_PIT_01_ASEReadCounter.table","NW_015090842.1:6228722",19,38,19
"PLCG2","s1633_S_PIT_01_ASEReadCounter.table","NW_015090842.1:6228747",13,37,24
"PLCG2","s1633_S_PIT_01_ASEReadCounter.table","NW_015090842.1:6228835",19,49,30
"PLCG2","s1633_S_PIT_01_ASEReadCounter.table","NW_015090842.1:6228841",17,48,31
"PLCG2","s1633_S_PIT_01_ASEReadCounter.table","NW_015090842.1:6228865",17,50,33
"PLCG2","s1633_S_PIT_01_ASEReadCounter.table","NW_015090842.1:6228917",19,54,35
"PLCG2","s1633_S_PIT_01_ASEReadCounter.table","NW_015090842.1:6228926",19,54,35
"PLCG2","s1633_S_PIT_01_ASEReadCounter.table","NW_015090842.1:6228954",17,45,28
"PLCG2","s1633_S_PIT_01_ASEReadCounter.table","NW_015090842.1:6229002",11,41,30
"PLCG2","s1633_S_PIT_01_ASEReadCounter.table","NW_015090842.1:6229006",10,40,30
"PLCG2","s1633_S_PIT_01_ASEReadCounter.table","NW_015090842.1:6229081",11,26,15
"PLCG2","s1633_S_PIT_01_ASEReadCounter.table","NW_015090842.1:6229097",8,20,12
"PLCG2","s1633_S_PIT_01_ASEReadCounter.table","NW_015090842.1:6229160",9,22,13
"PLCG2","s1633_S_PIT_01_ASEReadCounter.table","NW_015090842.1:6229213",11,24,13
"PLCG2","s1633_S_PIT_01_ASEReadCounter.table","NW_015090842.1:6229231",15,32,17
"PLCG2","s1633_S_PIT_01_ASEReadCounter.table","NW_015090842.1:6229663",13,16,3
"PLCG2","s1633_S_PIT_01_ASEReadCounter.table","NW_015090842.1:6229748",19,22,3
"PLCG2","s1633_S_PIT_01_ASEReadCounter.table","NW_015090842.1:6229892",10,17,7
"PLCG2","s1633_S_PIT_01_ASEReadCounter.table","NW_015090842.1:6230248",15,25,10
"PLCG2","s1633_S_PIT_01_ASEReadCounter.table","NW_015090842.1:6230255",13,25,12
"PLCG2","s1633_S_PIT_01_ASEReadCounter.table","NW_015090842.1:6230296",6,14,8
"PLCG2","s1633_S_PIT_01_ASEReadCounter.table","NW_015090842.1:6230349",16,30,14
"PLCG2","s1633_S_PIT_01_ASEReadCounter.table","NW_015090842.1:6230381",20,33,13
"PLCG2","s1633_S_PIT_01_ASEReadCounter.table","NW_015090842.1:6230408",20,38,18
"PLCG2","s1633_S_PIT_01_ASEReadCounter.table","NW_015090842.1:6230439",20,39,19
"PLCG2","s1633_S_PIT_01_ASEReadCounter.table","NW_015090842.1:6230757",3,13,10
"PLCG2","s1633_S_PIT_01_ASEReadCounter.table","NW_015090842.1:6230758",3,11,8
"PLCG2","s1633_S_PIT_01_ASEReadCounter.table","NW_015090842.1:6230898",12,22,10
"PLCG2","s1633_S_PIT_01_ASEReadCounter.table","NW_015090842.1:6230976",13,24,11
"PLCG2","s1633_S_PIT_01_ASEReadCounter.table","NW_015090842.1:6231078",10,16,6
"PLCG2","s1633_S_PIT_01_ASEReadCounter.table","NW_015090842.1:6231138",23,31,8
"PLCG2","s1633_S_PIT_01_ASEReadCounter.table","NW_015090842.1:6231177",24,32,8
"PLCG2","s1633_S_PIT_01_ASEReadCounter.table","NW_015090842.1:6231263",13,17,4
"PLCG2","s1633_S_PIT_01_ASEReadCounter.table","NW_015090842.1:6231309",7,9,2
"SDR42E1","s1633_S_PIT_01_ASEReadCounter.table","NW_015090842.1:6235292",0,6,6
"SDR42E1","s1633_S_PIT_01_ASEReadCounter.table","NW_015090842.1:6235315",0,7,7
"SDR42E1","s1633_S_PIT_01_ASEReadCounter.table","NW_015090842.1:6235348",3,11,8
"SDR42E1","s1633_S_PIT_01_ASEReadCounter.table","NW_015090842.1:6235355",3,11,8
"SDR42E1","s1633_S_PIT_01_ASEReadCounter.table","NW_015090842.1:6235417",10,18,8
"SDR42E1","s1633_S_PIT_01_ASEReadCounter.table","NW_015090842.1:6235526",25,25,0
"SDR42E1","s1633_S_PIT_01_ASEReadCounter.table","NW_015090842.1:6235558",11,22,11
"SDR42E1","s1633_S_PIT_01_ASEReadCounter.table","NW_015090842.1:6235603",19,19,0
"SDR42E1","s1633_S_PIT_01_ASEReadCounter.table","NW_015090842.1:6235741",18,33,15
"SDR42E1","s1633_S_PIT_01_ASEReadCounter.table","NW_015090842.1:6235777",16,31,15
"SDR42E1","s1633_S_PIT_01_ASEReadCounter.table","NW_015090842.1:6235806",16,41,25
"SDR42E1","s1633_S_PIT_01_ASEReadCounter.table","NW_015090842.1:6235809",16,43,27
"SDR42E1","s1633_S_PIT_01_ASEReadCounter.table","NW_015090842.1:6235816",15,40,25
"SDR42E1","s1633_S_PIT_01_ASEReadCounter.table","NW_015090842.1:6235914",18,39,21
"SDR42E1","s1633_S_PIT_01_ASEReadCounter.table","NW_015090842.1:6235935",16,39,23
"SDR42E1","s1633_S_PIT_01_ASEReadCounter.table","NW_015090842.1:6235957",17,42,25
"SDR42E1","s1633_S_PIT_01_ASEReadCounter.table","NW_015090842.1:6236040",7,30,23
"SDR42E1","s1633_S_PIT_01_ASEReadCounter.table","NW_015090842.1:6236260",15,35,20
"SDR42E1","s1633_S_PIT_01_ASEReadCounter.table","NW_015090842.1:6236281",13,29,16
"SDR42E1","s1633_S_PIT_01_ASEReadCounter.table","NW_015090842.1:6236305",15,34,19
"SDR42E1","s1633_S_PIT_01_ASEReadCounter.table","NW_015090842.1:6236458",14,33,19
"SDR42E1","s1633_S_PIT_01_ASEReadCounter.table","NW_015090842.1:6236476",16,38,22
"SDR42E1","s1633_S_PIT_01_ASEReadCounter.table","NW_015090842.1:6236608",11,25,14
"SDR42E1","s1633_S_PIT_01_ASEReadCounter.table","NW_015090842.1:6238244",10,27,17
"SDR42E1","s1633_S_PIT_01_ASEReadCounter.table","NW_015090842.1:6238829",3,12,9
"HSD17B2","s1633_S_PIT_01_ASEReadCounter.table","NW_015090842.1:6266918",0,1,1
"HSD17B2","s1633_S_PIT_01_ASEReadCounter.table","NW_015090842.1:6266944",0,1,1
"HSD17B2","s1633_S_PIT_01_ASEReadCounter.table","NW_015090842.1:6267196",0,3,3
"HSD17B2","s1633_S_PIT_01_ASEReadCounter.table","NW_015090842.1:6267273",0,2,2
"ARY2","s1633_S_PIT_01_ASEReadCounter.table","NW_015090842.1:6303922",2,3,1
"ARY2","s1633_S_PIT_01_ASEReadCounter.table","NW_015090842.1:6303954",1,3,2
"ARY2","s1633_S_PIT_01_ASEReadCounter.table","NW_015090842.1:6303979",2,4,2
"ARY2","s1633_S_PIT_01_ASEReadCounter.table","NW_015090842.1:6305848",1,2,1
"ARY2","s1633_S_PIT_01_ASEReadCounter.table","NW_015090842.1:6305856",1,2,1
"ARY2","s1633_S_PIT_01_ASEReadCounter.table","NW_015090842.1:6305857",1,2,1
"ARY2","s1633_S_PIT_01_ASEReadCounter.table","NW_015090842.1:6306017",2,5,3
"ARY2","s1633_S_PIT_01_ASEReadCounter.table","NW_015090842.1:6306052",1,5,4
"ARY2","s1633_S_PIT_01_ASEReadCounter.table","NW_015090842.1:6306094",3,7,4
"ARY2","s1633_S_PIT_01_ASEReadCounter.table","NW_015090842.1:6306100",3,7,4
"ARY2","s1633_S_PIT_01_ASEReadCounter.table","NW_015090842.1:6306146",3,5,2
"ARY2","s1633_S_PIT_01_ASEReadCounter.table","NW_015090842.1:6306147",3,5,2
"ARY2","s1633_S_PIT_01_ASEReadCounter.table","NW_015090842.1:6306390",3,4,1
"ARY2","s1633_S_PIT_01_ASEReadCounter.table","NW_015090842.1:6306567",1,1,0
"ARY2","s1633_S_PIT_01_ASEReadCounter.table","NW_015090842.1:6306705",2,3,1
"ARY2","s1633_S_PIT_01_ASEReadCounter.table","NW_015090842.1:6306713",3,3,0
"ARY2","s1633_S_PIT_01_ASEReadCounter.table","NW_015090842.1:6306773",2,2,0
"ARY2","s1633_S_PIT_01_ASEReadCounter.table","NW_015090842.1:6307039",1,2,1
"ARY2","s1633_S_PIT_01_ASEReadCounter.table","NW_015090842.1:6307043",1,2,1
"ARY2","s1633_S_PIT_01_ASEReadCounter.table","NW_015090842.1:6307093",1,1,0
"ARY2","s1633_S_PIT_01_ASEReadCounter.table","NW_015090842.1:6307138",1,3,2
"ARY2","s1633_S_PIT_01_ASEReadCounter.table","NW_015090842.1:6307157",1,3,2
"ARY2","s1633_S_PIT_01_ASEReadCounter.table","NW_015090842.1:6307187",3,5,2
"ARY2","s1633_S_PIT_01_ASEReadCounter.table","NW_015090842.1:6307278",5,6,1
"ARY2","s1633_S_PIT_01_ASEReadCounter.table","NW_015090842.1:6307305",1,1,0
"ARY2","s1633_S_PIT_01_ASEReadCounter.table","NW_015090842.1:6307318",1,2,1
"ARY2","s1633_S_PIT_01_ASEReadCounter.table","NW_015090842.1:6307487",3,3,0
"ARY2","s1633_S_PIT_01_ASEReadCounter.table","NW_015090842.1:6307670",3,5,2
"ARYL","s1633_S_PIT_01_ASEReadCounter.table","NW_015090842.1:6313360",1,2,1
"ARYL","s1633_S_PIT_01_ASEReadCounter.table","NW_015090842.1:6313377",1,2,1
"ARY1","s1633_S_PIT_01_ASEReadCounter.table","NW_015090842.1:6313909",1,1,0
"ARY1","s1633_S_PIT_01_ASEReadCounter.table","NW_015090842.1:6314296",0,2,2
"ARY1","s1633_S_PIT_01_ASEReadCounter.table","NW_015090842.1:6314541",0,1,1
"ARY1","s1633_S_PIT_01_ASEReadCounter.table","NW_015090842.1:6314597",0,1,1
"ARY1","s1633_S_PIT_01_ASEReadCounter.table","NW_015090842.1:6314750",1,2,1
"ARY1","s1633_S_PIT_01_ASEReadCounter.table","NW_015090842.1:6314794",1,1,0
"ARY1","s1633_S_PIT_01_ASEReadCounter.table","NW_015090842.1:6314827",1,2,1
"ARY1","s1633_S_PIT_01_ASEReadCounter.table","NW_015090842.1:6314843",1,2,1
"ARY1","s1633_S_PIT_01_ASEReadCounter.table","NW_015090842.1:6314859",1,2,1
"ARY1","s1633_S_PIT_01_ASEReadCounter.table","NW_015090842.1:6314886",1,2,1
"ARY1","s1633_S_PIT_01_ASEReadCounter.table","NW_015090842.1:6315022",1,1,0
"ARY1","s1633_S_PIT_01_ASEReadCounter.table","NW_015090842.1:6315026",1,1,0
"ARY1","s1633_S_PIT_01_ASEReadCounter.table","NW_015090842.1:6315043",1,1,0
"ARY1","s1633_S_PIT_01_ASEReadCounter.table","NW_015090842.1:6315065",1,1,0
"ARY1","s1633_S_PIT_01_ASEReadCounter.table","NW_015090842.1:6315409",2,2,0
"ARY1","s1633_S_PIT_01_ASEReadCounter.table","NW_015090842.1:6315479",1,1,0
"ARY1","s1633_S_PIT_01_ASEReadCounter.table","NW_015090842.1:6318342",1,4,3
"ARY1","s1633_S_PIT_01_ASEReadCounter.table","NW_015090842.1:6318427",2,4,2
"ARY1","s1633_S_PIT_01_ASEReadCounter.table","NW_015090842.1:6318603",4,5,1
"ARY1","s1633_S_PIT_01_ASEReadCounter.table","NW_015090842.1:6318708",0,1,1
"ARY1","s1633_S_PIT_01_ASEReadCounter.table","NW_015090842.1:6318858",2,3,1
"ARY1","s1633_S_PIT_01_ASEReadCounter.table","NW_015090842.1:6318952",1,1,0
"MPHOSPH6","s1633_S_PIT_01_ASEReadCounter.table","NW_015090842.1:6324063",21,54,33
"MPHOSPH6","s1633_S_PIT_01_ASEReadCounter.table","NW_015090842.1:6324174",55,123,68
"MPHOSPH6","s1633_S_PIT_01_ASEReadCounter.table","NW_015090842.1:6324270",76,149,73
"MPHOSPH6","s1633_S_PIT_01_ASEReadCounter.table","NW_015090842.1:6324762",77,149,72
"MPHOSPH6","s1633_S_PIT_01_ASEReadCounter.table","NW_015090842.1:6324772",78,144,66
"MPHOSPH6","s1633_S_PIT_01_ASEReadCounter.table","NW_015090842.1:6324780",78,144,66
"MPHOSPH6","s1633_S_PIT_01_ASEReadCounter.table","NW_015090842.1:6324902",62,152,90
"MPHOSPH6","s1633_S_PIT_01_ASEReadCounter.table","NW_015090842.1:6324910",154,154,0
"MPHOSPH6","s1633_S_PIT_01_ASEReadCounter.table","NW_015090842.1:6325066",70,168,98
"MPHOSPH6","s1633_S_PIT_01_ASEReadCounter.table","NW_015090842.1:6325089",84,201,117
"MPHOSPH6","s1633_S_PIT_01_ASEReadCounter.table","NW_015090842.1:6325298",108,270,162
"MPHOSPH6","s1633_S_PIT_01_ASEReadCounter.table","NW_015090842.1:6325877",100,219,119
"MPHOSPH6","s1633_S_PIT_01_ASEReadCounter.table","NW_015090842.1:6326976",63,159,96
"CDH13","s1633_S_PIT_01_ASEReadCounter.table","NW_015090842.1:6662283",3,3,0
"CDH13","s1633_S_PIT_01_ASEReadCounter.table","NW_015090842.1:6693697",1,1,0
"CDH13","s1633_S_PIT_01_ASEReadCounter.table","NW_015090842.1:6693712",2,2,0
"CDH13","s1633_S_PIT_01_ASEReadCounter.table","NW_015090842.1:6693723",2,2,0
"CDH13","s1633_S_PIT_01_ASEReadCounter.table","NW_015090842.1:6693738",2,2,0
"CDH13","s1633_S_PIT_01_ASEReadCounter.table","NW_015090842.1:6889713",3,3,0
"CDH13","s1633_S_PIT_01_ASEReadCounter.table","NW_015090842.1:6955167",2,2,0
"MLYCD","s1633_S_PIT_01_ASEReadCounter.table","NW_015090842.1:7150054",42,95,53
"MLYCD","s1633_S_PIT_01_ASEReadCounter.table","NW_015090842.1:7150131",61,134,73
"MLYCD","s1633_S_PIT_01_ASEReadCounter.table","NW_015090842.1:7150585",30,100,70
"MLYCD","s1633_S_PIT_01_ASEReadCounter.table","NW_015090842.1:7150686",21,83,62
"MLYCD","s1633_S_PIT_01_ASEReadCounter.table","NW_015090842.1:7150696",25,90,65
"MLYCD","s1633_S_PIT_01_ASEReadCounter.table","NW_015090842.1:7150698",87,87,0
"MLYCD","s1633_S_PIT_01_ASEReadCounter.table","NW_015090842.1:7150869",40,112,72
"MLYCD","s1633_S_PIT_01_ASEReadCounter.table","NW_015090842.1:7151100",44,119,75
"MLYCD","s1633_S_PIT_01_ASEReadCounter.table","NW_015090842.1:7151127",44,113,69
"MLYCD","s1633_S_PIT_01_ASEReadCounter.table","NW_015090842.1:7157538",46,101,55
"MLYCD","s1633_S_PIT_01_ASEReadCounter.table","NW_015090842.1:7167662",29,53,24
"MLYCD","s1633_S_PIT_01_ASEReadCounter.table","NW_015090842.1:7167675",29,54,25
"MLYCD","s1633_S_PIT_01_ASEReadCounter.table","NW_015090842.1:7167710",26,56,30
"MLYCD","s1633_S_PIT_01_ASEReadCounter.table","NW_015090842.1:7167781",16,42,26
"MLYCD","s1633_S_PIT_01_ASEReadCounter.table","NW_015090842.1:7167803",11,34,23
"MLYCD","s1633_S_PIT_01_ASEReadCounter.table","NW_015090842.1:7167812",10,33,23
"MLYCD","s1633_S_PIT_01_ASEReadCounter.table","NW_015090842.1:7167845",18,48,30
"MLYCD","s1633_S_PIT_01_ASEReadCounter.table","NW_015090842.1:7167862",19,46,27
"MLYCD","s1633_S_PIT_01_ASEReadCounter.table","NW_015090842.1:7167929",16,35,19
"MLYCD","s1633_S_PIT_01_ASEReadCounter.table","NW_015090842.1:7167995",16,36,20
"MLYCD","s1633_S_PIT_01_ASEReadCounter.table","NW_015090842.1:7168005",16,39,23
"MLYCD","s1633_S_PIT_01_ASEReadCounter.table","NW_015090842.1:7168037",16,40,24
"HSBP1","s1633_S_PIT_01_ASEReadCounter.table","NW_015090842.1:7245192",174,285,111
"HSBP1","s1633_S_PIT_01_ASEReadCounter.table","NW_015090842.1:7245226",210,356,146
"HSBP1","s1633_S_PIT_01_ASEReadCounter.table","NW_015090842.1:7245257",178,304,126
"HSBP1","s1633_S_PIT_01_ASEReadCounter.table","NW_015090842.1:7245296",164,319,155
"HSBP1","s1633_S_PIT_01_ASEReadCounter.table","NW_015090842.1:7245389",255,455,200
"HSBP1","s1633_S_PIT_01_ASEReadCounter.table","NW_015090842.1:7245400",248,433,185
"HSBP1","s1633_S_PIT_01_ASEReadCounter.table","NW_015090842.1:7245445",237,412,175
"HSBP1","s1633_S_PIT_01_ASEReadCounter.table","NW_015090842.1:7245495",219,367,148
"HSBP1","s1633_S_PIT_01_ASEReadCounter.table","NW_015090842.1:7245515",248,423,175
"HSBP1","s1633_S_PIT_01_ASEReadCounter.table","NW_015090842.1:7245733",160,303,143
"HSBP1","s1633_S_PIT_01_ASEReadCounter.table","NW_015090842.1:7245771",187,302,115
"HSBP1","s1633_S_PIT_01_ASEReadCounter.table","NW_015090842.1:7245813",198,326,128
"HSBP1","s1633_S_PIT_01_ASEReadCounter.table","NW_015090842.1:7245926",241,398,157
"HSBP1","s1633_S_PIT_01_ASEReadCounter.table","NW_015090842.1:7245927",241,394,153
"HSBP1","s1633_S_PIT_01_ASEReadCounter.table","NW_015090842.1:7245933",241,386,145
"HSBP1","s1633_S_PIT_01_ASEReadCounter.table","NW_015090842.1:7246002",158,292,134
"HSBP1","s1633_S_PIT_01_ASEReadCounter.table","NW_015090842.1:7246094",225,387,162
"HSBP1","s1633_S_PIT_01_ASEReadCounter.table","NW_015090842.1:7246167",205,359,154
"HSBP1","s1633_S_PIT_01_ASEReadCounter.table","NW_015090842.1:7246183",196,345,149
"HSBP1","s1633_S_PIT_01_ASEReadCounter.table","NW_015090842.1:7247285",56,68,12
"HSBP1","s1633_S_PIT_01_ASEReadCounter.table","NW_015090842.1:7247651",382,720,338
"HSBP1","s1633_S_PIT_01_ASEReadCounter.table","NW_015090842.1:7247657",388,728,340
"HSBP1","s1633_S_PIT_01_ASEReadCounter.table","NW_015090842.1:7248520",227,428,201
"HSBP1","s1633_S_PIT_01_ASEReadCounter.table","NW_015090842.1:7248535",174,332,158
"KCNG4","s1633_S_PIT_01_ASEReadCounter.table","NW_015090842.1:7282500",1,2,1
"KCNG4","s1633_S_PIT_01_ASEReadCounter.table","NW_015090842.1:7282542",2,3,1
"KCNG4","s1633_S_PIT_01_ASEReadCounter.table","NW_015090842.1:7282579",5,6,1
"KCNG4","s1633_S_PIT_01_ASEReadCounter.table","NW_015090842.1:7282630",4,5,1
"KCNG4","s1633_S_PIT_01_ASEReadCounter.table","NW_015090842.1:7282760",3,3,0
"KCNG4","s1633_S_PIT_01_ASEReadCounter.table","NW_015090842.1:7283056",3,4,1
"KCNG4","s1633_S_PIT_01_ASEReadCounter.table","NW_015090842.1:7283245",1,2,1
"KCNG4","s1633_S_PIT_01_ASEReadCounter.table","NW_015090842.1:7299491",1,1,0
"KCNG4","s1633_S_PIT_01_ASEReadCounter.table","NW_015090842.1:7301195",2,3,1
"KCNG4","s1633_S_PIT_01_ASEReadCounter.table","NW_015090842.1:7301227",1,2,1
"KCNG4","s1633_S_PIT_01_ASEReadCounter.table","NW_015090842.1:7301240",1,2,1
"KCNG4","s1633_S_PIT_01_ASEReadCounter.table","NW_015090842.1:7301413",1,1,0
"WFDC1","s1633_S_PIT_01_ASEReadCounter.table","NW_015090842.1:7366517",2,2,0
"ATP2C2","s1633_S_PIT_01_ASEReadCounter.table","NW_015090842.1:7413747",0,1,1
"TLDC1","s1633_S_PIT_01_ASEReadCounter.table","NW_015090842.1:7421997",32,72,40
"COTL1","s1633_S_PIT_01_ASEReadCounter.table","NW_015090842.1:7490707",75,161,86
"COTL1","s1633_S_PIT_01_ASEReadCounter.table","NW_015090842.1:7490708",76,164,88
"COTL1","s1633_S_PIT_01_ASEReadCounter.table","NW_015090842.1:7490711",77,164,87
"COTL1","s1633_S_PIT_01_ASEReadCounter.table","NW_015090842.1:7490739",76,172,96
"COTL1","s1633_S_PIT_01_ASEReadCounter.table","NW_015090842.1:7490785",80,170,90
"COTL1","s1633_S_PIT_01_ASEReadCounter.table","NW_015090842.1:7490820",12,111,99
"COTL1","s1633_S_PIT_01_ASEReadCounter.table","NW_015090842.1:7490846",77,162,85
"COTL1","s1633_S_PIT_01_ASEReadCounter.table","NW_015090842.1:7505571",2,3,1
"KLHL36","s1633_S_PIT_01_ASEReadCounter.table","NW_015090842.1:7526337",35,35,0
"KLHL36","s1633_S_PIT_01_ASEReadCounter.table","NW_015090842.1:7537681",20,20,0
"USP10","s1633_S_PIT_01_ASEReadCounter.table","NW_015090842.1:7572213",55,136,81
"USP10","s1633_S_PIT_01_ASEReadCounter.table","NW_015090842.1:7572358",88,88,0
"CRISPLD2","s1633_S_PIT_01_ASEReadCounter.table","NW_015090842.1:7619796",1,3,2
"CRISPLD2","s1633_S_PIT_01_ASEReadCounter.table","NW_015090842.1:7633611",4,4,0
"CRISPLD2","s1633_S_PIT_01_ASEReadCounter.table","NW_015090842.1:7633787",1,4,3
"CRISPLD2","s1633_S_PIT_01_ASEReadCounter.table","NW_015090842.1:7634023",1,3,2
"CRISPLD2","s1633_S_PIT_01_ASEReadCounter.table","NW_015090842.1:7634620",4,4,0
"MTHFSD","s1633_S_PIT_01_ASEReadCounter.table","NW_015090842.1:8152578",7,22,15
"DUSP15","s1633_S_PIT_01_ASEReadCounter.table","NW_015090842.1:8422840",1,7,6
"DUSP15","s1633_S_PIT_01_ASEReadCounter.table","NW_015090842.1:8431988",0,7,7
"EMC8","s1633_S_PIT_01_ASEReadCounter.table","NW_015090842.1:8452385",12,21,9
"GINS2","s1633_S_PIT_01_ASEReadCounter.table","NW_015090842.1:8467469",43,43,0
"GINS2","s1633_S_PIT_01_ASEReadCounter.table","NW_015090842.1:8470290",39,84,45
"GINS2","s1633_S_PIT_01_ASEReadCounter.table","NW_015090842.1:8470305",37,85,48
"GINS2","s1633_S_PIT_01_ASEReadCounter.table","NW_015090842.1:8470376",27,71,44
"GINS2","s1633_S_PIT_01_ASEReadCounter.table","NW_015090842.1:8471057",0,5,5
"KIAA0513","s1633_S_PIT_01_ASEReadCounter.table","NW_015090842.1:8674736",141,141,0
"KIAA0513","s1633_S_PIT_01_ASEReadCounter.table","NW_015090842.1:8687268",0,1,1
"KIAA0513","s1633_S_PIT_01_ASEReadCounter.table","NW_015090842.1:8693655",67,68,1
"ZCCHC14","s1633_S_PIT_01_ASEReadCounter.table","NW_015090842.1:8750189",34,34,0
"JPH3","s1633_S_PIT_01_ASEReadCounter.table","NW_015090842.1:8872294",15,23,8
"KLHDC4","s1633_S_PIT_01_ASEReadCounter.table","NW_015090842.1:8891175",78,163,85
"KLHDC4","s1633_S_PIT_01_ASEReadCounter.table","NW_015090842.1:8905251",34,72,38
"KLHDC4","s1633_S_PIT_01_ASEReadCounter.table","NW_015090842.1:8919630",7,10,3
"SLC7A5","s1633_S_PIT_01_ASEReadCounter.table","NW_015090842.1:8940382",219,219,0
"SLC7A5","s1633_S_PIT_01_ASEReadCounter.table","NW_015090842.1:8941818",223,223,0
"SLC7A5","s1633_S_PIT_01_ASEReadCounter.table","NW_015090842.1:8944655",205,205,0
"CA5A","s1633_S_PIT_01_ASEReadCounter.table","NW_015090842.1:8989479",27,83,56
"CA5A","s1633_S_PIT_01_ASEReadCounter.table","NW_015090842.1:8989562",45,109,64
"CA5A","s1633_S_PIT_01_ASEReadCounter.table","NW_015090842.1:8989609",59,130,71
"CA5A","s1633_S_PIT_01_ASEReadCounter.table","NW_015090842.1:8989693",60,156,96
"CA5A","s1633_S_PIT_01_ASEReadCounter.table","NW_015090842.1:8989702",62,156,94
"CA5A","s1633_S_PIT_01_ASEReadCounter.table","NW_015090842.1:8989746",86,208,122
"CA5A","s1633_S_PIT_01_ASEReadCounter.table","NW_015090842.1:8989880",54,156,102
"CA5A","s1633_S_PIT_01_ASEReadCounter.table","NW_015090842.1:8989885",58,158,100
"CA5A","s1633_S_PIT_01_ASEReadCounter.table","NW_015090842.1:8989929",63,159,96
"CA5A","s1633_S_PIT_01_ASEReadCounter.table","NW_015090842.1:8990002",54,146,92
"CA5A","s1633_S_PIT_01_ASEReadCounter.table","NW_015090842.1:8990004",54,144,90
"CA5A","s1633_S_PIT_01_ASEReadCounter.table","NW_015090842.1:8990005",54,145,91
"CA5A","s1633_S_PIT_01_ASEReadCounter.table","NW_015090842.1:8990017",53,138,85
"CA5A","s1633_S_PIT_01_ASEReadCounter.table","NW_015090842.1:8990043",47,123,76
"CA5A","s1633_S_PIT_01_ASEReadCounter.table","NW_015090842.1:8990080",34,128,94
"CA5A","s1633_S_PIT_01_ASEReadCounter.table","NW_015090842.1:8990084",33,126,93
"CA5A","s1633_S_PIT_01_ASEReadCounter.table","NW_015090842.1:8990090",41,134,93
"CA5A","s1633_S_PIT_01_ASEReadCounter.table","NW_015090842.1:8990095",39,132,93
"CA5A","s1633_S_PIT_01_ASEReadCounter.table","NW_015090842.1:8990111",34,125,91
"CA5A","s1633_S_PIT_01_ASEReadCounter.table","NW_015090842.1:8990112",34,121,87
"CA5A","s1633_S_PIT_01_ASEReadCounter.table","NW_015090842.1:8990115",37,120,83
"CA5A","s1633_S_PIT_01_ASEReadCounter.table","NW_015090842.1:8990166",40,100,60
"CA5A","s1633_S_PIT_01_ASEReadCounter.table","NW_015090842.1:8990169",41,103,62
"CA5A","s1633_S_PIT_01_ASEReadCounter.table","NW_015090842.1:8990222",42,86,44
"CA5A","s1633_S_PIT_01_ASEReadCounter.table","NW_015090842.1:8990289",59,128,69
"CA5A","s1633_S_PIT_01_ASEReadCounter.table","NW_015090842.1:8990314",62,131,69
"CA5A","s1633_S_PIT_01_ASEReadCounter.table","NW_015090842.1:8990361",56,121,65
"CA5A","s1633_S_PIT_01_ASEReadCounter.table","NW_015090842.1:8990368",53,118,65
"CA5A","s1633_S_PIT_01_ASEReadCounter.table","NW_015090842.1:8990429",60,120,60
"CA5A","s1633_S_PIT_01_ASEReadCounter.table","NW_015090842.1:8990466",37,95,58
"CA5A","s1633_S_PIT_01_ASEReadCounter.table","NW_015090842.1:8990663",39,109,70
"CA5A","s1633_S_PIT_01_ASEReadCounter.table","NW_015090842.1:8990797",28,88,60
"CA5A","s1633_S_PIT_01_ASEReadCounter.table","NW_015090842.1:8990836",40,102,62
"CA5A","s1633_S_PIT_01_ASEReadCounter.table","NW_015090842.1:8990842",39,100,61
"CA5A","s1633_S_PIT_01_ASEReadCounter.table","NW_015090842.1:8990851",40,96,56
"CA5A","s1633_S_PIT_01_ASEReadCounter.table","NW_015090842.1:8990918",30,82,52
"CA5A","s1633_S_PIT_01_ASEReadCounter.table","NW_015090842.1:8990921",26,83,57
"CA5A","s1633_S_PIT_01_ASEReadCounter.table","NW_015090842.1:8990942",31,89,58
"CA5A","s1633_S_PIT_01_ASEReadCounter.table","NW_015090842.1:8991001",46,130,84
"CA5A","s1633_S_PIT_01_ASEReadCounter.table","NW_015090842.1:8991038",55,126,71
"CA5A","s1633_S_PIT_01_ASEReadCounter.table","NW_015090842.1:8991149",59,143,84
"CA5A","s1633_S_PIT_01_ASEReadCounter.table","NW_015090842.1:8991176",62,157,95
"CA5A","s1633_S_PIT_01_ASEReadCounter.table","NW_015090842.1:8991241",56,152,96
"CA5A","s1633_S_PIT_01_ASEReadCounter.table","NW_015090842.1:8991262",56,136,80
"CA5A","s1633_S_PIT_01_ASEReadCounter.table","NW_015090842.1:8991316",65,73,8
"CA5A","s1633_S_PIT_01_ASEReadCounter.table","NW_015090842.1:8991319",62,70,8
"CA5A","s1633_S_PIT_01_ASEReadCounter.table","NW_015090842.1:8991330",60,66,6
"CA5A","s1633_S_PIT_01_ASEReadCounter.table","NW_015090842.1:8991334",54,62,8
"CA5A","s1633_S_PIT_01_ASEReadCounter.table","NW_015090842.1:8991362",59,111,52
"CA5A","s1633_S_PIT_01_ASEReadCounter.table","NW_015090842.1:8991368",56,109,53
"CA5A","s1633_S_PIT_01_ASEReadCounter.table","NW_015090842.1:8991390",56,116,60
"CA5A","s1633_S_PIT_01_ASEReadCounter.table","NW_015090842.1:8991395",59,121,62
"CA5A","s1633_S_PIT_01_ASEReadCounter.table","NW_015090842.1:8991422",55,130,75
"CA5A","s1633_S_PIT_01_ASEReadCounter.table","NW_015090842.1:8991467",45,108,63
"CA5A","s1633_S_PIT_01_ASEReadCounter.table","NW_015090842.1:8991576",29,79,50
"CA5A","s1633_S_PIT_01_ASEReadCounter.table","NW_015090842.1:8991587",36,97,61
"CA5A","s1633_S_PIT_01_ASEReadCounter.table","NW_015090842.1:8991655",51,121,70
"CA5A","s1633_S_PIT_01_ASEReadCounter.table","NW_015090842.1:8991717",39,108,69
"CA5A","s1633_S_PIT_01_ASEReadCounter.table","NW_015090842.1:8991726",42,111,69
"CA5A","s1633_S_PIT_01_ASEReadCounter.table","NW_015090842.1:8991799",31,111,80
"CA5A","s1633_S_PIT_01_ASEReadCounter.table","NW_015090842.1:8991809",26,103,77
"CA5A","s1633_S_PIT_01_ASEReadCounter.table","NW_015090842.1:8991848",16,84,68
"CA5A","s1633_S_PIT_01_ASEReadCounter.table","NW_015090842.1:8991849",16,84,68
"CA5A","s1633_S_PIT_01_ASEReadCounter.table","NW_015090842.1:8991927",32,101,69
"CA5A","s1633_S_PIT_01_ASEReadCounter.table","NW_015090842.1:8991941",32,92,60
"CA5A","s1633_S_PIT_01_ASEReadCounter.table","NW_015090842.1:8992121",26,101,75
"CA5A","s1633_S_PIT_01_ASEReadCounter.table","NW_015090842.1:8992224",36,113,77
"CA5A","s1633_S_PIT_01_ASEReadCounter.table","NW_015090842.1:9002570",25,68,43
"CA5A","s1633_S_PIT_01_ASEReadCounter.table","NW_015090842.1:9002600",21,61,40
"CA5A","s1633_S_PIT_01_ASEReadCounter.table","NW_015090842.1:9004312",15,40,25
"CA5A","s1633_S_PIT_01_ASEReadCounter.table","NW_015090842.1:9004506",1,1,0
"CA5A","s1633_S_PIT_01_ASEReadCounter.table","NW_015090842.1:9004523",1,2,1
"CA5A","s1633_S_PIT_01_ASEReadCounter.table","NW_015090842.1:9004530",2,3,1
"CA5A","s1633_S_PIT_01_ASEReadCounter.table","NW_015090842.1:9004556",2,3,1
"CA5A","s1633_S_PIT_01_ASEReadCounter.table","NW_015090842.1:9004620",3,4,1
"CA5A","s1633_S_PIT_01_ASEReadCounter.table","NW_015090842.1:9005116",2,3,1
"CA5A","s1633_S_PIT_01_ASEReadCounter.table","NW_015090842.1:9005120",3,4,1
"CA5A","s1633_S_PIT_01_ASEReadCounter.table","NW_015090842.1:9005140",1,2,1
"CA5A","s1633_S_PIT_01_ASEReadCounter.table","NW_015090842.1:9005152",2,3,1
"CA5A","s1633_S_PIT_01_ASEReadCounter.table","NW_015090842.1:9011011",0,1,1
"CA5A","s1633_S_PIT_01_ASEReadCounter.table","NW_015090842.1:9011189",1,1,0
"CA5A","s1633_S_PIT_01_ASEReadCounter.table","NW_015090842.1:9011194",1,1,0
"BANP","s1633_S_PIT_01_ASEReadCounter.table","NW_015090842.1:9033407",12,26,14
"BANP","s1633_S_PIT_01_ASEReadCounter.table","NW_015090842.1:9033409",12,25,13
"BANP","s1633_S_PIT_01_ASEReadCounter.table","NW_015090842.1:9033420",15,32,17
"BANP","s1633_S_PIT_01_ASEReadCounter.table","NW_015090842.1:9055284",18,34,16
"CIDEC","s1633_S_PIT_01_ASEReadCounter.table","NW_015090842.1:9481199",1,1,0
"ZC3H18","s1633_S_PIT_01_ASEReadCounter.table","NW_015090842.1:9528933",24,50,26
"MVD","s1633_S_PIT_01_ASEReadCounter.table","NW_015090842.1:9550690",19,19,0
"MVD","s1633_S_PIT_01_ASEReadCounter.table","NW_015090842.1:9550691",19,19,0
"MVD","s1633_S_PIT_01_ASEReadCounter.table","NW_015090842.1:9550699",29,29,0
"MVD","s1633_S_PIT_01_ASEReadCounter.table","NW_015090842.1:9550701",28,28,0
"MVD","s1633_S_PIT_01_ASEReadCounter.table","NW_015090842.1:9552202",64,64,0
"MVD","s1633_S_PIT_01_ASEReadCounter.table","NW_015090842.1:9552223",53,53,0
"MVD","s1633_S_PIT_01_ASEReadCounter.table","NW_015090842.1:9552533",41,41,0
"MVD","s1633_S_PIT_01_ASEReadCounter.table","NW_015090842.1:9552644",17,25,8
"PIEZO1","s1633_S_PIT_01_ASEReadCounter.table","NW_015090842.1:9577447",3,9,6
"PIEZO1","s1633_S_PIT_01_ASEReadCounter.table","NW_015090842.1:9579101",2,7,5
"PIEZO1","s1633_S_PIT_01_ASEReadCounter.table","NW_015090842.1:9582630",3,4,1
"PIEZO1","s1633_S_PIT_01_ASEReadCounter.table","NW_015090842.1:9582976",1,2,1
"PIEZO1","s1633_S_PIT_01_ASEReadCounter.table","NW_015090842.1:9583326",3,3,0
"CDT1","s1633_S_PIT_01_ASEReadCounter.table","NW_015090842.1:9596711",3,12,9
"CDT1","s1633_S_PIT_01_ASEReadCounter.table","NW_015090842.1:9597033",25,25,0
"CDT1","s1633_S_PIT_01_ASEReadCounter.table","NW_015090842.1:9597756",7,23,16
"CDT1","s1633_S_PIT_01_ASEReadCounter.table","NW_015090842.1:9598873",26,26,0
"ACSF3","s1633_S_PIT_01_ASEReadCounter.table","NW_015090842.1:9776737",12,21,9
"ACSF3","s1633_S_PIT_01_ASEReadCounter.table","NW_015090842.1:9809639",57,57,0
"ACSF3","s1633_S_PIT_01_ASEReadCounter.table","NW_015090842.1:9834743",47,83,36
"ACSF3","s1633_S_PIT_01_ASEReadCounter.table","NW_015090842.1:9834762",78,78,0
"ACSF3","s1633_S_PIT_01_ASEReadCounter.table","NW_015090842.1:9834852",32,77,45
"ACSF3","s1633_S_PIT_01_ASEReadCounter.table","NW_015090842.1:9834861",29,73,44
"ACSF3","s1633_S_PIT_01_ASEReadCounter.table","NW_015090842.1:9839359",35,58,23
"ACSF3","s1633_S_PIT_01_ASEReadCounter.table","NW_015090842.1:9839378",32,55,23
"ACSF3","s1633_S_PIT_01_ASEReadCounter.table","NW_015090842.1:9839455",21,47,26
"ACSF3","s1633_S_PIT_01_ASEReadCounter.table","NW_015090842.1:9839457",20,44,24
"ACSF3","s1633_S_PIT_01_ASEReadCounter.table","NW_015090842.1:9839489",16,33,17
"ACSF3","s1633_S_PIT_01_ASEReadCounter.table","NW_015090842.1:9839500",15,27,12
"ACSF3","s1633_S_PIT_01_ASEReadCounter.table","NW_015090842.1:9839501",15,28,13
"ACSF3","s1633_S_PIT_01_ASEReadCounter.table","NW_015090842.1:9839504",17,31,14
"ACSF3","s1633_S_PIT_01_ASEReadCounter.table","NW_015090842.1:9839512",13,26,13
"ACSF3","s1633_S_PIT_01_ASEReadCounter.table","NW_015090842.1:9839527",8,16,8
"ACSF3","s1633_S_PIT_01_ASEReadCounter.table","NW_015090842.1:9839533",4,10,6
"ACSF3","s1633_S_PIT_01_ASEReadCounter.table","NW_015090842.1:9839535",4,10,6
"ACSF3","s1633_S_PIT_01_ASEReadCounter.table","NW_015090842.1:9839545",2,7,5
"ACSF3","s1633_S_PIT_01_ASEReadCounter.table","NW_015090842.1:9839550",2,7,5
"ACSF3","s1633_S_PIT_01_ASEReadCounter.table","NW_015090842.1:9839551",2,7,5
"CDH15","s1633_S_PIT_01_ASEReadCounter.table","NW_015090842.1:9848888",1,1,0
"SLC22A31","s1633_S_PIT_01_ASEReadCounter.table","NW_015090842.1:9851130",5,5,0
"SLC22A31","s1633_S_PIT_01_ASEReadCounter.table","NW_015090842.1:9851139",5,5,0
"SLC22A31","s1633_S_PIT_01_ASEReadCounter.table","NW_015090842.1:9851265",6,10,4
"SLC22A31","s1633_S_PIT_01_ASEReadCounter.table","NW_015090842.1:9851302",5,11,6
"SLC22A31","s1633_S_PIT_01_ASEReadCounter.table","NW_015090842.1:9851303",5,11,6
"SLC22A31","s1633_S_PIT_01_ASEReadCounter.table","NW_015090842.1:9851305",5,11,6
"SLC22A31","s1633_S_PIT_01_ASEReadCounter.table","NW_015090842.1:9851343",4,10,6
"SLC22A31","s1633_S_PIT_01_ASEReadCounter.table","NW_015090842.1:9851344",4,10,6
"SLC22A31","s1633_S_PIT_01_ASEReadCounter.table","NW_015090842.1:9851381",9,19,10
"SLC22A31","s1633_S_PIT_01_ASEReadCounter.table","NW_015090842.1:9851421",11,19,8
"SLC22A31","s1633_S_PIT_01_ASEReadCounter.table","NW_015090842.1:9851526",7,15,8
"SLC22A31","s1633_S_PIT_01_ASEReadCounter.table","NW_015090842.1:9851589",13,22,9
"SLC22A31","s1633_S_PIT_01_ASEReadCounter.table","NW_015090842.1:9851712",7,12,5
"SLC22A31","s1633_S_PIT_01_ASEReadCounter.table","NW_015090842.1:9851899",9,14,5
"SLC22A31","s1633_S_PIT_01_ASEReadCounter.table","NW_015090842.1:9852139",14,18,4
"SLC22A31","s1633_S_PIT_01_ASEReadCounter.table","NW_015090842.1:9852380",10,19,9
"SLC22A31","s1633_S_PIT_01_ASEReadCounter.table","NW_015090842.1:9852431",10,17,7
"SLC22A31","s1633_S_PIT_01_ASEReadCounter.table","NW_015090842.1:9852630",10,20,10
"SLC22A31","s1633_S_PIT_01_ASEReadCounter.table","NW_015090842.1:9852711",6,14,8
"SLC22A31","s1633_S_PIT_01_ASEReadCounter.table","NW_015090842.1:9852742",8,14,6
"SLC22A31","s1633_S_PIT_01_ASEReadCounter.table","NW_015090842.1:9853099",10,13,3
"SLC22A31","s1633_S_PIT_01_ASEReadCounter.table","NW_015090842.1:9853102",10,13,3
"SLC22A31","s1633_S_PIT_01_ASEReadCounter.table","NW_015090842.1:9853421",14,14,0
"SLC22A31","s1633_S_PIT_01_ASEReadCounter.table","NW_015090842.1:9853457",13,14,1
"SLC22A31","s1633_S_PIT_01_ASEReadCounter.table","NW_015090842.1:9853502",6,7,1
"ANKRD11","s1633_S_PIT_01_ASEReadCounter.table","NW_015090842.1:9858863",1,6,5
"ANKRD11","s1633_S_PIT_01_ASEReadCounter.table","NW_015090842.1:9859101",55,128,73
"ANKRD11","s1633_S_PIT_01_ASEReadCounter.table","NW_015090842.1:9859352",65,179,114
"ANKRD11","s1633_S_PIT_01_ASEReadCounter.table","NW_015090842.1:9859381",16,100,84
"ANKRD11","s1633_S_PIT_01_ASEReadCounter.table","NW_015090842.1:9859527",38,77,39
"ANKRD11","s1633_S_PIT_01_ASEReadCounter.table","NW_015090842.1:9859529",38,81,43
"ANKRD11","s1633_S_PIT_01_ASEReadCounter.table","NW_015090842.1:9859679",88,155,67
"ANKRD11","s1633_S_PIT_01_ASEReadCounter.table","NW_015090842.1:9861097",76,173,97
"ANKRD11","s1633_S_PIT_01_ASEReadCounter.table","NW_015090842.1:9862571",60,118,58
"ANKRD11","s1633_S_PIT_01_ASEReadCounter.table","NW_015090842.1:9866071",0,58,58
"ANKRD11","s1633_S_PIT_01_ASEReadCounter.table","NW_015090842.1:9866200",0,51,51
"ANKRD11","s1633_S_PIT_01_ASEReadCounter.table","NW_015090842.1:9867391",24,65,41
"ANKRD11","s1633_S_PIT_01_ASEReadCounter.table","NW_015090842.1:9867472",47,89,42
"ANKRD11","s1633_S_PIT_01_ASEReadCounter.table","NW_015090842.1:9867559",48,97,49
"ANKRD11","s1633_S_PIT_01_ASEReadCounter.table","NW_015090842.1:9867934",55,107,52
"ANKRD11","s1633_S_PIT_01_ASEReadCounter.table","NW_015090842.1:9868093",52,99,47
"ANKRD11","s1633_S_PIT_01_ASEReadCounter.table","NW_015090842.1:9868222",52,90,38
"ANKRD11","s1633_S_PIT_01_ASEReadCounter.table","NW_015090842.1:9868327",44,83,39
"ANKRD11","s1633_S_PIT_01_ASEReadCounter.table","NW_015090842.1:9868414",63,121,58
"ANKRD11","s1633_S_PIT_01_ASEReadCounter.table","NW_015090842.1:9868441",59,110,51
"ANKRD11","s1633_S_PIT_01_ASEReadCounter.table","NW_015090842.1:9868444",64,120,56
"ANKRD11","s1633_S_PIT_01_ASEReadCounter.table","NW_015090842.1:9868519",78,135,57
"ANKRD11","s1633_S_PIT_01_ASEReadCounter.table","NW_015090842.1:9868609",68,135,67
"ANKRD11","s1633_S_PIT_01_ASEReadCounter.table","NW_015090842.1:9868666",65,125,60
"ANKRD11","s1633_S_PIT_01_ASEReadCounter.table","NW_015090842.1:9869431",51,95,44
"ANKRD11","s1633_S_PIT_01_ASEReadCounter.table","NW_015090842.1:9869578",73,153,80
"ANKRD11","s1633_S_PIT_01_ASEReadCounter.table","NW_015090842.1:9869734",73,156,83
"ANKRD11","s1633_S_PIT_01_ASEReadCounter.table","NW_015090842.1:9870070",62,116,54
"ANKRD11","s1633_S_PIT_01_ASEReadCounter.table","NW_015090842.1:9870349",60,112,52
"ANKRD11","s1633_S_PIT_01_ASEReadCounter.table","NW_015090842.1:9870604",67,119,52
"ANKRD11","s1633_S_PIT_01_ASEReadCounter.table","NW_015090842.1:9870613",72,128,56
"ANKRD11","s1633_S_PIT_01_ASEReadCounter.table","NW_015090842.1:9870685",74,139,65
"ANKRD11","s1633_S_PIT_01_ASEReadCounter.table","NW_015090842.1:9870847",54,116,62
"ANKRD11","s1633_S_PIT_01_ASEReadCounter.table","NW_015090842.1:9871103",50,87,37
"ANKRD11","s1633_S_PIT_01_ASEReadCounter.table","NW_015090842.1:9871165",57,108,51
"ANKRD11","s1633_S_PIT_01_ASEReadCounter.table","NW_015090842.1:9871820",28,68,40
"ANKRD11","s1633_S_PIT_01_ASEReadCounter.table","NW_015090842.1:9871994",68,69,1
"ANKRD11","s1633_S_PIT_01_ASEReadCounter.table","NW_015090842.1:9872118",29,77,48
"SPG7","s1633_S_PIT_01_ASEReadCounter.table","NW_015090842.1:10051190",74,155,81
"SPG7","s1633_S_PIT_01_ASEReadCounter.table","NW_015090842.1:10051218",91,181,90
"SPG7","s1633_S_PIT_01_ASEReadCounter.table","NW_015090842.1:10052348",108,184,76
"SPG7","s1633_S_PIT_01_ASEReadCounter.table","NW_015090842.1:10052366",113,196,83
"SPG7","s1633_S_PIT_01_ASEReadCounter.table","NW_015090842.1:10065173",102,215,113
"SPG7","s1633_S_PIT_01_ASEReadCounter.table","NW_015090842.1:10065215",82,180,98
"SPG7","s1633_S_PIT_01_ASEReadCounter.table","NW_015090842.1:10066301",56,138,82
"SPG7","s1633_S_PIT_01_ASEReadCounter.table","NW_015090842.1:10066365",70,142,72
"SPG7","s1633_S_PIT_01_ASEReadCounter.table","NW_015090842.1:10069752",76,172,96
"SPG7","s1633_S_PIT_01_ASEReadCounter.table","NW_015090842.1:10069800",83,182,99
"SPG7","s1633_S_PIT_01_ASEReadCounter.table","NW_015090842.1:10071192",83,201,118
"SPG7","s1633_S_PIT_01_ASEReadCounter.table","NW_015090842.1:10071204",74,183,109
"SPG7","s1633_S_PIT_01_ASEReadCounter.table","NW_015090842.1:10071219",75,185,110
"SPG7","s1633_S_PIT_01_ASEReadCounter.table","NW_015090842.1:10071967",89,175,86
"SPG7","s1633_S_PIT_01_ASEReadCounter.table","NW_015090842.1:10075109",126,222,96
"SPG7","s1633_S_PIT_01_ASEReadCounter.table","NW_015090842.1:10075114",127,219,92
"SPG7","s1633_S_PIT_01_ASEReadCounter.table","NW_015090842.1:10075198",97,164,67
"SPG7","s1633_S_PIT_01_ASEReadCounter.table","NW_015090842.1:10075487",55,109,54
"SPG7","s1633_S_PIT_01_ASEReadCounter.table","NW_015090842.1:10075488",55,110,55
"SPG7","s1633_S_PIT_01_ASEReadCounter.table","NW_015090842.1:10075548",45,88,43
"RPL13","s1633_S_PIT_01_ASEReadCounter.table","NW_015090842.1:10076979",1,2,1
"RPL13","s1633_S_PIT_01_ASEReadCounter.table","NW_015090842.1:10077387",588,1402,814
"RPL13","s1633_S_PIT_01_ASEReadCounter.table","NW_015090842.1:10077978",893,1995,1102
"RPL13","s1633_S_PIT_01_ASEReadCounter.table","NW_015090842.1:10077992",852,1892,1040
"CPNE7","s1633_S_PIT_01_ASEReadCounter.table","NW_015090842.1:10084892",1,1,0
"CPNE7","s1633_S_PIT_01_ASEReadCounter.table","NW_015090842.1:10084921",2,2,0
"CPNE7","s1633_S_PIT_01_ASEReadCounter.table","NW_015090842.1:10084935",2,2,0
"CPNE7","s1633_S_PIT_01_ASEReadCounter.table","NW_015090842.1:10085000",3,3,0
"CPNE7","s1633_S_PIT_01_ASEReadCounter.table","NW_015090842.1:10085089",1,1,0
"CPNE7","s1633_S_PIT_01_ASEReadCounter.table","NW_015090842.1:10085180",1,1,0
"CPNE7","s1633_S_PIT_01_ASEReadCounter.table","NW_015090842.1:10085201",2,2,0
"CPNE7","s1633_S_PIT_01_ASEReadCounter.table","NW_015090842.1:10088134",9,9,0
"CPNE7","s1633_S_PIT_01_ASEReadCounter.table","NW_015090842.1:10088146",8,8,0
"CPNE7","s1633_S_PIT_01_ASEReadCounter.table","NW_015090842.1:10088940",3,3,0
"CPNE7","s1633_S_PIT_01_ASEReadCounter.table","NW_015090842.1:10088965",4,4,0
"CPNE7","s1633_S_PIT_01_ASEReadCounter.table","NW_015090842.1:10088967",4,4,0
"CPNE7","s1633_S_PIT_01_ASEReadCounter.table","NW_015090842.1:10088973",6,6,0
"CPNE7","s1633_S_PIT_01_ASEReadCounter.table","NW_015090842.1:10090924",4,4,0
"CPNE7","s1633_S_PIT_01_ASEReadCounter.table","NW_015090842.1:10090930",4,4,0
"CPNE7","s1633_S_PIT_01_ASEReadCounter.table","NW_015090842.1:10091075",4,4,0
"CPNE7","s1633_S_PIT_01_ASEReadCounter.table","NW_015090842.1:10091389",3,3,0
"CPNE7","s1633_S_PIT_01_ASEReadCounter.table","NW_015090842.1:10091407",2,2,0
"CPNE7","s1633_S_PIT_01_ASEReadCounter.table","NW_015090842.1:10091530",2,2,0
"CPNE7","s1633_S_PIT_01_ASEReadCounter.table","NW_015090842.1:10091875",5,5,0
"CPNE7","s1633_S_PIT_01_ASEReadCounter.table","NW_015090842.1:10091983",3,3,0
"CPNE7","s1633_S_PIT_01_ASEReadCounter.table","NW_015090842.1:10091997",4,4,0
"CPNE7","s1633_S_PIT_01_ASEReadCounter.table","NW_015090842.1:10092038",2,2,0
"CPNE7","s1633_S_PIT_01_ASEReadCounter.table","NW_015090842.1:10092140",3,3,0
"CPNE7","s1633_S_PIT_01_ASEReadCounter.table","NW_015090842.1:10092183",2,2,0
"CPNE7","s1633_S_PIT_01_ASEReadCounter.table","NW_015090842.1:10092201",2,2,0
"CPNE7","s1633_S_PIT_01_ASEReadCounter.table","NW_015090842.1:10092230",2,2,0
"LOC106888185","s1633_S_PIT_01_ASEReadCounter.table","NW_015090842.1:10094965",3,16,13
"LOC106888185","s1633_S_PIT_01_ASEReadCounter.table","NW_015090842.1:10094966",3,17,14
"LOC106888185","s1633_S_PIT_01_ASEReadCounter.table","NW_015090842.1:10094985",4,20,16
"LOC106888185","s1633_S_PIT_01_ASEReadCounter.table","NW_015090842.1:10095055",0,13,13
"LOC106888185","s1633_S_PIT_01_ASEReadCounter.table","NW_015090842.1:10095062",0,11,11
"LOC106888185","s1633_S_PIT_01_ASEReadCounter.table","NW_015090842.1:10095130",1,13,12
"LOC106888185","s1633_S_PIT_01_ASEReadCounter.table","NW_015090842.1:10095265",46,97,51
"LOC106888185","s1633_S_PIT_01_ASEReadCounter.table","NW_015090842.1:10095586",44,101,57
"LOC106888185","s1633_S_PIT_01_ASEReadCounter.table","NW_015090842.1:10095593",45,103,58
"LOC106888185","s1633_S_PIT_01_ASEReadCounter.table","NW_015090842.1:10095616",30,78,48
"LOC106888185","s1633_S_PIT_01_ASEReadCounter.table","NW_015090842.1:10095662",25,56,31
"LOC106888185","s1633_S_PIT_01_ASEReadCounter.table","NW_015090842.1:10095674",21,51,30
"LOC106888185","s1633_S_PIT_01_ASEReadCounter.table","NW_015090842.1:10095786",26,62,36
"LOC106888185","s1633_S_PIT_01_ASEReadCounter.table","NW_015090842.1:10095831",32,73,41
"LOC106888185","s1633_S_PIT_01_ASEReadCounter.table","NW_015090842.1:10096230",42,79,37
"LOC106888185","s1633_S_PIT_01_ASEReadCounter.table","NW_015090842.1:10096249",41,80,39
"LOC106888185","s1633_S_PIT_01_ASEReadCounter.table","NW_015090842.1:10096272",45,85,40
"LOC106888185","s1633_S_PIT_01_ASEReadCounter.table","NW_015090842.1:10096288",42,83,41
"LOC106888185","s1633_S_PIT_01_ASEReadCounter.table","NW_015090842.1:10097248",44,99,55
"LOC106888185","s1633_S_PIT_01_ASEReadCounter.table","NW_015090842.1:10097265",52,126,74
"LOC106888185","s1633_S_PIT_01_ASEReadCounter.table","NW_015090842.1:10097446",5,23,18
"DPEP1","s1633_S_PIT_01_ASEReadCounter.table","NW_015090842.1:10098017",1,3,2
"DPEP1","s1633_S_PIT_01_ASEReadCounter.table","NW_015090842.1:10098518",0,7,7
"DPEP1","s1633_S_PIT_01_ASEReadCounter.table","NW_015090842.1:10098595",1,9,8
"DPEP1","s1633_S_PIT_01_ASEReadCounter.table","NW_015090842.1:10098597",1,8,7
"DPEP1","s1633_S_PIT_01_ASEReadCounter.table","NW_015090842.1:10098601",1,9,8
"DPEP1","s1633_S_PIT_01_ASEReadCounter.table","NW_015090842.1:10098608",0,8,8
"DPEP1","s1633_S_PIT_01_ASEReadCounter.table","NW_015090842.1:10098630",0,8,8
"DPEP1","s1633_S_PIT_01_ASEReadCounter.table","NW_015090842.1:10098659",1,11,10
"DPEP1","s1633_S_PIT_01_ASEReadCounter.table","NW_015090842.1:10099765",3,12,9
"DPEP1","s1633_S_PIT_01_ASEReadCounter.table","NW_015090842.1:10099985",0,3,3
"DPEP1","s1633_S_PIT_01_ASEReadCounter.table","NW_015090842.1:10099986",0,3,3
"DPEP1","s1633_S_PIT_01_ASEReadCounter.table","NW_015090842.1:10099991",0,4,4
"DPEP1","s1633_S_PIT_01_ASEReadCounter.table","NW_015090842.1:10100044",0,8,8
"DPEP1","s1633_S_PIT_01_ASEReadCounter.table","NW_015090842.1:10100045",0,8,8
"DPEP1","s1633_S_PIT_01_ASEReadCounter.table","NW_015090842.1:10100084",0,9,9
"DPEP1","s1633_S_PIT_01_ASEReadCounter.table","NW_015090842.1:10100295",1,11,10
"DPEP1","s1633_S_PIT_01_ASEReadCounter.table","NW_015090842.1:10100529",0,7,7
"DPEP1","s1633_S_PIT_01_ASEReadCounter.table","NW_015090842.1:10100893",1,19,18
"DPEP1","s1633_S_PIT_01_ASEReadCounter.table","NW_015090842.1:10100902",1,18,17
"DPEP1","s1633_S_PIT_01_ASEReadCounter.table","NW_015090842.1:10101072",0,15,15
"DPEP1","s1633_S_PIT_01_ASEReadCounter.table","NW_015090842.1:10101199",0,15,15
"DPEP1","s1633_S_PIT_01_ASEReadCounter.table","NW_015090842.1:10101483",0,15,15
"DPEP1","s1633_S_PIT_01_ASEReadCounter.table","NW_015090842.1:10101497",0,15,15
"DPEP1","s1633_S_PIT_01_ASEReadCounter.table","NW_015090842.1:10101525",0,15,15
"DPEP1","s1633_S_PIT_01_ASEReadCounter.table","NW_015090842.1:10101875",0,8,8
"DPEP1","s1633_S_PIT_01_ASEReadCounter.table","NW_015090842.1:10101913",0,6,6
"DPEP1","s1633_S_PIT_01_ASEReadCounter.table","NW_015090842.1:10101996",0,7,7
"DPEP1","s1633_S_PIT_01_ASEReadCounter.table","NW_015090842.1:10102014",0,6,6
"DPEP1","s1633_S_PIT_01_ASEReadCounter.table","NW_015090842.1:10102035",0,5,5
"DPEP1","s1633_S_PIT_01_ASEReadCounter.table","NW_015090842.1:10102076",0,1,1
"DPEP1","s1633_S_PIT_01_ASEReadCounter.table","NW_015090842.1:10102077",0,1,1
"CHMP1A","s1633_S_PIT_01_ASEReadCounter.table","NW_015090842.1:10102901",40,133,93
"CHMP1A","s1633_S_PIT_01_ASEReadCounter.table","NW_015090842.1:10102961",73,174,101
"CHMP1A","s1633_S_PIT_01_ASEReadCounter.table","NW_015090842.1:10102996",51,144,93
"CHMP1A","s1633_S_PIT_01_ASEReadCounter.table","NW_015090842.1:10103004",55,153,98
"CHMP1A","s1633_S_PIT_01_ASEReadCounter.table","NW_015090842.1:10103006",56,154,98
"CHMP1A","s1633_S_PIT_01_ASEReadCounter.table","NW_015090842.1:10103052",85,183,98
"CHMP1A","s1633_S_PIT_01_ASEReadCounter.table","NW_015090842.1:10103095",87,175,88
"CHMP1A","s1633_S_PIT_01_ASEReadCounter.table","NW_015090842.1:10103096",88,175,87
"CHMP1A","s1633_S_PIT_01_ASEReadCounter.table","NW_015090842.1:10103152",85,163,78
"CHMP1A","s1633_S_PIT_01_ASEReadCounter.table","NW_015090842.1:10103334",57,146,89
"CHMP1A","s1633_S_PIT_01_ASEReadCounter.table","NW_015090842.1:10103373",34,132,98
"CHMP1A","s1633_S_PIT_01_ASEReadCounter.table","NW_015090842.1:10103408",54,158,104
"CHMP1A","s1633_S_PIT_01_ASEReadCounter.table","NW_015090842.1:10103412",57,157,100
"CHMP1A","s1633_S_PIT_01_ASEReadCounter.table","NW_015090842.1:10103512",99,188,89
"CHMP1A","s1633_S_PIT_01_ASEReadCounter.table","NW_015090842.1:10103513",99,188,89
"CHMP1A","s1633_S_PIT_01_ASEReadCounter.table","NW_015090842.1:10103583",67,147,80
"CHMP1A","s1633_S_PIT_01_ASEReadCounter.table","NW_015090842.1:10103614",79,159,80
"CHMP1A","s1633_S_PIT_01_ASEReadCounter.table","NW_015090842.1:10103657",77,167,90
"CHMP1A","s1633_S_PIT_01_ASEReadCounter.table","NW_015090842.1:10103669",66,154,88
"CHMP1A","s1633_S_PIT_01_ASEReadCounter.table","NW_015090842.1:10103674",61,149,88
"CHMP1A","s1633_S_PIT_01_ASEReadCounter.table","NW_015090842.1:10103677",58,144,86
"CHMP1A","s1633_S_PIT_01_ASEReadCounter.table","NW_015090842.1:10103729",77,153,76
"CHMP1A","s1633_S_PIT_01_ASEReadCounter.table","NW_015090842.1:10103758",89,159,70
"CHMP1A","s1633_S_PIT_01_ASEReadCounter.table","NW_015090842.1:10103761",87,164,77
"CHMP1A","s1633_S_PIT_01_ASEReadCounter.table","NW_015090842.1:10103788",109,207,98
"CHMP1A","s1633_S_PIT_01_ASEReadCounter.table","NW_015090842.1:10103789",110,210,100
"CHMP1A","s1633_S_PIT_01_ASEReadCounter.table","NW_015090842.1:10103790",109,211,102
"CHMP1A","s1633_S_PIT_01_ASEReadCounter.table","NW_015090842.1:10103950",81,193,112
"CHMP1A","s1633_S_PIT_01_ASEReadCounter.table","NW_015090842.1:10104335",59,133,74
"CHMP1A","s1633_S_PIT_01_ASEReadCounter.table","NW_015090842.1:10104429",95,211,116
"CHMP1A","s1633_S_PIT_01_ASEReadCounter.table","NW_015090842.1:10104532",105,207,102
"CHMP1A","s1633_S_PIT_01_ASEReadCounter.table","NW_015090842.1:10104633",86,175,89
"CHMP1A","s1633_S_PIT_01_ASEReadCounter.table","NW_015090842.1:10104759",78,173,95
"CHMP1A","s1633_S_PIT_01_ASEReadCounter.table","NW_015090842.1:10104794",81,182,101
"CHMP1A","s1633_S_PIT_01_ASEReadCounter.table","NW_015090842.1:10104844",50,129,79
"CHMP1A","s1633_S_PIT_01_ASEReadCounter.table","NW_015090842.1:10106290",74,161,87
"CHMP1A","s1633_S_PIT_01_ASEReadCounter.table","NW_015090842.1:10106335",73,168,95
"CHMP1A","s1633_S_PIT_01_ASEReadCounter.table","NW_015090842.1:10106383",108,216,108
"CHMP1A","s1633_S_PIT_01_ASEReadCounter.table","NW_015090842.1:10106747",107,246,139
"CHMP1A","s1633_S_PIT_01_ASEReadCounter.table","NW_015090842.1:10107404",97,220,123
"CHMP1A","s1633_S_PIT_01_ASEReadCounter.table","NW_015090842.1:10107410",106,229,123
"CHMP1A","s1633_S_PIT_01_ASEReadCounter.table","NW_015090842.1:10107876",94,209,115
"CDK10","s1633_S_PIT_01_ASEReadCounter.table","NW_015090842.1:10109030",10,11,1
"CDK10","s1633_S_PIT_01_ASEReadCounter.table","NW_015090842.1:10109963",38,93,55
"CDK10","s1633_S_PIT_01_ASEReadCounter.table","NW_015090842.1:10110887",28,75,47
"CDK10","s1633_S_PIT_01_ASEReadCounter.table","NW_015090842.1:10111254",28,57,29
"CDK10","s1633_S_PIT_01_ASEReadCounter.table","NW_015090842.1:10111380",33,66,33
"CDK10","s1633_S_PIT_01_ASEReadCounter.table","NW_015090842.1:10111395",35,69,34
"CDK10","s1633_S_PIT_01_ASEReadCounter.table","NW_015090842.1:10111437",20,55,35
"CDK10","s1633_S_PIT_01_ASEReadCounter.table","NW_015090842.1:10111798",29,78,49
"CDK10","s1633_S_PIT_01_ASEReadCounter.table","NW_015090842.1:10111840",30,71,41
"CDK10","s1633_S_PIT_01_ASEReadCounter.table","NW_015090842.1:10112031",43,73,30
"CDK10","s1633_S_PIT_01_ASEReadCounter.table","NW_015090842.1:10112285",29,61,32
"CDK10","s1633_S_PIT_01_ASEReadCounter.table","NW_015090842.1:10112398",35,69,34
"CDK10","s1633_S_PIT_01_ASEReadCounter.table","NW_015090842.1:10112455",23,63,40
"CDK10","s1633_S_PIT_01_ASEReadCounter.table","NW_015090842.1:10112461",22,55,33
"CDK10","s1633_S_PIT_01_ASEReadCounter.table","NW_015090842.1:10112497",23,58,35
"CDK10","s1633_S_PIT_01_ASEReadCounter.table","NW_015090842.1:10112508",22,58,36
"CDK10","s1633_S_PIT_01_ASEReadCounter.table","NW_015090842.1:10112518",19,49,30
"CDK10","s1633_S_PIT_01_ASEReadCounter.table","NW_015090842.1:10112540",11,42,31
"CDK10","s1633_S_PIT_01_ASEReadCounter.table","NW_015090842.1:10112556",21,54,33
"CDK10","s1633_S_PIT_01_ASEReadCounter.table","NW_015090842.1:10112561",22,64,42
"CDK10","s1633_S_PIT_01_ASEReadCounter.table","NW_015090842.1:10112596",22,67,45
"CDK10","s1633_S_PIT_01_ASEReadCounter.table","NW_015090842.1:10112630",14,51,37
"CDK10","s1633_S_PIT_01_ASEReadCounter.table","NW_015090842.1:10112656",14,50,36
"CDK10","s1633_S_PIT_01_ASEReadCounter.table","NW_015090842.1:10112665",13,38,25
"CDK10","s1633_S_PIT_01_ASEReadCounter.table","NW_015090842.1:10112668",13,39,26
"CDK10","s1633_S_PIT_01_ASEReadCounter.table","NW_015090842.1:10112781",10,20,10
"CDK10","s1633_S_PIT_01_ASEReadCounter.table","NW_015090842.1:10112782",10,20,10
"CDK10","s1633_S_PIT_01_ASEReadCounter.table","NW_015090842.1:10112795",10,20,10
"CDK10","s1633_S_PIT_01_ASEReadCounter.table","NW_015090842.1:10112841",2,4,2
"CDK10","s1633_S_PIT_01_ASEReadCounter.table","NW_015090842.1:10112861",1,1,0
"SPATA2L","s1633_S_PIT_01_ASEReadCounter.table","NW_015090842.1:10113212",10,23,13
"SPATA2L","s1633_S_PIT_01_ASEReadCounter.table","NW_015090842.1:10113280",21,49,28
"SPATA2L","s1633_S_PIT_01_ASEReadCounter.table","NW_015090842.1:10113296",18,49,31
"SPATA2L","s1633_S_PIT_01_ASEReadCounter.table","NW_015090842.1:10113321",20,51,31
"SPATA2L","s1633_S_PIT_01_ASEReadCounter.table","NW_015090842.1:10113332",25,58,33
"SPATA2L","s1633_S_PIT_01_ASEReadCounter.table","NW_015090842.1:10113380",23,47,24
"SPATA2L","s1633_S_PIT_01_ASEReadCounter.table","NW_015090842.1:10113381",22,51,29
"SPATA2L","s1633_S_PIT_01_ASEReadCounter.table","NW_015090842.1:10113412",26,52,26
"SPATA2L","s1633_S_PIT_01_ASEReadCounter.table","NW_015090842.1:10113421",25,53,28
"SPATA2L","s1633_S_PIT_01_ASEReadCounter.table","NW_015090842.1:10113465",26,55,29
"SPATA2L","s1633_S_PIT_01_ASEReadCounter.table","NW_015090842.1:10113535",30,58,28
"SPATA2L","s1633_S_PIT_01_ASEReadCounter.table","NW_015090842.1:10113645",38,79,41
"SPATA2L","s1633_S_PIT_01_ASEReadCounter.table","NW_015090842.1:10113682",47,93,46
"SPATA2L","s1633_S_PIT_01_ASEReadCounter.table","NW_015090842.1:10113696",39,80,41
"SPATA2L","s1633_S_PIT_01_ASEReadCounter.table","NW_015090842.1:10113727",33,74,41
"SPATA2L","s1633_S_PIT_01_ASEReadCounter.table","NW_015090842.1:10113729",33,74,41
"SPATA2L","s1633_S_PIT_01_ASEReadCounter.table","NW_015090842.1:10113799",44,94,50
"SPATA2L","s1633_S_PIT_01_ASEReadCounter.table","NW_015090842.1:10113809",52,108,56
"SPATA2L","s1633_S_PIT_01_ASEReadCounter.table","NW_015090842.1:10113827",49,99,50
"SPATA2L","s1633_S_PIT_01_ASEReadCounter.table","NW_015090842.1:10113831",48,98,50
"SPATA2L","s1633_S_PIT_01_ASEReadCounter.table","NW_015090842.1:10113894",42,78,36
"SPATA2L","s1633_S_PIT_01_ASEReadCounter.table","NW_015090842.1:10113905",37,69,32
"SPATA2L","s1633_S_PIT_01_ASEReadCounter.table","NW_015090842.1:10113914",37,68,31
"SPATA2L","s1633_S_PIT_01_ASEReadCounter.table","NW_015090842.1:10113920",40,72,32
"SPATA2L","s1633_S_PIT_01_ASEReadCounter.table","NW_015090842.1:10113937",47,83,36
"SPATA2L","s1633_S_PIT_01_ASEReadCounter.table","NW_015090842.1:10113971",36,66,30
"SPATA2L","s1633_S_PIT_01_ASEReadCounter.table","NW_015090842.1:10113976",34,75,41
"SPATA2L","s1633_S_PIT_01_ASEReadCounter.table","NW_015090842.1:10113985",38,67,29
"SPATA2L","s1633_S_PIT_01_ASEReadCounter.table","NW_015090842.1:10113994",42,75,33
"SPATA2L","s1633_S_PIT_01_ASEReadCounter.table","NW_015090842.1:10114063",32,68,36
"SPATA2L","s1633_S_PIT_01_ASEReadCounter.table","NW_015090842.1:10114066",31,69,38
"SPATA2L","s1633_S_PIT_01_ASEReadCounter.table","NW_015090842.1:10114069",33,72,39
"SPATA2L","s1633_S_PIT_01_ASEReadCounter.table","NW_015090842.1:10114159",25,58,33
"SPATA2L","s1633_S_PIT_01_ASEReadCounter.table","NW_015090842.1:10114262",80,80,0
"SPATA2L","s1633_S_PIT_01_ASEReadCounter.table","NW_015090842.1:10114470",24,56,32
"SPATA2L","s1633_S_PIT_01_ASEReadCounter.table","NW_015090842.1:10114524",17,46,29
"VPS9D1","s1633_S_PIT_01_ASEReadCounter.table","NW_015090842.1:10116377",19,34,15
"VPS9D1","s1633_S_PIT_01_ASEReadCounter.table","NW_015090842.1:10116415",22,36,14
"VPS9D1","s1633_S_PIT_01_ASEReadCounter.table","NW_015090842.1:10116607",22,34,12
"VPS9D1","s1633_S_PIT_01_ASEReadCounter.table","NW_015090842.1:10116821",13,22,9
"VPS9D1","s1633_S_PIT_01_ASEReadCounter.table","NW_015090842.1:10116825",14,23,9
"VPS9D1","s1633_S_PIT_01_ASEReadCounter.table","NW_015090842.1:10116882",23,32,9
"VPS9D1","s1633_S_PIT_01_ASEReadCounter.table","NW_015090842.1:10116933",21,35,14
"VPS9D1","s1633_S_PIT_01_ASEReadCounter.table","NW_015090842.1:10116942",19,36,17
"VPS9D1","s1633_S_PIT_01_ASEReadCounter.table","NW_015090842.1:10117152",15,32,17
"VPS9D1","s1633_S_PIT_01_ASEReadCounter.table","NW_015090842.1:10117480",12,22,10
"VPS9D1","s1633_S_PIT_01_ASEReadCounter.table","NW_015090842.1:10117497",11,22,11
"VPS9D1","s1633_S_PIT_01_ASEReadCounter.table","NW_015090842.1:10117499",9,21,12
"VPS9D1","s1633_S_PIT_01_ASEReadCounter.table","NW_015090842.1:10117516",12,24,12
"VPS9D1","s1633_S_PIT_01_ASEReadCounter.table","NW_015090842.1:10117525",15,32,17
"VPS9D1","s1633_S_PIT_01_ASEReadCounter.table","NW_015090842.1:10117579",17,33,16
"VPS9D1","s1633_S_PIT_01_ASEReadCounter.table","NW_015090842.1:10117627",22,33,11
"VPS9D1","s1633_S_PIT_01_ASEReadCounter.table","NW_015090842.1:10117678",11,24,13
"VPS9D1","s1633_S_PIT_01_ASEReadCounter.table","NW_015090842.1:10117773",14,37,23
"VPS9D1","s1633_S_PIT_01_ASEReadCounter.table","NW_015090842.1:10117937",17,41,24
"VPS9D1","s1633_S_PIT_01_ASEReadCounter.table","NW_015090842.1:10117961",18,43,25
"VPS9D1","s1633_S_PIT_01_ASEReadCounter.table","NW_015090842.1:10118236",17,45,28
"VPS9D1","s1633_S_PIT_01_ASEReadCounter.table","NW_015090842.1:10118414",20,39,19
"VPS9D1","s1633_S_PIT_01_ASEReadCounter.table","NW_015090842.1:10118973",27,55,28
"VPS9D1","s1633_S_PIT_01_ASEReadCounter.table","NW_015090842.1:10119500",19,37,18
"ZNF276","s1633_S_PIT_01_ASEReadCounter.table","NW_015090842.1:10121760",4,13,9
"ZNF276","s1633_S_PIT_01_ASEReadCounter.table","NW_015090842.1:10121769",4,13,9
"ZNF276","s1633_S_PIT_01_ASEReadCounter.table","NW_015090842.1:10121802",11,26,15
"ZNF276","s1633_S_PIT_01_ASEReadCounter.table","NW_015090842.1:10121971",19,38,19
"ZNF276","s1633_S_PIT_01_ASEReadCounter.table","NW_015090842.1:10122161",44,44,0
"ZNF276","s1633_S_PIT_01_ASEReadCounter.table","NW_015090842.1:10122164",45,45,0
"ZNF276","s1633_S_PIT_01_ASEReadCounter.table","NW_015090842.1:10122184",43,43,0
"ZNF276","s1633_S_PIT_01_ASEReadCounter.table","NW_015090842.1:10122883",12,23,11
"ZNF276","s1633_S_PIT_01_ASEReadCounter.table","NW_015090842.1:10122997",19,41,22
"ZNF276","s1633_S_PIT_01_ASEReadCounter.table","NW_015090842.1:10123069",26,47,21
"ZNF276","s1633_S_PIT_01_ASEReadCounter.table","NW_015090842.1:10123207",33,54,21
"ZNF276","s1633_S_PIT_01_ASEReadCounter.table","NW_015090842.1:10125787",27,59,32
"ZNF276","s1633_S_PIT_01_ASEReadCounter.table","NW_015090842.1:10126309",31,58,27
"ZNF276","s1633_S_PIT_01_ASEReadCounter.table","NW_015090842.1:10126348",27,71,44
"ZNF276","s1633_S_PIT_01_ASEReadCounter.table","NW_015090842.1:10126978",30,61,31
"ZNF276","s1633_S_PIT_01_ASEReadCounter.table","NW_015090842.1:10126991",30,56,26
"ZNF276","s1633_S_PIT_01_ASEReadCounter.table","NW_015090842.1:10127023",29,53,24
"ZNF276","s1633_S_PIT_01_ASEReadCounter.table","NW_015090842.1:10127063",30,49,19
"ZNF276","s1633_S_PIT_01_ASEReadCounter.table","NW_015090842.1:10127373",27,40,13
"ZNF276","s1633_S_PIT_01_ASEReadCounter.table","NW_015090842.1:10127931",29,61,32
"ZNF276","s1633_S_PIT_01_ASEReadCounter.table","NW_015090842.1:10128070",32,56,24
"ZNF276","s1633_S_PIT_01_ASEReadCounter.table","NW_015090842.1:10128102",30,58,28
"ZNF276","s1633_S_PIT_01_ASEReadCounter.table","NW_015090842.1:10128356",19,45,26
"ZNF276","s1633_S_PIT_01_ASEReadCounter.table","NW_015090842.1:10128497",20,29,9
"FANCA","s1633_S_PIT_01_ASEReadCounter.table","NW_015090842.1:10128743",2,6,4
"FANCA","s1633_S_PIT_01_ASEReadCounter.table","NW_015090842.1:10128822",2,5,3
"FANCA","s1633_S_PIT_01_ASEReadCounter.table","NW_015090842.1:10129383",2,6,4
"FANCA","s1633_S_PIT_01_ASEReadCounter.table","NW_015090842.1:10129390",2,6,4
"FANCA","s1633_S_PIT_01_ASEReadCounter.table","NW_015090842.1:10129422",2,7,5
"FANCA","s1633_S_PIT_01_ASEReadCounter.table","NW_015090842.1:10129969",2,7,5
"FANCA","s1633_S_PIT_01_ASEReadCounter.table","NW_015090842.1:10130399",4,9,5
"FANCA","s1633_S_PIT_01_ASEReadCounter.table","NW_015090842.1:10130857",4,7,3
"FANCA","s1633_S_PIT_01_ASEReadCounter.table","NW_015090842.1:10130878",5,9,4
"FANCA","s1633_S_PIT_01_ASEReadCounter.table","NW_015090842.1:10133530",5,5,0
"FANCA","s1633_S_PIT_01_ASEReadCounter.table","NW_015090842.1:10133533",5,5,0
"FANCA","s1633_S_PIT_01_ASEReadCounter.table","NW_015090842.1:10133536",5,5,0
"FANCA","s1633_S_PIT_01_ASEReadCounter.table","NW_015090842.1:10133601",4,4,0
"FANCA","s1633_S_PIT_01_ASEReadCounter.table","NW_015090842.1:10134492",5,7,2
"FANCA","s1633_S_PIT_01_ASEReadCounter.table","NW_015090842.1:10136957",1,3,2
"FANCA","s1633_S_PIT_01_ASEReadCounter.table","NW_015090842.1:10136982",1,1,0
"FANCA","s1633_S_PIT_01_ASEReadCounter.table","NW_015090842.1:10136999",0,1,1
"FANCA","s1633_S_PIT_01_ASEReadCounter.table","NW_015090842.1:10137019",1,1,0
"FANCA","s1633_S_PIT_01_ASEReadCounter.table","NW_015090842.1:10137673",3,3,0
"FANCA","s1633_S_PIT_01_ASEReadCounter.table","NW_015090842.1:10138618",5,6,1
"FANCA","s1633_S_PIT_01_ASEReadCounter.table","NW_015090842.1:10139140",3,4,1
"FANCA","s1633_S_PIT_01_ASEReadCounter.table","NW_015090842.1:10140699",1,5,4
"FANCA","s1633_S_PIT_01_ASEReadCounter.table","NW_015090842.1:10141234",1,4,3
"FANCA","s1633_S_PIT_01_ASEReadCounter.table","NW_015090842.1:10145030",1,2,1
"FANCA","s1633_S_PIT_01_ASEReadCounter.table","NW_015090842.1:10150518",4,4,0
"FANCA","s1633_S_PIT_01_ASEReadCounter.table","NW_015090842.1:10152863",5,8,3
"FANCA","s1633_S_PIT_01_ASEReadCounter.table","NW_015090842.1:10154490",5,8,3
"FANCA","s1633_S_PIT_01_ASEReadCounter.table","NW_015090842.1:10158162",0,1,1
"FANCA","s1633_S_PIT_01_ASEReadCounter.table","NW_015090842.1:10158957",0,1,1
"FANCA","s1633_S_PIT_01_ASEReadCounter.table","NW_015090842.1:10160177",0,1,1
"FANCA","s1633_S_PIT_01_ASEReadCounter.table","NW_015090842.1:10164257",0,1,1
"FANCA","s1633_S_PIT_01_ASEReadCounter.table","NW_015090842.1:10165331",0,2,2
"SPIRE2","s1633_S_PIT_01_ASEReadCounter.table","NW_015090842.1:10172284",12,22,10
"SPIRE2","s1633_S_PIT_01_ASEReadCounter.table","NW_015090842.1:10175262",23,44,21
"SPIRE2","s1633_S_PIT_01_ASEReadCounter.table","NW_015090842.1:10175352",16,26,10
"SPIRE2","s1633_S_PIT_01_ASEReadCounter.table","NW_015090842.1:10175400",47,87,40
"SPIRE2","s1633_S_PIT_01_ASEReadCounter.table","NW_015090842.1:10175418",50,93,43
"SPIRE2","s1633_S_PIT_01_ASEReadCounter.table","NW_015090842.1:10175704",62,113,51
"SPIRE2","s1633_S_PIT_01_ASEReadCounter.table","NW_015090842.1:10176115",61,138,77
"SPIRE2","s1633_S_PIT_01_ASEReadCounter.table","NW_015090842.1:10176561",88,155,67
"SPIRE2","s1633_S_PIT_01_ASEReadCounter.table","NW_015090842.1:10176817",80,143,63
"SPIRE2","s1633_S_PIT_01_ASEReadCounter.table","NW_015090842.1:10177084",54,91,37
"SPIRE2","s1633_S_PIT_01_ASEReadCounter.table","NW_015090842.1:10177838",69,120,51
"SPIRE2","s1633_S_PIT_01_ASEReadCounter.table","NW_015090842.1:10178000",56,111,55
"SPIRE2","s1633_S_PIT_01_ASEReadCounter.table","NW_015090842.1:10178164",60,112,52
"SPIRE2","s1633_S_PIT_01_ASEReadCounter.table","NW_015090842.1:10178216",73,142,69
"SPIRE2","s1633_S_PIT_01_ASEReadCounter.table","NW_015090842.1:10178303",62,105,43
"SPIRE2","s1633_S_PIT_01_ASEReadCounter.table","NW_015090842.1:10178403",60,108,48
"SPIRE2","s1633_S_PIT_01_ASEReadCounter.table","NW_015090842.1:10178409",55,103,48
"SPIRE2","s1633_S_PIT_01_ASEReadCounter.table","NW_015090842.1:10178524",48,90,42
"SPIRE2","s1633_S_PIT_01_ASEReadCounter.table","NW_015090842.1:10178526",47,91,44
"SPIRE2","s1633_S_PIT_01_ASEReadCounter.table","NW_015090842.1:10178531",50,93,43
"SPIRE2","s1633_S_PIT_01_ASEReadCounter.table","NW_015090842.1:10178565",45,87,42
"SPIRE2","s1633_S_PIT_01_ASEReadCounter.table","NW_015090842.1:10178587",44,83,39
"SPIRE2","s1633_S_PIT_01_ASEReadCounter.table","NW_015090842.1:10178640",37,70,33
"SPIRE2","s1633_S_PIT_01_ASEReadCounter.table","NW_015090842.1:10178651",40,79,39
"SPIRE2","s1633_S_PIT_01_ASEReadCounter.table","NW_015090842.1:10178682",33,66,33
"TCF25","s1633_S_PIT_01_ASEReadCounter.table","NW_015090842.1:10180912",41,69,28
"TCF25","s1633_S_PIT_01_ASEReadCounter.table","NW_015090842.1:10180924",45,75,30
"TCF25","s1633_S_PIT_01_ASEReadCounter.table","NW_015090842.1:10180931",48,78,30
"TCF25","s1633_S_PIT_01_ASEReadCounter.table","NW_015090842.1:10185332",79,169,90
"TCF25","s1633_S_PIT_01_ASEReadCounter.table","NW_015090842.1:10196561",63,117,54
"TCF25","s1633_S_PIT_01_ASEReadCounter.table","NW_015090842.1:10197399",171,171,0
"TUBB3","s1633_S_PIT_01_ASEReadCounter.table","NW_015090842.1:10205322",0,32,32
"GAS8","s1633_S_PIT_01_ASEReadCounter.table","NW_015090842.1:10228982",51,89,38
"GAS8","s1633_S_PIT_01_ASEReadCounter.table","NW_015090842.1:10229832",34,62,28
"GAS8","s1633_S_PIT_01_ASEReadCounter.table","NW_015090842.1:10232901",31,64,33
"GAS8","s1633_S_PIT_01_ASEReadCounter.table","NW_015090842.1:10232928",35,70,35
"GAS8","s1633_S_PIT_01_ASEReadCounter.table","NW_015090842.1:10232967",30,69,39
"GAS8","s1633_S_PIT_01_ASEReadCounter.table","NW_015090842.1:10233032",20,51,31
"GAS8","s1633_S_PIT_01_ASEReadCounter.table","NW_015090842.1:10233057",18,42,24
"GAS8","s1633_S_PIT_01_ASEReadCounter.table","NW_015090842.1:10233058",18,41,23
"GAS8","s1633_S_PIT_01_ASEReadCounter.table","NW_015090842.1:10233176",8,28,20
"GAS8","s1633_S_PIT_01_ASEReadCounter.table","NW_015090842.1:10233196",11,29,18
"GAS8","s1633_S_PIT_01_ASEReadCounter.table","NW_015090842.1:10233252",9,18,9
"GAS8","s1633_S_PIT_01_ASEReadCounter.table","NW_015090842.1:10233303",3,8,5
"LOC106888094","s1633_S_PIT_01_ASEReadCounter.table","NW_015090842.1:10233334",1,3,2
"LOC106888094","s1633_S_PIT_01_ASEReadCounter.table","NW_015090842.1:10233362",2,8,6
"LOC106888094","s1633_S_PIT_01_ASEReadCounter.table","NW_015090842.1:10233373",2,10,8
"LOC106888094","s1633_S_PIT_01_ASEReadCounter.table","NW_015090842.1:10233388",7,18,11
"LOC106888094","s1633_S_PIT_01_ASEReadCounter.table","NW_015090842.1:10233402",7,19,12
"LOC106888094","s1633_S_PIT_01_ASEReadCounter.table","NW_015090842.1:10233465",9,28,19
"LOC106888094","s1633_S_PIT_01_ASEReadCounter.table","NW_015090842.1:10233803",8,28,20
"LOC106888094","s1633_S_PIT_01_ASEReadCounter.table","NW_015090842.1:10233815",6,22,16
"LOC106888094","s1633_S_PIT_01_ASEReadCounter.table","NW_015090842.1:10235484",1,2,1
"LOC106888094","s1633_S_PIT_01_ASEReadCounter.table","NW_015090842.1:10235611",1,3,2
"LOC106888094","s1633_S_PIT_01_ASEReadCounter.table","NW_015090842.1:10235977",4,4,0
"LOC106888094","s1633_S_PIT_01_ASEReadCounter.table","NW_015090842.1:10236098",3,8,5
"LOC106888094","s1633_S_PIT_01_ASEReadCounter.table","NW_015090842.1:10236161",1,6,5
"LOC106888094","s1633_S_PIT_01_ASEReadCounter.table","NW_015090842.1:10236380",1,2,1
"LOC106888094","s1633_S_PIT_01_ASEReadCounter.table","NW_015090842.1:10236388",1,1,0
"LOC106888094","s1633_S_PIT_01_ASEReadCounter.table","NW_015090842.1:10236425",1,1,0
"LOC106888094","s1633_S_PIT_01_ASEReadCounter.table","NW_015090842.1:10236426",1,1,0
"LOC106888094","s1633_S_PIT_01_ASEReadCounter.table","NW_015090842.1:10236603",0,2,2
"LOC106888173","s1633_S_PIT_01_ASEReadCounter.table","NW_015090842.1:10239596",22,28,6
"LOC106888173","s1633_S_PIT_01_ASEReadCounter.table","NW_015090842.1:10240036",74,94,20
"LOC106888173","s1633_S_PIT_01_ASEReadCounter.table","NW_015090842.1:10240095",81,97,16
"LOC106888173","s1633_S_PIT_01_ASEReadCounter.table","NW_015090842.1:10240280",67,85,18
"LOC106888173","s1633_S_PIT_01_ASEReadCounter.table","NW_015090842.1:10240557",82,104,22
"LOC106888173","s1633_S_PIT_01_ASEReadCounter.table","NW_015090842.1:10240603",98,118,20
"LOC106888173","s1633_S_PIT_01_ASEReadCounter.table","NW_015090842.1:10240609",98,117,19
"LOC106888173","s1633_S_PIT_01_ASEReadCounter.table","NW_015090842.1:10240924",74,93,19
"LOC106888173","s1633_S_PIT_01_ASEReadCounter.table","NW_015090842.1:10241037",49,69,20
"LOC106888173","s1633_S_PIT_01_ASEReadCounter.table","NW_015090842.1:10241046",58,77,19
"LOC106888173","s1633_S_PIT_01_ASEReadCounter.table","NW_015090842.1:10241058",67,86,19
"LOC106888173","s1633_S_PIT_01_ASEReadCounter.table","NW_015090842.1:10241064",76,97,21
"LOC106888173","s1633_S_PIT_01_ASEReadCounter.table","NW_015090842.1:10241163",71,89,18
"LOC106888173","s1633_S_PIT_01_ASEReadCounter.table","NW_015090842.1:10241803",116,139,23
"LOC106888173","s1633_S_PIT_01_ASEReadCounter.table","NW_015090842.1:10241827",108,131,23
"LOC106888173","s1633_S_PIT_01_ASEReadCounter.table","NW_015090842.1:10241869",116,142,26
"LOC106888173","s1633_S_PIT_01_ASEReadCounter.table","NW_015090842.1:10242079",101,122,21
"LOC106888173","s1633_S_PIT_01_ASEReadCounter.table","NW_015090842.1:10242103",89,111,22
"LOC106888173","s1633_S_PIT_01_ASEReadCounter.table","NW_015090842.1:10242157",97,121,24
"LOC106888173","s1633_S_PIT_01_ASEReadCounter.table","NW_015090842.1:10242455",112,140,28
"LOC106888173","s1633_S_PIT_01_ASEReadCounter.table","NW_015090842.1:10242481",116,144,28
"LOC106888173","s1633_S_PIT_01_ASEReadCounter.table","NW_015090842.1:10242590",102,122,20
"LOC106888173","s1633_S_PIT_01_ASEReadCounter.table","NW_015090842.1:10242794",84,103,19
"LOC106888173","s1633_S_PIT_01_ASEReadCounter.table","NW_015090842.1:10242909",71,89,18
"LOC106888173","s1633_S_PIT_01_ASEReadCounter.table","NW_015090842.1:10243094",97,116,19
"LOC106888173","s1633_S_PIT_01_ASEReadCounter.table","NW_015090842.1:10243133",83,98,15
"LOC106888173","s1633_S_PIT_01_ASEReadCounter.table","NW_015090842.1:10243273",102,119,17
"LOC106888173","s1633_S_PIT_01_ASEReadCounter.table","NW_015090842.1:10243278",105,122,17
"LOC106888173","s1633_S_PIT_01_ASEReadCounter.table","NW_015090842.1:10243281",106,124,18
"LOC106888173","s1633_S_PIT_01_ASEReadCounter.table","NW_015090842.1:10243347",84,85,1
"LOC106888173","s1633_S_PIT_01_ASEReadCounter.table","NW_015090842.1:10243353",69,77,8
"LOC106888173","s1633_S_PIT_01_ASEReadCounter.table","NW_015090842.1:10243363",57,63,6
"LOC106888173","s1633_S_PIT_01_ASEReadCounter.table","NW_015090842.1:10243365",58,64,6
"LOC106888173","s1633_S_PIT_01_ASEReadCounter.table","NW_015090842.1:10243529",71,84,13
"LOC106888173","s1633_S_PIT_01_ASEReadCounter.table","NW_015090842.1:10243566",106,129,23
"LOC106888173","s1633_S_PIT_01_ASEReadCounter.table","NW_015090842.1:10243605",94,122,28
"LOC106888173","s1633_S_PIT_01_ASEReadCounter.table","NW_015090842.1:10243614",97,125,28
"LOC106888173","s1633_S_PIT_01_ASEReadCounter.table","NW_015090842.1:10243615",95,123,28
"LOC106888173","s1633_S_PIT_01_ASEReadCounter.table","NW_015090842.1:10243640",69,94,25
"LOC106888173","s1633_S_PIT_01_ASEReadCounter.table","NW_015090842.1:10243680",59,75,16
"LOC106888173","s1633_S_PIT_01_ASEReadCounter.table","NW_015090842.1:10243742",92,105,13
"LOC106888173","s1633_S_PIT_01_ASEReadCounter.table","NW_015090842.1:10243804",72,81,9
"LOC106888173","s1633_S_PIT_01_ASEReadCounter.table","NW_015090842.1:10243913",24,32,8
"LOC106888173","s1633_S_PIT_01_ASEReadCounter.table","NW_015090842.1:10243921",23,29,6
"LOC106888384","s1633_S_PIT_01_ASEReadCounter.table","NW_015090842.1:10244714",1,7,6
"LOC106888384","s1633_S_PIT_01_ASEReadCounter.table","NW_015090842.1:10244998",5,13,8
"LOC106888384","s1633_S_PIT_01_ASEReadCounter.table","NW_015090842.1:10250743",5,19,14
"LOC106888384","s1633_S_PIT_01_ASEReadCounter.table","NW_015090842.1:10250771",6,23,17
"LOC106888384","s1633_S_PIT_01_ASEReadCounter.table","NW_015090842.1:10251343",9,9,0
"LOC106888384","s1633_S_PIT_01_ASEReadCounter.table","NW_015090842.1:10251344",9,9,0
"LOC106888384","s1633_S_PIT_01_ASEReadCounter.table","NW_015090842.1:10251349",8,8,0
"LOC106888384","s1633_S_PIT_01_ASEReadCounter.table","NW_015090842.1:10251354",8,32,24
"LOC106888384","s1633_S_PIT_01_ASEReadCounter.table","NW_015090842.1:10251358",7,32,25
"LOC106888384","s1633_S_PIT_01_ASEReadCounter.table","NW_015090842.1:10251369",6,35,29
"LOC106888384","s1633_S_PIT_01_ASEReadCounter.table","NW_015090842.1:10251370",9,34,25
"LOC106888384","s1633_S_PIT_01_ASEReadCounter.table","NW_015090842.1:10251375",8,33,25
"LOC106888384","s1633_S_PIT_01_ASEReadCounter.table","NW_015090842.1:10251388",6,27,21
"LOC106888384","s1633_S_PIT_01_ASEReadCounter.table","NW_015090842.1:10251390",6,27,21
"LOC106888384","s1633_S_PIT_01_ASEReadCounter.table","NW_015090842.1:10251393",5,26,21
"LOC106888384","s1633_S_PIT_01_ASEReadCounter.table","NW_015090842.1:10251399",7,28,21
"LOC106888384","s1633_S_PIT_01_ASEReadCounter.table","NW_015090842.1:10251492",14,14,0
"LOC106888384","s1633_S_PIT_01_ASEReadCounter.table","NW_015090842.1:10253165",17,32,15
"LOC106888384","s1633_S_PIT_01_ASEReadCounter.table","NW_015090842.1:10253284",11,25,14
"LOC106888384","s1633_S_PIT_01_ASEReadCounter.table","NW_015090842.1:10253605",31,31,0
"LOC106888384","s1633_S_PIT_01_ASEReadCounter.table","NW_015090842.1:10254028",6,26,20
"LOC106888384","s1633_S_PIT_01_ASEReadCounter.table","NW_015090842.1:10254227",9,36,27
"LOC106888384","s1633_S_PIT_01_ASEReadCounter.table","NW_015090842.1:10254233",12,41,29
"LOC106888384","s1633_S_PIT_01_ASEReadCounter.table","NW_015090842.1:10254263",16,44,28
"LOC106888384","s1633_S_PIT_01_ASEReadCounter.table","NW_015090842.1:10254293",13,38,25
"LOC106888384","s1633_S_PIT_01_ASEReadCounter.table","NW_015090842.1:10254570",13,34,21
"LOC106888384","s1633_S_PIT_01_ASEReadCounter.table","NW_015090842.1:10254647",9,20,11
"LOC106888384","s1633_S_PIT_01_ASEReadCounter.table","NW_015090842.1:10254663",7,15,8
"LOC106888384","s1633_S_PIT_01_ASEReadCounter.table","NW_015090842.1:10254840",2,9,7
"LOC106888384","s1633_S_PIT_01_ASEReadCounter.table","NW_015090842.1:10254854",14,14,0
"LOC106888384","s1633_S_PIT_01_ASEReadCounter.table","NW_015090842.1:10254891",16,16,0
"LOC106888384","s1633_S_PIT_01_ASEReadCounter.table","NW_015090842.1:10254900",3,15,12
"LOC106888384","s1633_S_PIT_01_ASEReadCounter.table","NW_015090842.1:10254915",4,21,17
"LOC106888384","s1633_S_PIT_01_ASEReadCounter.table","NW_015090842.1:10254965",10,10,0
"LOC106888384","s1633_S_PIT_01_ASEReadCounter.table","NW_015090842.1:10254975",3,11,8
"LOC106888384","s1633_S_PIT_01_ASEReadCounter.table","NW_015090842.1:10255077",6,23,17
"LOC106888384","s1633_S_PIT_01_ASEReadCounter.table","NW_015090842.1:10255117",5,19,14
"LOC106888384","s1633_S_PIT_01_ASEReadCounter.table","NW_015090842.1:10255138",4,16,12
"LOC106888384","s1633_S_PIT_01_ASEReadCounter.table","NW_015090842.1:10255139",4,14,10
"LOC106888384","s1633_S_PIT_01_ASEReadCounter.table","NW_015090842.1:10255209",8,15,7
"LOC106888384","s1633_S_PIT_01_ASEReadCounter.table","NW_015090842.1:10255211",8,16,8
"LOC106888384","s1633_S_PIT_01_ASEReadCounter.table","NW_015090842.1:10255236",8,17,9
"LOC106888384","s1633_S_PIT_01_ASEReadCounter.table","NW_015090842.1:10255262",6,13,7
"LOC106888384","s1633_S_PIT_01_ASEReadCounter.table","NW_015090842.1:10255264",5,15,10
"LOC106888384","s1633_S_PIT_01_ASEReadCounter.table","NW_015090842.1:10255306",7,24,17
"LOC106888384","s1633_S_PIT_01_ASEReadCounter.table","NW_015090842.1:10255340",9,28,19
"LOC106888384","s1633_S_PIT_01_ASEReadCounter.table","NW_015090842.1:10255410",9,26,17
"LOC106888384","s1633_S_PIT_01_ASEReadCounter.table","NW_015090842.1:10255449",9,29,20
"LOC106888384","s1633_S_PIT_01_ASEReadCounter.table","NW_015090842.1:10255496",10,30,20
"LOC106888384","s1633_S_PIT_01_ASEReadCounter.table","NW_015090842.1:10255505",9,29,20
"LOC106888384","s1633_S_PIT_01_ASEReadCounter.table","NW_015090842.1:10255531",9,31,22
"LOC106888384","s1633_S_PIT_01_ASEReadCounter.table","NW_015090842.1:10255608",7,26,19
"LOC106888384","s1633_S_PIT_01_ASEReadCounter.table","NW_015090842.1:10255614",7,25,18
"LOC106888384","s1633_S_PIT_01_ASEReadCounter.table","NW_015090842.1:10255704",9,27,18
"LOC106888384","s1633_S_PIT_01_ASEReadCounter.table","NW_015090842.1:10255731",10,26,16
"LOC106888384","s1633_S_PIT_01_ASEReadCounter.table","NW_015090842.1:10255771",8,19,11
"TANGO6","s1633_S_PIT_01_ASEReadCounter.table","NW_015090842.1:10257782",6,8,2
"TANGO6","s1633_S_PIT_01_ASEReadCounter.table","NW_015090842.1:10258162",12,14,2
"TANGO6","s1633_S_PIT_01_ASEReadCounter.table","NW_015090842.1:10258185",10,12,2
"TANGO6","s1633_S_PIT_01_ASEReadCounter.table","NW_015090842.1:10259267",11,17,6
"TANGO6","s1633_S_PIT_01_ASEReadCounter.table","NW_015090842.1:10260250",40,56,16
"TANGO6","s1633_S_PIT_01_ASEReadCounter.table","NW_015090842.1:10260979",27,38,11
"TANGO6","s1633_S_PIT_01_ASEReadCounter.table","NW_015090842.1:10261599",31,40,9
"TANGO6","s1633_S_PIT_01_ASEReadCounter.table","NW_015090842.1:10268425",48,63,15
"TANGO6","s1633_S_PIT_01_ASEReadCounter.table","NW_015090842.1:10269831",32,45,13
"TANGO6","s1633_S_PIT_01_ASEReadCounter.table","NW_015090842.1:10270813",37,50,13
"TANGO6","s1633_S_PIT_01_ASEReadCounter.table","NW_015090842.1:10273952",21,29,8
"TANGO6","s1633_S_PIT_01_ASEReadCounter.table","NW_015090842.1:10273970",20,28,8
"TANGO6","s1633_S_PIT_01_ASEReadCounter.table","NW_015090842.1:10274018",24,33,9
"TANGO6","s1633_S_PIT_01_ASEReadCounter.table","NW_015090842.1:10275974",23,33,10
"TANGO6","s1633_S_PIT_01_ASEReadCounter.table","NW_015090842.1:10275976",24,33,9
"TANGO6","s1633_S_PIT_01_ASEReadCounter.table","NW_015090842.1:10276123",22,30,8
"TANGO6","s1633_S_PIT_01_ASEReadCounter.table","NW_015090842.1:10276271",21,30,9
"TANGO6","s1633_S_PIT_01_ASEReadCounter.table","NW_015090842.1:10276272",21,30,9
"TANGO6","s1633_S_PIT_01_ASEReadCounter.table","NW_015090842.1:10276275",24,33,9
"TANGO6","s1633_S_PIT_01_ASEReadCounter.table","NW_015090842.1:10276278",24,33,9
"TANGO6","s1633_S_PIT_01_ASEReadCounter.table","NW_015090842.1:10276368",8,13,5
"TANGO6","s1633_S_PIT_01_ASEReadCounter.table","NW_015090842.1:10276373",8,14,6
"TANGO6","s1633_S_PIT_01_ASEReadCounter.table","NW_015090842.1:10276630",16,21,5
"TANGO6","s1633_S_PIT_01_ASEReadCounter.table","NW_015090842.1:10281498",22,34,12
"TANGO6","s1633_S_PIT_01_ASEReadCounter.table","NW_015090842.1:10282842",24,35,11
"TANGO6","s1633_S_PIT_01_ASEReadCounter.table","NW_015090842.1:10282863",17,27,10
"TANGO6","s1633_S_PIT_01_ASEReadCounter.table","NW_015090842.1:10282869",19,29,10
"TANGO6","s1633_S_PIT_01_ASEReadCounter.table","NW_015090842.1:10282903",23,34,11
"TANGO6","s1633_S_PIT_01_ASEReadCounter.table","NW_015090842.1:10283757",31,43,12
"TANGO6","s1633_S_PIT_01_ASEReadCounter.table","NW_015090842.1:10283785",35,42,7
"HAS3","s1633_S_PIT_01_ASEReadCounter.table","NW_015090842.1:10288266",1,1,0
"HAS3","s1633_S_PIT_01_ASEReadCounter.table","NW_015090842.1:10288274",1,1,0
"HAS3","s1633_S_PIT_01_ASEReadCounter.table","NW_015090842.1:10288364",1,1,0
"HAS3","s1633_S_PIT_01_ASEReadCounter.table","NW_015090842.1:10288405",1,1,0
"HAS3","s1633_S_PIT_01_ASEReadCounter.table","NW_015090842.1:10290609",1,1,0
"HAS3","s1633_S_PIT_01_ASEReadCounter.table","NW_015090842.1:10290666",1,1,0
"HAS3","s1633_S_PIT_01_ASEReadCounter.table","NW_015090842.1:10290927",3,4,1
"HAS3","s1633_S_PIT_01_ASEReadCounter.table","NW_015090842.1:10291004",4,4,0
"CHTF8","s1633_S_PIT_01_ASEReadCounter.table","NW_015090842.1:10291319",1,5,4
"CHTF8","s1633_S_PIT_01_ASEReadCounter.table","NW_015090842.1:10291342",3,7,4
"CHTF8","s1633_S_PIT_01_ASEReadCounter.table","NW_015090842.1:10291491",17,29,12
"CHTF8","s1633_S_PIT_01_ASEReadCounter.table","NW_015090842.1:10291520",21,40,19
"CHTF8","s1633_S_PIT_01_ASEReadCounter.table","NW_015090842.1:10291593",27,43,16
"CHTF8","s1633_S_PIT_01_ASEReadCounter.table","NW_015090842.1:10291600",23,37,14
"CHTF8","s1633_S_PIT_01_ASEReadCounter.table","NW_015090842.1:10291609",20,35,15
"CHTF8","s1633_S_PIT_01_ASEReadCounter.table","NW_015090842.1:10291639",20,35,15
"CHTF8","s1633_S_PIT_01_ASEReadCounter.table","NW_015090842.1:10291641",20,36,16
"CHTF8","s1633_S_PIT_01_ASEReadCounter.table","NW_015090842.1:10291648",22,38,16
"CHTF8","s1633_S_PIT_01_ASEReadCounter.table","NW_015090842.1:10291656",22,35,13
"CHTF8","s1633_S_PIT_01_ASEReadCounter.table","NW_015090842.1:10291675",19,33,14
"CHTF8","s1633_S_PIT_01_ASEReadCounter.table","NW_015090842.1:10291696",17,32,15
"CHTF8","s1633_S_PIT_01_ASEReadCounter.table","NW_015090842.1:10291714",16,27,11
"CHTF8","s1633_S_PIT_01_ASEReadCounter.table","NW_015090842.1:10291732",22,34,12
"CHTF8","s1633_S_PIT_01_ASEReadCounter.table","NW_015090842.1:10291755",22,32,10
"CHTF8","s1633_S_PIT_01_ASEReadCounter.table","NW_015090842.1:10291756",22,31,9
"CHTF8","s1633_S_PIT_01_ASEReadCounter.table","NW_015090842.1:10291758",22,33,11
"CHTF8","s1633_S_PIT_01_ASEReadCounter.table","NW_015090842.1:10291792",27,38,11
"CHTF8","s1633_S_PIT_01_ASEReadCounter.table","NW_015090842.1:10291895",20,30,10
"CHTF8","s1633_S_PIT_01_ASEReadCounter.table","NW_015090842.1:10292132",9,21,12
"CHTF8","s1633_S_PIT_01_ASEReadCounter.table","NW_015090842.1:10292314",20,31,11
"CHTF8","s1633_S_PIT_01_ASEReadCounter.table","NW_015090842.1:10292317",19,30,11
"CHTF8","s1633_S_PIT_01_ASEReadCounter.table","NW_015090842.1:10292928",4,5,1
"UTP4","s1633_S_PIT_01_ASEReadCounter.table","NW_015090842.1:10293146",45,83,38
"UTP4","s1633_S_PIT_01_ASEReadCounter.table","NW_015090842.1:10293151",41,78,37
"UTP4","s1633_S_PIT_01_ASEReadCounter.table","NW_015090842.1:10293191",26,48,22
"UTP4","s1633_S_PIT_01_ASEReadCounter.table","NW_015090842.1:10293362",37,81,44
"UTP4","s1633_S_PIT_01_ASEReadCounter.table","NW_015090842.1:10293430",22,58,36
"UTP4","s1633_S_PIT_01_ASEReadCounter.table","NW_015090842.1:10293625",29,53,24
"UTP4","s1633_S_PIT_01_ASEReadCounter.table","NW_015090842.1:10293684",33,60,27
"UTP4","s1633_S_PIT_01_ASEReadCounter.table","NW_015090842.1:10294093",24,48,24
"UTP4","s1633_S_PIT_01_ASEReadCounter.table","NW_015090842.1:10294568",43,75,32
"UTP4","s1633_S_PIT_01_ASEReadCounter.table","NW_015090842.1:10294622",35,61,26
"UTP4","s1633_S_PIT_01_ASEReadCounter.table","NW_015090842.1:10294632",37,63,26
"UTP4","s1633_S_PIT_01_ASEReadCounter.table","NW_015090842.1:10295238",26,53,27
"UTP4","s1633_S_PIT_01_ASEReadCounter.table","NW_015090842.1:10295880",38,80,42
"UTP4","s1633_S_PIT_01_ASEReadCounter.table","NW_015090842.1:10295884",39,83,44
"UTP4","s1633_S_PIT_01_ASEReadCounter.table","NW_015090842.1:10295903",32,68,36
"UTP4","s1633_S_PIT_01_ASEReadCounter.table","NW_015090842.1:10295906",30,65,35
"UTP4","s1633_S_PIT_01_ASEReadCounter.table","NW_015090842.1:10295915",31,66,35
"UTP4","s1633_S_PIT_01_ASEReadCounter.table","NW_015090842.1:10295938",27,66,39
"UTP4","s1633_S_PIT_01_ASEReadCounter.table","NW_015090842.1:10296175",28,58,30
"UTP4","s1633_S_PIT_01_ASEReadCounter.table","NW_015090842.1:10296660",31,52,21
"UTP4","s1633_S_PIT_01_ASEReadCounter.table","NW_015090842.1:10296679",27,45,18
"UTP4","s1633_S_PIT_01_ASEReadCounter.table","NW_015090842.1:10297193",34,68,34
"UTP4","s1633_S_PIT_01_ASEReadCounter.table","NW_015090842.1:10297220",38,73,35
"UTP4","s1633_S_PIT_01_ASEReadCounter.table","NW_015090842.1:10297307",47,84,37
"UTP4","s1633_S_PIT_01_ASEReadCounter.table","NW_015090842.1:10297558",40,69,29
"UTP4","s1633_S_PIT_01_ASEReadCounter.table","NW_015090842.1:10297943",29,53,24
"UTP4","s1633_S_PIT_01_ASEReadCounter.table","NW_015090842.1:10297979",26,50,24
"UTP4","s1633_S_PIT_01_ASEReadCounter.table","NW_015090842.1:10298022",14,33,19
"UTP4","s1633_S_PIT_01_ASEReadCounter.table","NW_015090842.1:10298079",3,11,8
"UTP4","s1633_S_PIT_01_ASEReadCounter.table","NW_015090842.1:10298081",3,10,7
"UTP4","s1633_S_PIT_01_ASEReadCounter.table","NW_015090842.1:10298082",2,10,8
"SNTB2","s1633_S_PIT_01_ASEReadCounter.table","NW_015090842.1:10298905",6,14,8
"SNTB2","s1633_S_PIT_01_ASEReadCounter.table","NW_015090842.1:10298928",9,19,10
"SNTB2","s1633_S_PIT_01_ASEReadCounter.table","NW_015090842.1:10303506",37,78,41
"SNTB2","s1633_S_PIT_01_ASEReadCounter.table","NW_015090842.1:10303524",31,70,39
"SNTB2","s1633_S_PIT_01_ASEReadCounter.table","NW_015090842.1:10304059",37,73,36
"SNTB2","s1633_S_PIT_01_ASEReadCounter.table","NW_015090842.1:10304089",38,73,35
"SNTB2","s1633_S_PIT_01_ASEReadCounter.table","NW_015090842.1:10304167",31,66,35
"SNTB2","s1633_S_PIT_01_ASEReadCounter.table","NW_015090842.1:10304176",30,60,30
"SNTB2","s1633_S_PIT_01_ASEReadCounter.table","NW_015090842.1:10305069",26,55,29
"SNTB2","s1633_S_PIT_01_ASEReadCounter.table","NW_015090842.1:10305099",31,65,34
"SNTB2","s1633_S_PIT_01_ASEReadCounter.table","NW_015090842.1:10305451",24,53,29
"SNTB2","s1633_S_PIT_01_ASEReadCounter.table","NW_015090842.1:10305547",36,79,43
"SNTB2","s1633_S_PIT_01_ASEReadCounter.table","NW_015090842.1:10305847",33,63,30
"SNTB2","s1633_S_PIT_01_ASEReadCounter.table","NW_015090842.1:10305911",34,73,39
"SNTB2","s1633_S_PIT_01_ASEReadCounter.table","NW_015090842.1:10306173",34,73,39
"SNTB2","s1633_S_PIT_01_ASEReadCounter.table","NW_015090842.1:10306275",12,42,30
"SNTB2","s1633_S_PIT_01_ASEReadCounter.table","NW_015090842.1:10306457",25,81,56
"SNTB2","s1633_S_PIT_01_ASEReadCounter.table","NW_015090842.1:10306496",34,86,52
"SNTB2","s1633_S_PIT_01_ASEReadCounter.table","NW_015090842.1:10306499",33,76,43
"VPS4A","s1633_S_PIT_01_ASEReadCounter.table","NW_015090842.1:10308566",76,178,102
"VPS4A","s1633_S_PIT_01_ASEReadCounter.table","NW_015090842.1:10308573",77,189,112
"VPS4A","s1633_S_PIT_01_ASEReadCounter.table","NW_015090842.1:10308856",117,283,166
"VPS4A","s1633_S_PIT_01_ASEReadCounter.table","NW_015090842.1:10309056",138,345,207
"VPS4A","s1633_S_PIT_01_ASEReadCounter.table","NW_015090842.1:10309089",174,379,205
"VPS4A","s1633_S_PIT_01_ASEReadCounter.table","NW_015090842.1:10309392",158,334,176
"VPS4A","s1633_S_PIT_01_ASEReadCounter.table","NW_015090842.1:10309413",164,356,192
"VPS4A","s1633_S_PIT_01_ASEReadCounter.table","NW_015090842.1:10309467",174,433,259
"VPS4A","s1633_S_PIT_01_ASEReadCounter.table","NW_015090842.1:10310230",191,402,211
"VPS4A","s1633_S_PIT_01_ASEReadCounter.table","NW_015090842.1:10310425",194,355,161
"VPS4A","s1633_S_PIT_01_ASEReadCounter.table","NW_015090842.1:10310639",167,385,218
"VPS4A","s1633_S_PIT_01_ASEReadCounter.table","NW_015090842.1:10310640",382,382,0
"VPS4A","s1633_S_PIT_01_ASEReadCounter.table","NW_015090842.1:10310687",197,411,214
"VPS4A","s1633_S_PIT_01_ASEReadCounter.table","NW_015090842.1:10310734",167,330,163
"VPS4A","s1633_S_PIT_01_ASEReadCounter.table","NW_015090842.1:10310737",163,327,164
"VPS4A","s1633_S_PIT_01_ASEReadCounter.table","NW_015090842.1:10310746",170,326,156
"VPS4A","s1633_S_PIT_01_ASEReadCounter.table","NW_015090842.1:10310767",166,317,151
"VPS4A","s1633_S_PIT_01_ASEReadCounter.table","NW_015090842.1:10310995",145,312,167
"VPS4A","s1633_S_PIT_01_ASEReadCounter.table","NW_015090842.1:10311004",147,302,155
"VPS4A","s1633_S_PIT_01_ASEReadCounter.table","NW_015090842.1:10311007",150,318,168
"VPS4A","s1633_S_PIT_01_ASEReadCounter.table","NW_015090842.1:10311013",165,329,164
"VPS4A","s1633_S_PIT_01_ASEReadCounter.table","NW_015090842.1:10311022",152,315,163
"VPS4A","s1633_S_PIT_01_ASEReadCounter.table","NW_015090842.1:10311023",151,311,160
"VPS4A","s1633_S_PIT_01_ASEReadCounter.table","NW_015090842.1:10311426",152,335,183
"VPS4A","s1633_S_PIT_01_ASEReadCounter.table","NW_015090842.1:10311489",3,9,6
"VPS4A","s1633_S_PIT_01_ASEReadCounter.table","NW_015090842.1:10311490",3,9,6
"VPS4A","s1633_S_PIT_01_ASEReadCounter.table","NW_015090842.1:10311525",10,20,10
"VPS4A","s1633_S_PIT_01_ASEReadCounter.table","NW_015090842.1:10311529",10,21,11
"VPS4A","s1633_S_PIT_01_ASEReadCounter.table","NW_015090842.1:10311530",10,21,11
"VPS4A","s1633_S_PIT_01_ASEReadCounter.table","NW_015090842.1:10311552",17,38,21
"VPS4A","s1633_S_PIT_01_ASEReadCounter.table","NW_015090842.1:10311689",7,30,23
"VPS4A","s1633_S_PIT_01_ASEReadCounter.table","NW_015090842.1:10311700",14,36,22
"VPS4A","s1633_S_PIT_01_ASEReadCounter.table","NW_015090842.1:10311701",14,36,22
"VPS4A","s1633_S_PIT_01_ASEReadCounter.table","NW_015090842.1:10311703",14,36,22
"COG8","s1633_S_PIT_01_ASEReadCounter.table","NW_015090842.1:10313487",23,53,30
"COG8","s1633_S_PIT_01_ASEReadCounter.table","NW_015090842.1:10313559",33,71,38
"COG8","s1633_S_PIT_01_ASEReadCounter.table","NW_015090842.1:10313579",29,64,35
"COG8","s1633_S_PIT_01_ASEReadCounter.table","NW_015090842.1:10313665",34,69,35
"COG8","s1633_S_PIT_01_ASEReadCounter.table","NW_015090842.1:10313681",35,73,38
"COG8","s1633_S_PIT_01_ASEReadCounter.table","NW_015090842.1:10313768",47,92,45
"COG8","s1633_S_PIT_01_ASEReadCounter.table","NW_015090842.1:10313775",47,92,45
"COG8","s1633_S_PIT_01_ASEReadCounter.table","NW_015090842.1:10313811",30,64,34
"COG8","s1633_S_PIT_01_ASEReadCounter.table","NW_015090842.1:10313858",17,43,26
"COG8","s1633_S_PIT_01_ASEReadCounter.table","NW_015090842.1:10313859",43,43,0
"COG8","s1633_S_PIT_01_ASEReadCounter.table","NW_015090842.1:10314100",41,84,43
"COG8","s1633_S_PIT_01_ASEReadCounter.table","NW_015090842.1:10314213",36,78,42
"COG8","s1633_S_PIT_01_ASEReadCounter.table","NW_015090842.1:10315093",31,64,33
"COG8","s1633_S_PIT_01_ASEReadCounter.table","NW_015090842.1:10315162",37,68,31
"COG8","s1633_S_PIT_01_ASEReadCounter.table","NW_015090842.1:10315285",39,81,42
"COG8","s1633_S_PIT_01_ASEReadCounter.table","NW_015090842.1:10315360",36,64,28
"COG8","s1633_S_PIT_01_ASEReadCounter.table","NW_015090842.1:10315369",40,73,33
"COG8","s1633_S_PIT_01_ASEReadCounter.table","NW_015090842.1:10315508",23,42,19
"COG8","s1633_S_PIT_01_ASEReadCounter.table","NW_015090842.1:10315624",41,77,36
"COG8","s1633_S_PIT_01_ASEReadCounter.table","NW_015090842.1:10315693",41,75,34
"COG8","s1633_S_PIT_01_ASEReadCounter.table","NW_015090842.1:10315698",39,71,32
"COG8","s1633_S_PIT_01_ASEReadCounter.table","NW_015090842.1:10315768",30,65,35
"COG8","s1633_S_PIT_01_ASEReadCounter.table","NW_015090842.1:10315769",29,63,34
"COG8","s1633_S_PIT_01_ASEReadCounter.table","NW_015090842.1:10315784",30,64,34
"COG8","s1633_S_PIT_01_ASEReadCounter.table","NW_015090842.1:10316093",28,58,30
"COG8","s1633_S_PIT_01_ASEReadCounter.table","NW_015090842.1:10316133",16,44,28
"NIP7","s1633_S_PIT_01_ASEReadCounter.table","NW_015090842.1:10316759",16,38,22
"NIP7","s1633_S_PIT_01_ASEReadCounter.table","NW_015090842.1:10316967",65,161,96
"NIP7","s1633_S_PIT_01_ASEReadCounter.table","NW_015090842.1:10316995",72,181,109
"NIP7","s1633_S_PIT_01_ASEReadCounter.table","NW_015090842.1:10317240",107,240,133
"NIP7","s1633_S_PIT_01_ASEReadCounter.table","NW_015090842.1:10317247",106,231,125
"NIP7","s1633_S_PIT_01_ASEReadCounter.table","NW_015090842.1:10317264",100,210,110
"NIP7","s1633_S_PIT_01_ASEReadCounter.table","NW_015090842.1:10317433",103,225,122
"NIP7","s1633_S_PIT_01_ASEReadCounter.table","NW_015090842.1:10317738",67,181,114
"NIP7","s1633_S_PIT_01_ASEReadCounter.table","NW_015090842.1:10317769",63,178,115
"NIP7","s1633_S_PIT_01_ASEReadCounter.table","NW_015090842.1:10317808",44,119,75
"NIP7","s1633_S_PIT_01_ASEReadCounter.table","NW_015090842.1:10317870",45,93,48
"NIP7","s1633_S_PIT_01_ASEReadCounter.table","NW_015090842.1:10317871",45,91,46
"NIP7","s1633_S_PIT_01_ASEReadCounter.table","NW_015090842.1:10317898",34,66,32
"NIP7","s1633_S_PIT_01_ASEReadCounter.table","NW_015090842.1:10317911",30,54,24
"TMED6","s1633_S_PIT_01_ASEReadCounter.table","NW_015090842.1:10318514",3,4,1
"TMED6","s1633_S_PIT_01_ASEReadCounter.table","NW_015090842.1:10318731",5,6,1
"TERF2","s1633_S_PIT_01_ASEReadCounter.table","NW_015090842.1:10321768",20,49,29
"TERF2","s1633_S_PIT_01_ASEReadCounter.table","NW_015090842.1:10321777",19,49,30
"TERF2","s1633_S_PIT_01_ASEReadCounter.table","NW_015090842.1:10321805",11,44,33
"TERF2","s1633_S_PIT_01_ASEReadCounter.table","NW_015090842.1:10321878",35,76,41
"TERF2","s1633_S_PIT_01_ASEReadCounter.table","NW_015090842.1:10321893",32,71,39
"TERF2","s1633_S_PIT_01_ASEReadCounter.table","NW_015090842.1:10321897",33,68,35
"TERF2","s1633_S_PIT_01_ASEReadCounter.table","NW_015090842.1:10321908",31,68,37
"TERF2","s1633_S_PIT_01_ASEReadCounter.table","NW_015090842.1:10322001",37,85,48
"TERF2","s1633_S_PIT_01_ASEReadCounter.table","NW_015090842.1:10322035",31,73,42
"TERF2","s1633_S_PIT_01_ASEReadCounter.table","NW_015090842.1:10322051",29,71,42
"TERF2","s1633_S_PIT_01_ASEReadCounter.table","NW_015090842.1:10322137",42,72,30
"TERF2","s1633_S_PIT_01_ASEReadCounter.table","NW_015090842.1:10322144",46,73,27
"TERF2","s1633_S_PIT_01_ASEReadCounter.table","NW_015090842.1:10322388",24,75,51
"TERF2","s1633_S_PIT_01_ASEReadCounter.table","NW_015090842.1:10322396",24,67,43
"TERF2","s1633_S_PIT_01_ASEReadCounter.table","NW_015090842.1:10322502",50,98,48
"TERF2","s1633_S_PIT_01_ASEReadCounter.table","NW_015090842.1:10322504",49,99,50
"TERF2","s1633_S_PIT_01_ASEReadCounter.table","NW_015090842.1:10322510",50,102,52
"TERF2","s1633_S_PIT_01_ASEReadCounter.table","NW_015090842.1:10323580",47,99,52
"TERF2","s1633_S_PIT_01_ASEReadCounter.table","NW_015090842.1:10324314",39,87,48
"TERF2","s1633_S_PIT_01_ASEReadCounter.table","NW_015090842.1:10326832",38,81,43
"TERF2","s1633_S_PIT_01_ASEReadCounter.table","NW_015090842.1:10327787",23,60,37
"TERF2","s1633_S_PIT_01_ASEReadCounter.table","NW_015090842.1:10328588",44,84,40
"TERF2","s1633_S_PIT_01_ASEReadCounter.table","NW_015090842.1:10328644",29,67,38
"TERF2","s1633_S_PIT_01_ASEReadCounter.table","NW_015090842.1:10329813",29,54,25
"TERF2","s1633_S_PIT_01_ASEReadCounter.table","NW_015090842.1:10330749",36,67,31
"TERF2","s1633_S_PIT_01_ASEReadCounter.table","NW_015090842.1:10330789",36,70,34
"CYB5B","s1633_S_PIT_01_ASEReadCounter.table","NW_015090842.1:10336595",9,27,18
"CYB5B","s1633_S_PIT_01_ASEReadCounter.table","NW_015090842.1:10336667",86,188,102
"CYB5B","s1633_S_PIT_01_ASEReadCounter.table","NW_015090842.1:10336689",128,279,151
"CYB5B","s1633_S_PIT_01_ASEReadCounter.table","NW_015090842.1:10336728",180,396,216
"CYB5B","s1633_S_PIT_01_ASEReadCounter.table","NW_015090842.1:10345068",179,432,253
"CYB5B","s1633_S_PIT_01_ASEReadCounter.table","NW_015090842.1:10348800",243,513,270
"CYB5B","s1633_S_PIT_01_ASEReadCounter.table","NW_015090842.1:10349046",153,352,199
"CYB5B","s1633_S_PIT_01_ASEReadCounter.table","NW_015090842.1:10349119",105,295,190
"CYB5B","s1633_S_PIT_01_ASEReadCounter.table","NW_015090842.1:10349146",55,243,188
"CYB5B","s1633_S_PIT_01_ASEReadCounter.table","NW_015090842.1:10349157",93,282,189
"CYB5B","s1633_S_PIT_01_ASEReadCounter.table","NW_015090842.1:10349263",275,275,0
