"gene","id","snp","ref_count","total_count","alt_count"
"CENPN","s1633_S_TNA_03_ASEReadCounter.table","NW_015090842.1:5801655",1,2,1
"CENPN","s1633_S_TNA_03_ASEReadCounter.table","NW_015090842.1:5801670",1,2,1
"CENPN","s1633_S_TNA_03_ASEReadCounter.table","NW_015090842.1:5801674",1,2,1
"CENPN","s1633_S_TNA_03_ASEReadCounter.table","NW_015090842.1:5801692",1,3,2
"CENPN","s1633_S_TNA_03_ASEReadCounter.table","NW_015090842.1:5802008",0,4,4
"CENPN","s1633_S_TNA_03_ASEReadCounter.table","NW_015090842.1:5802012",0,4,4
"CENPN","s1633_S_TNA_03_ASEReadCounter.table","NW_015090842.1:5802087",3,7,4
"CENPN","s1633_S_TNA_03_ASEReadCounter.table","NW_015090842.1:5810113",5,5,0
"CENPN","s1633_S_TNA_03_ASEReadCounter.table","NW_015090842.1:5810147",9,9,0
"CENPN","s1633_S_TNA_03_ASEReadCounter.table","NW_015090842.1:5810148",9,9,0
"ATMIN","s1633_S_TNA_03_ASEReadCounter.table","NW_015090842.1:5818789",3,5,2
"ATMIN","s1633_S_TNA_03_ASEReadCounter.table","NW_015090842.1:5819958",3,6,3
"ATMIN","s1633_S_TNA_03_ASEReadCounter.table","NW_015090842.1:5820004",0,4,4
"ATMIN","s1633_S_TNA_03_ASEReadCounter.table","NW_015090842.1:5820217",2,2,0
"ATMIN","s1633_S_TNA_03_ASEReadCounter.table","NW_015090842.1:5820250",2,3,1
"ATMIN","s1633_S_TNA_03_ASEReadCounter.table","NW_015090842.1:5820298",2,3,1
"ATMIN","s1633_S_TNA_03_ASEReadCounter.table","NW_015090842.1:5820417",1,3,2
"ATMIN","s1633_S_TNA_03_ASEReadCounter.table","NW_015090842.1:5820421",1,3,2
"ATMIN","s1633_S_TNA_03_ASEReadCounter.table","NW_015090842.1:5820448",1,2,1
"ATMIN","s1633_S_TNA_03_ASEReadCounter.table","NW_015090842.1:5820457",1,2,1
"ATMIN","s1633_S_TNA_03_ASEReadCounter.table","NW_015090842.1:5820510",2,3,1
"ATMIN","s1633_S_TNA_03_ASEReadCounter.table","NW_015090842.1:5820673",3,5,2
"ATMIN","s1633_S_TNA_03_ASEReadCounter.table","NW_015090842.1:5820754",0,1,1
"ATMIN","s1633_S_TNA_03_ASEReadCounter.table","NW_015090842.1:5820820",0,1,1
"ATMIN","s1633_S_TNA_03_ASEReadCounter.table","NW_015090842.1:5820865",1,3,2
"ATMIN","s1633_S_TNA_03_ASEReadCounter.table","NW_015090842.1:5820889",1,5,4
"ATMIN","s1633_S_TNA_03_ASEReadCounter.table","NW_015090842.1:5820891",1,5,4
"ATMIN","s1633_S_TNA_03_ASEReadCounter.table","NW_015090842.1:5820997",3,6,3
"ATMIN","s1633_S_TNA_03_ASEReadCounter.table","NW_015090842.1:5821063",3,6,3
"ATMIN","s1633_S_TNA_03_ASEReadCounter.table","NW_015090842.1:5821132",4,8,4
"ATMIN","s1633_S_TNA_03_ASEReadCounter.table","NW_015090842.1:5821645",4,7,3
"ATMIN","s1633_S_TNA_03_ASEReadCounter.table","NW_015090842.1:5825066",9,22,13
"ATMIN","s1633_S_TNA_03_ASEReadCounter.table","NW_015090842.1:5825106",12,29,17
"ATMIN","s1633_S_TNA_03_ASEReadCounter.table","NW_015090842.1:5825122",12,23,11
"ATMIN","s1633_S_TNA_03_ASEReadCounter.table","NW_015090842.1:5825178",10,21,11
"ATMIN","s1633_S_TNA_03_ASEReadCounter.table","NW_015090842.1:5825194",10,21,11
"ATMIN","s1633_S_TNA_03_ASEReadCounter.table","NW_015090842.1:5825195",10,21,11
"ATMIN","s1633_S_TNA_03_ASEReadCounter.table","NW_015090842.1:5825220",7,22,15
"ATMIN","s1633_S_TNA_03_ASEReadCounter.table","NW_015090842.1:5825240",11,28,17
"ATMIN","s1633_S_TNA_03_ASEReadCounter.table","NW_015090842.1:5825303",15,35,20
"ATMIN","s1633_S_TNA_03_ASEReadCounter.table","NW_015090842.1:5825304",15,35,20
"ATMIN","s1633_S_TNA_03_ASEReadCounter.table","NW_015090842.1:5825310",15,36,21
"ATMIN","s1633_S_TNA_03_ASEReadCounter.table","NW_015090842.1:5825406",15,34,19
"ATMIN","s1633_S_TNA_03_ASEReadCounter.table","NW_015090842.1:5825415",16,33,17
"ATMIN","s1633_S_TNA_03_ASEReadCounter.table","NW_015090842.1:5825438",18,37,19
"ATMIN","s1633_S_TNA_03_ASEReadCounter.table","NW_015090842.1:5825485",11,28,17
"ATMIN","s1633_S_TNA_03_ASEReadCounter.table","NW_015090842.1:5825524",10,30,20
"ATMIN","s1633_S_TNA_03_ASEReadCounter.table","NW_015090842.1:5825557",12,36,24
"ATMIN","s1633_S_TNA_03_ASEReadCounter.table","NW_015090842.1:5825571",13,39,26
"ATMIN","s1633_S_TNA_03_ASEReadCounter.table","NW_015090842.1:5825579",13,41,28
"ATMIN","s1633_S_TNA_03_ASEReadCounter.table","NW_015090842.1:5825590",12,36,24
"ATMIN","s1633_S_TNA_03_ASEReadCounter.table","NW_015090842.1:5825689",15,41,26
"ATMIN","s1633_S_TNA_03_ASEReadCounter.table","NW_015090842.1:5825703",16,45,29
"ATMIN","s1633_S_TNA_03_ASEReadCounter.table","NW_015090842.1:5825787",13,47,34
"ATMIN","s1633_S_TNA_03_ASEReadCounter.table","NW_015090842.1:5825833",12,43,31
"ATMIN","s1633_S_TNA_03_ASEReadCounter.table","NW_015090842.1:5825841",13,41,28
"ATMIN","s1633_S_TNA_03_ASEReadCounter.table","NW_015090842.1:5825895",23,52,29
"ATMIN","s1633_S_TNA_03_ASEReadCounter.table","NW_015090842.1:5825984",20,50,30
"ATMIN","s1633_S_TNA_03_ASEReadCounter.table","NW_015090842.1:5826162",27,54,27
"ATMIN","s1633_S_TNA_03_ASEReadCounter.table","NW_015090842.1:5826194",31,55,24
"ATMIN","s1633_S_TNA_03_ASEReadCounter.table","NW_015090842.1:5826235",36,72,36
"ATMIN","s1633_S_TNA_03_ASEReadCounter.table","NW_015090842.1:5826245",33,70,37
"ATMIN","s1633_S_TNA_03_ASEReadCounter.table","NW_015090842.1:5826335",19,38,19
"ATMIN","s1633_S_TNA_03_ASEReadCounter.table","NW_015090842.1:5826417",28,49,21
"ATMIN","s1633_S_TNA_03_ASEReadCounter.table","NW_015090842.1:5826431",21,59,38
"ATMIN","s1633_S_TNA_03_ASEReadCounter.table","NW_015090842.1:5826438",27,55,28
"ATMIN","s1633_S_TNA_03_ASEReadCounter.table","NW_015090842.1:5826463",34,66,32
"ATMIN","s1633_S_TNA_03_ASEReadCounter.table","NW_015090842.1:5826502",40,74,34
"ATMIN","s1633_S_TNA_03_ASEReadCounter.table","NW_015090842.1:5826511",40,75,35
"ATMIN","s1633_S_TNA_03_ASEReadCounter.table","NW_015090842.1:5826659",32,70,38
"ATMIN","s1633_S_TNA_03_ASEReadCounter.table","NW_015090842.1:5826701",35,78,43
"ATMIN","s1633_S_TNA_03_ASEReadCounter.table","NW_015090842.1:5826702",35,78,43
"ATMIN","s1633_S_TNA_03_ASEReadCounter.table","NW_015090842.1:5826732",44,89,45
"ATMIN","s1633_S_TNA_03_ASEReadCounter.table","NW_015090842.1:5826745",43,94,51
"ATMIN","s1633_S_TNA_03_ASEReadCounter.table","NW_015090842.1:5826835",49,101,52
"ATMIN","s1633_S_TNA_03_ASEReadCounter.table","NW_015090842.1:5826910",36,75,39
"ATMIN","s1633_S_TNA_03_ASEReadCounter.table","NW_015090842.1:5826942",25,76,51
"ATMIN","s1633_S_TNA_03_ASEReadCounter.table","NW_015090842.1:5827193",62,145,83
"ATMIN","s1633_S_TNA_03_ASEReadCounter.table","NW_015090842.1:5827196",60,143,83
"ATMIN","s1633_S_TNA_03_ASEReadCounter.table","NW_015090842.1:5827269",70,155,85
"ATMIN","s1633_S_TNA_03_ASEReadCounter.table","NW_015090842.1:5827315",62,121,59
"ATMIN","s1633_S_TNA_03_ASEReadCounter.table","NW_015090842.1:5827316",61,124,63
"ATMIN","s1633_S_TNA_03_ASEReadCounter.table","NW_015090842.1:5827333",63,124,61
"PPP1R3E","s1633_S_TNA_03_ASEReadCounter.table","NW_015090842.1:5837733",1,2,1
"PPP1R3E","s1633_S_TNA_03_ASEReadCounter.table","NW_015090842.1:5837947",0,2,2
"PKD1L2","s1633_S_TNA_03_ASEReadCounter.table","NW_015090842.1:5867660",2,3,1
"PKD1L2","s1633_S_TNA_03_ASEReadCounter.table","NW_015090842.1:5867675",2,3,1
"PKD1L2","s1633_S_TNA_03_ASEReadCounter.table","NW_015090842.1:5867788",1,2,1
"PKD1L2","s1633_S_TNA_03_ASEReadCounter.table","NW_015090842.1:5867843",0,1,1
"BCO1","s1633_S_TNA_03_ASEReadCounter.table","NW_015090842.1:5917836",1,1,0
"BCO1","s1633_S_TNA_03_ASEReadCounter.table","NW_015090842.1:5917941",0,1,1
"BCO1","s1633_S_TNA_03_ASEReadCounter.table","NW_015090842.1:5917971",1,2,1
"BCO1","s1633_S_TNA_03_ASEReadCounter.table","NW_015090842.1:5921679",5,6,1
"BCO1","s1633_S_TNA_03_ASEReadCounter.table","NW_015090842.1:5921726",3,3,0
"BCO1","s1633_S_TNA_03_ASEReadCounter.table","NW_015090842.1:5925669",0,1,1
"BCO1","s1633_S_TNA_03_ASEReadCounter.table","NW_015090842.1:5925753",0,1,1
"BCO1","s1633_S_TNA_03_ASEReadCounter.table","NW_015090842.1:5926937",2,2,0
"BCO1","s1633_S_TNA_03_ASEReadCounter.table","NW_015090842.1:5927921",2,3,1
"BCO1","s1633_S_TNA_03_ASEReadCounter.table","NW_015090842.1:5927948",3,4,1
"BCO1","s1633_S_TNA_03_ASEReadCounter.table","NW_015090842.1:5927968",3,4,1
"BCO1","s1633_S_TNA_03_ASEReadCounter.table","NW_015090842.1:5928052",1,1,0
"BCO1","s1633_S_TNA_03_ASEReadCounter.table","NW_015090842.1:5932726",3,3,0
"BCO1","s1633_S_TNA_03_ASEReadCounter.table","NW_015090842.1:5932801",5,5,0
"BCO1","s1633_S_TNA_03_ASEReadCounter.table","NW_015090842.1:5934558",5,7,2
"BCO1","s1633_S_TNA_03_ASEReadCounter.table","NW_015090842.1:5934575",7,9,2
"BCO1","s1633_S_TNA_03_ASEReadCounter.table","NW_015090842.1:5934608",7,11,4
"BCO1","s1633_S_TNA_03_ASEReadCounter.table","NW_015090842.1:5934647",6,11,5
"BCO1","s1633_S_TNA_03_ASEReadCounter.table","NW_015090842.1:5934725",8,13,5
"BCO1","s1633_S_TNA_03_ASEReadCounter.table","NW_015090842.1:5934726",8,13,5
"BCO1","s1633_S_TNA_03_ASEReadCounter.table","NW_015090842.1:5934733",7,12,5
"BCO1","s1633_S_TNA_03_ASEReadCounter.table","NW_015090842.1:5934821",7,8,1
"BCO1","s1633_S_TNA_03_ASEReadCounter.table","NW_015090842.1:5934826",7,8,1
"BCO1","s1633_S_TNA_03_ASEReadCounter.table","NW_015090842.1:5934844",4,5,1
"BCO1","s1633_S_TNA_03_ASEReadCounter.table","NW_015090842.1:5934958",4,7,3
"BCO1","s1633_S_TNA_03_ASEReadCounter.table","NW_015090842.1:5934976",4,8,4
"GAN","s1633_S_TNA_03_ASEReadCounter.table","NW_015090842.1:5953759",4,10,6
"GAN","s1633_S_TNA_03_ASEReadCounter.table","NW_015090842.1:5957502",11,27,16
"GAN","s1633_S_TNA_03_ASEReadCounter.table","NW_015090842.1:5957578",15,29,14
"GAN","s1633_S_TNA_03_ASEReadCounter.table","NW_015090842.1:5965028",15,43,28
"GAN","s1633_S_TNA_03_ASEReadCounter.table","NW_015090842.1:5966047",18,42,24
"GAN","s1633_S_TNA_03_ASEReadCounter.table","NW_015090842.1:5966126",15,47,32
"GAN","s1633_S_TNA_03_ASEReadCounter.table","NW_015090842.1:5966127",15,47,32
"GAN","s1633_S_TNA_03_ASEReadCounter.table","NW_015090842.1:5966162",21,63,42
"GAN","s1633_S_TNA_03_ASEReadCounter.table","NW_015090842.1:5966483",50,114,64
"CMIP","s1633_S_TNA_03_ASEReadCounter.table","NW_015090842.1:6109159",13,19,6
"CMIP","s1633_S_TNA_03_ASEReadCounter.table","NW_015090842.1:6109166",9,15,6
"CMIP","s1633_S_TNA_03_ASEReadCounter.table","NW_015090842.1:6114641",13,28,15
"CMIP","s1633_S_TNA_03_ASEReadCounter.table","NW_015090842.1:6114751",12,28,16
"CMIP","s1633_S_TNA_03_ASEReadCounter.table","NW_015090842.1:6114824",14,35,21
"CMIP","s1633_S_TNA_03_ASEReadCounter.table","NW_015090842.1:6128998",18,43,25
"CMIP","s1633_S_TNA_03_ASEReadCounter.table","NW_015090842.1:6130562",58,104,46
"CMIP","s1633_S_TNA_03_ASEReadCounter.table","NW_015090842.1:6132522",50,94,44
"CMIP","s1633_S_TNA_03_ASEReadCounter.table","NW_015090842.1:6134088",64,128,64
"CMIP","s1633_S_TNA_03_ASEReadCounter.table","NW_015090842.1:6138265",139,293,154
"CMIP","s1633_S_TNA_03_ASEReadCounter.table","NW_015090842.1:6138300",139,299,160
"CMIP","s1633_S_TNA_03_ASEReadCounter.table","NW_015090842.1:6138342",113,242,129
"CMIP","s1633_S_TNA_03_ASEReadCounter.table","NW_015090842.1:6138343",111,235,124
"CMIP","s1633_S_TNA_03_ASEReadCounter.table","NW_015090842.1:6138345",112,233,121
"CMIP","s1633_S_TNA_03_ASEReadCounter.table","NW_015090842.1:6138647",81,168,87
"CMIP","s1633_S_TNA_03_ASEReadCounter.table","NW_015090842.1:6138745",73,158,85
"CMIP","s1633_S_TNA_03_ASEReadCounter.table","NW_015090842.1:6138832",13,52,39
"CMIP","s1633_S_TNA_03_ASEReadCounter.table","NW_015090842.1:6138967",57,135,78
"CMIP","s1633_S_TNA_03_ASEReadCounter.table","NW_015090842.1:6139131",45,90,45
"CMIP","s1633_S_TNA_03_ASEReadCounter.table","NW_015090842.1:6139163",19,68,49
"CMIP","s1633_S_TNA_03_ASEReadCounter.table","NW_015090842.1:6139360",43,73,30
"CMIP","s1633_S_TNA_03_ASEReadCounter.table","NW_015090842.1:6139572",27,37,10
"CMIP","s1633_S_TNA_03_ASEReadCounter.table","NW_015090842.1:6139773",102,102,0
"PLCG2","s1633_S_TNA_03_ASEReadCounter.table","NW_015090842.1:6179613",1,1,0
"PLCG2","s1633_S_TNA_03_ASEReadCounter.table","NW_015090842.1:6179658",5,8,3
"PLCG2","s1633_S_TNA_03_ASEReadCounter.table","NW_015090842.1:6203766",0,2,2
"PLCG2","s1633_S_TNA_03_ASEReadCounter.table","NW_015090842.1:6203775",0,2,2
"PLCG2","s1633_S_TNA_03_ASEReadCounter.table","NW_015090842.1:6203787",0,2,2
"PLCG2","s1633_S_TNA_03_ASEReadCounter.table","NW_015090842.1:6205047",2,3,1
"PLCG2","s1633_S_TNA_03_ASEReadCounter.table","NW_015090842.1:6208541",1,2,1
"PLCG2","s1633_S_TNA_03_ASEReadCounter.table","NW_015090842.1:6209798",0,1,1
"PLCG2","s1633_S_TNA_03_ASEReadCounter.table","NW_015090842.1:6209816",0,1,1
"PLCG2","s1633_S_TNA_03_ASEReadCounter.table","NW_015090842.1:6217547",0,1,1
"PLCG2","s1633_S_TNA_03_ASEReadCounter.table","NW_015090842.1:6218641",0,1,1
"PLCG2","s1633_S_TNA_03_ASEReadCounter.table","NW_015090842.1:6220552",1,3,2
"PLCG2","s1633_S_TNA_03_ASEReadCounter.table","NW_015090842.1:6221969",2,6,4
"PLCG2","s1633_S_TNA_03_ASEReadCounter.table","NW_015090842.1:6228672",1,3,2
"PLCG2","s1633_S_TNA_03_ASEReadCounter.table","NW_015090842.1:6228694",1,3,2
"PLCG2","s1633_S_TNA_03_ASEReadCounter.table","NW_015090842.1:6228722",0,3,3
"PLCG2","s1633_S_TNA_03_ASEReadCounter.table","NW_015090842.1:6228747",0,3,3
"PLCG2","s1633_S_TNA_03_ASEReadCounter.table","NW_015090842.1:6228835",2,3,1
"PLCG2","s1633_S_TNA_03_ASEReadCounter.table","NW_015090842.1:6228841",2,4,2
"PLCG2","s1633_S_TNA_03_ASEReadCounter.table","NW_015090842.1:6228865",1,3,2
"PLCG2","s1633_S_TNA_03_ASEReadCounter.table","NW_015090842.1:6228917",1,3,2
"PLCG2","s1633_S_TNA_03_ASEReadCounter.table","NW_015090842.1:6228926",1,3,2
"PLCG2","s1633_S_TNA_03_ASEReadCounter.table","NW_015090842.1:6229081",0,2,2
"PLCG2","s1633_S_TNA_03_ASEReadCounter.table","NW_015090842.1:6229097",0,1,1
"PLCG2","s1633_S_TNA_03_ASEReadCounter.table","NW_015090842.1:6229160",0,2,2
"PLCG2","s1633_S_TNA_03_ASEReadCounter.table","NW_015090842.1:6229213",2,3,1
"PLCG2","s1633_S_TNA_03_ASEReadCounter.table","NW_015090842.1:6229231",2,3,1
"PLCG2","s1633_S_TNA_03_ASEReadCounter.table","NW_015090842.1:6229663",2,3,1
"PLCG2","s1633_S_TNA_03_ASEReadCounter.table","NW_015090842.1:6229748",1,1,0
"PLCG2","s1633_S_TNA_03_ASEReadCounter.table","NW_015090842.1:6229892",1,2,1
"PLCG2","s1633_S_TNA_03_ASEReadCounter.table","NW_015090842.1:6230248",1,2,1
"PLCG2","s1633_S_TNA_03_ASEReadCounter.table","NW_015090842.1:6230255",1,2,1
"PLCG2","s1633_S_TNA_03_ASEReadCounter.table","NW_015090842.1:6230296",1,2,1
"PLCG2","s1633_S_TNA_03_ASEReadCounter.table","NW_015090842.1:6230349",0,1,1
"PLCG2","s1633_S_TNA_03_ASEReadCounter.table","NW_015090842.1:6230381",0,1,1
"PLCG2","s1633_S_TNA_03_ASEReadCounter.table","NW_015090842.1:6230408",1,2,1
"PLCG2","s1633_S_TNA_03_ASEReadCounter.table","NW_015090842.1:6230898",3,4,1
"PLCG2","s1633_S_TNA_03_ASEReadCounter.table","NW_015090842.1:6230976",2,3,1
"PLCG2","s1633_S_TNA_03_ASEReadCounter.table","NW_015090842.1:6231078",2,2,0
"PLCG2","s1633_S_TNA_03_ASEReadCounter.table","NW_015090842.1:6231138",2,3,1
"PLCG2","s1633_S_TNA_03_ASEReadCounter.table","NW_015090842.1:6231177",2,3,1
"SDR42E1","s1633_S_TNA_03_ASEReadCounter.table","NW_015090842.1:6235292",0,1,1
"SDR42E1","s1633_S_TNA_03_ASEReadCounter.table","NW_015090842.1:6235315",0,3,3
"SDR42E1","s1633_S_TNA_03_ASEReadCounter.table","NW_015090842.1:6235348",0,8,8
"SDR42E1","s1633_S_TNA_03_ASEReadCounter.table","NW_015090842.1:6235355",0,8,8
"SDR42E1","s1633_S_TNA_03_ASEReadCounter.table","NW_015090842.1:6235417",0,10,10
"SDR42E1","s1633_S_TNA_03_ASEReadCounter.table","NW_015090842.1:6235526",5,5,0
"SDR42E1","s1633_S_TNA_03_ASEReadCounter.table","NW_015090842.1:6235558",4,7,3
"SDR42E1","s1633_S_TNA_03_ASEReadCounter.table","NW_015090842.1:6235603",9,9,0
"SDR42E1","s1633_S_TNA_03_ASEReadCounter.table","NW_015090842.1:6235741",3,7,4
"SDR42E1","s1633_S_TNA_03_ASEReadCounter.table","NW_015090842.1:6235777",2,6,4
"SDR42E1","s1633_S_TNA_03_ASEReadCounter.table","NW_015090842.1:6235806",3,9,6
"SDR42E1","s1633_S_TNA_03_ASEReadCounter.table","NW_015090842.1:6235809",2,9,7
"SDR42E1","s1633_S_TNA_03_ASEReadCounter.table","NW_015090842.1:6235816",2,9,7
"SDR42E1","s1633_S_TNA_03_ASEReadCounter.table","NW_015090842.1:6235914",2,10,8
"SDR42E1","s1633_S_TNA_03_ASEReadCounter.table","NW_015090842.1:6235935",2,9,7
"SDR42E1","s1633_S_TNA_03_ASEReadCounter.table","NW_015090842.1:6235957",1,9,8
"SDR42E1","s1633_S_TNA_03_ASEReadCounter.table","NW_015090842.1:6236040",1,4,3
"SDR42E1","s1633_S_TNA_03_ASEReadCounter.table","NW_015090842.1:6236260",0,4,4
"SDR42E1","s1633_S_TNA_03_ASEReadCounter.table","NW_015090842.1:6236281",0,4,4
"SDR42E1","s1633_S_TNA_03_ASEReadCounter.table","NW_015090842.1:6236305",1,5,4
"SDR42E1","s1633_S_TNA_03_ASEReadCounter.table","NW_015090842.1:6236458",0,4,4
"SDR42E1","s1633_S_TNA_03_ASEReadCounter.table","NW_015090842.1:6236476",1,7,6
"SDR42E1","s1633_S_TNA_03_ASEReadCounter.table","NW_015090842.1:6236608",2,5,3
"SDR42E1","s1633_S_TNA_03_ASEReadCounter.table","NW_015090842.1:6238829",0,1,1
"HSD17B2","s1633_S_TNA_03_ASEReadCounter.table","NW_015090842.1:6267273",0,1,1
"HSD17B2","s1633_S_TNA_03_ASEReadCounter.table","NW_015090842.1:6267358",0,1,1
"HSD17B2","s1633_S_TNA_03_ASEReadCounter.table","NW_015090842.1:6268180",0,1,1
"HSD17B2","s1633_S_TNA_03_ASEReadCounter.table","NW_015090842.1:6268203",0,1,1
"ARY2","s1633_S_TNA_03_ASEReadCounter.table","NW_015090842.1:6303922",5,8,3
"ARY2","s1633_S_TNA_03_ASEReadCounter.table","NW_015090842.1:6303954",4,7,3
"ARY2","s1633_S_TNA_03_ASEReadCounter.table","NW_015090842.1:6303979",2,4,2
"ARY2","s1633_S_TNA_03_ASEReadCounter.table","NW_015090842.1:6305848",6,11,5
"ARY2","s1633_S_TNA_03_ASEReadCounter.table","NW_015090842.1:6305856",5,10,5
"ARY2","s1633_S_TNA_03_ASEReadCounter.table","NW_015090842.1:6305857",6,11,5
"ARY2","s1633_S_TNA_03_ASEReadCounter.table","NW_015090842.1:6306017",3,8,5
"ARY2","s1633_S_TNA_03_ASEReadCounter.table","NW_015090842.1:6306052",3,9,6
"ARY2","s1633_S_TNA_03_ASEReadCounter.table","NW_015090842.1:6306094",9,13,4
"ARY2","s1633_S_TNA_03_ASEReadCounter.table","NW_015090842.1:6306100",9,13,4
"ARY2","s1633_S_TNA_03_ASEReadCounter.table","NW_015090842.1:6306146",12,19,7
"ARY2","s1633_S_TNA_03_ASEReadCounter.table","NW_015090842.1:6306147",12,19,7
"ARY2","s1633_S_TNA_03_ASEReadCounter.table","NW_015090842.1:6306390",7,10,3
"ARY2","s1633_S_TNA_03_ASEReadCounter.table","NW_015090842.1:6306567",2,3,1
"ARY2","s1633_S_TNA_03_ASEReadCounter.table","NW_015090842.1:6306705",4,5,1
"ARY2","s1633_S_TNA_03_ASEReadCounter.table","NW_015090842.1:6306713",5,5,0
"ARY2","s1633_S_TNA_03_ASEReadCounter.table","NW_015090842.1:6306773",4,6,2
"ARY2","s1633_S_TNA_03_ASEReadCounter.table","NW_015090842.1:6307039",9,12,3
"ARY2","s1633_S_TNA_03_ASEReadCounter.table","NW_015090842.1:6307043",8,11,3
"ARY2","s1633_S_TNA_03_ASEReadCounter.table","NW_015090842.1:6307093",10,12,2
"ARY2","s1633_S_TNA_03_ASEReadCounter.table","NW_015090842.1:6307138",11,12,1
"ARY2","s1633_S_TNA_03_ASEReadCounter.table","NW_015090842.1:6307157",11,12,1
"ARY2","s1633_S_TNA_03_ASEReadCounter.table","NW_015090842.1:6307187",12,13,1
"ARY2","s1633_S_TNA_03_ASEReadCounter.table","NW_015090842.1:6307278",8,11,3
"ARY2","s1633_S_TNA_03_ASEReadCounter.table","NW_015090842.1:6307305",14,18,4
"ARY2","s1633_S_TNA_03_ASEReadCounter.table","NW_015090842.1:6307318",11,17,6
"ARY2","s1633_S_TNA_03_ASEReadCounter.table","NW_015090842.1:6307429",14,19,5
"ARY2","s1633_S_TNA_03_ASEReadCounter.table","NW_015090842.1:6307487",12,20,8
"ARY2","s1633_S_TNA_03_ASEReadCounter.table","NW_015090842.1:6307670",9,9,0
"ARYL","s1633_S_TNA_03_ASEReadCounter.table","NW_015090842.1:6313360",3,3,0
"ARYL","s1633_S_TNA_03_ASEReadCounter.table","NW_015090842.1:6313377",3,3,0
"ARYL","s1633_S_TNA_03_ASEReadCounter.table","NW_015090842.1:6313767",3,4,1
"ARY1","s1633_S_TNA_03_ASEReadCounter.table","NW_015090842.1:6313909",8,8,0
"ARY1","s1633_S_TNA_03_ASEReadCounter.table","NW_015090842.1:6314296",3,7,4
"ARY1","s1633_S_TNA_03_ASEReadCounter.table","NW_015090842.1:6314541",4,4,0
"ARY1","s1633_S_TNA_03_ASEReadCounter.table","NW_015090842.1:6314597",7,8,1
"ARY1","s1633_S_TNA_03_ASEReadCounter.table","NW_015090842.1:6314750",5,5,0
"ARY1","s1633_S_TNA_03_ASEReadCounter.table","NW_015090842.1:6314794",4,4,0
"ARY1","s1633_S_TNA_03_ASEReadCounter.table","NW_015090842.1:6314827",5,5,0
"ARY1","s1633_S_TNA_03_ASEReadCounter.table","NW_015090842.1:6314843",5,6,1
"ARY1","s1633_S_TNA_03_ASEReadCounter.table","NW_015090842.1:6314859",5,7,2
"ARY1","s1633_S_TNA_03_ASEReadCounter.table","NW_015090842.1:6314886",5,8,3
"ARY1","s1633_S_TNA_03_ASEReadCounter.table","NW_015090842.1:6314943",8,8,0
"ARY1","s1633_S_TNA_03_ASEReadCounter.table","NW_015090842.1:6314949",8,8,0
"ARY1","s1633_S_TNA_03_ASEReadCounter.table","NW_015090842.1:6315022",3,6,3
"ARY1","s1633_S_TNA_03_ASEReadCounter.table","NW_015090842.1:6315026",2,5,3
"ARY1","s1633_S_TNA_03_ASEReadCounter.table","NW_015090842.1:6315043",3,6,3
"ARY1","s1633_S_TNA_03_ASEReadCounter.table","NW_015090842.1:6315065",3,7,4
"ARY1","s1633_S_TNA_03_ASEReadCounter.table","NW_015090842.1:6315409",4,8,4
"ARY1","s1633_S_TNA_03_ASEReadCounter.table","NW_015090842.1:6315479",3,5,2
"ARY1","s1633_S_TNA_03_ASEReadCounter.table","NW_015090842.1:6318342",8,12,4
"ARY1","s1633_S_TNA_03_ASEReadCounter.table","NW_015090842.1:6318427",10,18,8
"ARY1","s1633_S_TNA_03_ASEReadCounter.table","NW_015090842.1:6318603",7,11,4
"ARY1","s1633_S_TNA_03_ASEReadCounter.table","NW_015090842.1:6318708",10,16,6
"ARY1","s1633_S_TNA_03_ASEReadCounter.table","NW_015090842.1:6318858",5,14,9
"ARY1","s1633_S_TNA_03_ASEReadCounter.table","NW_015090842.1:6318952",11,16,5
"MPHOSPH6","s1633_S_TNA_03_ASEReadCounter.table","NW_015090842.1:6324063",47,111,64
"MPHOSPH6","s1633_S_TNA_03_ASEReadCounter.table","NW_015090842.1:6324174",116,261,145
"MPHOSPH6","s1633_S_TNA_03_ASEReadCounter.table","NW_015090842.1:6324270",98,255,157
"MPHOSPH6","s1633_S_TNA_03_ASEReadCounter.table","NW_015090842.1:6324762",82,165,83
"MPHOSPH6","s1633_S_TNA_03_ASEReadCounter.table","NW_015090842.1:6324772",83,155,72
"MPHOSPH6","s1633_S_TNA_03_ASEReadCounter.table","NW_015090842.1:6324780",78,152,74
"MPHOSPH6","s1633_S_TNA_03_ASEReadCounter.table","NW_015090842.1:6324902",83,164,81
"MPHOSPH6","s1633_S_TNA_03_ASEReadCounter.table","NW_015090842.1:6324910",166,166,0
"MPHOSPH6","s1633_S_TNA_03_ASEReadCounter.table","NW_015090842.1:6325066",65,139,74
"MPHOSPH6","s1633_S_TNA_03_ASEReadCounter.table","NW_015090842.1:6325089",72,154,82
"MPHOSPH6","s1633_S_TNA_03_ASEReadCounter.table","NW_015090842.1:6325298",81,180,99
"MPHOSPH6","s1633_S_TNA_03_ASEReadCounter.table","NW_015090842.1:6325877",69,143,74
"MPHOSPH6","s1633_S_TNA_03_ASEReadCounter.table","NW_015090842.1:6326976",37,94,57
"CDH13","s1633_S_TNA_03_ASEReadCounter.table","NW_015090842.1:6693697",1,1,0
"CDH13","s1633_S_TNA_03_ASEReadCounter.table","NW_015090842.1:6693712",1,1,0
"CDH13","s1633_S_TNA_03_ASEReadCounter.table","NW_015090842.1:6693723",1,1,0
"CDH13","s1633_S_TNA_03_ASEReadCounter.table","NW_015090842.1:6693738",1,1,0
"CDH13","s1633_S_TNA_03_ASEReadCounter.table","NW_015090842.1:6823730",0,3,3
"CDH13","s1633_S_TNA_03_ASEReadCounter.table","NW_015090842.1:6889713",2,4,2
"CDH13","s1633_S_TNA_03_ASEReadCounter.table","NW_015090842.1:6955167",1,3,2
"MLYCD","s1633_S_TNA_03_ASEReadCounter.table","NW_015090842.1:7150054",57,136,79
"MLYCD","s1633_S_TNA_03_ASEReadCounter.table","NW_015090842.1:7150131",93,216,123
"MLYCD","s1633_S_TNA_03_ASEReadCounter.table","NW_015090842.1:7150585",40,99,59
"MLYCD","s1633_S_TNA_03_ASEReadCounter.table","NW_015090842.1:7150686",38,81,43
"MLYCD","s1633_S_TNA_03_ASEReadCounter.table","NW_015090842.1:7150696",40,83,43
"MLYCD","s1633_S_TNA_03_ASEReadCounter.table","NW_015090842.1:7150698",83,83,0
"MLYCD","s1633_S_TNA_03_ASEReadCounter.table","NW_015090842.1:7150869",38,74,36
"MLYCD","s1633_S_TNA_03_ASEReadCounter.table","NW_015090842.1:7151100",38,74,36
"MLYCD","s1633_S_TNA_03_ASEReadCounter.table","NW_015090842.1:7151127",34,69,35
"MLYCD","s1633_S_TNA_03_ASEReadCounter.table","NW_015090842.1:7157538",18,49,31
"MLYCD","s1633_S_TNA_03_ASEReadCounter.table","NW_015090842.1:7167662",9,20,11
"MLYCD","s1633_S_TNA_03_ASEReadCounter.table","NW_015090842.1:7167675",8,20,12
"MLYCD","s1633_S_TNA_03_ASEReadCounter.table","NW_015090842.1:7167710",2,11,9
"MLYCD","s1633_S_TNA_03_ASEReadCounter.table","NW_015090842.1:7167781",3,11,8
"MLYCD","s1633_S_TNA_03_ASEReadCounter.table","NW_015090842.1:7167803",3,11,8
"MLYCD","s1633_S_TNA_03_ASEReadCounter.table","NW_015090842.1:7167812",3,11,8
"MLYCD","s1633_S_TNA_03_ASEReadCounter.table","NW_015090842.1:7167845",1,7,6
"MLYCD","s1633_S_TNA_03_ASEReadCounter.table","NW_015090842.1:7167862",1,5,4
"MLYCD","s1633_S_TNA_03_ASEReadCounter.table","NW_015090842.1:7167929",2,8,6
"MLYCD","s1633_S_TNA_03_ASEReadCounter.table","NW_015090842.1:7167995",5,10,5
"MLYCD","s1633_S_TNA_03_ASEReadCounter.table","NW_015090842.1:7168005",5,9,4
"MLYCD","s1633_S_TNA_03_ASEReadCounter.table","NW_015090842.1:7168037",5,7,2
"HSBP1","s1633_S_TNA_03_ASEReadCounter.table","NW_015090842.1:7245192",428,803,375
"HSBP1","s1633_S_TNA_03_ASEReadCounter.table","NW_015090842.1:7245226",505,962,457
"HSBP1","s1633_S_TNA_03_ASEReadCounter.table","NW_015090842.1:7245257",450,843,393
"HSBP1","s1633_S_TNA_03_ASEReadCounter.table","NW_015090842.1:7245296",409,833,424
"HSBP1","s1633_S_TNA_03_ASEReadCounter.table","NW_015090842.1:7245389",601,1073,472
"HSBP1","s1633_S_TNA_03_ASEReadCounter.table","NW_015090842.1:7245400",616,1038,422
"HSBP1","s1633_S_TNA_03_ASEReadCounter.table","NW_015090842.1:7245445",582,1016,434
"HSBP1","s1633_S_TNA_03_ASEReadCounter.table","NW_015090842.1:7245495",523,934,411
"HSBP1","s1633_S_TNA_03_ASEReadCounter.table","NW_015090842.1:7245515",568,1015,447
"HSBP1","s1633_S_TNA_03_ASEReadCounter.table","NW_015090842.1:7245733",291,573,282
"HSBP1","s1633_S_TNA_03_ASEReadCounter.table","NW_015090842.1:7245771",313,576,263
"HSBP1","s1633_S_TNA_03_ASEReadCounter.table","NW_015090842.1:7245813",330,590,260
"HSBP1","s1633_S_TNA_03_ASEReadCounter.table","NW_015090842.1:7245926",341,619,278
"HSBP1","s1633_S_TNA_03_ASEReadCounter.table","NW_015090842.1:7245927",348,629,281
"HSBP1","s1633_S_TNA_03_ASEReadCounter.table","NW_015090842.1:7245933",341,608,267
"HSBP1","s1633_S_TNA_03_ASEReadCounter.table","NW_015090842.1:7246002",262,495,233
"HSBP1","s1633_S_TNA_03_ASEReadCounter.table","NW_015090842.1:7246094",328,561,233
"HSBP1","s1633_S_TNA_03_ASEReadCounter.table","NW_015090842.1:7246167",292,515,223
"HSBP1","s1633_S_TNA_03_ASEReadCounter.table","NW_015090842.1:7246183",270,493,223
"HSBP1","s1633_S_TNA_03_ASEReadCounter.table","NW_015090842.1:7247285",24,30,6
"HSBP1","s1633_S_TNA_03_ASEReadCounter.table","NW_015090842.1:7247651",345,677,332
"HSBP1","s1633_S_TNA_03_ASEReadCounter.table","NW_015090842.1:7247657",329,666,337
"HSBP1","s1633_S_TNA_03_ASEReadCounter.table","NW_015090842.1:7248520",202,421,219
"HSBP1","s1633_S_TNA_03_ASEReadCounter.table","NW_015090842.1:7248535",171,349,178
"KCNG4","s1633_S_TNA_03_ASEReadCounter.table","NW_015090842.1:7282481",3,7,4
"KCNG4","s1633_S_TNA_03_ASEReadCounter.table","NW_015090842.1:7282500",2,5,3
"KCNG4","s1633_S_TNA_03_ASEReadCounter.table","NW_015090842.1:7282542",4,8,4
"KCNG4","s1633_S_TNA_03_ASEReadCounter.table","NW_015090842.1:7282579",2,5,3
"KCNG4","s1633_S_TNA_03_ASEReadCounter.table","NW_015090842.1:7282630",1,3,2
"KCNG4","s1633_S_TNA_03_ASEReadCounter.table","NW_015090842.1:7282760",3,6,3
"KCNG4","s1633_S_TNA_03_ASEReadCounter.table","NW_015090842.1:7283056",1,4,3
"KCNG4","s1633_S_TNA_03_ASEReadCounter.table","NW_015090842.1:7283245",2,5,3
"KCNG4","s1633_S_TNA_03_ASEReadCounter.table","NW_015090842.1:7299491",2,4,2
"KCNG4","s1633_S_TNA_03_ASEReadCounter.table","NW_015090842.1:7301195",0,2,2
"KCNG4","s1633_S_TNA_03_ASEReadCounter.table","NW_015090842.1:7301227",1,3,2
"KCNG4","s1633_S_TNA_03_ASEReadCounter.table","NW_015090842.1:7301240",1,3,2
"KCNG4","s1633_S_TNA_03_ASEReadCounter.table","NW_015090842.1:7301413",4,6,2
"ATP2C2","s1633_S_TNA_03_ASEReadCounter.table","NW_015090842.1:7413747",3,11,8
"TLDC1","s1633_S_TNA_03_ASEReadCounter.table","NW_015090842.1:7421997",11,24,13
"COTL1","s1633_S_TNA_03_ASEReadCounter.table","NW_015090842.1:7490707",684,1365,681
"COTL1","s1633_S_TNA_03_ASEReadCounter.table","NW_015090842.1:7490708",684,1378,694
"COTL1","s1633_S_TNA_03_ASEReadCounter.table","NW_015090842.1:7490711",698,1390,692
"COTL1","s1633_S_TNA_03_ASEReadCounter.table","NW_015090842.1:7490739",654,1347,693
"COTL1","s1633_S_TNA_03_ASEReadCounter.table","NW_015090842.1:7490785",629,1279,650
"COTL1","s1633_S_TNA_03_ASEReadCounter.table","NW_015090842.1:7490820",56,789,733
"COTL1","s1633_S_TNA_03_ASEReadCounter.table","NW_015090842.1:7490846",568,1195,627
"COTL1","s1633_S_TNA_03_ASEReadCounter.table","NW_015090842.1:7505672",0,2,2
"KLHL36","s1633_S_TNA_03_ASEReadCounter.table","NW_015090842.1:7526337",27,27,0
"KLHL36","s1633_S_TNA_03_ASEReadCounter.table","NW_015090842.1:7537681",114,114,0
"USP10","s1633_S_TNA_03_ASEReadCounter.table","NW_015090842.1:7572213",16,33,17
"USP10","s1633_S_TNA_03_ASEReadCounter.table","NW_015090842.1:7572358",24,24,0
"CRISPLD2","s1633_S_TNA_03_ASEReadCounter.table","NW_015090842.1:7630779",8,8,0
"CRISPLD2","s1633_S_TNA_03_ASEReadCounter.table","NW_015090842.1:7633611",7,7,0
"CRISPLD2","s1633_S_TNA_03_ASEReadCounter.table","NW_015090842.1:7633787",3,5,2
"CRISPLD2","s1633_S_TNA_03_ASEReadCounter.table","NW_015090842.1:7634023",0,3,3
"CRISPLD2","s1633_S_TNA_03_ASEReadCounter.table","NW_015090842.1:7634620",4,4,0
"CRISPLD2","s1633_S_TNA_03_ASEReadCounter.table","NW_015090842.1:7636315",2,5,3
"MTHFSD","s1633_S_TNA_03_ASEReadCounter.table","NW_015090842.1:8152578",11,22,11
"DUSP15","s1633_S_TNA_03_ASEReadCounter.table","NW_015090842.1:8422840",1,1,0
"DUSP15","s1633_S_TNA_03_ASEReadCounter.table","NW_015090842.1:8431988",0,1,1
"EMC8","s1633_S_TNA_03_ASEReadCounter.table","NW_015090842.1:8452385",34,59,25
"GINS2","s1633_S_TNA_03_ASEReadCounter.table","NW_015090842.1:8467469",18,18,0
"GINS2","s1633_S_TNA_03_ASEReadCounter.table","NW_015090842.1:8470290",17,49,32
"GINS2","s1633_S_TNA_03_ASEReadCounter.table","NW_015090842.1:8470305",17,48,31
"GINS2","s1633_S_TNA_03_ASEReadCounter.table","NW_015090842.1:8470376",22,58,36
"GINS2","s1633_S_TNA_03_ASEReadCounter.table","NW_015090842.1:8471057",0,15,15
"KIAA0513","s1633_S_TNA_03_ASEReadCounter.table","NW_015090842.1:8674736",64,64,0
"KIAA0513","s1633_S_TNA_03_ASEReadCounter.table","NW_015090842.1:8687268",0,2,2
"ZCCHC14","s1633_S_TNA_03_ASEReadCounter.table","NW_015090842.1:8750189",119,119,0
"JPH3","s1633_S_TNA_03_ASEReadCounter.table","NW_015090842.1:8872294",48,106,58
"KLHDC4","s1633_S_TNA_03_ASEReadCounter.table","NW_015090842.1:8891175",64,139,75
"KLHDC4","s1633_S_TNA_03_ASEReadCounter.table","NW_015090842.1:8905251",18,36,18
"KLHDC4","s1633_S_TNA_03_ASEReadCounter.table","NW_015090842.1:8919630",2,4,2
"SLC7A5","s1633_S_TNA_03_ASEReadCounter.table","NW_015090842.1:8940382",152,152,0
"SLC7A5","s1633_S_TNA_03_ASEReadCounter.table","NW_015090842.1:8941818",67,67,0
"SLC7A5","s1633_S_TNA_03_ASEReadCounter.table","NW_015090842.1:8944655",38,38,0
"CA5A","s1633_S_TNA_03_ASEReadCounter.table","NW_015090842.1:8989479",48,103,55
"CA5A","s1633_S_TNA_03_ASEReadCounter.table","NW_015090842.1:8989562",60,121,61
"CA5A","s1633_S_TNA_03_ASEReadCounter.table","NW_015090842.1:8989609",78,144,66
"CA5A","s1633_S_TNA_03_ASEReadCounter.table","NW_015090842.1:8989693",85,167,82
"CA5A","s1633_S_TNA_03_ASEReadCounter.table","NW_015090842.1:8989702",87,159,72
"CA5A","s1633_S_TNA_03_ASEReadCounter.table","NW_015090842.1:8989746",85,164,79
"CA5A","s1633_S_TNA_03_ASEReadCounter.table","NW_015090842.1:8989880",54,131,77
"CA5A","s1633_S_TNA_03_ASEReadCounter.table","NW_015090842.1:8989885",59,135,76
"CA5A","s1633_S_TNA_03_ASEReadCounter.table","NW_015090842.1:8989929",81,151,70
"CA5A","s1633_S_TNA_03_ASEReadCounter.table","NW_015090842.1:8990002",64,125,61
"CA5A","s1633_S_TNA_03_ASEReadCounter.table","NW_015090842.1:8990004",65,123,58
"CA5A","s1633_S_TNA_03_ASEReadCounter.table","NW_015090842.1:8990005",66,124,58
"CA5A","s1633_S_TNA_03_ASEReadCounter.table","NW_015090842.1:8990017",65,113,48
"CA5A","s1633_S_TNA_03_ASEReadCounter.table","NW_015090842.1:8990043",52,95,43
"CA5A","s1633_S_TNA_03_ASEReadCounter.table","NW_015090842.1:8990080",41,82,41
"CA5A","s1633_S_TNA_03_ASEReadCounter.table","NW_015090842.1:8990084",42,83,41
"CA5A","s1633_S_TNA_03_ASEReadCounter.table","NW_015090842.1:8990090",48,91,43
"CA5A","s1633_S_TNA_03_ASEReadCounter.table","NW_015090842.1:8990095",46,89,43
"CA5A","s1633_S_TNA_03_ASEReadCounter.table","NW_015090842.1:8990111",41,85,44
"CA5A","s1633_S_TNA_03_ASEReadCounter.table","NW_015090842.1:8990112",41,83,42
"CA5A","s1633_S_TNA_03_ASEReadCounter.table","NW_015090842.1:8990115",44,85,41
"CA5A","s1633_S_TNA_03_ASEReadCounter.table","NW_015090842.1:8990166",37,75,38
"CA5A","s1633_S_TNA_03_ASEReadCounter.table","NW_015090842.1:8990169",41,77,36
"CA5A","s1633_S_TNA_03_ASEReadCounter.table","NW_015090842.1:8990222",40,69,29
"CA5A","s1633_S_TNA_03_ASEReadCounter.table","NW_015090842.1:8990289",45,78,33
"CA5A","s1633_S_TNA_03_ASEReadCounter.table","NW_015090842.1:8990314",46,79,33
"CA5A","s1633_S_TNA_03_ASEReadCounter.table","NW_015090842.1:8990361",40,77,37
"CA5A","s1633_S_TNA_03_ASEReadCounter.table","NW_015090842.1:8990368",41,77,36
"CA5A","s1633_S_TNA_03_ASEReadCounter.table","NW_015090842.1:8990429",36,64,28
"CA5A","s1633_S_TNA_03_ASEReadCounter.table","NW_015090842.1:8990466",25,42,17
"CA5A","s1633_S_TNA_03_ASEReadCounter.table","NW_015090842.1:8990663",24,48,24
"CA5A","s1633_S_TNA_03_ASEReadCounter.table","NW_015090842.1:8990797",24,38,14
"CA5A","s1633_S_TNA_03_ASEReadCounter.table","NW_015090842.1:8990836",26,39,13
"CA5A","s1633_S_TNA_03_ASEReadCounter.table","NW_015090842.1:8990842",25,38,13
"CA5A","s1633_S_TNA_03_ASEReadCounter.table","NW_015090842.1:8990851",28,41,13
"CA5A","s1633_S_TNA_03_ASEReadCounter.table","NW_015090842.1:8990918",26,42,16
"CA5A","s1633_S_TNA_03_ASEReadCounter.table","NW_015090842.1:8990921",26,41,15
"CA5A","s1633_S_TNA_03_ASEReadCounter.table","NW_015090842.1:8990942",28,41,13
"CA5A","s1633_S_TNA_03_ASEReadCounter.table","NW_015090842.1:8991001",32,45,13
"CA5A","s1633_S_TNA_03_ASEReadCounter.table","NW_015090842.1:8991038",27,38,11
"CA5A","s1633_S_TNA_03_ASEReadCounter.table","NW_015090842.1:8991149",22,38,16
"CA5A","s1633_S_TNA_03_ASEReadCounter.table","NW_015090842.1:8991176",22,39,17
"CA5A","s1633_S_TNA_03_ASEReadCounter.table","NW_015090842.1:8991241",13,29,16
"CA5A","s1633_S_TNA_03_ASEReadCounter.table","NW_015090842.1:8991262",12,28,16
"CA5A","s1633_S_TNA_03_ASEReadCounter.table","NW_015090842.1:8991316",18,20,2
"CA5A","s1633_S_TNA_03_ASEReadCounter.table","NW_015090842.1:8991319",21,23,2
"CA5A","s1633_S_TNA_03_ASEReadCounter.table","NW_015090842.1:8991330",22,23,1
"CA5A","s1633_S_TNA_03_ASEReadCounter.table","NW_015090842.1:8991334",22,23,1
"CA5A","s1633_S_TNA_03_ASEReadCounter.table","NW_015090842.1:8991362",29,43,14
"CA5A","s1633_S_TNA_03_ASEReadCounter.table","NW_015090842.1:8991368",28,42,14
"CA5A","s1633_S_TNA_03_ASEReadCounter.table","NW_015090842.1:8991390",26,40,14
"CA5A","s1633_S_TNA_03_ASEReadCounter.table","NW_015090842.1:8991395",28,44,16
"CA5A","s1633_S_TNA_03_ASEReadCounter.table","NW_015090842.1:8991422",23,41,18
"CA5A","s1633_S_TNA_03_ASEReadCounter.table","NW_015090842.1:8991467",24,36,12
"CA5A","s1633_S_TNA_03_ASEReadCounter.table","NW_015090842.1:8991576",16,28,12
"CA5A","s1633_S_TNA_03_ASEReadCounter.table","NW_015090842.1:8991587",16,31,15
"CA5A","s1633_S_TNA_03_ASEReadCounter.table","NW_015090842.1:8991655",14,24,10
"CA5A","s1633_S_TNA_03_ASEReadCounter.table","NW_015090842.1:8991717",20,34,14
"CA5A","s1633_S_TNA_03_ASEReadCounter.table","NW_015090842.1:8991726",18,33,15
"CA5A","s1633_S_TNA_03_ASEReadCounter.table","NW_015090842.1:8991799",19,35,16
"CA5A","s1633_S_TNA_03_ASEReadCounter.table","NW_015090842.1:8991809",16,29,13
"CA5A","s1633_S_TNA_03_ASEReadCounter.table","NW_015090842.1:8991848",16,25,9
"CA5A","s1633_S_TNA_03_ASEReadCounter.table","NW_015090842.1:8991849",16,26,10
"CA5A","s1633_S_TNA_03_ASEReadCounter.table","NW_015090842.1:8991927",19,27,8
"CA5A","s1633_S_TNA_03_ASEReadCounter.table","NW_015090842.1:8991941",19,27,8
"CA5A","s1633_S_TNA_03_ASEReadCounter.table","NW_015090842.1:8992121",10,21,11
"CA5A","s1633_S_TNA_03_ASEReadCounter.table","NW_015090842.1:8992224",8,19,11
"CA5A","s1633_S_TNA_03_ASEReadCounter.table","NW_015090842.1:9002570",4,11,7
"CA5A","s1633_S_TNA_03_ASEReadCounter.table","NW_015090842.1:9002600",2,8,6
"CA5A","s1633_S_TNA_03_ASEReadCounter.table","NW_015090842.1:9004312",2,7,5
"CA5A","s1633_S_TNA_03_ASEReadCounter.table","NW_015090842.1:9004620",0,1,1
"CA5A","s1633_S_TNA_03_ASEReadCounter.table","NW_015090842.1:9005116",0,1,1
"CA5A","s1633_S_TNA_03_ASEReadCounter.table","NW_015090842.1:9005120",0,1,1
"CA5A","s1633_S_TNA_03_ASEReadCounter.table","NW_015090842.1:9005140",0,1,1
"CA5A","s1633_S_TNA_03_ASEReadCounter.table","NW_015090842.1:9005152",0,1,1
"BANP","s1633_S_TNA_03_ASEReadCounter.table","NW_015090842.1:9033407",3,3,0
"BANP","s1633_S_TNA_03_ASEReadCounter.table","NW_015090842.1:9033409",3,3,0
"BANP","s1633_S_TNA_03_ASEReadCounter.table","NW_015090842.1:9033420",4,4,0
"BANP","s1633_S_TNA_03_ASEReadCounter.table","NW_015090842.1:9055284",3,11,8
"ZC3H18","s1633_S_TNA_03_ASEReadCounter.table","NW_015090842.1:9528933",17,43,26
"MVD","s1633_S_TNA_03_ASEReadCounter.table","NW_015090842.1:9550690",80,80,0
"MVD","s1633_S_TNA_03_ASEReadCounter.table","NW_015090842.1:9550691",81,81,0
"MVD","s1633_S_TNA_03_ASEReadCounter.table","NW_015090842.1:9550699",89,90,1
"MVD","s1633_S_TNA_03_ASEReadCounter.table","NW_015090842.1:9550701",92,92,0
"MVD","s1633_S_TNA_03_ASEReadCounter.table","NW_015090842.1:9552202",113,113,0
"MVD","s1633_S_TNA_03_ASEReadCounter.table","NW_015090842.1:9552223",100,100,0
"MVD","s1633_S_TNA_03_ASEReadCounter.table","NW_015090842.1:9552533",84,84,0
"MVD","s1633_S_TNA_03_ASEReadCounter.table","NW_015090842.1:9552644",21,60,39
"PIEZO1","s1633_S_TNA_03_ASEReadCounter.table","NW_015090842.1:9577447",2,6,4
"PIEZO1","s1633_S_TNA_03_ASEReadCounter.table","NW_015090842.1:9579101",2,4,2
"PIEZO1","s1633_S_TNA_03_ASEReadCounter.table","NW_015090842.1:9582630",1,2,1
"PIEZO1","s1633_S_TNA_03_ASEReadCounter.table","NW_015090842.1:9582976",1,3,2
"PIEZO1","s1633_S_TNA_03_ASEReadCounter.table","NW_015090842.1:9583326",1,1,0
"CDT1","s1633_S_TNA_03_ASEReadCounter.table","NW_015090842.1:9596711",1,2,1
"CDT1","s1633_S_TNA_03_ASEReadCounter.table","NW_015090842.1:9597033",6,6,0
"CDT1","s1633_S_TNA_03_ASEReadCounter.table","NW_015090842.1:9597756",2,7,5
"CDT1","s1633_S_TNA_03_ASEReadCounter.table","NW_015090842.1:9598873",18,18,0
"ACSF3","s1633_S_TNA_03_ASEReadCounter.table","NW_015090842.1:9776737",2,5,3
"ACSF3","s1633_S_TNA_03_ASEReadCounter.table","NW_015090842.1:9809639",56,56,0
"ACSF3","s1633_S_TNA_03_ASEReadCounter.table","NW_015090842.1:9834743",30,66,36
"ACSF3","s1633_S_TNA_03_ASEReadCounter.table","NW_015090842.1:9834762",61,61,0
"ACSF3","s1633_S_TNA_03_ASEReadCounter.table","NW_015090842.1:9834852",41,87,46
"ACSF3","s1633_S_TNA_03_ASEReadCounter.table","NW_015090842.1:9834861",35,80,45
"ACSF3","s1633_S_TNA_03_ASEReadCounter.table","NW_015090842.1:9839359",28,77,49
"ACSF3","s1633_S_TNA_03_ASEReadCounter.table","NW_015090842.1:9839378",26,71,45
"ACSF3","s1633_S_TNA_03_ASEReadCounter.table","NW_015090842.1:9839455",18,54,36
"ACSF3","s1633_S_TNA_03_ASEReadCounter.table","NW_015090842.1:9839457",18,51,33
"ACSF3","s1633_S_TNA_03_ASEReadCounter.table","NW_015090842.1:9839489",15,39,24
"ACSF3","s1633_S_TNA_03_ASEReadCounter.table","NW_015090842.1:9839500",11,32,21
"ACSF3","s1633_S_TNA_03_ASEReadCounter.table","NW_015090842.1:9839501",11,31,20
"ACSF3","s1633_S_TNA_03_ASEReadCounter.table","NW_015090842.1:9839504",13,33,20
"ACSF3","s1633_S_TNA_03_ASEReadCounter.table","NW_015090842.1:9839512",9,21,12
"ACSF3","s1633_S_TNA_03_ASEReadCounter.table","NW_015090842.1:9839527",8,20,12
"ACSF3","s1633_S_TNA_03_ASEReadCounter.table","NW_015090842.1:9839533",5,16,11
"ACSF3","s1633_S_TNA_03_ASEReadCounter.table","NW_015090842.1:9839535",5,16,11
"ACSF3","s1633_S_TNA_03_ASEReadCounter.table","NW_015090842.1:9839545",4,15,11
"ACSF3","s1633_S_TNA_03_ASEReadCounter.table","NW_015090842.1:9839550",4,14,10
"ACSF3","s1633_S_TNA_03_ASEReadCounter.table","NW_015090842.1:9839551",4,14,10
"CDH15","s1633_S_TNA_03_ASEReadCounter.table","NW_015090842.1:9847163",0,1,1
"CDH15","s1633_S_TNA_03_ASEReadCounter.table","NW_015090842.1:9847174",0,1,1
"CDH15","s1633_S_TNA_03_ASEReadCounter.table","NW_015090842.1:9848220",0,1,1
"CDH15","s1633_S_TNA_03_ASEReadCounter.table","NW_015090842.1:9848265",1,2,1
"CDH15","s1633_S_TNA_03_ASEReadCounter.table","NW_015090842.1:9848531",1,1,0
"CDH15","s1633_S_TNA_03_ASEReadCounter.table","NW_015090842.1:9848552",1,1,0
"CDH15","s1633_S_TNA_03_ASEReadCounter.table","NW_015090842.1:9849086",0,1,1
"CDH15","s1633_S_TNA_03_ASEReadCounter.table","NW_015090842.1:9849119",0,1,1
"CDH15","s1633_S_TNA_03_ASEReadCounter.table","NW_015090842.1:9849473",1,2,1
"CDH15","s1633_S_TNA_03_ASEReadCounter.table","NW_015090842.1:9850386",2,2,0
"CDH15","s1633_S_TNA_03_ASEReadCounter.table","NW_015090842.1:9850432",2,3,1
"CDH15","s1633_S_TNA_03_ASEReadCounter.table","NW_015090842.1:9850609",2,2,0
"SLC22A31","s1633_S_TNA_03_ASEReadCounter.table","NW_015090842.1:9850797",2,4,2
"SLC22A31","s1633_S_TNA_03_ASEReadCounter.table","NW_015090842.1:9850818",3,4,1
"SLC22A31","s1633_S_TNA_03_ASEReadCounter.table","NW_015090842.1:9850929",4,5,1
"SLC22A31","s1633_S_TNA_03_ASEReadCounter.table","NW_015090842.1:9850936",3,4,1
"SLC22A31","s1633_S_TNA_03_ASEReadCounter.table","NW_015090842.1:9850940",4,5,1
"SLC22A31","s1633_S_TNA_03_ASEReadCounter.table","NW_015090842.1:9850948",4,5,1
"SLC22A31","s1633_S_TNA_03_ASEReadCounter.table","NW_015090842.1:9850961",5,6,1
"SLC22A31","s1633_S_TNA_03_ASEReadCounter.table","NW_015090842.1:9850970",5,6,1
"SLC22A31","s1633_S_TNA_03_ASEReadCounter.table","NW_015090842.1:9850978",4,5,1
"SLC22A31","s1633_S_TNA_03_ASEReadCounter.table","NW_015090842.1:9850981",5,7,2
"SLC22A31","s1633_S_TNA_03_ASEReadCounter.table","NW_015090842.1:9851032",2,3,1
"SLC22A31","s1633_S_TNA_03_ASEReadCounter.table","NW_015090842.1:9851053",0,1,1
"SLC22A31","s1633_S_TNA_03_ASEReadCounter.table","NW_015090842.1:9851130",9,17,8
"SLC22A31","s1633_S_TNA_03_ASEReadCounter.table","NW_015090842.1:9851139",9,17,8
"SLC22A31","s1633_S_TNA_03_ASEReadCounter.table","NW_015090842.1:9851265",7,21,14
"SLC22A31","s1633_S_TNA_03_ASEReadCounter.table","NW_015090842.1:9851302",4,15,11
"SLC22A31","s1633_S_TNA_03_ASEReadCounter.table","NW_015090842.1:9851303",5,15,10
"SLC22A31","s1633_S_TNA_03_ASEReadCounter.table","NW_015090842.1:9851305",5,17,12
"SLC22A31","s1633_S_TNA_03_ASEReadCounter.table","NW_015090842.1:9851343",4,12,8
"SLC22A31","s1633_S_TNA_03_ASEReadCounter.table","NW_015090842.1:9851344",4,12,8
"SLC22A31","s1633_S_TNA_03_ASEReadCounter.table","NW_015090842.1:9851381",8,14,6
"SLC22A31","s1633_S_TNA_03_ASEReadCounter.table","NW_015090842.1:9851421",12,20,8
"SLC22A31","s1633_S_TNA_03_ASEReadCounter.table","NW_015090842.1:9851526",11,22,11
"SLC22A31","s1633_S_TNA_03_ASEReadCounter.table","NW_015090842.1:9851589",13,21,8
"SLC22A31","s1633_S_TNA_03_ASEReadCounter.table","NW_015090842.1:9851712",10,21,11
"SLC22A31","s1633_S_TNA_03_ASEReadCounter.table","NW_015090842.1:9851899",13,30,17
"SLC22A31","s1633_S_TNA_03_ASEReadCounter.table","NW_015090842.1:9852139",10,19,9
"SLC22A31","s1633_S_TNA_03_ASEReadCounter.table","NW_015090842.1:9852380",7,16,9
"SLC22A31","s1633_S_TNA_03_ASEReadCounter.table","NW_015090842.1:9852431",8,11,3
"SLC22A31","s1633_S_TNA_03_ASEReadCounter.table","NW_015090842.1:9852630",4,10,6
"SLC22A31","s1633_S_TNA_03_ASEReadCounter.table","NW_015090842.1:9852711",5,10,5
"SLC22A31","s1633_S_TNA_03_ASEReadCounter.table","NW_015090842.1:9852742",6,11,5
"SLC22A31","s1633_S_TNA_03_ASEReadCounter.table","NW_015090842.1:9853099",3,8,5
"SLC22A31","s1633_S_TNA_03_ASEReadCounter.table","NW_015090842.1:9853102",3,8,5
"SLC22A31","s1633_S_TNA_03_ASEReadCounter.table","NW_015090842.1:9853421",4,4,0
"SLC22A31","s1633_S_TNA_03_ASEReadCounter.table","NW_015090842.1:9853457",4,4,0
"SLC22A31","s1633_S_TNA_03_ASEReadCounter.table","NW_015090842.1:9853502",3,3,0
"ANKRD11","s1633_S_TNA_03_ASEReadCounter.table","NW_015090842.1:9858863",18,40,22
"ANKRD11","s1633_S_TNA_03_ASEReadCounter.table","NW_015090842.1:9859101",166,366,200
"ANKRD11","s1633_S_TNA_03_ASEReadCounter.table","NW_015090842.1:9859352",188,410,222
"ANKRD11","s1633_S_TNA_03_ASEReadCounter.table","NW_015090842.1:9859381",47,216,169
"ANKRD11","s1633_S_TNA_03_ASEReadCounter.table","NW_015090842.1:9859527",95,204,109
"ANKRD11","s1633_S_TNA_03_ASEReadCounter.table","NW_015090842.1:9859529",98,213,115
"ANKRD11","s1633_S_TNA_03_ASEReadCounter.table","NW_015090842.1:9859679",213,393,180
"ANKRD11","s1633_S_TNA_03_ASEReadCounter.table","NW_015090842.1:9861097",119,246,127
"ANKRD11","s1633_S_TNA_03_ASEReadCounter.table","NW_015090842.1:9862571",83,146,63
"ANKRD11","s1633_S_TNA_03_ASEReadCounter.table","NW_015090842.1:9866071",0,84,84
"ANKRD11","s1633_S_TNA_03_ASEReadCounter.table","NW_015090842.1:9866200",0,59,59
"ANKRD11","s1633_S_TNA_03_ASEReadCounter.table","NW_015090842.1:9867391",14,26,12
"ANKRD11","s1633_S_TNA_03_ASEReadCounter.table","NW_015090842.1:9867472",18,49,31
"ANKRD11","s1633_S_TNA_03_ASEReadCounter.table","NW_015090842.1:9867559",13,43,30
"ANKRD11","s1633_S_TNA_03_ASEReadCounter.table","NW_015090842.1:9867934",26,55,29
"ANKRD11","s1633_S_TNA_03_ASEReadCounter.table","NW_015090842.1:9868093",27,70,43
"ANKRD11","s1633_S_TNA_03_ASEReadCounter.table","NW_015090842.1:9868222",35,72,37
"ANKRD11","s1633_S_TNA_03_ASEReadCounter.table","NW_015090842.1:9868327",43,99,56
"ANKRD11","s1633_S_TNA_03_ASEReadCounter.table","NW_015090842.1:9868414",57,120,63
"ANKRD11","s1633_S_TNA_03_ASEReadCounter.table","NW_015090842.1:9868441",58,115,57
"ANKRD11","s1633_S_TNA_03_ASEReadCounter.table","NW_015090842.1:9868444",59,121,62
"ANKRD11","s1633_S_TNA_03_ASEReadCounter.table","NW_015090842.1:9868519",72,145,73
"ANKRD11","s1633_S_TNA_03_ASEReadCounter.table","NW_015090842.1:9868609",90,191,101
"ANKRD11","s1633_S_TNA_03_ASEReadCounter.table","NW_015090842.1:9868666",120,237,117
"ANKRD11","s1633_S_TNA_03_ASEReadCounter.table","NW_015090842.1:9869431",196,379,183
"ANKRD11","s1633_S_TNA_03_ASEReadCounter.table","NW_015090842.1:9869578",297,596,299
"ANKRD11","s1633_S_TNA_03_ASEReadCounter.table","NW_015090842.1:9869734",338,648,310
"ANKRD11","s1633_S_TNA_03_ASEReadCounter.table","NW_015090842.1:9870070",325,644,319
"ANKRD11","s1633_S_TNA_03_ASEReadCounter.table","NW_015090842.1:9870349",367,729,362
"ANKRD11","s1633_S_TNA_03_ASEReadCounter.table","NW_015090842.1:9870604",396,762,366
"ANKRD11","s1633_S_TNA_03_ASEReadCounter.table","NW_015090842.1:9870613",433,810,377
"ANKRD11","s1633_S_TNA_03_ASEReadCounter.table","NW_015090842.1:9870685",450,925,475
"ANKRD11","s1633_S_TNA_03_ASEReadCounter.table","NW_015090842.1:9870847",390,752,362
"ANKRD11","s1633_S_TNA_03_ASEReadCounter.table","NW_015090842.1:9871103",260,537,277
"ANKRD11","s1633_S_TNA_03_ASEReadCounter.table","NW_015090842.1:9871165",307,606,299
"ANKRD11","s1633_S_TNA_03_ASEReadCounter.table","NW_015090842.1:9871820",72,145,73
"ANKRD11","s1633_S_TNA_03_ASEReadCounter.table","NW_015090842.1:9871994",122,122,0
"ANKRD11","s1633_S_TNA_03_ASEReadCounter.table","NW_015090842.1:9872118",55,121,66
"SPG7","s1633_S_TNA_03_ASEReadCounter.table","NW_015090842.1:10051190",45,111,66
"SPG7","s1633_S_TNA_03_ASEReadCounter.table","NW_015090842.1:10051218",48,125,77
"SPG7","s1633_S_TNA_03_ASEReadCounter.table","NW_015090842.1:10052348",81,158,77
"SPG7","s1633_S_TNA_03_ASEReadCounter.table","NW_015090842.1:10052366",76,151,75
"SPG7","s1633_S_TNA_03_ASEReadCounter.table","NW_015090842.1:10065173",130,244,114
"SPG7","s1633_S_TNA_03_ASEReadCounter.table","NW_015090842.1:10065215",118,210,92
"SPG7","s1633_S_TNA_03_ASEReadCounter.table","NW_015090842.1:10066301",96,188,92
"SPG7","s1633_S_TNA_03_ASEReadCounter.table","NW_015090842.1:10066365",126,238,112
"SPG7","s1633_S_TNA_03_ASEReadCounter.table","NW_015090842.1:10069752",146,280,134
"SPG7","s1633_S_TNA_03_ASEReadCounter.table","NW_015090842.1:10069800",140,292,152
"SPG7","s1633_S_TNA_03_ASEReadCounter.table","NW_015090842.1:10071192",163,330,167
"SPG7","s1633_S_TNA_03_ASEReadCounter.table","NW_015090842.1:10071204",154,309,155
"SPG7","s1633_S_TNA_03_ASEReadCounter.table","NW_015090842.1:10071219",160,310,150
"SPG7","s1633_S_TNA_03_ASEReadCounter.table","NW_015090842.1:10071967",168,354,186
"SPG7","s1633_S_TNA_03_ASEReadCounter.table","NW_015090842.1:10075109",328,615,287
"SPG7","s1633_S_TNA_03_ASEReadCounter.table","NW_015090842.1:10075114",337,624,287
"SPG7","s1633_S_TNA_03_ASEReadCounter.table","NW_015090842.1:10075198",297,522,225
"SPG7","s1633_S_TNA_03_ASEReadCounter.table","NW_015090842.1:10075487",215,438,223
"SPG7","s1633_S_TNA_03_ASEReadCounter.table","NW_015090842.1:10075488",214,439,225
"SPG7","s1633_S_TNA_03_ASEReadCounter.table","NW_015090842.1:10075548",180,350,170
"RPL13","s1633_S_TNA_03_ASEReadCounter.table","NW_015090842.1:10076979",3,6,3
"RPL13","s1633_S_TNA_03_ASEReadCounter.table","NW_015090842.1:10077387",411,912,501
"RPL13","s1633_S_TNA_03_ASEReadCounter.table","NW_015090842.1:10077978",673,1426,753
"RPL13","s1633_S_TNA_03_ASEReadCounter.table","NW_015090842.1:10077992",669,1397,728
"CPNE7","s1633_S_TNA_03_ASEReadCounter.table","NW_015090842.1:10084001",39,94,55
"CPNE7","s1633_S_TNA_03_ASEReadCounter.table","NW_015090842.1:10084856",23,70,47
"CPNE7","s1633_S_TNA_03_ASEReadCounter.table","NW_015090842.1:10084872",22,68,46
"CPNE7","s1633_S_TNA_03_ASEReadCounter.table","NW_015090842.1:10084892",31,85,54
"CPNE7","s1633_S_TNA_03_ASEReadCounter.table","NW_015090842.1:10084921",34,81,47
"CPNE7","s1633_S_TNA_03_ASEReadCounter.table","NW_015090842.1:10084935",36,84,48
"CPNE7","s1633_S_TNA_03_ASEReadCounter.table","NW_015090842.1:10085000",42,91,49
"CPNE7","s1633_S_TNA_03_ASEReadCounter.table","NW_015090842.1:10085089",38,92,54
"CPNE7","s1633_S_TNA_03_ASEReadCounter.table","NW_015090842.1:10085096",44,96,52
"CPNE7","s1633_S_TNA_03_ASEReadCounter.table","NW_015090842.1:10085126",43,96,53
"CPNE7","s1633_S_TNA_03_ASEReadCounter.table","NW_015090842.1:10085180",46,101,55
"CPNE7","s1633_S_TNA_03_ASEReadCounter.table","NW_015090842.1:10085201",42,90,48
"CPNE7","s1633_S_TNA_03_ASEReadCounter.table","NW_015090842.1:10088134",104,219,115
"CPNE7","s1633_S_TNA_03_ASEReadCounter.table","NW_015090842.1:10088146",95,202,107
"CPNE7","s1633_S_TNA_03_ASEReadCounter.table","NW_015090842.1:10088940",182,364,182
"CPNE7","s1633_S_TNA_03_ASEReadCounter.table","NW_015090842.1:10088965",165,345,180
"CPNE7","s1633_S_TNA_03_ASEReadCounter.table","NW_015090842.1:10088967",163,336,173
"CPNE7","s1633_S_TNA_03_ASEReadCounter.table","NW_015090842.1:10088973",163,350,187
"CPNE7","s1633_S_TNA_03_ASEReadCounter.table","NW_015090842.1:10090924",326,671,345
"CPNE7","s1633_S_TNA_03_ASEReadCounter.table","NW_015090842.1:10090930",328,682,354
"CPNE7","s1633_S_TNA_03_ASEReadCounter.table","NW_015090842.1:10091075",366,727,361
"CPNE7","s1633_S_TNA_03_ASEReadCounter.table","NW_015090842.1:10091389",405,914,509
"CPNE7","s1633_S_TNA_03_ASEReadCounter.table","NW_015090842.1:10091407",456,959,503
"CPNE7","s1633_S_TNA_03_ASEReadCounter.table","NW_015090842.1:10091530",392,900,508
"CPNE7","s1633_S_TNA_03_ASEReadCounter.table","NW_015090842.1:10091875",554,1149,595
"CPNE7","s1633_S_TNA_03_ASEReadCounter.table","NW_015090842.1:10091983",492,1016,524
"CPNE7","s1633_S_TNA_03_ASEReadCounter.table","NW_015090842.1:10091997",497,1053,556
"CPNE7","s1633_S_TNA_03_ASEReadCounter.table","NW_015090842.1:10092038",287,670,383
"CPNE7","s1633_S_TNA_03_ASEReadCounter.table","NW_015090842.1:10092140",375,911,536
"CPNE7","s1633_S_TNA_03_ASEReadCounter.table","NW_015090842.1:10092183",298,673,375
"CPNE7","s1633_S_TNA_03_ASEReadCounter.table","NW_015090842.1:10092201",247,568,321
"CPNE7","s1633_S_TNA_03_ASEReadCounter.table","NW_015090842.1:10092230",166,413,247
"CPNE7","s1633_S_TNA_03_ASEReadCounter.table","NW_015090842.1:10092246",102,283,181
"LOC106888185","s1633_S_TNA_03_ASEReadCounter.table","NW_015090842.1:10094965",1,3,2
"LOC106888185","s1633_S_TNA_03_ASEReadCounter.table","NW_015090842.1:10094966",1,3,2
"LOC106888185","s1633_S_TNA_03_ASEReadCounter.table","NW_015090842.1:10094985",1,4,3
"LOC106888185","s1633_S_TNA_03_ASEReadCounter.table","NW_015090842.1:10095055",0,3,3
"LOC106888185","s1633_S_TNA_03_ASEReadCounter.table","NW_015090842.1:10095062",0,2,2
"LOC106888185","s1633_S_TNA_03_ASEReadCounter.table","NW_015090842.1:10095130",2,2,0
"LOC106888185","s1633_S_TNA_03_ASEReadCounter.table","NW_015090842.1:10095265",1,3,2
"LOC106888185","s1633_S_TNA_03_ASEReadCounter.table","NW_015090842.1:10095586",3,11,8
"LOC106888185","s1633_S_TNA_03_ASEReadCounter.table","NW_015090842.1:10095593",3,10,7
"LOC106888185","s1633_S_TNA_03_ASEReadCounter.table","NW_015090842.1:10095616",1,7,6
"LOC106888185","s1633_S_TNA_03_ASEReadCounter.table","NW_015090842.1:10095662",1,9,8
"LOC106888185","s1633_S_TNA_03_ASEReadCounter.table","NW_015090842.1:10095674",1,9,8
"LOC106888185","s1633_S_TNA_03_ASEReadCounter.table","NW_015090842.1:10095786",1,8,7
"LOC106888185","s1633_S_TNA_03_ASEReadCounter.table","NW_015090842.1:10095831",0,6,6
"LOC106888185","s1633_S_TNA_03_ASEReadCounter.table","NW_015090842.1:10096230",0,2,2
"LOC106888185","s1633_S_TNA_03_ASEReadCounter.table","NW_015090842.1:10096249",0,2,2
"LOC106888185","s1633_S_TNA_03_ASEReadCounter.table","NW_015090842.1:10096272",0,3,3
"LOC106888185","s1633_S_TNA_03_ASEReadCounter.table","NW_015090842.1:10096288",1,4,3
"LOC106888185","s1633_S_TNA_03_ASEReadCounter.table","NW_015090842.1:10097248",1,4,3
"LOC106888185","s1633_S_TNA_03_ASEReadCounter.table","NW_015090842.1:10097265",2,5,3
"LOC106888185","s1633_S_TNA_03_ASEReadCounter.table","NW_015090842.1:10097446",1,1,0
"DPEP1","s1633_S_TNA_03_ASEReadCounter.table","NW_015090842.1:10098518",0,1,1
"DPEP1","s1633_S_TNA_03_ASEReadCounter.table","NW_015090842.1:10098595",0,1,1
"DPEP1","s1633_S_TNA_03_ASEReadCounter.table","NW_015090842.1:10098597",0,1,1
"DPEP1","s1633_S_TNA_03_ASEReadCounter.table","NW_015090842.1:10098601",0,1,1
"DPEP1","s1633_S_TNA_03_ASEReadCounter.table","NW_015090842.1:10098608",0,1,1
"DPEP1","s1633_S_TNA_03_ASEReadCounter.table","NW_015090842.1:10098630",0,1,1
"DPEP1","s1633_S_TNA_03_ASEReadCounter.table","NW_015090842.1:10098659",0,1,1
"DPEP1","s1633_S_TNA_03_ASEReadCounter.table","NW_015090842.1:10099765",0,1,1
"DPEP1","s1633_S_TNA_03_ASEReadCounter.table","NW_015090842.1:10099985",1,5,4
"DPEP1","s1633_S_TNA_03_ASEReadCounter.table","NW_015090842.1:10099986",1,5,4
"DPEP1","s1633_S_TNA_03_ASEReadCounter.table","NW_015090842.1:10099991",1,5,4
"DPEP1","s1633_S_TNA_03_ASEReadCounter.table","NW_015090842.1:10100044",0,4,4
"DPEP1","s1633_S_TNA_03_ASEReadCounter.table","NW_015090842.1:10100045",0,4,4
"DPEP1","s1633_S_TNA_03_ASEReadCounter.table","NW_015090842.1:10100084",0,4,4
"DPEP1","s1633_S_TNA_03_ASEReadCounter.table","NW_015090842.1:10100295",0,4,4
"DPEP1","s1633_S_TNA_03_ASEReadCounter.table","NW_015090842.1:10100529",0,3,3
"DPEP1","s1633_S_TNA_03_ASEReadCounter.table","NW_015090842.1:10100893",0,1,1
"DPEP1","s1633_S_TNA_03_ASEReadCounter.table","NW_015090842.1:10100902",0,3,3
"DPEP1","s1633_S_TNA_03_ASEReadCounter.table","NW_015090842.1:10101072",0,4,4
"DPEP1","s1633_S_TNA_03_ASEReadCounter.table","NW_015090842.1:10101199",1,2,1
"DPEP1","s1633_S_TNA_03_ASEReadCounter.table","NW_015090842.1:10101483",0,2,2
"DPEP1","s1633_S_TNA_03_ASEReadCounter.table","NW_015090842.1:10101497",0,2,2
"DPEP1","s1633_S_TNA_03_ASEReadCounter.table","NW_015090842.1:10101525",0,3,3
"DPEP1","s1633_S_TNA_03_ASEReadCounter.table","NW_015090842.1:10101875",0,3,3
"DPEP1","s1633_S_TNA_03_ASEReadCounter.table","NW_015090842.1:10101913",1,3,2
"DPEP1","s1633_S_TNA_03_ASEReadCounter.table","NW_015090842.1:10101996",1,2,1
"DPEP1","s1633_S_TNA_03_ASEReadCounter.table","NW_015090842.1:10102014",1,2,1
"DPEP1","s1633_S_TNA_03_ASEReadCounter.table","NW_015090842.1:10102035",0,1,1
"CHMP1A","s1633_S_TNA_03_ASEReadCounter.table","NW_015090842.1:10102901",81,198,117
"CHMP1A","s1633_S_TNA_03_ASEReadCounter.table","NW_015090842.1:10102961",82,225,143
"CHMP1A","s1633_S_TNA_03_ASEReadCounter.table","NW_015090842.1:10102996",69,204,135
"CHMP1A","s1633_S_TNA_03_ASEReadCounter.table","NW_015090842.1:10103004",73,208,135
"CHMP1A","s1633_S_TNA_03_ASEReadCounter.table","NW_015090842.1:10103006",72,209,137
"CHMP1A","s1633_S_TNA_03_ASEReadCounter.table","NW_015090842.1:10103052",110,265,155
"CHMP1A","s1633_S_TNA_03_ASEReadCounter.table","NW_015090842.1:10103095",108,261,153
"CHMP1A","s1633_S_TNA_03_ASEReadCounter.table","NW_015090842.1:10103096",109,260,151
"CHMP1A","s1633_S_TNA_03_ASEReadCounter.table","NW_015090842.1:10103152",104,208,104
"CHMP1A","s1633_S_TNA_03_ASEReadCounter.table","NW_015090842.1:10103334",61,136,75
"CHMP1A","s1633_S_TNA_03_ASEReadCounter.table","NW_015090842.1:10103373",30,101,71
"CHMP1A","s1633_S_TNA_03_ASEReadCounter.table","NW_015090842.1:10103408",69,157,88
"CHMP1A","s1633_S_TNA_03_ASEReadCounter.table","NW_015090842.1:10103412",69,155,86
"CHMP1A","s1633_S_TNA_03_ASEReadCounter.table","NW_015090842.1:10103512",95,171,76
"CHMP1A","s1633_S_TNA_03_ASEReadCounter.table","NW_015090842.1:10103513",95,173,78
"CHMP1A","s1633_S_TNA_03_ASEReadCounter.table","NW_015090842.1:10103583",57,114,57
"CHMP1A","s1633_S_TNA_03_ASEReadCounter.table","NW_015090842.1:10103614",54,106,52
"CHMP1A","s1633_S_TNA_03_ASEReadCounter.table","NW_015090842.1:10103657",59,118,59
"CHMP1A","s1633_S_TNA_03_ASEReadCounter.table","NW_015090842.1:10103669",55,114,59
"CHMP1A","s1633_S_TNA_03_ASEReadCounter.table","NW_015090842.1:10103674",54,106,52
"CHMP1A","s1633_S_TNA_03_ASEReadCounter.table","NW_015090842.1:10103677",51,105,54
"CHMP1A","s1633_S_TNA_03_ASEReadCounter.table","NW_015090842.1:10103729",57,99,42
"CHMP1A","s1633_S_TNA_03_ASEReadCounter.table","NW_015090842.1:10103758",51,92,41
"CHMP1A","s1633_S_TNA_03_ASEReadCounter.table","NW_015090842.1:10103761",48,89,41
"CHMP1A","s1633_S_TNA_03_ASEReadCounter.table","NW_015090842.1:10103788",58,117,59
"CHMP1A","s1633_S_TNA_03_ASEReadCounter.table","NW_015090842.1:10103789",59,117,58
"CHMP1A","s1633_S_TNA_03_ASEReadCounter.table","NW_015090842.1:10103790",56,115,59
"CHMP1A","s1633_S_TNA_03_ASEReadCounter.table","NW_015090842.1:10103950",54,107,53
"CHMP1A","s1633_S_TNA_03_ASEReadCounter.table","NW_015090842.1:10104335",38,73,35
"CHMP1A","s1633_S_TNA_03_ASEReadCounter.table","NW_015090842.1:10104429",54,107,53
"CHMP1A","s1633_S_TNA_03_ASEReadCounter.table","NW_015090842.1:10104532",39,90,51
"CHMP1A","s1633_S_TNA_03_ASEReadCounter.table","NW_015090842.1:10104633",33,69,36
"CHMP1A","s1633_S_TNA_03_ASEReadCounter.table","NW_015090842.1:10104759",32,63,31
"CHMP1A","s1633_S_TNA_03_ASEReadCounter.table","NW_015090842.1:10104794",36,69,33
"CHMP1A","s1633_S_TNA_03_ASEReadCounter.table","NW_015090842.1:10104844",27,56,29
"CHMP1A","s1633_S_TNA_03_ASEReadCounter.table","NW_015090842.1:10106290",27,46,19
"CHMP1A","s1633_S_TNA_03_ASEReadCounter.table","NW_015090842.1:10106335",33,57,24
"CHMP1A","s1633_S_TNA_03_ASEReadCounter.table","NW_015090842.1:10106383",38,68,30
"CHMP1A","s1633_S_TNA_03_ASEReadCounter.table","NW_015090842.1:10106747",37,65,28
"CHMP1A","s1633_S_TNA_03_ASEReadCounter.table","NW_015090842.1:10107404",27,62,35
"CHMP1A","s1633_S_TNA_03_ASEReadCounter.table","NW_015090842.1:10107410",27,59,32
"CHMP1A","s1633_S_TNA_03_ASEReadCounter.table","NW_015090842.1:10107876",30,60,30
"CDK10","s1633_S_TNA_03_ASEReadCounter.table","NW_015090842.1:10109030",8,9,1
"CDK10","s1633_S_TNA_03_ASEReadCounter.table","NW_015090842.1:10109963",30,89,59
"CDK10","s1633_S_TNA_03_ASEReadCounter.table","NW_015090842.1:10110887",35,85,50
"CDK10","s1633_S_TNA_03_ASEReadCounter.table","NW_015090842.1:10111254",23,70,47
"CDK10","s1633_S_TNA_03_ASEReadCounter.table","NW_015090842.1:10111380",28,84,56
"CDK10","s1633_S_TNA_03_ASEReadCounter.table","NW_015090842.1:10111395",28,80,52
"CDK10","s1633_S_TNA_03_ASEReadCounter.table","NW_015090842.1:10111437",19,78,59
"CDK10","s1633_S_TNA_03_ASEReadCounter.table","NW_015090842.1:10111798",37,110,73
"CDK10","s1633_S_TNA_03_ASEReadCounter.table","NW_015090842.1:10111840",34,104,70
"CDK10","s1633_S_TNA_03_ASEReadCounter.table","NW_015090842.1:10112031",48,150,102
"CDK10","s1633_S_TNA_03_ASEReadCounter.table","NW_015090842.1:10112285",62,160,98
"CDK10","s1633_S_TNA_03_ASEReadCounter.table","NW_015090842.1:10112398",78,187,109
"CDK10","s1633_S_TNA_03_ASEReadCounter.table","NW_015090842.1:10112455",75,191,116
"CDK10","s1633_S_TNA_03_ASEReadCounter.table","NW_015090842.1:10112461",66,176,110
"CDK10","s1633_S_TNA_03_ASEReadCounter.table","NW_015090842.1:10112497",49,146,97
"CDK10","s1633_S_TNA_03_ASEReadCounter.table","NW_015090842.1:10112508",42,144,102
"CDK10","s1633_S_TNA_03_ASEReadCounter.table","NW_015090842.1:10112518",35,131,96
"CDK10","s1633_S_TNA_03_ASEReadCounter.table","NW_015090842.1:10112540",13,113,100
"CDK10","s1633_S_TNA_03_ASEReadCounter.table","NW_015090842.1:10112556",40,133,93
"CDK10","s1633_S_TNA_03_ASEReadCounter.table","NW_015090842.1:10112561",40,149,109
"CDK10","s1633_S_TNA_03_ASEReadCounter.table","NW_015090842.1:10112596",53,185,132
"CDK10","s1633_S_TNA_03_ASEReadCounter.table","NW_015090842.1:10112630",51,175,124
"CDK10","s1633_S_TNA_03_ASEReadCounter.table","NW_015090842.1:10112656",47,153,106
"CDK10","s1633_S_TNA_03_ASEReadCounter.table","NW_015090842.1:10112665",38,116,78
"CDK10","s1633_S_TNA_03_ASEReadCounter.table","NW_015090842.1:10112668",36,112,76
"CDK10","s1633_S_TNA_03_ASEReadCounter.table","NW_015090842.1:10112781",24,59,35
"CDK10","s1633_S_TNA_03_ASEReadCounter.table","NW_015090842.1:10112782",26,62,36
"CDK10","s1633_S_TNA_03_ASEReadCounter.table","NW_015090842.1:10112795",23,56,33
"CDK10","s1633_S_TNA_03_ASEReadCounter.table","NW_015090842.1:10112841",10,17,7
"CDK10","s1633_S_TNA_03_ASEReadCounter.table","NW_015090842.1:10112861",3,8,5
"SPATA2L","s1633_S_TNA_03_ASEReadCounter.table","NW_015090842.1:10113212",43,117,74
"SPATA2L","s1633_S_TNA_03_ASEReadCounter.table","NW_015090842.1:10113280",53,191,138
"SPATA2L","s1633_S_TNA_03_ASEReadCounter.table","NW_015090842.1:10113296",57,185,128
"SPATA2L","s1633_S_TNA_03_ASEReadCounter.table","NW_015090842.1:10113321",70,213,143
"SPATA2L","s1633_S_TNA_03_ASEReadCounter.table","NW_015090842.1:10113332",69,232,163
"SPATA2L","s1633_S_TNA_03_ASEReadCounter.table","NW_015090842.1:10113380",76,229,153
"SPATA2L","s1633_S_TNA_03_ASEReadCounter.table","NW_015090842.1:10113381",76,229,153
"SPATA2L","s1633_S_TNA_03_ASEReadCounter.table","NW_015090842.1:10113412",74,224,150
"SPATA2L","s1633_S_TNA_03_ASEReadCounter.table","NW_015090842.1:10113421",73,220,147
"SPATA2L","s1633_S_TNA_03_ASEReadCounter.table","NW_015090842.1:10113465",57,186,129
"SPATA2L","s1633_S_TNA_03_ASEReadCounter.table","NW_015090842.1:10113535",98,188,90
"SPATA2L","s1633_S_TNA_03_ASEReadCounter.table","NW_015090842.1:10113645",92,242,150
"SPATA2L","s1633_S_TNA_03_ASEReadCounter.table","NW_015090842.1:10113682",104,286,182
"SPATA2L","s1633_S_TNA_03_ASEReadCounter.table","NW_015090842.1:10113696",97,255,158
"SPATA2L","s1633_S_TNA_03_ASEReadCounter.table","NW_015090842.1:10113727",82,246,164
"SPATA2L","s1633_S_TNA_03_ASEReadCounter.table","NW_015090842.1:10113729",81,244,163
"SPATA2L","s1633_S_TNA_03_ASEReadCounter.table","NW_015090842.1:10113799",112,266,154
"SPATA2L","s1633_S_TNA_03_ASEReadCounter.table","NW_015090842.1:10113809",118,277,159
"SPATA2L","s1633_S_TNA_03_ASEReadCounter.table","NW_015090842.1:10113827",118,262,144
"SPATA2L","s1633_S_TNA_03_ASEReadCounter.table","NW_015090842.1:10113831",117,266,149
"SPATA2L","s1633_S_TNA_03_ASEReadCounter.table","NW_015090842.1:10113894",89,228,139
"SPATA2L","s1633_S_TNA_03_ASEReadCounter.table","NW_015090842.1:10113905",74,204,130
"SPATA2L","s1633_S_TNA_03_ASEReadCounter.table","NW_015090842.1:10113914",82,205,123
"SPATA2L","s1633_S_TNA_03_ASEReadCounter.table","NW_015090842.1:10113920",87,212,125
"SPATA2L","s1633_S_TNA_03_ASEReadCounter.table","NW_015090842.1:10113937",96,223,127
"SPATA2L","s1633_S_TNA_03_ASEReadCounter.table","NW_015090842.1:10113971",74,204,130
"SPATA2L","s1633_S_TNA_03_ASEReadCounter.table","NW_015090842.1:10113976",62,209,147
"SPATA2L","s1633_S_TNA_03_ASEReadCounter.table","NW_015090842.1:10113985",70,190,120
"SPATA2L","s1633_S_TNA_03_ASEReadCounter.table","NW_015090842.1:10113994",76,207,131
"SPATA2L","s1633_S_TNA_03_ASEReadCounter.table","NW_015090842.1:10114063",61,178,117
"SPATA2L","s1633_S_TNA_03_ASEReadCounter.table","NW_015090842.1:10114066",60,174,114
"SPATA2L","s1633_S_TNA_03_ASEReadCounter.table","NW_015090842.1:10114069",61,171,110
"SPATA2L","s1633_S_TNA_03_ASEReadCounter.table","NW_015090842.1:10114159",50,139,89
"SPATA2L","s1633_S_TNA_03_ASEReadCounter.table","NW_015090842.1:10114262",154,154,0
"SPATA2L","s1633_S_TNA_03_ASEReadCounter.table","NW_015090842.1:10114470",51,123,72
"SPATA2L","s1633_S_TNA_03_ASEReadCounter.table","NW_015090842.1:10114524",24,85,61
"VPS9D1","s1633_S_TNA_03_ASEReadCounter.table","NW_015090842.1:10116377",34,104,70
"VPS9D1","s1633_S_TNA_03_ASEReadCounter.table","NW_015090842.1:10116415",31,97,66
"VPS9D1","s1633_S_TNA_03_ASEReadCounter.table","NW_015090842.1:10116607",31,103,72
"VPS9D1","s1633_S_TNA_03_ASEReadCounter.table","NW_015090842.1:10116821",30,79,49
"VPS9D1","s1633_S_TNA_03_ASEReadCounter.table","NW_015090842.1:10116825",28,72,44
"VPS9D1","s1633_S_TNA_03_ASEReadCounter.table","NW_015090842.1:10116882",26,75,49
"VPS9D1","s1633_S_TNA_03_ASEReadCounter.table","NW_015090842.1:10116933",27,75,48
"VPS9D1","s1633_S_TNA_03_ASEReadCounter.table","NW_015090842.1:10116942",29,78,49
"VPS9D1","s1633_S_TNA_03_ASEReadCounter.table","NW_015090842.1:10117152",28,78,50
"VPS9D1","s1633_S_TNA_03_ASEReadCounter.table","NW_015090842.1:10117480",14,40,26
"VPS9D1","s1633_S_TNA_03_ASEReadCounter.table","NW_015090842.1:10117497",14,38,24
"VPS9D1","s1633_S_TNA_03_ASEReadCounter.table","NW_015090842.1:10117499",13,36,23
"VPS9D1","s1633_S_TNA_03_ASEReadCounter.table","NW_015090842.1:10117516",19,50,31
"VPS9D1","s1633_S_TNA_03_ASEReadCounter.table","NW_015090842.1:10117525",21,56,35
"VPS9D1","s1633_S_TNA_03_ASEReadCounter.table","NW_015090842.1:10117579",21,63,42
"VPS9D1","s1633_S_TNA_03_ASEReadCounter.table","NW_015090842.1:10117627",15,55,40
"VPS9D1","s1633_S_TNA_03_ASEReadCounter.table","NW_015090842.1:10117678",11,55,44
"VPS9D1","s1633_S_TNA_03_ASEReadCounter.table","NW_015090842.1:10117773",18,72,54
"VPS9D1","s1633_S_TNA_03_ASEReadCounter.table","NW_015090842.1:10117937",24,85,61
"VPS9D1","s1633_S_TNA_03_ASEReadCounter.table","NW_015090842.1:10117961",30,88,58
"VPS9D1","s1633_S_TNA_03_ASEReadCounter.table","NW_015090842.1:10118236",24,84,60
"VPS9D1","s1633_S_TNA_03_ASEReadCounter.table","NW_015090842.1:10118414",23,79,56
"VPS9D1","s1633_S_TNA_03_ASEReadCounter.table","NW_015090842.1:10118973",26,78,52
"VPS9D1","s1633_S_TNA_03_ASEReadCounter.table","NW_015090842.1:10119500",17,38,21
"ZNF276","s1633_S_TNA_03_ASEReadCounter.table","NW_015090842.1:10121760",4,6,2
"ZNF276","s1633_S_TNA_03_ASEReadCounter.table","NW_015090842.1:10121769",5,8,3
"ZNF276","s1633_S_TNA_03_ASEReadCounter.table","NW_015090842.1:10121802",5,11,6
"ZNF276","s1633_S_TNA_03_ASEReadCounter.table","NW_015090842.1:10121971",4,9,5
"ZNF276","s1633_S_TNA_03_ASEReadCounter.table","NW_015090842.1:10122161",15,15,0
"ZNF276","s1633_S_TNA_03_ASEReadCounter.table","NW_015090842.1:10122164",16,16,0
"ZNF276","s1633_S_TNA_03_ASEReadCounter.table","NW_015090842.1:10122184",15,15,0
"ZNF276","s1633_S_TNA_03_ASEReadCounter.table","NW_015090842.1:10122883",7,12,5
"ZNF276","s1633_S_TNA_03_ASEReadCounter.table","NW_015090842.1:10122997",9,18,9
"ZNF276","s1633_S_TNA_03_ASEReadCounter.table","NW_015090842.1:10123069",6,11,5
"ZNF276","s1633_S_TNA_03_ASEReadCounter.table","NW_015090842.1:10123207",17,28,11
"ZNF276","s1633_S_TNA_03_ASEReadCounter.table","NW_015090842.1:10125787",12,29,17
"ZNF276","s1633_S_TNA_03_ASEReadCounter.table","NW_015090842.1:10126309",10,26,16
"ZNF276","s1633_S_TNA_03_ASEReadCounter.table","NW_015090842.1:10126348",11,29,18
"ZNF276","s1633_S_TNA_03_ASEReadCounter.table","NW_015090842.1:10126978",22,39,17
"ZNF276","s1633_S_TNA_03_ASEReadCounter.table","NW_015090842.1:10126991",18,33,15
"ZNF276","s1633_S_TNA_03_ASEReadCounter.table","NW_015090842.1:10127023",20,34,14
"ZNF276","s1633_S_TNA_03_ASEReadCounter.table","NW_015090842.1:10127063",17,34,17
"ZNF276","s1633_S_TNA_03_ASEReadCounter.table","NW_015090842.1:10127373",25,46,21
"ZNF276","s1633_S_TNA_03_ASEReadCounter.table","NW_015090842.1:10127931",34,57,23
"ZNF276","s1633_S_TNA_03_ASEReadCounter.table","NW_015090842.1:10128070",31,61,30
"ZNF276","s1633_S_TNA_03_ASEReadCounter.table","NW_015090842.1:10128102",30,56,26
"ZNF276","s1633_S_TNA_03_ASEReadCounter.table","NW_015090842.1:10128356",8,37,29
"ZNF276","s1633_S_TNA_03_ASEReadCounter.table","NW_015090842.1:10128497",17,47,30
"FANCA","s1633_S_TNA_03_ASEReadCounter.table","NW_015090842.1:10128743",1,1,0
"FANCA","s1633_S_TNA_03_ASEReadCounter.table","NW_015090842.1:10128822",1,2,1
"FANCA","s1633_S_TNA_03_ASEReadCounter.table","NW_015090842.1:10129383",0,2,2
"FANCA","s1633_S_TNA_03_ASEReadCounter.table","NW_015090842.1:10129390",0,2,2
"FANCA","s1633_S_TNA_03_ASEReadCounter.table","NW_015090842.1:10129422",0,1,1
"FANCA","s1633_S_TNA_03_ASEReadCounter.table","NW_015090842.1:10129969",1,1,0
"FANCA","s1633_S_TNA_03_ASEReadCounter.table","NW_015090842.1:10130399",3,3,0
"FANCA","s1633_S_TNA_03_ASEReadCounter.table","NW_015090842.1:10130857",2,2,0
"FANCA","s1633_S_TNA_03_ASEReadCounter.table","NW_015090842.1:10130878",1,1,0
"FANCA","s1633_S_TNA_03_ASEReadCounter.table","NW_015090842.1:10133530",1,1,0
"FANCA","s1633_S_TNA_03_ASEReadCounter.table","NW_015090842.1:10133533",1,1,0
"FANCA","s1633_S_TNA_03_ASEReadCounter.table","NW_015090842.1:10133536",1,1,0
"FANCA","s1633_S_TNA_03_ASEReadCounter.table","NW_015090842.1:10133601",1,1,0
"FANCA","s1633_S_TNA_03_ASEReadCounter.table","NW_015090842.1:10134492",0,1,1
"FANCA","s1633_S_TNA_03_ASEReadCounter.table","NW_015090842.1:10136957",0,1,1
"FANCA","s1633_S_TNA_03_ASEReadCounter.table","NW_015090842.1:10137673",0,1,1
"FANCA","s1633_S_TNA_03_ASEReadCounter.table","NW_015090842.1:10152863",1,1,0
"FANCA","s1633_S_TNA_03_ASEReadCounter.table","NW_015090842.1:10158162",1,1,0
"FANCA","s1633_S_TNA_03_ASEReadCounter.table","NW_015090842.1:10165331",0,1,1
"SPIRE2","s1633_S_TNA_03_ASEReadCounter.table","NW_015090842.1:10172284",17,37,20
"SPIRE2","s1633_S_TNA_03_ASEReadCounter.table","NW_015090842.1:10175262",38,62,24
"SPIRE2","s1633_S_TNA_03_ASEReadCounter.table","NW_015090842.1:10175352",19,32,13
"SPIRE2","s1633_S_TNA_03_ASEReadCounter.table","NW_015090842.1:10175400",57,113,56
"SPIRE2","s1633_S_TNA_03_ASEReadCounter.table","NW_015090842.1:10175418",70,127,57
"SPIRE2","s1633_S_TNA_03_ASEReadCounter.table","NW_015090842.1:10175704",76,159,83
"SPIRE2","s1633_S_TNA_03_ASEReadCounter.table","NW_015090842.1:10176115",103,220,117
"SPIRE2","s1633_S_TNA_03_ASEReadCounter.table","NW_015090842.1:10176561",90,218,128
"SPIRE2","s1633_S_TNA_03_ASEReadCounter.table","NW_015090842.1:10176817",119,222,103
"SPIRE2","s1633_S_TNA_03_ASEReadCounter.table","NW_015090842.1:10177084",64,157,93
"SPIRE2","s1633_S_TNA_03_ASEReadCounter.table","NW_015090842.1:10177838",137,300,163
"SPIRE2","s1633_S_TNA_03_ASEReadCounter.table","NW_015090842.1:10178000",133,311,178
"SPIRE2","s1633_S_TNA_03_ASEReadCounter.table","NW_015090842.1:10178164",146,313,167
"SPIRE2","s1633_S_TNA_03_ASEReadCounter.table","NW_015090842.1:10178216",164,345,181
"SPIRE2","s1633_S_TNA_03_ASEReadCounter.table","NW_015090842.1:10178303",162,314,152
"SPIRE2","s1633_S_TNA_03_ASEReadCounter.table","NW_015090842.1:10178403",178,350,172
"SPIRE2","s1633_S_TNA_03_ASEReadCounter.table","NW_015090842.1:10178409",178,342,164
"SPIRE2","s1633_S_TNA_03_ASEReadCounter.table","NW_015090842.1:10178524",176,352,176
"SPIRE2","s1633_S_TNA_03_ASEReadCounter.table","NW_015090842.1:10178526",178,359,181
"SPIRE2","s1633_S_TNA_03_ASEReadCounter.table","NW_015090842.1:10178531",183,358,175
"SPIRE2","s1633_S_TNA_03_ASEReadCounter.table","NW_015090842.1:10178565",177,366,189
"SPIRE2","s1633_S_TNA_03_ASEReadCounter.table","NW_015090842.1:10178587",171,325,154
"SPIRE2","s1633_S_TNA_03_ASEReadCounter.table","NW_015090842.1:10178640",118,245,127
"SPIRE2","s1633_S_TNA_03_ASEReadCounter.table","NW_015090842.1:10178651",134,265,131
"SPIRE2","s1633_S_TNA_03_ASEReadCounter.table","NW_015090842.1:10178682",119,225,106
"TCF25","s1633_S_TNA_03_ASEReadCounter.table","NW_015090842.1:10180912",47,77,30
"TCF25","s1633_S_TNA_03_ASEReadCounter.table","NW_015090842.1:10180924",50,79,29
"TCF25","s1633_S_TNA_03_ASEReadCounter.table","NW_015090842.1:10180931",49,76,27
"TCF25","s1633_S_TNA_03_ASEReadCounter.table","NW_015090842.1:10185332",112,205,93
"TCF25","s1633_S_TNA_03_ASEReadCounter.table","NW_015090842.1:10196561",64,127,63
"TCF25","s1633_S_TNA_03_ASEReadCounter.table","NW_015090842.1:10197399",206,206,0
"MC1R","s1633_S_TNA_03_ASEReadCounter.table","NW_015090842.1:10201853",1,3,2
"MC1R","s1633_S_TNA_03_ASEReadCounter.table","NW_015090842.1:10201986",0,1,1
"MC1R","s1633_S_TNA_03_ASEReadCounter.table","NW_015090842.1:10202160",1,2,1
"MC1R","s1633_S_TNA_03_ASEReadCounter.table","NW_015090842.1:10202447",1,3,2
"TUBB3","s1633_S_TNA_03_ASEReadCounter.table","NW_015090842.1:10205322",1,199,198
"GAS8","s1633_S_TNA_03_ASEReadCounter.table","NW_015090842.1:10228982",13,32,19
"GAS8","s1633_S_TNA_03_ASEReadCounter.table","NW_015090842.1:10229832",14,21,7
"GAS8","s1633_S_TNA_03_ASEReadCounter.table","NW_015090842.1:10232901",16,34,18
"GAS8","s1633_S_TNA_03_ASEReadCounter.table","NW_015090842.1:10232928",19,33,14
"GAS8","s1633_S_TNA_03_ASEReadCounter.table","NW_015090842.1:10232967",28,47,19
"GAS8","s1633_S_TNA_03_ASEReadCounter.table","NW_015090842.1:10233032",17,30,13
"GAS8","s1633_S_TNA_03_ASEReadCounter.table","NW_015090842.1:10233057",11,17,6
"GAS8","s1633_S_TNA_03_ASEReadCounter.table","NW_015090842.1:10233058",11,17,6
"GAS8","s1633_S_TNA_03_ASEReadCounter.table","NW_015090842.1:10233176",8,19,11
"GAS8","s1633_S_TNA_03_ASEReadCounter.table","NW_015090842.1:10233196",6,16,10
"GAS8","s1633_S_TNA_03_ASEReadCounter.table","NW_015090842.1:10233252",7,11,4
"GAS8","s1633_S_TNA_03_ASEReadCounter.table","NW_015090842.1:10233303",5,9,4
"LOC106888094","s1633_S_TNA_03_ASEReadCounter.table","NW_015090842.1:10233334",5,8,3
"LOC106888094","s1633_S_TNA_03_ASEReadCounter.table","NW_015090842.1:10233362",12,16,4
"LOC106888094","s1633_S_TNA_03_ASEReadCounter.table","NW_015090842.1:10233373",14,19,5
"LOC106888094","s1633_S_TNA_03_ASEReadCounter.table","NW_015090842.1:10233388",17,21,4
"LOC106888094","s1633_S_TNA_03_ASEReadCounter.table","NW_015090842.1:10233402",16,20,4
"LOC106888094","s1633_S_TNA_03_ASEReadCounter.table","NW_015090842.1:10233465",20,34,14
"LOC106888094","s1633_S_TNA_03_ASEReadCounter.table","NW_015090842.1:10233803",14,29,15
"LOC106888094","s1633_S_TNA_03_ASEReadCounter.table","NW_015090842.1:10233815",13,27,14
"LOC106888094","s1633_S_TNA_03_ASEReadCounter.table","NW_015090842.1:10235484",3,3,0
"LOC106888094","s1633_S_TNA_03_ASEReadCounter.table","NW_015090842.1:10235611",3,3,0
"LOC106888094","s1633_S_TNA_03_ASEReadCounter.table","NW_015090842.1:10236380",1,1,0
"LOC106888094","s1633_S_TNA_03_ASEReadCounter.table","NW_015090842.1:10236388",1,1,0
"LOC106888094","s1633_S_TNA_03_ASEReadCounter.table","NW_015090842.1:10236425",1,1,0
"LOC106888094","s1633_S_TNA_03_ASEReadCounter.table","NW_015090842.1:10236426",1,1,0
"LOC106888094","s1633_S_TNA_03_ASEReadCounter.table","NW_015090842.1:10236603",1,1,0
"LOC106888173","s1633_S_TNA_03_ASEReadCounter.table","NW_015090842.1:10239596",0,7,7
"LOC106888173","s1633_S_TNA_03_ASEReadCounter.table","NW_015090842.1:10240036",0,12,12
"LOC106888173","s1633_S_TNA_03_ASEReadCounter.table","NW_015090842.1:10240095",0,8,8
"LOC106888173","s1633_S_TNA_03_ASEReadCounter.table","NW_015090842.1:10240280",1,12,11
"LOC106888173","s1633_S_TNA_03_ASEReadCounter.table","NW_015090842.1:10240557",2,15,13
"LOC106888173","s1633_S_TNA_03_ASEReadCounter.table","NW_015090842.1:10240603",1,10,9
"LOC106888173","s1633_S_TNA_03_ASEReadCounter.table","NW_015090842.1:10240609",1,10,9
"LOC106888173","s1633_S_TNA_03_ASEReadCounter.table","NW_015090842.1:10240924",2,16,14
"LOC106888173","s1633_S_TNA_03_ASEReadCounter.table","NW_015090842.1:10241037",1,17,16
"LOC106888173","s1633_S_TNA_03_ASEReadCounter.table","NW_015090842.1:10241046",1,17,16
"LOC106888173","s1633_S_TNA_03_ASEReadCounter.table","NW_015090842.1:10241058",1,19,18
"LOC106888173","s1633_S_TNA_03_ASEReadCounter.table","NW_015090842.1:10241064",1,19,18
"LOC106888173","s1633_S_TNA_03_ASEReadCounter.table","NW_015090842.1:10241163",4,17,13
"LOC106888173","s1633_S_TNA_03_ASEReadCounter.table","NW_015090842.1:10241803",1,14,13
"LOC106888173","s1633_S_TNA_03_ASEReadCounter.table","NW_015090842.1:10241827",1,12,11
"LOC106888173","s1633_S_TNA_03_ASEReadCounter.table","NW_015090842.1:10241869",0,11,11
"LOC106888173","s1633_S_TNA_03_ASEReadCounter.table","NW_015090842.1:10242079",1,9,8
"LOC106888173","s1633_S_TNA_03_ASEReadCounter.table","NW_015090842.1:10242103",1,12,11
"LOC106888173","s1633_S_TNA_03_ASEReadCounter.table","NW_015090842.1:10242157",2,12,10
"LOC106888173","s1633_S_TNA_03_ASEReadCounter.table","NW_015090842.1:10242455",2,15,13
"LOC106888173","s1633_S_TNA_03_ASEReadCounter.table","NW_015090842.1:10242481",2,14,12
"LOC106888173","s1633_S_TNA_03_ASEReadCounter.table","NW_015090842.1:10242590",3,12,9
"LOC106888173","s1633_S_TNA_03_ASEReadCounter.table","NW_015090842.1:10242794",4,21,17
"LOC106888173","s1633_S_TNA_03_ASEReadCounter.table","NW_015090842.1:10242909",2,16,14
"LOC106888173","s1633_S_TNA_03_ASEReadCounter.table","NW_015090842.1:10243094",2,15,13
"LOC106888173","s1633_S_TNA_03_ASEReadCounter.table","NW_015090842.1:10243133",3,9,6
"LOC106888173","s1633_S_TNA_03_ASEReadCounter.table","NW_015090842.1:10243273",2,16,14
"LOC106888173","s1633_S_TNA_03_ASEReadCounter.table","NW_015090842.1:10243278",1,14,13
"LOC106888173","s1633_S_TNA_03_ASEReadCounter.table","NW_015090842.1:10243281",1,15,14
"LOC106888173","s1633_S_TNA_03_ASEReadCounter.table","NW_015090842.1:10243347",10,10,0
"LOC106888173","s1633_S_TNA_03_ASEReadCounter.table","NW_015090842.1:10243353",3,10,7
"LOC106888173","s1633_S_TNA_03_ASEReadCounter.table","NW_015090842.1:10243363",2,4,2
"LOC106888173","s1633_S_TNA_03_ASEReadCounter.table","NW_015090842.1:10243365",3,6,3
"LOC106888173","s1633_S_TNA_03_ASEReadCounter.table","NW_015090842.1:10243529",1,8,7
"LOC106888173","s1633_S_TNA_03_ASEReadCounter.table","NW_015090842.1:10243566",3,17,14
"LOC106888173","s1633_S_TNA_03_ASEReadCounter.table","NW_015090842.1:10243605",3,18,15
"LOC106888173","s1633_S_TNA_03_ASEReadCounter.table","NW_015090842.1:10243614",3,17,14
"LOC106888173","s1633_S_TNA_03_ASEReadCounter.table","NW_015090842.1:10243615",3,20,17
"LOC106888173","s1633_S_TNA_03_ASEReadCounter.table","NW_015090842.1:10243640",4,16,12
"LOC106888173","s1633_S_TNA_03_ASEReadCounter.table","NW_015090842.1:10243680",4,13,9
"LOC106888173","s1633_S_TNA_03_ASEReadCounter.table","NW_015090842.1:10243742",4,11,7
"LOC106888173","s1633_S_TNA_03_ASEReadCounter.table","NW_015090842.1:10243804",6,13,7
"LOC106888173","s1633_S_TNA_03_ASEReadCounter.table","NW_015090842.1:10243913",1,5,4
"LOC106888173","s1633_S_TNA_03_ASEReadCounter.table","NW_015090842.1:10243921",1,4,3
"LOC106888384","s1633_S_TNA_03_ASEReadCounter.table","NW_015090842.1:10244714",1,1,0
"LOC106888384","s1633_S_TNA_03_ASEReadCounter.table","NW_015090842.1:10251354",0,1,1
"LOC106888384","s1633_S_TNA_03_ASEReadCounter.table","NW_015090842.1:10251358",0,1,1
"LOC106888384","s1633_S_TNA_03_ASEReadCounter.table","NW_015090842.1:10253165",1,1,0
"LOC106888384","s1633_S_TNA_03_ASEReadCounter.table","NW_015090842.1:10255410",2,3,1
"LOC106888384","s1633_S_TNA_03_ASEReadCounter.table","NW_015090842.1:10255449",2,3,1
"LOC106888384","s1633_S_TNA_03_ASEReadCounter.table","NW_015090842.1:10255496",1,1,0
"LOC106888384","s1633_S_TNA_03_ASEReadCounter.table","NW_015090842.1:10255505",1,1,0
"LOC106888384","s1633_S_TNA_03_ASEReadCounter.table","NW_015090842.1:10255608",1,1,0
"LOC106888384","s1633_S_TNA_03_ASEReadCounter.table","NW_015090842.1:10255614",1,1,0
"LOC106888384","s1633_S_TNA_03_ASEReadCounter.table","NW_015090842.1:10255704",1,2,1
"LOC106888384","s1633_S_TNA_03_ASEReadCounter.table","NW_015090842.1:10255731",2,2,0
"LOC106888384","s1633_S_TNA_03_ASEReadCounter.table","NW_015090842.1:10255771",3,3,0
"TANGO6","s1633_S_TNA_03_ASEReadCounter.table","NW_015090842.1:10258162",1,5,4
"TANGO6","s1633_S_TNA_03_ASEReadCounter.table","NW_015090842.1:10258185",1,4,3
"TANGO6","s1633_S_TNA_03_ASEReadCounter.table","NW_015090842.1:10259267",2,10,8
"TANGO6","s1633_S_TNA_03_ASEReadCounter.table","NW_015090842.1:10260250",22,35,13
"TANGO6","s1633_S_TNA_03_ASEReadCounter.table","NW_015090842.1:10260979",16,21,5
"TANGO6","s1633_S_TNA_03_ASEReadCounter.table","NW_015090842.1:10261599",17,23,6
"TANGO6","s1633_S_TNA_03_ASEReadCounter.table","NW_015090842.1:10268425",27,41,14
"TANGO6","s1633_S_TNA_03_ASEReadCounter.table","NW_015090842.1:10269831",26,35,9
"TANGO6","s1633_S_TNA_03_ASEReadCounter.table","NW_015090842.1:10270813",26,34,8
"TANGO6","s1633_S_TNA_03_ASEReadCounter.table","NW_015090842.1:10273952",19,24,5
"TANGO6","s1633_S_TNA_03_ASEReadCounter.table","NW_015090842.1:10273970",26,32,6
"TANGO6","s1633_S_TNA_03_ASEReadCounter.table","NW_015090842.1:10274018",26,31,5
"TANGO6","s1633_S_TNA_03_ASEReadCounter.table","NW_015090842.1:10275974",28,33,5
"TANGO6","s1633_S_TNA_03_ASEReadCounter.table","NW_015090842.1:10275976",27,32,5
"TANGO6","s1633_S_TNA_03_ASEReadCounter.table","NW_015090842.1:10276123",19,33,14
"TANGO6","s1633_S_TNA_03_ASEReadCounter.table","NW_015090842.1:10276271",22,33,11
"TANGO6","s1633_S_TNA_03_ASEReadCounter.table","NW_015090842.1:10276272",22,33,11
"TANGO6","s1633_S_TNA_03_ASEReadCounter.table","NW_015090842.1:10276275",24,34,10
"TANGO6","s1633_S_TNA_03_ASEReadCounter.table","NW_015090842.1:10276278",23,33,10
"TANGO6","s1633_S_TNA_03_ASEReadCounter.table","NW_015090842.1:10276368",21,29,8
"TANGO6","s1633_S_TNA_03_ASEReadCounter.table","NW_015090842.1:10276373",22,29,7
"TANGO6","s1633_S_TNA_03_ASEReadCounter.table","NW_015090842.1:10276630",22,30,8
"TANGO6","s1633_S_TNA_03_ASEReadCounter.table","NW_015090842.1:10281498",40,48,8
"TANGO6","s1633_S_TNA_03_ASEReadCounter.table","NW_015090842.1:10282842",42,51,9
"TANGO6","s1633_S_TNA_03_ASEReadCounter.table","NW_015090842.1:10282863",33,41,8
"TANGO6","s1633_S_TNA_03_ASEReadCounter.table","NW_015090842.1:10282869",36,47,11
"TANGO6","s1633_S_TNA_03_ASEReadCounter.table","NW_015090842.1:10282903",43,54,11
"TANGO6","s1633_S_TNA_03_ASEReadCounter.table","NW_015090842.1:10283757",57,72,15
"TANGO6","s1633_S_TNA_03_ASEReadCounter.table","NW_015090842.1:10283785",61,77,16
"HAS3","s1633_S_TNA_03_ASEReadCounter.table","NW_015090842.1:10288093",0,3,3
"HAS3","s1633_S_TNA_03_ASEReadCounter.table","NW_015090842.1:10288274",0,3,3
"HAS3","s1633_S_TNA_03_ASEReadCounter.table","NW_015090842.1:10288364",1,3,2
"HAS3","s1633_S_TNA_03_ASEReadCounter.table","NW_015090842.1:10289469",1,1,0
"HAS3","s1633_S_TNA_03_ASEReadCounter.table","NW_015090842.1:10289708",1,3,2
"HAS3","s1633_S_TNA_03_ASEReadCounter.table","NW_015090842.1:10290561",1,1,0
"HAS3","s1633_S_TNA_03_ASEReadCounter.table","NW_015090842.1:10290609",1,2,1
"HAS3","s1633_S_TNA_03_ASEReadCounter.table","NW_015090842.1:10290666",2,3,1
"HAS3","s1633_S_TNA_03_ASEReadCounter.table","NW_015090842.1:10290723",1,2,1
"HAS3","s1633_S_TNA_03_ASEReadCounter.table","NW_015090842.1:10290927",0,3,3
"HAS3","s1633_S_TNA_03_ASEReadCounter.table","NW_015090842.1:10291004",0,4,4
"CHTF8","s1633_S_TNA_03_ASEReadCounter.table","NW_015090842.1:10291319",0,2,2
"CHTF8","s1633_S_TNA_03_ASEReadCounter.table","NW_015090842.1:10291491",4,8,4
"CHTF8","s1633_S_TNA_03_ASEReadCounter.table","NW_015090842.1:10291520",1,6,5
"CHTF8","s1633_S_TNA_03_ASEReadCounter.table","NW_015090842.1:10291593",3,6,3
"CHTF8","s1633_S_TNA_03_ASEReadCounter.table","NW_015090842.1:10291600",3,6,3
"CHTF8","s1633_S_TNA_03_ASEReadCounter.table","NW_015090842.1:10291609",4,7,3
"CHTF8","s1633_S_TNA_03_ASEReadCounter.table","NW_015090842.1:10291639",8,10,2
"CHTF8","s1633_S_TNA_03_ASEReadCounter.table","NW_015090842.1:10291641",8,10,2
"CHTF8","s1633_S_TNA_03_ASEReadCounter.table","NW_015090842.1:10291648",10,11,1
"CHTF8","s1633_S_TNA_03_ASEReadCounter.table","NW_015090842.1:10291656",9,11,2
"CHTF8","s1633_S_TNA_03_ASEReadCounter.table","NW_015090842.1:10291675",8,9,1
"CHTF8","s1633_S_TNA_03_ASEReadCounter.table","NW_015090842.1:10291696",8,10,2
"CHTF8","s1633_S_TNA_03_ASEReadCounter.table","NW_015090842.1:10291714",6,9,3
"CHTF8","s1633_S_TNA_03_ASEReadCounter.table","NW_015090842.1:10291732",4,8,4
"CHTF8","s1633_S_TNA_03_ASEReadCounter.table","NW_015090842.1:10291755",4,10,6
"CHTF8","s1633_S_TNA_03_ASEReadCounter.table","NW_015090842.1:10291756",4,7,3
"CHTF8","s1633_S_TNA_03_ASEReadCounter.table","NW_015090842.1:10291758",4,9,5
"CHTF8","s1633_S_TNA_03_ASEReadCounter.table","NW_015090842.1:10291792",6,11,5
"CHTF8","s1633_S_TNA_03_ASEReadCounter.table","NW_015090842.1:10291895",7,9,2
"CHTF8","s1633_S_TNA_03_ASEReadCounter.table","NW_015090842.1:10292132",4,5,1
"CHTF8","s1633_S_TNA_03_ASEReadCounter.table","NW_015090842.1:10292314",5,8,3
"CHTF8","s1633_S_TNA_03_ASEReadCounter.table","NW_015090842.1:10292317",5,8,3
"CHTF8","s1633_S_TNA_03_ASEReadCounter.table","NW_015090842.1:10292928",3,3,0
"UTP4","s1633_S_TNA_03_ASEReadCounter.table","NW_015090842.1:10293146",4,17,13
"UTP4","s1633_S_TNA_03_ASEReadCounter.table","NW_015090842.1:10293151",3,16,13
"UTP4","s1633_S_TNA_03_ASEReadCounter.table","NW_015090842.1:10293191",1,12,11
"UTP4","s1633_S_TNA_03_ASEReadCounter.table","NW_015090842.1:10293362",5,13,8
"UTP4","s1633_S_TNA_03_ASEReadCounter.table","NW_015090842.1:10293430",4,9,5
"UTP4","s1633_S_TNA_03_ASEReadCounter.table","NW_015090842.1:10293625",6,16,10
"UTP4","s1633_S_TNA_03_ASEReadCounter.table","NW_015090842.1:10293684",5,16,11
"UTP4","s1633_S_TNA_03_ASEReadCounter.table","NW_015090842.1:10294093",8,15,7
"UTP4","s1633_S_TNA_03_ASEReadCounter.table","NW_015090842.1:10294568",10,21,11
"UTP4","s1633_S_TNA_03_ASEReadCounter.table","NW_015090842.1:10294622",8,16,8
"UTP4","s1633_S_TNA_03_ASEReadCounter.table","NW_015090842.1:10294632",6,15,9
"UTP4","s1633_S_TNA_03_ASEReadCounter.table","NW_015090842.1:10295238",11,25,14
"UTP4","s1633_S_TNA_03_ASEReadCounter.table","NW_015090842.1:10295880",14,31,17
"UTP4","s1633_S_TNA_03_ASEReadCounter.table","NW_015090842.1:10295884",13,30,17
"UTP4","s1633_S_TNA_03_ASEReadCounter.table","NW_015090842.1:10295903",11,22,11
"UTP4","s1633_S_TNA_03_ASEReadCounter.table","NW_015090842.1:10295906",12,24,12
"UTP4","s1633_S_TNA_03_ASEReadCounter.table","NW_015090842.1:10295915",10,22,12
"UTP4","s1633_S_TNA_03_ASEReadCounter.table","NW_015090842.1:10295938",10,22,12
"UTP4","s1633_S_TNA_03_ASEReadCounter.table","NW_015090842.1:10296175",7,20,13
"UTP4","s1633_S_TNA_03_ASEReadCounter.table","NW_015090842.1:10296660",11,22,11
"UTP4","s1633_S_TNA_03_ASEReadCounter.table","NW_015090842.1:10296679",9,20,11
"UTP4","s1633_S_TNA_03_ASEReadCounter.table","NW_015090842.1:10297193",16,40,24
"UTP4","s1633_S_TNA_03_ASEReadCounter.table","NW_015090842.1:10297220",20,47,27
"UTP4","s1633_S_TNA_03_ASEReadCounter.table","NW_015090842.1:10297307",23,48,25
"UTP4","s1633_S_TNA_03_ASEReadCounter.table","NW_015090842.1:10297558",41,87,46
"UTP4","s1633_S_TNA_03_ASEReadCounter.table","NW_015090842.1:10297943",33,63,30
"UTP4","s1633_S_TNA_03_ASEReadCounter.table","NW_015090842.1:10297979",34,61,27
"UTP4","s1633_S_TNA_03_ASEReadCounter.table","NW_015090842.1:10298022",19,45,26
"UTP4","s1633_S_TNA_03_ASEReadCounter.table","NW_015090842.1:10298079",2,19,17
"UTP4","s1633_S_TNA_03_ASEReadCounter.table","NW_015090842.1:10298081",2,15,13
"UTP4","s1633_S_TNA_03_ASEReadCounter.table","NW_015090842.1:10298082",1,16,15
"SNTB2","s1633_S_TNA_03_ASEReadCounter.table","NW_015090842.1:10303506",1,2,1
"SNTB2","s1633_S_TNA_03_ASEReadCounter.table","NW_015090842.1:10303524",1,2,1
"SNTB2","s1633_S_TNA_03_ASEReadCounter.table","NW_015090842.1:10304059",2,4,2
"SNTB2","s1633_S_TNA_03_ASEReadCounter.table","NW_015090842.1:10304089",2,4,2
"SNTB2","s1633_S_TNA_03_ASEReadCounter.table","NW_015090842.1:10304167",3,4,1
"SNTB2","s1633_S_TNA_03_ASEReadCounter.table","NW_015090842.1:10304176",3,4,1
"SNTB2","s1633_S_TNA_03_ASEReadCounter.table","NW_015090842.1:10305069",4,7,3
"SNTB2","s1633_S_TNA_03_ASEReadCounter.table","NW_015090842.1:10305099",8,9,1
"SNTB2","s1633_S_TNA_03_ASEReadCounter.table","NW_015090842.1:10305451",1,7,6
"SNTB2","s1633_S_TNA_03_ASEReadCounter.table","NW_015090842.1:10305547",2,10,8
"SNTB2","s1633_S_TNA_03_ASEReadCounter.table","NW_015090842.1:10305847",4,8,4
"SNTB2","s1633_S_TNA_03_ASEReadCounter.table","NW_015090842.1:10305911",5,11,6
"SNTB2","s1633_S_TNA_03_ASEReadCounter.table","NW_015090842.1:10306173",4,6,2
"SNTB2","s1633_S_TNA_03_ASEReadCounter.table","NW_015090842.1:10306275",6,11,5
"SNTB2","s1633_S_TNA_03_ASEReadCounter.table","NW_015090842.1:10306457",3,6,3
"SNTB2","s1633_S_TNA_03_ASEReadCounter.table","NW_015090842.1:10306496",4,7,3
"SNTB2","s1633_S_TNA_03_ASEReadCounter.table","NW_015090842.1:10306499",4,7,3
"VPS4A","s1633_S_TNA_03_ASEReadCounter.table","NW_015090842.1:10308566",73,129,56
"VPS4A","s1633_S_TNA_03_ASEReadCounter.table","NW_015090842.1:10308573",74,134,60
"VPS4A","s1633_S_TNA_03_ASEReadCounter.table","NW_015090842.1:10308856",99,208,109
"VPS4A","s1633_S_TNA_03_ASEReadCounter.table","NW_015090842.1:10309056",130,268,138
"VPS4A","s1633_S_TNA_03_ASEReadCounter.table","NW_015090842.1:10309089",172,308,136
"VPS4A","s1633_S_TNA_03_ASEReadCounter.table","NW_015090842.1:10309392",167,286,119
"VPS4A","s1633_S_TNA_03_ASEReadCounter.table","NW_015090842.1:10309413",173,316,143
"VPS4A","s1633_S_TNA_03_ASEReadCounter.table","NW_015090842.1:10309467",150,317,167
"VPS4A","s1633_S_TNA_03_ASEReadCounter.table","NW_015090842.1:10310230",192,385,193
"VPS4A","s1633_S_TNA_03_ASEReadCounter.table","NW_015090842.1:10310425",184,360,176
"VPS4A","s1633_S_TNA_03_ASEReadCounter.table","NW_015090842.1:10310639",196,394,198
"VPS4A","s1633_S_TNA_03_ASEReadCounter.table","NW_015090842.1:10310640",382,382,0
"VPS4A","s1633_S_TNA_03_ASEReadCounter.table","NW_015090842.1:10310687",190,399,209
"VPS4A","s1633_S_TNA_03_ASEReadCounter.table","NW_015090842.1:10310734",155,340,185
"VPS4A","s1633_S_TNA_03_ASEReadCounter.table","NW_015090842.1:10310737",159,347,188
"VPS4A","s1633_S_TNA_03_ASEReadCounter.table","NW_015090842.1:10310746",155,346,191
"VPS4A","s1633_S_TNA_03_ASEReadCounter.table","NW_015090842.1:10310767",162,357,195
"VPS4A","s1633_S_TNA_03_ASEReadCounter.table","NW_015090842.1:10310995",187,383,196
"VPS4A","s1633_S_TNA_03_ASEReadCounter.table","NW_015090842.1:10311004",185,372,187
"VPS4A","s1633_S_TNA_03_ASEReadCounter.table","NW_015090842.1:10311007",188,387,199
"VPS4A","s1633_S_TNA_03_ASEReadCounter.table","NW_015090842.1:10311013",212,411,199
"VPS4A","s1633_S_TNA_03_ASEReadCounter.table","NW_015090842.1:10311022",196,395,199
"VPS4A","s1633_S_TNA_03_ASEReadCounter.table","NW_015090842.1:10311023",195,393,198
"VPS4A","s1633_S_TNA_03_ASEReadCounter.table","NW_015090842.1:10311426",191,418,227
"VPS4A","s1633_S_TNA_03_ASEReadCounter.table","NW_015090842.1:10311489",2,17,15
"VPS4A","s1633_S_TNA_03_ASEReadCounter.table","NW_015090842.1:10311490",3,14,11
"VPS4A","s1633_S_TNA_03_ASEReadCounter.table","NW_015090842.1:10311525",9,25,16
"VPS4A","s1633_S_TNA_03_ASEReadCounter.table","NW_015090842.1:10311529",10,34,24
"VPS4A","s1633_S_TNA_03_ASEReadCounter.table","NW_015090842.1:10311530",10,37,27
"VPS4A","s1633_S_TNA_03_ASEReadCounter.table","NW_015090842.1:10311552",31,76,45
"VPS4A","s1633_S_TNA_03_ASEReadCounter.table","NW_015090842.1:10311689",36,77,41
"VPS4A","s1633_S_TNA_03_ASEReadCounter.table","NW_015090842.1:10311700",47,85,38
"VPS4A","s1633_S_TNA_03_ASEReadCounter.table","NW_015090842.1:10311701",46,87,41
"VPS4A","s1633_S_TNA_03_ASEReadCounter.table","NW_015090842.1:10311703",46,87,41
"COG8","s1633_S_TNA_03_ASEReadCounter.table","NW_015090842.1:10313487",15,29,14
"COG8","s1633_S_TNA_03_ASEReadCounter.table","NW_015090842.1:10313559",33,50,17
"COG8","s1633_S_TNA_03_ASEReadCounter.table","NW_015090842.1:10313579",33,51,18
"COG8","s1633_S_TNA_03_ASEReadCounter.table","NW_015090842.1:10313665",36,57,21
"COG8","s1633_S_TNA_03_ASEReadCounter.table","NW_015090842.1:10313681",34,57,23
"COG8","s1633_S_TNA_03_ASEReadCounter.table","NW_015090842.1:10313768",29,52,23
"COG8","s1633_S_TNA_03_ASEReadCounter.table","NW_015090842.1:10313775",27,51,24
"COG8","s1633_S_TNA_03_ASEReadCounter.table","NW_015090842.1:10313811",13,28,15
"COG8","s1633_S_TNA_03_ASEReadCounter.table","NW_015090842.1:10313858",12,25,13
"COG8","s1633_S_TNA_03_ASEReadCounter.table","NW_015090842.1:10313859",25,25,0
"COG8","s1633_S_TNA_03_ASEReadCounter.table","NW_015090842.1:10314100",15,44,29
"COG8","s1633_S_TNA_03_ASEReadCounter.table","NW_015090842.1:10314213",17,34,17
"COG8","s1633_S_TNA_03_ASEReadCounter.table","NW_015090842.1:10315093",14,25,11
"COG8","s1633_S_TNA_03_ASEReadCounter.table","NW_015090842.1:10315162",12,30,18
"COG8","s1633_S_TNA_03_ASEReadCounter.table","NW_015090842.1:10315285",16,25,9
"COG8","s1633_S_TNA_03_ASEReadCounter.table","NW_015090842.1:10315360",11,21,10
"COG8","s1633_S_TNA_03_ASEReadCounter.table","NW_015090842.1:10315369",12,24,12
"COG8","s1633_S_TNA_03_ASEReadCounter.table","NW_015090842.1:10315508",7,12,5
"COG8","s1633_S_TNA_03_ASEReadCounter.table","NW_015090842.1:10315624",11,21,10
"COG8","s1633_S_TNA_03_ASEReadCounter.table","NW_015090842.1:10315693",10,21,11
"COG8","s1633_S_TNA_03_ASEReadCounter.table","NW_015090842.1:10315698",10,20,10
"COG8","s1633_S_TNA_03_ASEReadCounter.table","NW_015090842.1:10315768",9,15,6
"COG8","s1633_S_TNA_03_ASEReadCounter.table","NW_015090842.1:10315769",8,12,4
"COG8","s1633_S_TNA_03_ASEReadCounter.table","NW_015090842.1:10315784",8,11,3
"COG8","s1633_S_TNA_03_ASEReadCounter.table","NW_015090842.1:10316093",5,11,6
"COG8","s1633_S_TNA_03_ASEReadCounter.table","NW_015090842.1:10316133",2,7,5
"NIP7","s1633_S_TNA_03_ASEReadCounter.table","NW_015090842.1:10316759",15,42,27
"NIP7","s1633_S_TNA_03_ASEReadCounter.table","NW_015090842.1:10316967",123,238,115
"NIP7","s1633_S_TNA_03_ASEReadCounter.table","NW_015090842.1:10316995",142,269,127
"NIP7","s1633_S_TNA_03_ASEReadCounter.table","NW_015090842.1:10317240",175,372,197
"NIP7","s1633_S_TNA_03_ASEReadCounter.table","NW_015090842.1:10317247",178,374,196
"NIP7","s1633_S_TNA_03_ASEReadCounter.table","NW_015090842.1:10317264",183,360,177
"NIP7","s1633_S_TNA_03_ASEReadCounter.table","NW_015090842.1:10317433",239,476,237
"NIP7","s1633_S_TNA_03_ASEReadCounter.table","NW_015090842.1:10317738",189,446,257
"NIP7","s1633_S_TNA_03_ASEReadCounter.table","NW_015090842.1:10317769",173,400,227
"NIP7","s1633_S_TNA_03_ASEReadCounter.table","NW_015090842.1:10317808",125,282,157
"NIP7","s1633_S_TNA_03_ASEReadCounter.table","NW_015090842.1:10317870",79,199,120
"NIP7","s1633_S_TNA_03_ASEReadCounter.table","NW_015090842.1:10317871",79,195,116
"NIP7","s1633_S_TNA_03_ASEReadCounter.table","NW_015090842.1:10317898",54,133,79
"NIP7","s1633_S_TNA_03_ASEReadCounter.table","NW_015090842.1:10317911",52,118,66
"TMED6","s1633_S_TNA_03_ASEReadCounter.table","NW_015090842.1:10318514",1,1,0
"TMED6","s1633_S_TNA_03_ASEReadCounter.table","NW_015090842.1:10318731",1,1,0
"TERF2","s1633_S_TNA_03_ASEReadCounter.table","NW_015090842.1:10321768",38,85,47
"TERF2","s1633_S_TNA_03_ASEReadCounter.table","NW_015090842.1:10321777",36,80,44
"TERF2","s1633_S_TNA_03_ASEReadCounter.table","NW_015090842.1:10321805",38,89,51
"TERF2","s1633_S_TNA_03_ASEReadCounter.table","NW_015090842.1:10321878",56,113,57
"TERF2","s1633_S_TNA_03_ASEReadCounter.table","NW_015090842.1:10321893",55,111,56
"TERF2","s1633_S_TNA_03_ASEReadCounter.table","NW_015090842.1:10321897",49,103,54
"TERF2","s1633_S_TNA_03_ASEReadCounter.table","NW_015090842.1:10321908",44,99,55
"TERF2","s1633_S_TNA_03_ASEReadCounter.table","NW_015090842.1:10322001",53,127,74
"TERF2","s1633_S_TNA_03_ASEReadCounter.table","NW_015090842.1:10322035",51,106,55
"TERF2","s1633_S_TNA_03_ASEReadCounter.table","NW_015090842.1:10322051",55,114,59
"TERF2","s1633_S_TNA_03_ASEReadCounter.table","NW_015090842.1:10322137",39,72,33
"TERF2","s1633_S_TNA_03_ASEReadCounter.table","NW_015090842.1:10322144",40,69,29
"TERF2","s1633_S_TNA_03_ASEReadCounter.table","NW_015090842.1:10322388",14,57,43
"TERF2","s1633_S_TNA_03_ASEReadCounter.table","NW_015090842.1:10322396",16,53,37
"TERF2","s1633_S_TNA_03_ASEReadCounter.table","NW_015090842.1:10322502",41,82,41
"TERF2","s1633_S_TNA_03_ASEReadCounter.table","NW_015090842.1:10322504",41,82,41
"TERF2","s1633_S_TNA_03_ASEReadCounter.table","NW_015090842.1:10322510",40,81,41
"TERF2","s1633_S_TNA_03_ASEReadCounter.table","NW_015090842.1:10323580",34,90,56
"TERF2","s1633_S_TNA_03_ASEReadCounter.table","NW_015090842.1:10324314",27,79,52
"TERF2","s1633_S_TNA_03_ASEReadCounter.table","NW_015090842.1:10326832",21,35,14
"TERF2","s1633_S_TNA_03_ASEReadCounter.table","NW_015090842.1:10327787",15,29,14
"TERF2","s1633_S_TNA_03_ASEReadCounter.table","NW_015090842.1:10328588",9,21,12
"TERF2","s1633_S_TNA_03_ASEReadCounter.table","NW_015090842.1:10328644",5,23,18
"TERF2","s1633_S_TNA_03_ASEReadCounter.table","NW_015090842.1:10329813",3,9,6
"TERF2","s1633_S_TNA_03_ASEReadCounter.table","NW_015090842.1:10330749",7,13,6
"TERF2","s1633_S_TNA_03_ASEReadCounter.table","NW_015090842.1:10330789",9,15,6
"CYB5B","s1633_S_TNA_03_ASEReadCounter.table","NW_015090842.1:10336595",1,11,10
"CYB5B","s1633_S_TNA_03_ASEReadCounter.table","NW_015090842.1:10336667",25,69,44
"CYB5B","s1633_S_TNA_03_ASEReadCounter.table","NW_015090842.1:10336689",47,110,63
"CYB5B","s1633_S_TNA_03_ASEReadCounter.table","NW_015090842.1:10336728",68,144,76
"CYB5B","s1633_S_TNA_03_ASEReadCounter.table","NW_015090842.1:10345068",61,154,93
"CYB5B","s1633_S_TNA_03_ASEReadCounter.table","NW_015090842.1:10348800",118,234,116
"CYB5B","s1633_S_TNA_03_ASEReadCounter.table","NW_015090842.1:10349046",115,233,118
"CYB5B","s1633_S_TNA_03_ASEReadCounter.table","NW_015090842.1:10349119",59,194,135
"CYB5B","s1633_S_TNA_03_ASEReadCounter.table","NW_015090842.1:10349146",39,173,134
"CYB5B","s1633_S_TNA_03_ASEReadCounter.table","NW_015090842.1:10349157",64,206,142
"CYB5B","s1633_S_TNA_03_ASEReadCounter.table","NW_015090842.1:10349263",196,196,0
