"gene","id","snp","ref_count","total_count","alt_count"
"CENPN","s1633_S_VTA_03_ASEReadCounter.table","NW_015090842.1:5801612",0,2,2
"CENPN","s1633_S_VTA_03_ASEReadCounter.table","NW_015090842.1:5801618",0,2,2
"CENPN","s1633_S_VTA_03_ASEReadCounter.table","NW_015090842.1:5801623",0,2,2
"CENPN","s1633_S_VTA_03_ASEReadCounter.table","NW_015090842.1:5801631",0,2,2
"CENPN","s1633_S_VTA_03_ASEReadCounter.table","NW_015090842.1:5801632",0,2,2
"CENPN","s1633_S_VTA_03_ASEReadCounter.table","NW_015090842.1:5801655",1,5,4
"CENPN","s1633_S_VTA_03_ASEReadCounter.table","NW_015090842.1:5801670",1,4,3
"CENPN","s1633_S_VTA_03_ASEReadCounter.table","NW_015090842.1:5801674",1,5,4
"CENPN","s1633_S_VTA_03_ASEReadCounter.table","NW_015090842.1:5801692",1,3,2
"CENPN","s1633_S_VTA_03_ASEReadCounter.table","NW_015090842.1:5802008",1,4,3
"CENPN","s1633_S_VTA_03_ASEReadCounter.table","NW_015090842.1:5802012",1,4,3
"CENPN","s1633_S_VTA_03_ASEReadCounter.table","NW_015090842.1:5802087",4,8,4
"CENPN","s1633_S_VTA_03_ASEReadCounter.table","NW_015090842.1:5810113",5,6,1
"CENPN","s1633_S_VTA_03_ASEReadCounter.table","NW_015090842.1:5810147",12,12,0
"CENPN","s1633_S_VTA_03_ASEReadCounter.table","NW_015090842.1:5810148",12,12,0
"ATMIN","s1633_S_VTA_03_ASEReadCounter.table","NW_015090842.1:5818789",2,2,0
"ATMIN","s1633_S_VTA_03_ASEReadCounter.table","NW_015090842.1:5819958",5,5,0
"ATMIN","s1633_S_VTA_03_ASEReadCounter.table","NW_015090842.1:5820004",5,6,1
"ATMIN","s1633_S_VTA_03_ASEReadCounter.table","NW_015090842.1:5820250",1,2,1
"ATMIN","s1633_S_VTA_03_ASEReadCounter.table","NW_015090842.1:5820298",1,2,1
"ATMIN","s1633_S_VTA_03_ASEReadCounter.table","NW_015090842.1:5820421",2,2,0
"ATMIN","s1633_S_VTA_03_ASEReadCounter.table","NW_015090842.1:5820448",1,3,2
"ATMIN","s1633_S_VTA_03_ASEReadCounter.table","NW_015090842.1:5820457",1,3,2
"ATMIN","s1633_S_VTA_03_ASEReadCounter.table","NW_015090842.1:5820510",2,4,2
"ATMIN","s1633_S_VTA_03_ASEReadCounter.table","NW_015090842.1:5820673",2,4,2
"ATMIN","s1633_S_VTA_03_ASEReadCounter.table","NW_015090842.1:5820820",2,3,1
"ATMIN","s1633_S_VTA_03_ASEReadCounter.table","NW_015090842.1:5820865",2,3,1
"ATMIN","s1633_S_VTA_03_ASEReadCounter.table","NW_015090842.1:5820889",1,1,0
"ATMIN","s1633_S_VTA_03_ASEReadCounter.table","NW_015090842.1:5820891",1,1,0
"ATMIN","s1633_S_VTA_03_ASEReadCounter.table","NW_015090842.1:5820997",4,6,2
"ATMIN","s1633_S_VTA_03_ASEReadCounter.table","NW_015090842.1:5821063",2,4,2
"ATMIN","s1633_S_VTA_03_ASEReadCounter.table","NW_015090842.1:5821132",1,3,2
"ATMIN","s1633_S_VTA_03_ASEReadCounter.table","NW_015090842.1:5821645",4,8,4
"ATMIN","s1633_S_VTA_03_ASEReadCounter.table","NW_015090842.1:5825066",12,23,11
"ATMIN","s1633_S_VTA_03_ASEReadCounter.table","NW_015090842.1:5825106",6,22,16
"ATMIN","s1633_S_VTA_03_ASEReadCounter.table","NW_015090842.1:5825122",2,16,14
"ATMIN","s1633_S_VTA_03_ASEReadCounter.table","NW_015090842.1:5825178",7,21,14
"ATMIN","s1633_S_VTA_03_ASEReadCounter.table","NW_015090842.1:5825194",9,23,14
"ATMIN","s1633_S_VTA_03_ASEReadCounter.table","NW_015090842.1:5825195",9,23,14
"ATMIN","s1633_S_VTA_03_ASEReadCounter.table","NW_015090842.1:5825220",11,21,10
"ATMIN","s1633_S_VTA_03_ASEReadCounter.table","NW_015090842.1:5825240",13,23,10
"ATMIN","s1633_S_VTA_03_ASEReadCounter.table","NW_015090842.1:5825303",10,25,15
"ATMIN","s1633_S_VTA_03_ASEReadCounter.table","NW_015090842.1:5825304",9,25,16
"ATMIN","s1633_S_VTA_03_ASEReadCounter.table","NW_015090842.1:5825310",12,27,15
"ATMIN","s1633_S_VTA_03_ASEReadCounter.table","NW_015090842.1:5825406",18,27,9
"ATMIN","s1633_S_VTA_03_ASEReadCounter.table","NW_015090842.1:5825415",18,24,6
"ATMIN","s1633_S_VTA_03_ASEReadCounter.table","NW_015090842.1:5825438",21,33,12
"ATMIN","s1633_S_VTA_03_ASEReadCounter.table","NW_015090842.1:5825485",19,31,12
"ATMIN","s1633_S_VTA_03_ASEReadCounter.table","NW_015090842.1:5825524",18,32,14
"ATMIN","s1633_S_VTA_03_ASEReadCounter.table","NW_015090842.1:5825557",18,32,14
"ATMIN","s1633_S_VTA_03_ASEReadCounter.table","NW_015090842.1:5825571",22,36,14
"ATMIN","s1633_S_VTA_03_ASEReadCounter.table","NW_015090842.1:5825579",20,36,16
"ATMIN","s1633_S_VTA_03_ASEReadCounter.table","NW_015090842.1:5825590",18,33,15
"ATMIN","s1633_S_VTA_03_ASEReadCounter.table","NW_015090842.1:5825689",22,38,16
"ATMIN","s1633_S_VTA_03_ASEReadCounter.table","NW_015090842.1:5825703",26,44,18
"ATMIN","s1633_S_VTA_03_ASEReadCounter.table","NW_015090842.1:5825787",18,36,18
"ATMIN","s1633_S_VTA_03_ASEReadCounter.table","NW_015090842.1:5825833",18,40,22
"ATMIN","s1633_S_VTA_03_ASEReadCounter.table","NW_015090842.1:5825841",14,37,23
"ATMIN","s1633_S_VTA_03_ASEReadCounter.table","NW_015090842.1:5825895",22,49,27
"ATMIN","s1633_S_VTA_03_ASEReadCounter.table","NW_015090842.1:5825984",14,35,21
"ATMIN","s1633_S_VTA_03_ASEReadCounter.table","NW_015090842.1:5826162",16,44,28
"ATMIN","s1633_S_VTA_03_ASEReadCounter.table","NW_015090842.1:5826194",18,47,29
"ATMIN","s1633_S_VTA_03_ASEReadCounter.table","NW_015090842.1:5826235",22,53,31
"ATMIN","s1633_S_VTA_03_ASEReadCounter.table","NW_015090842.1:5826245",20,48,28
"ATMIN","s1633_S_VTA_03_ASEReadCounter.table","NW_015090842.1:5826335",14,31,17
"ATMIN","s1633_S_VTA_03_ASEReadCounter.table","NW_015090842.1:5826417",16,38,22
"ATMIN","s1633_S_VTA_03_ASEReadCounter.table","NW_015090842.1:5826431",7,41,34
"ATMIN","s1633_S_VTA_03_ASEReadCounter.table","NW_015090842.1:5826438",9,35,26
"ATMIN","s1633_S_VTA_03_ASEReadCounter.table","NW_015090842.1:5826463",14,46,32
"ATMIN","s1633_S_VTA_03_ASEReadCounter.table","NW_015090842.1:5826502",17,57,40
"ATMIN","s1633_S_VTA_03_ASEReadCounter.table","NW_015090842.1:5826511",20,59,39
"ATMIN","s1633_S_VTA_03_ASEReadCounter.table","NW_015090842.1:5826659",21,60,39
"ATMIN","s1633_S_VTA_03_ASEReadCounter.table","NW_015090842.1:5826701",28,72,44
"ATMIN","s1633_S_VTA_03_ASEReadCounter.table","NW_015090842.1:5826702",28,71,43
"ATMIN","s1633_S_VTA_03_ASEReadCounter.table","NW_015090842.1:5826732",34,80,46
"ATMIN","s1633_S_VTA_03_ASEReadCounter.table","NW_015090842.1:5826745",34,78,44
"ATMIN","s1633_S_VTA_03_ASEReadCounter.table","NW_015090842.1:5826835",38,73,35
"ATMIN","s1633_S_VTA_03_ASEReadCounter.table","NW_015090842.1:5826910",34,64,30
"ATMIN","s1633_S_VTA_03_ASEReadCounter.table","NW_015090842.1:5826942",22,59,37
"ATMIN","s1633_S_VTA_03_ASEReadCounter.table","NW_015090842.1:5827193",49,115,66
"ATMIN","s1633_S_VTA_03_ASEReadCounter.table","NW_015090842.1:5827196",45,110,65
"ATMIN","s1633_S_VTA_03_ASEReadCounter.table","NW_015090842.1:5827269",56,112,56
"ATMIN","s1633_S_VTA_03_ASEReadCounter.table","NW_015090842.1:5827315",42,85,43
"ATMIN","s1633_S_VTA_03_ASEReadCounter.table","NW_015090842.1:5827316",44,90,46
"ATMIN","s1633_S_VTA_03_ASEReadCounter.table","NW_015090842.1:5827333",47,89,42
"PPP1R3E","s1633_S_VTA_03_ASEReadCounter.table","NW_015090842.1:5837733",3,8,5
"PPP1R3E","s1633_S_VTA_03_ASEReadCounter.table","NW_015090842.1:5837947",2,4,2
"PKD1L2","s1633_S_VTA_03_ASEReadCounter.table","NW_015090842.1:5867597",1,1,0
"PKD1L2","s1633_S_VTA_03_ASEReadCounter.table","NW_015090842.1:5867600",1,1,0
"PKD1L2","s1633_S_VTA_03_ASEReadCounter.table","NW_015090842.1:5867660",1,1,0
"BCO1","s1633_S_VTA_03_ASEReadCounter.table","NW_015090842.1:5915610",2,2,0
"BCO1","s1633_S_VTA_03_ASEReadCounter.table","NW_015090842.1:5915646",2,2,0
"BCO1","s1633_S_VTA_03_ASEReadCounter.table","NW_015090842.1:5917836",0,1,1
"BCO1","s1633_S_VTA_03_ASEReadCounter.table","NW_015090842.1:5917912",2,3,1
"BCO1","s1633_S_VTA_03_ASEReadCounter.table","NW_015090842.1:5917941",4,5,1
"BCO1","s1633_S_VTA_03_ASEReadCounter.table","NW_015090842.1:5917971",6,9,3
"BCO1","s1633_S_VTA_03_ASEReadCounter.table","NW_015090842.1:5921679",7,10,3
"BCO1","s1633_S_VTA_03_ASEReadCounter.table","NW_015090842.1:5921726",6,7,1
"BCO1","s1633_S_VTA_03_ASEReadCounter.table","NW_015090842.1:5925669",5,6,1
"BCO1","s1633_S_VTA_03_ASEReadCounter.table","NW_015090842.1:5925753",3,3,0
"BCO1","s1633_S_VTA_03_ASEReadCounter.table","NW_015090842.1:5926937",8,9,1
"BCO1","s1633_S_VTA_03_ASEReadCounter.table","NW_015090842.1:5927921",8,9,1
"BCO1","s1633_S_VTA_03_ASEReadCounter.table","NW_015090842.1:5927948",6,7,1
"BCO1","s1633_S_VTA_03_ASEReadCounter.table","NW_015090842.1:5927968",3,4,1
"BCO1","s1633_S_VTA_03_ASEReadCounter.table","NW_015090842.1:5928052",5,5,0
"BCO1","s1633_S_VTA_03_ASEReadCounter.table","NW_015090842.1:5932726",8,11,3
"BCO1","s1633_S_VTA_03_ASEReadCounter.table","NW_015090842.1:5932801",10,11,1
"BCO1","s1633_S_VTA_03_ASEReadCounter.table","NW_015090842.1:5934558",10,15,5
"BCO1","s1633_S_VTA_03_ASEReadCounter.table","NW_015090842.1:5934575",10,19,9
"BCO1","s1633_S_VTA_03_ASEReadCounter.table","NW_015090842.1:5934608",12,21,9
"BCO1","s1633_S_VTA_03_ASEReadCounter.table","NW_015090842.1:5934647",14,21,7
"BCO1","s1633_S_VTA_03_ASEReadCounter.table","NW_015090842.1:5934725",20,24,4
"BCO1","s1633_S_VTA_03_ASEReadCounter.table","NW_015090842.1:5934726",20,24,4
"BCO1","s1633_S_VTA_03_ASEReadCounter.table","NW_015090842.1:5934733",18,23,5
"BCO1","s1633_S_VTA_03_ASEReadCounter.table","NW_015090842.1:5934821",13,18,5
"BCO1","s1633_S_VTA_03_ASEReadCounter.table","NW_015090842.1:5934826",11,17,6
"BCO1","s1633_S_VTA_03_ASEReadCounter.table","NW_015090842.1:5934844",4,7,3
"BCO1","s1633_S_VTA_03_ASEReadCounter.table","NW_015090842.1:5934958",15,17,2
"BCO1","s1633_S_VTA_03_ASEReadCounter.table","NW_015090842.1:5934976",13,15,2
"GAN","s1633_S_VTA_03_ASEReadCounter.table","NW_015090842.1:5953759",7,9,2
"GAN","s1633_S_VTA_03_ASEReadCounter.table","NW_015090842.1:5957502",9,27,18
"GAN","s1633_S_VTA_03_ASEReadCounter.table","NW_015090842.1:5957578",14,30,16
"GAN","s1633_S_VTA_03_ASEReadCounter.table","NW_015090842.1:5965028",13,36,23
"GAN","s1633_S_VTA_03_ASEReadCounter.table","NW_015090842.1:5966047",18,54,36
"GAN","s1633_S_VTA_03_ASEReadCounter.table","NW_015090842.1:5966126",11,44,33
"GAN","s1633_S_VTA_03_ASEReadCounter.table","NW_015090842.1:5966127",12,44,32
"GAN","s1633_S_VTA_03_ASEReadCounter.table","NW_015090842.1:5966162",22,58,36
"GAN","s1633_S_VTA_03_ASEReadCounter.table","NW_015090842.1:5966483",37,97,60
"CMIP","s1633_S_VTA_03_ASEReadCounter.table","NW_015090842.1:6109159",26,39,13
"CMIP","s1633_S_VTA_03_ASEReadCounter.table","NW_015090842.1:6109166",25,37,12
"CMIP","s1633_S_VTA_03_ASEReadCounter.table","NW_015090842.1:6114641",35,56,21
"CMIP","s1633_S_VTA_03_ASEReadCounter.table","NW_015090842.1:6114751",28,43,15
"CMIP","s1633_S_VTA_03_ASEReadCounter.table","NW_015090842.1:6114824",27,42,15
"CMIP","s1633_S_VTA_03_ASEReadCounter.table","NW_015090842.1:6128998",36,59,23
"CMIP","s1633_S_VTA_03_ASEReadCounter.table","NW_015090842.1:6130562",78,127,49
"CMIP","s1633_S_VTA_03_ASEReadCounter.table","NW_015090842.1:6132522",60,114,54
"CMIP","s1633_S_VTA_03_ASEReadCounter.table","NW_015090842.1:6134088",53,102,49
"CMIP","s1633_S_VTA_03_ASEReadCounter.table","NW_015090842.1:6138265",100,234,134
"CMIP","s1633_S_VTA_03_ASEReadCounter.table","NW_015090842.1:6138300",112,247,135
"CMIP","s1633_S_VTA_03_ASEReadCounter.table","NW_015090842.1:6138342",115,235,120
"CMIP","s1633_S_VTA_03_ASEReadCounter.table","NW_015090842.1:6138343",115,233,118
"CMIP","s1633_S_VTA_03_ASEReadCounter.table","NW_015090842.1:6138345",116,235,119
"CMIP","s1633_S_VTA_03_ASEReadCounter.table","NW_015090842.1:6138647",62,149,87
"CMIP","s1633_S_VTA_03_ASEReadCounter.table","NW_015090842.1:6138745",82,160,78
"CMIP","s1633_S_VTA_03_ASEReadCounter.table","NW_015090842.1:6138832",15,61,46
"CMIP","s1633_S_VTA_03_ASEReadCounter.table","NW_015090842.1:6138967",80,151,71
"CMIP","s1633_S_VTA_03_ASEReadCounter.table","NW_015090842.1:6139131",56,119,63
"CMIP","s1633_S_VTA_03_ASEReadCounter.table","NW_015090842.1:6139163",18,75,57
"CMIP","s1633_S_VTA_03_ASEReadCounter.table","NW_015090842.1:6139360",36,60,24
"CMIP","s1633_S_VTA_03_ASEReadCounter.table","NW_015090842.1:6139572",22,38,16
"CMIP","s1633_S_VTA_03_ASEReadCounter.table","NW_015090842.1:6139773",118,119,1
"PLCG2","s1633_S_VTA_03_ASEReadCounter.table","NW_015090842.1:6179613",1,2,1
"PLCG2","s1633_S_VTA_03_ASEReadCounter.table","NW_015090842.1:6179658",3,7,4
"PLCG2","s1633_S_VTA_03_ASEReadCounter.table","NW_015090842.1:6203766",4,9,5
"PLCG2","s1633_S_VTA_03_ASEReadCounter.table","NW_015090842.1:6203775",3,10,7
"PLCG2","s1633_S_VTA_03_ASEReadCounter.table","NW_015090842.1:6203787",3,10,7
"PLCG2","s1633_S_VTA_03_ASEReadCounter.table","NW_015090842.1:6205047",2,8,6
"PLCG2","s1633_S_VTA_03_ASEReadCounter.table","NW_015090842.1:6208541",0,3,3
"PLCG2","s1633_S_VTA_03_ASEReadCounter.table","NW_015090842.1:6209741",2,6,4
"PLCG2","s1633_S_VTA_03_ASEReadCounter.table","NW_015090842.1:6209798",2,6,4
"PLCG2","s1633_S_VTA_03_ASEReadCounter.table","NW_015090842.1:6209816",2,5,3
"PLCG2","s1633_S_VTA_03_ASEReadCounter.table","NW_015090842.1:6217547",1,6,5
"PLCG2","s1633_S_VTA_03_ASEReadCounter.table","NW_015090842.1:6218641",1,5,4
"PLCG2","s1633_S_VTA_03_ASEReadCounter.table","NW_015090842.1:6220552",0,8,8
"PLCG2","s1633_S_VTA_03_ASEReadCounter.table","NW_015090842.1:6221969",1,6,5
"PLCG2","s1633_S_VTA_03_ASEReadCounter.table","NW_015090842.1:6228672",3,12,9
"PLCG2","s1633_S_VTA_03_ASEReadCounter.table","NW_015090842.1:6228694",2,13,11
"PLCG2","s1633_S_VTA_03_ASEReadCounter.table","NW_015090842.1:6228722",1,10,9
"PLCG2","s1633_S_VTA_03_ASEReadCounter.table","NW_015090842.1:6228747",2,13,11
"PLCG2","s1633_S_VTA_03_ASEReadCounter.table","NW_015090842.1:6228835",2,15,13
"PLCG2","s1633_S_VTA_03_ASEReadCounter.table","NW_015090842.1:6228841",2,16,14
"PLCG2","s1633_S_VTA_03_ASEReadCounter.table","NW_015090842.1:6228865",2,18,16
"PLCG2","s1633_S_VTA_03_ASEReadCounter.table","NW_015090842.1:6228917",2,16,14
"PLCG2","s1633_S_VTA_03_ASEReadCounter.table","NW_015090842.1:6228926",1,15,14
"PLCG2","s1633_S_VTA_03_ASEReadCounter.table","NW_015090842.1:6228954",1,8,7
"PLCG2","s1633_S_VTA_03_ASEReadCounter.table","NW_015090842.1:6229002",0,9,9
"PLCG2","s1633_S_VTA_03_ASEReadCounter.table","NW_015090842.1:6229006",0,7,7
"PLCG2","s1633_S_VTA_03_ASEReadCounter.table","NW_015090842.1:6229081",0,11,11
"PLCG2","s1633_S_VTA_03_ASEReadCounter.table","NW_015090842.1:6229097",0,8,8
"PLCG2","s1633_S_VTA_03_ASEReadCounter.table","NW_015090842.1:6229160",2,7,5
"PLCG2","s1633_S_VTA_03_ASEReadCounter.table","NW_015090842.1:6229213",3,11,8
"PLCG2","s1633_S_VTA_03_ASEReadCounter.table","NW_015090842.1:6229231",4,13,9
"PLCG2","s1633_S_VTA_03_ASEReadCounter.table","NW_015090842.1:6229663",4,6,2
"PLCG2","s1633_S_VTA_03_ASEReadCounter.table","NW_015090842.1:6229748",1,1,0
"PLCG2","s1633_S_VTA_03_ASEReadCounter.table","NW_015090842.1:6229892",6,7,1
"PLCG2","s1633_S_VTA_03_ASEReadCounter.table","NW_015090842.1:6230248",4,5,1
"PLCG2","s1633_S_VTA_03_ASEReadCounter.table","NW_015090842.1:6230255",4,5,1
"PLCG2","s1633_S_VTA_03_ASEReadCounter.table","NW_015090842.1:6230296",1,2,1
"PLCG2","s1633_S_VTA_03_ASEReadCounter.table","NW_015090842.1:6230349",3,4,1
"PLCG2","s1633_S_VTA_03_ASEReadCounter.table","NW_015090842.1:6230381",4,6,2
"PLCG2","s1633_S_VTA_03_ASEReadCounter.table","NW_015090842.1:6230408",5,9,4
"PLCG2","s1633_S_VTA_03_ASEReadCounter.table","NW_015090842.1:6230439",4,8,4
"PLCG2","s1633_S_VTA_03_ASEReadCounter.table","NW_015090842.1:6230757",1,2,1
"PLCG2","s1633_S_VTA_03_ASEReadCounter.table","NW_015090842.1:6230758",2,3,1
"PLCG2","s1633_S_VTA_03_ASEReadCounter.table","NW_015090842.1:6230898",4,5,1
"PLCG2","s1633_S_VTA_03_ASEReadCounter.table","NW_015090842.1:6230976",4,5,1
"PLCG2","s1633_S_VTA_03_ASEReadCounter.table","NW_015090842.1:6231078",2,3,1
"PLCG2","s1633_S_VTA_03_ASEReadCounter.table","NW_015090842.1:6231138",3,4,1
"PLCG2","s1633_S_VTA_03_ASEReadCounter.table","NW_015090842.1:6231177",5,6,1
"PLCG2","s1633_S_VTA_03_ASEReadCounter.table","NW_015090842.1:6231263",7,12,5
"PLCG2","s1633_S_VTA_03_ASEReadCounter.table","NW_015090842.1:6231309",6,11,5
"SDR42E1","s1633_S_VTA_03_ASEReadCounter.table","NW_015090842.1:6235292",1,3,2
"SDR42E1","s1633_S_VTA_03_ASEReadCounter.table","NW_015090842.1:6235315",1,6,5
"SDR42E1","s1633_S_VTA_03_ASEReadCounter.table","NW_015090842.1:6235348",4,13,9
"SDR42E1","s1633_S_VTA_03_ASEReadCounter.table","NW_015090842.1:6235355",4,11,7
"SDR42E1","s1633_S_VTA_03_ASEReadCounter.table","NW_015090842.1:6235417",4,16,12
"SDR42E1","s1633_S_VTA_03_ASEReadCounter.table","NW_015090842.1:6235526",13,13,0
"SDR42E1","s1633_S_VTA_03_ASEReadCounter.table","NW_015090842.1:6235558",2,15,13
"SDR42E1","s1633_S_VTA_03_ASEReadCounter.table","NW_015090842.1:6235603",22,22,0
"SDR42E1","s1633_S_VTA_03_ASEReadCounter.table","NW_015090842.1:6235741",11,22,11
"SDR42E1","s1633_S_VTA_03_ASEReadCounter.table","NW_015090842.1:6235777",8,18,10
"SDR42E1","s1633_S_VTA_03_ASEReadCounter.table","NW_015090842.1:6235806",10,23,13
"SDR42E1","s1633_S_VTA_03_ASEReadCounter.table","NW_015090842.1:6235809",11,26,15
"SDR42E1","s1633_S_VTA_03_ASEReadCounter.table","NW_015090842.1:6235816",10,26,16
"SDR42E1","s1633_S_VTA_03_ASEReadCounter.table","NW_015090842.1:6235914",3,8,5
"SDR42E1","s1633_S_VTA_03_ASEReadCounter.table","NW_015090842.1:6235935",5,11,6
"SDR42E1","s1633_S_VTA_03_ASEReadCounter.table","NW_015090842.1:6235957",6,13,7
"SDR42E1","s1633_S_VTA_03_ASEReadCounter.table","NW_015090842.1:6236040",1,5,4
"SDR42E1","s1633_S_VTA_03_ASEReadCounter.table","NW_015090842.1:6236260",4,12,8
"SDR42E1","s1633_S_VTA_03_ASEReadCounter.table","NW_015090842.1:6236281",4,13,9
"SDR42E1","s1633_S_VTA_03_ASEReadCounter.table","NW_015090842.1:6236305",5,12,7
"SDR42E1","s1633_S_VTA_03_ASEReadCounter.table","NW_015090842.1:6236458",1,5,4
"SDR42E1","s1633_S_VTA_03_ASEReadCounter.table","NW_015090842.1:6236476",2,6,4
"SDR42E1","s1633_S_VTA_03_ASEReadCounter.table","NW_015090842.1:6236608",3,7,4
"SDR42E1","s1633_S_VTA_03_ASEReadCounter.table","NW_015090842.1:6238244",1,5,4
"SDR42E1","s1633_S_VTA_03_ASEReadCounter.table","NW_015090842.1:6238829",0,2,2
"HSD17B2","s1633_S_VTA_03_ASEReadCounter.table","NW_015090842.1:6257616",0,3,3
"HSD17B2","s1633_S_VTA_03_ASEReadCounter.table","NW_015090842.1:6257670",0,3,3
"HSD17B2","s1633_S_VTA_03_ASEReadCounter.table","NW_015090842.1:6257684",0,3,3
"HSD17B2","s1633_S_VTA_03_ASEReadCounter.table","NW_015090842.1:6257829",0,2,2
"HSD17B2","s1633_S_VTA_03_ASEReadCounter.table","NW_015090842.1:6266125",0,1,1
"HSD17B2","s1633_S_VTA_03_ASEReadCounter.table","NW_015090842.1:6266135",0,1,1
"HSD17B2","s1633_S_VTA_03_ASEReadCounter.table","NW_015090842.1:6266795",0,3,3
"HSD17B2","s1633_S_VTA_03_ASEReadCounter.table","NW_015090842.1:6266918",0,1,1
"HSD17B2","s1633_S_VTA_03_ASEReadCounter.table","NW_015090842.1:6266944",0,3,3
"HSD17B2","s1633_S_VTA_03_ASEReadCounter.table","NW_015090842.1:6266997",0,3,3
"HSD17B2","s1633_S_VTA_03_ASEReadCounter.table","NW_015090842.1:6267053",0,1,1
"HSD17B2","s1633_S_VTA_03_ASEReadCounter.table","NW_015090842.1:6267196",0,2,2
"HSD17B2","s1633_S_VTA_03_ASEReadCounter.table","NW_015090842.1:6267273",0,2,2
"HSD17B2","s1633_S_VTA_03_ASEReadCounter.table","NW_015090842.1:6267358",0,1,1
"HSD17B2","s1633_S_VTA_03_ASEReadCounter.table","NW_015090842.1:6267674",0,2,2
"HSD17B2","s1633_S_VTA_03_ASEReadCounter.table","NW_015090842.1:6268098",0,1,1
"HSD17B2","s1633_S_VTA_03_ASEReadCounter.table","NW_015090842.1:6268180",0,1,1
"HSD17B2","s1633_S_VTA_03_ASEReadCounter.table","NW_015090842.1:6268203",0,3,3
"ARY2","s1633_S_VTA_03_ASEReadCounter.table","NW_015090842.1:6303922",11,20,9
"ARY2","s1633_S_VTA_03_ASEReadCounter.table","NW_015090842.1:6303954",17,26,9
"ARY2","s1633_S_VTA_03_ASEReadCounter.table","NW_015090842.1:6303979",15,24,9
"ARY2","s1633_S_VTA_03_ASEReadCounter.table","NW_015090842.1:6305848",6,11,5
"ARY2","s1633_S_VTA_03_ASEReadCounter.table","NW_015090842.1:6305856",6,13,7
"ARY2","s1633_S_VTA_03_ASEReadCounter.table","NW_015090842.1:6305857",6,13,7
"ARY2","s1633_S_VTA_03_ASEReadCounter.table","NW_015090842.1:6306017",8,19,11
"ARY2","s1633_S_VTA_03_ASEReadCounter.table","NW_015090842.1:6306052",12,23,11
"ARY2","s1633_S_VTA_03_ASEReadCounter.table","NW_015090842.1:6306094",12,24,12
"ARY2","s1633_S_VTA_03_ASEReadCounter.table","NW_015090842.1:6306100",13,25,12
"ARY2","s1633_S_VTA_03_ASEReadCounter.table","NW_015090842.1:6306146",9,18,9
"ARY2","s1633_S_VTA_03_ASEReadCounter.table","NW_015090842.1:6306147",10,19,9
"ARY2","s1633_S_VTA_03_ASEReadCounter.table","NW_015090842.1:6306390",11,20,9
"ARY2","s1633_S_VTA_03_ASEReadCounter.table","NW_015090842.1:6306567",18,26,8
"ARY2","s1633_S_VTA_03_ASEReadCounter.table","NW_015090842.1:6306705",18,23,5
"ARY2","s1633_S_VTA_03_ASEReadCounter.table","NW_015090842.1:6306713",26,26,0
"ARY2","s1633_S_VTA_03_ASEReadCounter.table","NW_015090842.1:6306773",20,27,7
"ARY2","s1633_S_VTA_03_ASEReadCounter.table","NW_015090842.1:6307039",17,23,6
"ARY2","s1633_S_VTA_03_ASEReadCounter.table","NW_015090842.1:6307043",18,26,8
"ARY2","s1633_S_VTA_03_ASEReadCounter.table","NW_015090842.1:6307093",20,25,5
"ARY2","s1633_S_VTA_03_ASEReadCounter.table","NW_015090842.1:6307138",23,33,10
"ARY2","s1633_S_VTA_03_ASEReadCounter.table","NW_015090842.1:6307157",26,35,9
"ARY2","s1633_S_VTA_03_ASEReadCounter.table","NW_015090842.1:6307187",28,41,13
"ARY2","s1633_S_VTA_03_ASEReadCounter.table","NW_015090842.1:6307278",14,26,12
"ARY2","s1633_S_VTA_03_ASEReadCounter.table","NW_015090842.1:6307305",25,38,13
"ARY2","s1633_S_VTA_03_ASEReadCounter.table","NW_015090842.1:6307318",30,43,13
"ARY2","s1633_S_VTA_03_ASEReadCounter.table","NW_015090842.1:6307429",35,46,11
"ARY2","s1633_S_VTA_03_ASEReadCounter.table","NW_015090842.1:6307487",21,30,9
"ARY2","s1633_S_VTA_03_ASEReadCounter.table","NW_015090842.1:6307670",27,34,7
"ARYL","s1633_S_VTA_03_ASEReadCounter.table","NW_015090842.1:6313360",5,9,4
"ARYL","s1633_S_VTA_03_ASEReadCounter.table","NW_015090842.1:6313377",5,8,3
"ARYL","s1633_S_VTA_03_ASEReadCounter.table","NW_015090842.1:6313767",2,3,1
"ARY1","s1633_S_VTA_03_ASEReadCounter.table","NW_015090842.1:6313909",8,8,0
"ARY1","s1633_S_VTA_03_ASEReadCounter.table","NW_015090842.1:6314296",3,4,1
"ARY1","s1633_S_VTA_03_ASEReadCounter.table","NW_015090842.1:6314541",5,8,3
"ARY1","s1633_S_VTA_03_ASEReadCounter.table","NW_015090842.1:6314597",4,6,2
"ARY1","s1633_S_VTA_03_ASEReadCounter.table","NW_015090842.1:6314750",11,14,3
"ARY1","s1633_S_VTA_03_ASEReadCounter.table","NW_015090842.1:6314794",6,8,2
"ARY1","s1633_S_VTA_03_ASEReadCounter.table","NW_015090842.1:6314827",6,7,1
"ARY1","s1633_S_VTA_03_ASEReadCounter.table","NW_015090842.1:6314843",9,10,1
"ARY1","s1633_S_VTA_03_ASEReadCounter.table","NW_015090842.1:6314859",10,10,0
"ARY1","s1633_S_VTA_03_ASEReadCounter.table","NW_015090842.1:6314886",11,13,2
"ARY1","s1633_S_VTA_03_ASEReadCounter.table","NW_015090842.1:6314943",15,15,0
"ARY1","s1633_S_VTA_03_ASEReadCounter.table","NW_015090842.1:6314949",14,14,0
"ARY1","s1633_S_VTA_03_ASEReadCounter.table","NW_015090842.1:6315022",11,16,5
"ARY1","s1633_S_VTA_03_ASEReadCounter.table","NW_015090842.1:6315026",10,14,4
"ARY1","s1633_S_VTA_03_ASEReadCounter.table","NW_015090842.1:6315043",10,13,3
"ARY1","s1633_S_VTA_03_ASEReadCounter.table","NW_015090842.1:6315065",10,14,4
"ARY1","s1633_S_VTA_03_ASEReadCounter.table","NW_015090842.1:6315409",4,5,1
"ARY1","s1633_S_VTA_03_ASEReadCounter.table","NW_015090842.1:6315479",4,6,2
"ARY1","s1633_S_VTA_03_ASEReadCounter.table","NW_015090842.1:6318342",11,17,6
"ARY1","s1633_S_VTA_03_ASEReadCounter.table","NW_015090842.1:6318427",12,18,6
"ARY1","s1633_S_VTA_03_ASEReadCounter.table","NW_015090842.1:6318603",15,20,5
"ARY1","s1633_S_VTA_03_ASEReadCounter.table","NW_015090842.1:6318708",12,18,6
"ARY1","s1633_S_VTA_03_ASEReadCounter.table","NW_015090842.1:6318858",19,22,3
"ARY1","s1633_S_VTA_03_ASEReadCounter.table","NW_015090842.1:6318952",24,39,15
"MPHOSPH6","s1633_S_VTA_03_ASEReadCounter.table","NW_015090842.1:6324063",55,112,57
"MPHOSPH6","s1633_S_VTA_03_ASEReadCounter.table","NW_015090842.1:6324174",89,184,95
"MPHOSPH6","s1633_S_VTA_03_ASEReadCounter.table","NW_015090842.1:6324270",98,211,113
"MPHOSPH6","s1633_S_VTA_03_ASEReadCounter.table","NW_015090842.1:6324762",74,163,89
"MPHOSPH6","s1633_S_VTA_03_ASEReadCounter.table","NW_015090842.1:6324772",72,149,77
"MPHOSPH6","s1633_S_VTA_03_ASEReadCounter.table","NW_015090842.1:6324780",66,148,82
"MPHOSPH6","s1633_S_VTA_03_ASEReadCounter.table","NW_015090842.1:6324902",76,155,79
"MPHOSPH6","s1633_S_VTA_03_ASEReadCounter.table","NW_015090842.1:6324910",152,152,0
"MPHOSPH6","s1633_S_VTA_03_ASEReadCounter.table","NW_015090842.1:6325066",68,155,87
"MPHOSPH6","s1633_S_VTA_03_ASEReadCounter.table","NW_015090842.1:6325089",75,172,97
"MPHOSPH6","s1633_S_VTA_03_ASEReadCounter.table","NW_015090842.1:6325298",78,176,98
"MPHOSPH6","s1633_S_VTA_03_ASEReadCounter.table","NW_015090842.1:6325877",69,147,78
"MPHOSPH6","s1633_S_VTA_03_ASEReadCounter.table","NW_015090842.1:6326976",44,115,71
"CDH13","s1633_S_VTA_03_ASEReadCounter.table","NW_015090842.1:6662283",4,9,5
"CDH13","s1633_S_VTA_03_ASEReadCounter.table","NW_015090842.1:6693665",4,8,4
"CDH13","s1633_S_VTA_03_ASEReadCounter.table","NW_015090842.1:6693697",8,10,2
"CDH13","s1633_S_VTA_03_ASEReadCounter.table","NW_015090842.1:6693712",6,7,1
"CDH13","s1633_S_VTA_03_ASEReadCounter.table","NW_015090842.1:6693723",5,6,1
"CDH13","s1633_S_VTA_03_ASEReadCounter.table","NW_015090842.1:6693738",6,8,2
"CDH13","s1633_S_VTA_03_ASEReadCounter.table","NW_015090842.1:6823730",10,13,3
"CDH13","s1633_S_VTA_03_ASEReadCounter.table","NW_015090842.1:6889713",7,12,5
"CDH13","s1633_S_VTA_03_ASEReadCounter.table","NW_015090842.1:6955167",18,30,12
"MLYCD","s1633_S_VTA_03_ASEReadCounter.table","NW_015090842.1:7150054",67,134,67
"MLYCD","s1633_S_VTA_03_ASEReadCounter.table","NW_015090842.1:7150131",89,189,100
"MLYCD","s1633_S_VTA_03_ASEReadCounter.table","NW_015090842.1:7150585",54,100,46
"MLYCD","s1633_S_VTA_03_ASEReadCounter.table","NW_015090842.1:7150686",52,98,46
"MLYCD","s1633_S_VTA_03_ASEReadCounter.table","NW_015090842.1:7150696",55,106,51
"MLYCD","s1633_S_VTA_03_ASEReadCounter.table","NW_015090842.1:7150698",105,105,0
"MLYCD","s1633_S_VTA_03_ASEReadCounter.table","NW_015090842.1:7150869",48,97,49
"MLYCD","s1633_S_VTA_03_ASEReadCounter.table","NW_015090842.1:7151100",44,79,35
"MLYCD","s1633_S_VTA_03_ASEReadCounter.table","NW_015090842.1:7151127",39,78,39
"MLYCD","s1633_S_VTA_03_ASEReadCounter.table","NW_015090842.1:7157538",36,61,25
"MLYCD","s1633_S_VTA_03_ASEReadCounter.table","NW_015090842.1:7167662",13,27,14
"MLYCD","s1633_S_VTA_03_ASEReadCounter.table","NW_015090842.1:7167675",12,27,15
"MLYCD","s1633_S_VTA_03_ASEReadCounter.table","NW_015090842.1:7167710",15,27,12
"MLYCD","s1633_S_VTA_03_ASEReadCounter.table","NW_015090842.1:7167781",13,20,7
"MLYCD","s1633_S_VTA_03_ASEReadCounter.table","NW_015090842.1:7167803",10,17,7
"MLYCD","s1633_S_VTA_03_ASEReadCounter.table","NW_015090842.1:7167812",12,16,4
"MLYCD","s1633_S_VTA_03_ASEReadCounter.table","NW_015090842.1:7167845",11,17,6
"MLYCD","s1633_S_VTA_03_ASEReadCounter.table","NW_015090842.1:7167862",8,15,7
"MLYCD","s1633_S_VTA_03_ASEReadCounter.table","NW_015090842.1:7167929",4,9,5
"MLYCD","s1633_S_VTA_03_ASEReadCounter.table","NW_015090842.1:7167995",3,9,6
"MLYCD","s1633_S_VTA_03_ASEReadCounter.table","NW_015090842.1:7168005",3,9,6
"MLYCD","s1633_S_VTA_03_ASEReadCounter.table","NW_015090842.1:7168037",5,7,2
"HSBP1","s1633_S_VTA_03_ASEReadCounter.table","NW_015090842.1:7245192",324,522,198
"HSBP1","s1633_S_VTA_03_ASEReadCounter.table","NW_015090842.1:7245226",349,586,237
"HSBP1","s1633_S_VTA_03_ASEReadCounter.table","NW_015090842.1:7245257",286,505,219
"HSBP1","s1633_S_VTA_03_ASEReadCounter.table","NW_015090842.1:7245296",283,523,240
"HSBP1","s1633_S_VTA_03_ASEReadCounter.table","NW_015090842.1:7245389",393,707,314
"HSBP1","s1633_S_VTA_03_ASEReadCounter.table","NW_015090842.1:7245400",408,688,280
"HSBP1","s1633_S_VTA_03_ASEReadCounter.table","NW_015090842.1:7245445",396,653,257
"HSBP1","s1633_S_VTA_03_ASEReadCounter.table","NW_015090842.1:7245495",344,599,255
"HSBP1","s1633_S_VTA_03_ASEReadCounter.table","NW_015090842.1:7245515",355,633,278
"HSBP1","s1633_S_VTA_03_ASEReadCounter.table","NW_015090842.1:7245733",189,388,199
"HSBP1","s1633_S_VTA_03_ASEReadCounter.table","NW_015090842.1:7245771",208,392,184
"HSBP1","s1633_S_VTA_03_ASEReadCounter.table","NW_015090842.1:7245813",215,400,185
"HSBP1","s1633_S_VTA_03_ASEReadCounter.table","NW_015090842.1:7245926",251,433,182
"HSBP1","s1633_S_VTA_03_ASEReadCounter.table","NW_015090842.1:7245927",251,435,184
"HSBP1","s1633_S_VTA_03_ASEReadCounter.table","NW_015090842.1:7245933",261,434,173
"HSBP1","s1633_S_VTA_03_ASEReadCounter.table","NW_015090842.1:7246002",207,370,163
"HSBP1","s1633_S_VTA_03_ASEReadCounter.table","NW_015090842.1:7246094",214,352,138
"HSBP1","s1633_S_VTA_03_ASEReadCounter.table","NW_015090842.1:7246167",190,317,127
"HSBP1","s1633_S_VTA_03_ASEReadCounter.table","NW_015090842.1:7246183",192,318,126
"HSBP1","s1633_S_VTA_03_ASEReadCounter.table","NW_015090842.1:7247285",28,35,7
"HSBP1","s1633_S_VTA_03_ASEReadCounter.table","NW_015090842.1:7247651",256,529,273
"HSBP1","s1633_S_VTA_03_ASEReadCounter.table","NW_015090842.1:7247657",248,529,281
"HSBP1","s1633_S_VTA_03_ASEReadCounter.table","NW_015090842.1:7248520",184,378,194
"HSBP1","s1633_S_VTA_03_ASEReadCounter.table","NW_015090842.1:7248535",154,306,152
"KCNG4","s1633_S_VTA_03_ASEReadCounter.table","NW_015090842.1:7282481",3,5,2
"KCNG4","s1633_S_VTA_03_ASEReadCounter.table","NW_015090842.1:7282500",3,4,1
"KCNG4","s1633_S_VTA_03_ASEReadCounter.table","NW_015090842.1:7282542",4,7,3
"KCNG4","s1633_S_VTA_03_ASEReadCounter.table","NW_015090842.1:7282579",4,7,3
"KCNG4","s1633_S_VTA_03_ASEReadCounter.table","NW_015090842.1:7282630",3,7,4
"KCNG4","s1633_S_VTA_03_ASEReadCounter.table","NW_015090842.1:7282760",2,5,3
"KCNG4","s1633_S_VTA_03_ASEReadCounter.table","NW_015090842.1:7283056",1,3,2
"KCNG4","s1633_S_VTA_03_ASEReadCounter.table","NW_015090842.1:7283245",1,1,0
"KCNG4","s1633_S_VTA_03_ASEReadCounter.table","NW_015090842.1:7299491",1,2,1
"WFDC1","s1633_S_VTA_03_ASEReadCounter.table","NW_015090842.1:7366517",1,1,0
"ATP2C2","s1633_S_VTA_03_ASEReadCounter.table","NW_015090842.1:7413747",3,9,6
"TLDC1","s1633_S_VTA_03_ASEReadCounter.table","NW_015090842.1:7421997",24,42,18
"COTL1","s1633_S_VTA_03_ASEReadCounter.table","NW_015090842.1:7490707",470,997,527
"COTL1","s1633_S_VTA_03_ASEReadCounter.table","NW_015090842.1:7490708",469,1001,532
"COTL1","s1633_S_VTA_03_ASEReadCounter.table","NW_015090842.1:7490711",477,1011,534
"COTL1","s1633_S_VTA_03_ASEReadCounter.table","NW_015090842.1:7490739",445,977,532
"COTL1","s1633_S_VTA_03_ASEReadCounter.table","NW_015090842.1:7490785",435,959,524
"COTL1","s1633_S_VTA_03_ASEReadCounter.table","NW_015090842.1:7490820",54,624,570
"COTL1","s1633_S_VTA_03_ASEReadCounter.table","NW_015090842.1:7490846",434,905,471
"COTL1","s1633_S_VTA_03_ASEReadCounter.table","NW_015090842.1:7505571",1,1,0
"KLHL36","s1633_S_VTA_03_ASEReadCounter.table","NW_015090842.1:7526337",25,25,0
"KLHL36","s1633_S_VTA_03_ASEReadCounter.table","NW_015090842.1:7537681",68,69,1
"USP10","s1633_S_VTA_03_ASEReadCounter.table","NW_015090842.1:7572213",25,56,31
"USP10","s1633_S_VTA_03_ASEReadCounter.table","NW_015090842.1:7572358",31,31,0
"CRISPLD2","s1633_S_VTA_03_ASEReadCounter.table","NW_015090842.1:7630779",10,10,0
"CRISPLD2","s1633_S_VTA_03_ASEReadCounter.table","NW_015090842.1:7633611",9,9,0
"CRISPLD2","s1633_S_VTA_03_ASEReadCounter.table","NW_015090842.1:7633787",3,8,5
"CRISPLD2","s1633_S_VTA_03_ASEReadCounter.table","NW_015090842.1:7634023",4,6,2
"CRISPLD2","s1633_S_VTA_03_ASEReadCounter.table","NW_015090842.1:7634620",6,6,0
"CRISPLD2","s1633_S_VTA_03_ASEReadCounter.table","NW_015090842.1:7636315",4,6,2
"MTHFSD","s1633_S_VTA_03_ASEReadCounter.table","NW_015090842.1:8152578",12,30,18
"DUSP15","s1633_S_VTA_03_ASEReadCounter.table","NW_015090842.1:8422840",1,1,0
"DUSP15","s1633_S_VTA_03_ASEReadCounter.table","NW_015090842.1:8431988",0,5,5
"EMC8","s1633_S_VTA_03_ASEReadCounter.table","NW_015090842.1:8452385",15,29,14
"GINS2","s1633_S_VTA_03_ASEReadCounter.table","NW_015090842.1:8467469",31,31,0
"GINS2","s1633_S_VTA_03_ASEReadCounter.table","NW_015090842.1:8470290",29,56,27
"GINS2","s1633_S_VTA_03_ASEReadCounter.table","NW_015090842.1:8470305",25,51,26
"GINS2","s1633_S_VTA_03_ASEReadCounter.table","NW_015090842.1:8470376",25,52,27
"GINS2","s1633_S_VTA_03_ASEReadCounter.table","NW_015090842.1:8471057",0,3,3
"GSE1","s1633_S_VTA_03_ASEReadCounter.table","NW_015090842.1:8483570",1,1,0
"KIAA0513","s1633_S_VTA_03_ASEReadCounter.table","NW_015090842.1:8674736",107,107,0
"KIAA0513","s1633_S_VTA_03_ASEReadCounter.table","NW_015090842.1:8687268",0,1,1
"KIAA0513","s1633_S_VTA_03_ASEReadCounter.table","NW_015090842.1:8693655",4,4,0
"ZCCHC14","s1633_S_VTA_03_ASEReadCounter.table","NW_015090842.1:8750189",76,76,0
"JPH3","s1633_S_VTA_03_ASEReadCounter.table","NW_015090842.1:8872294",37,77,40
"KLHDC4","s1633_S_VTA_03_ASEReadCounter.table","NW_015090842.1:8891175",58,136,78
"KLHDC4","s1633_S_VTA_03_ASEReadCounter.table","NW_015090842.1:8905251",18,34,16
"KLHDC4","s1633_S_VTA_03_ASEReadCounter.table","NW_015090842.1:8919630",7,11,4
"SLC7A5","s1633_S_VTA_03_ASEReadCounter.table","NW_015090842.1:8940382",173,173,0
"SLC7A5","s1633_S_VTA_03_ASEReadCounter.table","NW_015090842.1:8941818",107,107,0
"SLC7A5","s1633_S_VTA_03_ASEReadCounter.table","NW_015090842.1:8944655",58,58,0
"CA5A","s1633_S_VTA_03_ASEReadCounter.table","NW_015090842.1:8989479",62,144,82
"CA5A","s1633_S_VTA_03_ASEReadCounter.table","NW_015090842.1:8989562",89,201,112
"CA5A","s1633_S_VTA_03_ASEReadCounter.table","NW_015090842.1:8989609",96,228,132
"CA5A","s1633_S_VTA_03_ASEReadCounter.table","NW_015090842.1:8989693",104,256,152
"CA5A","s1633_S_VTA_03_ASEReadCounter.table","NW_015090842.1:8989702",105,241,136
"CA5A","s1633_S_VTA_03_ASEReadCounter.table","NW_015090842.1:8989746",108,261,153
"CA5A","s1633_S_VTA_03_ASEReadCounter.table","NW_015090842.1:8989880",94,199,105
"CA5A","s1633_S_VTA_03_ASEReadCounter.table","NW_015090842.1:8989885",96,202,106
"CA5A","s1633_S_VTA_03_ASEReadCounter.table","NW_015090842.1:8989929",98,222,124
"CA5A","s1633_S_VTA_03_ASEReadCounter.table","NW_015090842.1:8990002",83,196,113
"CA5A","s1633_S_VTA_03_ASEReadCounter.table","NW_015090842.1:8990004",82,195,113
"CA5A","s1633_S_VTA_03_ASEReadCounter.table","NW_015090842.1:8990005",82,198,116
"CA5A","s1633_S_VTA_03_ASEReadCounter.table","NW_015090842.1:8990017",89,191,102
"CA5A","s1633_S_VTA_03_ASEReadCounter.table","NW_015090842.1:8990043",65,151,86
"CA5A","s1633_S_VTA_03_ASEReadCounter.table","NW_015090842.1:8990080",52,139,87
"CA5A","s1633_S_VTA_03_ASEReadCounter.table","NW_015090842.1:8990084",58,146,88
"CA5A","s1633_S_VTA_03_ASEReadCounter.table","NW_015090842.1:8990090",56,139,83
"CA5A","s1633_S_VTA_03_ASEReadCounter.table","NW_015090842.1:8990095",57,140,83
"CA5A","s1633_S_VTA_03_ASEReadCounter.table","NW_015090842.1:8990111",43,129,86
"CA5A","s1633_S_VTA_03_ASEReadCounter.table","NW_015090842.1:8990112",43,126,83
"CA5A","s1633_S_VTA_03_ASEReadCounter.table","NW_015090842.1:8990115",41,120,79
"CA5A","s1633_S_VTA_03_ASEReadCounter.table","NW_015090842.1:8990166",61,130,69
"CA5A","s1633_S_VTA_03_ASEReadCounter.table","NW_015090842.1:8990169",69,141,72
"CA5A","s1633_S_VTA_03_ASEReadCounter.table","NW_015090842.1:8990222",65,118,53
"CA5A","s1633_S_VTA_03_ASEReadCounter.table","NW_015090842.1:8990289",68,124,56
"CA5A","s1633_S_VTA_03_ASEReadCounter.table","NW_015090842.1:8990314",68,124,56
"CA5A","s1633_S_VTA_03_ASEReadCounter.table","NW_015090842.1:8990361",61,112,51
"CA5A","s1633_S_VTA_03_ASEReadCounter.table","NW_015090842.1:8990368",62,114,52
"CA5A","s1633_S_VTA_03_ASEReadCounter.table","NW_015090842.1:8990429",47,100,53
"CA5A","s1633_S_VTA_03_ASEReadCounter.table","NW_015090842.1:8990466",37,78,41
"CA5A","s1633_S_VTA_03_ASEReadCounter.table","NW_015090842.1:8990663",54,104,50
"CA5A","s1633_S_VTA_03_ASEReadCounter.table","NW_015090842.1:8990797",35,83,48
"CA5A","s1633_S_VTA_03_ASEReadCounter.table","NW_015090842.1:8990836",45,86,41
"CA5A","s1633_S_VTA_03_ASEReadCounter.table","NW_015090842.1:8990842",47,87,40
"CA5A","s1633_S_VTA_03_ASEReadCounter.table","NW_015090842.1:8990851",46,83,37
"CA5A","s1633_S_VTA_03_ASEReadCounter.table","NW_015090842.1:8990918",46,84,38
"CA5A","s1633_S_VTA_03_ASEReadCounter.table","NW_015090842.1:8990921",41,83,42
"CA5A","s1633_S_VTA_03_ASEReadCounter.table","NW_015090842.1:8990942",50,95,45
"CA5A","s1633_S_VTA_03_ASEReadCounter.table","NW_015090842.1:8991001",54,104,50
"CA5A","s1633_S_VTA_03_ASEReadCounter.table","NW_015090842.1:8991038",57,104,47
"CA5A","s1633_S_VTA_03_ASEReadCounter.table","NW_015090842.1:8991149",61,117,56
"CA5A","s1633_S_VTA_03_ASEReadCounter.table","NW_015090842.1:8991176",66,117,51
"CA5A","s1633_S_VTA_03_ASEReadCounter.table","NW_015090842.1:8991241",59,125,66
"CA5A","s1633_S_VTA_03_ASEReadCounter.table","NW_015090842.1:8991262",57,121,64
"CA5A","s1633_S_VTA_03_ASEReadCounter.table","NW_015090842.1:8991316",52,56,4
"CA5A","s1633_S_VTA_03_ASEReadCounter.table","NW_015090842.1:8991319",55,60,5
"CA5A","s1633_S_VTA_03_ASEReadCounter.table","NW_015090842.1:8991330",53,56,3
"CA5A","s1633_S_VTA_03_ASEReadCounter.table","NW_015090842.1:8991334",50,54,4
"CA5A","s1633_S_VTA_03_ASEReadCounter.table","NW_015090842.1:8991362",45,85,40
"CA5A","s1633_S_VTA_03_ASEReadCounter.table","NW_015090842.1:8991368",48,90,42
"CA5A","s1633_S_VTA_03_ASEReadCounter.table","NW_015090842.1:8991390",53,99,46
"CA5A","s1633_S_VTA_03_ASEReadCounter.table","NW_015090842.1:8991395",53,103,50
"CA5A","s1633_S_VTA_03_ASEReadCounter.table","NW_015090842.1:8991422",43,104,61
"CA5A","s1633_S_VTA_03_ASEReadCounter.table","NW_015090842.1:8991467",41,100,59
"CA5A","s1633_S_VTA_03_ASEReadCounter.table","NW_015090842.1:8991576",24,68,44
"CA5A","s1633_S_VTA_03_ASEReadCounter.table","NW_015090842.1:8991587",28,74,46
"CA5A","s1633_S_VTA_03_ASEReadCounter.table","NW_015090842.1:8991655",47,88,41
"CA5A","s1633_S_VTA_03_ASEReadCounter.table","NW_015090842.1:8991717",40,86,46
"CA5A","s1633_S_VTA_03_ASEReadCounter.table","NW_015090842.1:8991726",43,89,46
"CA5A","s1633_S_VTA_03_ASEReadCounter.table","NW_015090842.1:8991799",33,72,39
"CA5A","s1633_S_VTA_03_ASEReadCounter.table","NW_015090842.1:8991809",31,64,33
"CA5A","s1633_S_VTA_03_ASEReadCounter.table","NW_015090842.1:8991848",20,53,33
"CA5A","s1633_S_VTA_03_ASEReadCounter.table","NW_015090842.1:8991849",20,52,32
"CA5A","s1633_S_VTA_03_ASEReadCounter.table","NW_015090842.1:8991927",20,53,33
"CA5A","s1633_S_VTA_03_ASEReadCounter.table","NW_015090842.1:8991941",18,50,32
"CA5A","s1633_S_VTA_03_ASEReadCounter.table","NW_015090842.1:8992121",27,61,34
"CA5A","s1633_S_VTA_03_ASEReadCounter.table","NW_015090842.1:8992224",26,53,27
"CA5A","s1633_S_VTA_03_ASEReadCounter.table","NW_015090842.1:9002570",14,31,17
"CA5A","s1633_S_VTA_03_ASEReadCounter.table","NW_015090842.1:9002600",14,31,17
"CA5A","s1633_S_VTA_03_ASEReadCounter.table","NW_015090842.1:9004312",8,17,9
"CA5A","s1633_S_VTA_03_ASEReadCounter.table","NW_015090842.1:9004620",2,3,1
"CA5A","s1633_S_VTA_03_ASEReadCounter.table","NW_015090842.1:9005116",2,6,4
"CA5A","s1633_S_VTA_03_ASEReadCounter.table","NW_015090842.1:9005120",2,7,5
"CA5A","s1633_S_VTA_03_ASEReadCounter.table","NW_015090842.1:9005140",4,10,6
"CA5A","s1633_S_VTA_03_ASEReadCounter.table","NW_015090842.1:9005152",4,10,6
"BANP","s1633_S_VTA_03_ASEReadCounter.table","NW_015090842.1:9033407",4,11,7
"BANP","s1633_S_VTA_03_ASEReadCounter.table","NW_015090842.1:9033409",4,10,6
"BANP","s1633_S_VTA_03_ASEReadCounter.table","NW_015090842.1:9033420",4,12,8
"BANP","s1633_S_VTA_03_ASEReadCounter.table","NW_015090842.1:9055284",8,12,4
"ZC3H18","s1633_S_VTA_03_ASEReadCounter.table","NW_015090842.1:9528933",18,41,23
"MVD","s1633_S_VTA_03_ASEReadCounter.table","NW_015090842.1:9550690",74,74,0
"MVD","s1633_S_VTA_03_ASEReadCounter.table","NW_015090842.1:9550691",74,74,0
"MVD","s1633_S_VTA_03_ASEReadCounter.table","NW_015090842.1:9550699",84,84,0
"MVD","s1633_S_VTA_03_ASEReadCounter.table","NW_015090842.1:9550701",84,84,0
"MVD","s1633_S_VTA_03_ASEReadCounter.table","NW_015090842.1:9552202",69,69,0
"MVD","s1633_S_VTA_03_ASEReadCounter.table","NW_015090842.1:9552223",67,68,1
"MVD","s1633_S_VTA_03_ASEReadCounter.table","NW_015090842.1:9552533",68,68,0
"MVD","s1633_S_VTA_03_ASEReadCounter.table","NW_015090842.1:9552644",36,65,29
"PIEZO1","s1633_S_VTA_03_ASEReadCounter.table","NW_015090842.1:9577447",2,6,4
"PIEZO1","s1633_S_VTA_03_ASEReadCounter.table","NW_015090842.1:9579101",3,10,7
"PIEZO1","s1633_S_VTA_03_ASEReadCounter.table","NW_015090842.1:9582630",3,9,6
"PIEZO1","s1633_S_VTA_03_ASEReadCounter.table","NW_015090842.1:9582976",1,3,2
"PIEZO1","s1633_S_VTA_03_ASEReadCounter.table","NW_015090842.1:9583326",6,6,0
"CDT1","s1633_S_VTA_03_ASEReadCounter.table","NW_015090842.1:9596711",0,3,3
"CDT1","s1633_S_VTA_03_ASEReadCounter.table","NW_015090842.1:9597033",9,9,0
"CDT1","s1633_S_VTA_03_ASEReadCounter.table","NW_015090842.1:9597756",4,11,7
"CDT1","s1633_S_VTA_03_ASEReadCounter.table","NW_015090842.1:9598873",9,9,0
"ACSF3","s1633_S_VTA_03_ASEReadCounter.table","NW_015090842.1:9776737",11,12,1
"ACSF3","s1633_S_VTA_03_ASEReadCounter.table","NW_015090842.1:9809639",56,57,1
"ACSF3","s1633_S_VTA_03_ASEReadCounter.table","NW_015090842.1:9834743",37,87,50
"ACSF3","s1633_S_VTA_03_ASEReadCounter.table","NW_015090842.1:9834762",73,73,0
"ACSF3","s1633_S_VTA_03_ASEReadCounter.table","NW_015090842.1:9834852",34,87,53
"ACSF3","s1633_S_VTA_03_ASEReadCounter.table","NW_015090842.1:9834861",28,76,48
"ACSF3","s1633_S_VTA_03_ASEReadCounter.table","NW_015090842.1:9839359",30,56,26
"ACSF3","s1633_S_VTA_03_ASEReadCounter.table","NW_015090842.1:9839378",25,50,25
"ACSF3","s1633_S_VTA_03_ASEReadCounter.table","NW_015090842.1:9839455",19,52,33
"ACSF3","s1633_S_VTA_03_ASEReadCounter.table","NW_015090842.1:9839457",20,47,27
"ACSF3","s1633_S_VTA_03_ASEReadCounter.table","NW_015090842.1:9839489",18,45,27
"ACSF3","s1633_S_VTA_03_ASEReadCounter.table","NW_015090842.1:9839500",13,36,23
"ACSF3","s1633_S_VTA_03_ASEReadCounter.table","NW_015090842.1:9839501",12,34,22
"ACSF3","s1633_S_VTA_03_ASEReadCounter.table","NW_015090842.1:9839504",14,36,22
"ACSF3","s1633_S_VTA_03_ASEReadCounter.table","NW_015090842.1:9839512",12,29,17
"ACSF3","s1633_S_VTA_03_ASEReadCounter.table","NW_015090842.1:9839527",10,28,18
"ACSF3","s1633_S_VTA_03_ASEReadCounter.table","NW_015090842.1:9839533",9,24,15
"ACSF3","s1633_S_VTA_03_ASEReadCounter.table","NW_015090842.1:9839535",9,24,15
"ACSF3","s1633_S_VTA_03_ASEReadCounter.table","NW_015090842.1:9839545",6,17,11
"ACSF3","s1633_S_VTA_03_ASEReadCounter.table","NW_015090842.1:9839550",5,16,11
"ACSF3","s1633_S_VTA_03_ASEReadCounter.table","NW_015090842.1:9839551",6,17,11
"CDH15","s1633_S_VTA_03_ASEReadCounter.table","NW_015090842.1:9847163",1,1,0
"CDH15","s1633_S_VTA_03_ASEReadCounter.table","NW_015090842.1:9847174",1,1,0
"CDH15","s1633_S_VTA_03_ASEReadCounter.table","NW_015090842.1:9848531",2,2,0
"CDH15","s1633_S_VTA_03_ASEReadCounter.table","NW_015090842.1:9848552",3,3,0
"CDH15","s1633_S_VTA_03_ASEReadCounter.table","NW_015090842.1:9848888",2,2,0
"CDH15","s1633_S_VTA_03_ASEReadCounter.table","NW_015090842.1:9849140",1,1,0
"CDH15","s1633_S_VTA_03_ASEReadCounter.table","NW_015090842.1:9849473",1,1,0
"CDH15","s1633_S_VTA_03_ASEReadCounter.table","NW_015090842.1:9850141",2,4,2
"CDH15","s1633_S_VTA_03_ASEReadCounter.table","NW_015090842.1:9850386",1,3,2
"CDH15","s1633_S_VTA_03_ASEReadCounter.table","NW_015090842.1:9850432",1,3,2
"CDH15","s1633_S_VTA_03_ASEReadCounter.table","NW_015090842.1:9850609",1,3,2
"SLC22A31","s1633_S_VTA_03_ASEReadCounter.table","NW_015090842.1:9850797",1,1,0
"SLC22A31","s1633_S_VTA_03_ASEReadCounter.table","NW_015090842.1:9851130",4,4,0
"SLC22A31","s1633_S_VTA_03_ASEReadCounter.table","NW_015090842.1:9851139",3,3,0
"SLC22A31","s1633_S_VTA_03_ASEReadCounter.table","NW_015090842.1:9851265",2,8,6
"SLC22A31","s1633_S_VTA_03_ASEReadCounter.table","NW_015090842.1:9851302",4,9,5
"SLC22A31","s1633_S_VTA_03_ASEReadCounter.table","NW_015090842.1:9851303",4,9,5
"SLC22A31","s1633_S_VTA_03_ASEReadCounter.table","NW_015090842.1:9851305",4,8,4
"SLC22A31","s1633_S_VTA_03_ASEReadCounter.table","NW_015090842.1:9851343",3,7,4
"SLC22A31","s1633_S_VTA_03_ASEReadCounter.table","NW_015090842.1:9851344",3,7,4
"SLC22A31","s1633_S_VTA_03_ASEReadCounter.table","NW_015090842.1:9851381",6,11,5
"SLC22A31","s1633_S_VTA_03_ASEReadCounter.table","NW_015090842.1:9851421",12,15,3
"SLC22A31","s1633_S_VTA_03_ASEReadCounter.table","NW_015090842.1:9851526",7,16,9
"SLC22A31","s1633_S_VTA_03_ASEReadCounter.table","NW_015090842.1:9851589",10,18,8
"SLC22A31","s1633_S_VTA_03_ASEReadCounter.table","NW_015090842.1:9851712",8,12,4
"SLC22A31","s1633_S_VTA_03_ASEReadCounter.table","NW_015090842.1:9851899",7,13,6
"SLC22A31","s1633_S_VTA_03_ASEReadCounter.table","NW_015090842.1:9852139",4,11,7
"SLC22A31","s1633_S_VTA_03_ASEReadCounter.table","NW_015090842.1:9852380",2,14,12
"SLC22A31","s1633_S_VTA_03_ASEReadCounter.table","NW_015090842.1:9852431",4,11,7
"SLC22A31","s1633_S_VTA_03_ASEReadCounter.table","NW_015090842.1:9852630",4,8,4
"SLC22A31","s1633_S_VTA_03_ASEReadCounter.table","NW_015090842.1:9852711",0,4,4
"SLC22A31","s1633_S_VTA_03_ASEReadCounter.table","NW_015090842.1:9852742",0,3,3
"SLC22A31","s1633_S_VTA_03_ASEReadCounter.table","NW_015090842.1:9853099",2,2,0
"SLC22A31","s1633_S_VTA_03_ASEReadCounter.table","NW_015090842.1:9853102",2,3,1
"SLC22A31","s1633_S_VTA_03_ASEReadCounter.table","NW_015090842.1:9853421",2,2,0
"SLC22A31","s1633_S_VTA_03_ASEReadCounter.table","NW_015090842.1:9853457",1,1,0
"SLC22A31","s1633_S_VTA_03_ASEReadCounter.table","NW_015090842.1:9853502",1,2,1
"ANKRD11","s1633_S_VTA_03_ASEReadCounter.table","NW_015090842.1:9858863",14,28,14
"ANKRD11","s1633_S_VTA_03_ASEReadCounter.table","NW_015090842.1:9859101",138,274,136
"ANKRD11","s1633_S_VTA_03_ASEReadCounter.table","NW_015090842.1:9859352",129,295,166
"ANKRD11","s1633_S_VTA_03_ASEReadCounter.table","NW_015090842.1:9859381",26,144,118
"ANKRD11","s1633_S_VTA_03_ASEReadCounter.table","NW_015090842.1:9859527",50,133,83
"ANKRD11","s1633_S_VTA_03_ASEReadCounter.table","NW_015090842.1:9859529",49,133,84
"ANKRD11","s1633_S_VTA_03_ASEReadCounter.table","NW_015090842.1:9859679",123,260,137
"ANKRD11","s1633_S_VTA_03_ASEReadCounter.table","NW_015090842.1:9861097",80,179,99
"ANKRD11","s1633_S_VTA_03_ASEReadCounter.table","NW_015090842.1:9862571",64,121,57
"ANKRD11","s1633_S_VTA_03_ASEReadCounter.table","NW_015090842.1:9866071",0,68,68
"ANKRD11","s1633_S_VTA_03_ASEReadCounter.table","NW_015090842.1:9866200",0,47,47
"ANKRD11","s1633_S_VTA_03_ASEReadCounter.table","NW_015090842.1:9867391",19,37,18
"ANKRD11","s1633_S_VTA_03_ASEReadCounter.table","NW_015090842.1:9867472",37,62,25
"ANKRD11","s1633_S_VTA_03_ASEReadCounter.table","NW_015090842.1:9867559",28,65,37
"ANKRD11","s1633_S_VTA_03_ASEReadCounter.table","NW_015090842.1:9867934",40,68,28
"ANKRD11","s1633_S_VTA_03_ASEReadCounter.table","NW_015090842.1:9868093",39,61,22
"ANKRD11","s1633_S_VTA_03_ASEReadCounter.table","NW_015090842.1:9868222",28,51,23
"ANKRD11","s1633_S_VTA_03_ASEReadCounter.table","NW_015090842.1:9868327",46,86,40
"ANKRD11","s1633_S_VTA_03_ASEReadCounter.table","NW_015090842.1:9868414",52,108,56
"ANKRD11","s1633_S_VTA_03_ASEReadCounter.table","NW_015090842.1:9868441",46,96,50
"ANKRD11","s1633_S_VTA_03_ASEReadCounter.table","NW_015090842.1:9868444",44,99,55
"ANKRD11","s1633_S_VTA_03_ASEReadCounter.table","NW_015090842.1:9868519",45,114,69
"ANKRD11","s1633_S_VTA_03_ASEReadCounter.table","NW_015090842.1:9868609",59,133,74
"ANKRD11","s1633_S_VTA_03_ASEReadCounter.table","NW_015090842.1:9868666",64,150,86
"ANKRD11","s1633_S_VTA_03_ASEReadCounter.table","NW_015090842.1:9869431",127,275,148
"ANKRD11","s1633_S_VTA_03_ASEReadCounter.table","NW_015090842.1:9869578",172,373,201
"ANKRD11","s1633_S_VTA_03_ASEReadCounter.table","NW_015090842.1:9869734",186,374,188
"ANKRD11","s1633_S_VTA_03_ASEReadCounter.table","NW_015090842.1:9870070",155,348,193
"ANKRD11","s1633_S_VTA_03_ASEReadCounter.table","NW_015090842.1:9870349",204,408,204
"ANKRD11","s1633_S_VTA_03_ASEReadCounter.table","NW_015090842.1:9870604",251,477,226
"ANKRD11","s1633_S_VTA_03_ASEReadCounter.table","NW_015090842.1:9870613",266,498,232
"ANKRD11","s1633_S_VTA_03_ASEReadCounter.table","NW_015090842.1:9870685",259,525,266
"ANKRD11","s1633_S_VTA_03_ASEReadCounter.table","NW_015090842.1:9870847",249,519,270
"ANKRD11","s1633_S_VTA_03_ASEReadCounter.table","NW_015090842.1:9871103",182,367,185
"ANKRD11","s1633_S_VTA_03_ASEReadCounter.table","NW_015090842.1:9871165",169,390,221
"ANKRD11","s1633_S_VTA_03_ASEReadCounter.table","NW_015090842.1:9871820",48,102,54
"ANKRD11","s1633_S_VTA_03_ASEReadCounter.table","NW_015090842.1:9871994",118,118,0
"ANKRD11","s1633_S_VTA_03_ASEReadCounter.table","NW_015090842.1:9872118",60,125,65
"SPG7","s1633_S_VTA_03_ASEReadCounter.table","NW_015090842.1:10051190",62,125,63
"SPG7","s1633_S_VTA_03_ASEReadCounter.table","NW_015090842.1:10051218",71,145,74
"SPG7","s1633_S_VTA_03_ASEReadCounter.table","NW_015090842.1:10052348",83,154,71
"SPG7","s1633_S_VTA_03_ASEReadCounter.table","NW_015090842.1:10052366",84,155,71
"SPG7","s1633_S_VTA_03_ASEReadCounter.table","NW_015090842.1:10065173",110,244,134
"SPG7","s1633_S_VTA_03_ASEReadCounter.table","NW_015090842.1:10065215",107,226,119
"SPG7","s1633_S_VTA_03_ASEReadCounter.table","NW_015090842.1:10066301",85,176,91
"SPG7","s1633_S_VTA_03_ASEReadCounter.table","NW_015090842.1:10066365",88,186,98
"SPG7","s1633_S_VTA_03_ASEReadCounter.table","NW_015090842.1:10069752",120,253,133
"SPG7","s1633_S_VTA_03_ASEReadCounter.table","NW_015090842.1:10069800",137,293,156
"SPG7","s1633_S_VTA_03_ASEReadCounter.table","NW_015090842.1:10071192",134,295,161
"SPG7","s1633_S_VTA_03_ASEReadCounter.table","NW_015090842.1:10071204",131,273,142
"SPG7","s1633_S_VTA_03_ASEReadCounter.table","NW_015090842.1:10071219",129,257,128
"SPG7","s1633_S_VTA_03_ASEReadCounter.table","NW_015090842.1:10071967",149,290,141
"SPG7","s1633_S_VTA_03_ASEReadCounter.table","NW_015090842.1:10075109",262,479,217
"SPG7","s1633_S_VTA_03_ASEReadCounter.table","NW_015090842.1:10075114",271,481,210
"SPG7","s1633_S_VTA_03_ASEReadCounter.table","NW_015090842.1:10075198",219,400,181
"SPG7","s1633_S_VTA_03_ASEReadCounter.table","NW_015090842.1:10075487",178,341,163
"SPG7","s1633_S_VTA_03_ASEReadCounter.table","NW_015090842.1:10075488",177,336,159
"SPG7","s1633_S_VTA_03_ASEReadCounter.table","NW_015090842.1:10075548",125,237,112
"RPL13","s1633_S_VTA_03_ASEReadCounter.table","NW_015090842.1:10076979",3,7,4
"RPL13","s1633_S_VTA_03_ASEReadCounter.table","NW_015090842.1:10077387",408,962,554
"RPL13","s1633_S_VTA_03_ASEReadCounter.table","NW_015090842.1:10077978",665,1409,744
"RPL13","s1633_S_VTA_03_ASEReadCounter.table","NW_015090842.1:10077992",669,1361,692
"CPNE7","s1633_S_VTA_03_ASEReadCounter.table","NW_015090842.1:10084001",5,5,0
"CPNE7","s1633_S_VTA_03_ASEReadCounter.table","NW_015090842.1:10084856",3,3,0
"CPNE7","s1633_S_VTA_03_ASEReadCounter.table","NW_015090842.1:10084872",3,3,0
"CPNE7","s1633_S_VTA_03_ASEReadCounter.table","NW_015090842.1:10084892",4,5,1
"CPNE7","s1633_S_VTA_03_ASEReadCounter.table","NW_015090842.1:10084921",2,3,1
"CPNE7","s1633_S_VTA_03_ASEReadCounter.table","NW_015090842.1:10084935",2,3,1
"CPNE7","s1633_S_VTA_03_ASEReadCounter.table","NW_015090842.1:10085000",7,7,0
"CPNE7","s1633_S_VTA_03_ASEReadCounter.table","NW_015090842.1:10085089",3,4,1
"CPNE7","s1633_S_VTA_03_ASEReadCounter.table","NW_015090842.1:10085096",2,3,1
"CPNE7","s1633_S_VTA_03_ASEReadCounter.table","NW_015090842.1:10085126",3,4,1
"CPNE7","s1633_S_VTA_03_ASEReadCounter.table","NW_015090842.1:10085180",4,5,1
"CPNE7","s1633_S_VTA_03_ASEReadCounter.table","NW_015090842.1:10085201",2,3,1
"CPNE7","s1633_S_VTA_03_ASEReadCounter.table","NW_015090842.1:10088134",5,8,3
"CPNE7","s1633_S_VTA_03_ASEReadCounter.table","NW_015090842.1:10088146",8,11,3
"CPNE7","s1633_S_VTA_03_ASEReadCounter.table","NW_015090842.1:10088940",6,10,4
"CPNE7","s1633_S_VTA_03_ASEReadCounter.table","NW_015090842.1:10088965",2,6,4
"CPNE7","s1633_S_VTA_03_ASEReadCounter.table","NW_015090842.1:10088967",2,6,4
"CPNE7","s1633_S_VTA_03_ASEReadCounter.table","NW_015090842.1:10088973",3,6,3
"CPNE7","s1633_S_VTA_03_ASEReadCounter.table","NW_015090842.1:10090924",20,24,4
"CPNE7","s1633_S_VTA_03_ASEReadCounter.table","NW_015090842.1:10090930",19,23,4
"CPNE7","s1633_S_VTA_03_ASEReadCounter.table","NW_015090842.1:10091075",19,23,4
"CPNE7","s1633_S_VTA_03_ASEReadCounter.table","NW_015090842.1:10091389",17,22,5
"CPNE7","s1633_S_VTA_03_ASEReadCounter.table","NW_015090842.1:10091407",18,24,6
"CPNE7","s1633_S_VTA_03_ASEReadCounter.table","NW_015090842.1:10091530",19,24,5
"CPNE7","s1633_S_VTA_03_ASEReadCounter.table","NW_015090842.1:10091875",19,28,9
"CPNE7","s1633_S_VTA_03_ASEReadCounter.table","NW_015090842.1:10091983",16,21,5
"CPNE7","s1633_S_VTA_03_ASEReadCounter.table","NW_015090842.1:10091997",16,22,6
"CPNE7","s1633_S_VTA_03_ASEReadCounter.table","NW_015090842.1:10092038",6,11,5
"CPNE7","s1633_S_VTA_03_ASEReadCounter.table","NW_015090842.1:10092140",14,24,10
"CPNE7","s1633_S_VTA_03_ASEReadCounter.table","NW_015090842.1:10092183",10,17,7
"CPNE7","s1633_S_VTA_03_ASEReadCounter.table","NW_015090842.1:10092201",10,17,7
"CPNE7","s1633_S_VTA_03_ASEReadCounter.table","NW_015090842.1:10092230",7,14,7
"CPNE7","s1633_S_VTA_03_ASEReadCounter.table","NW_015090842.1:10092246",6,10,4
"LOC106888185","s1633_S_VTA_03_ASEReadCounter.table","NW_015090842.1:10094965",2,6,4
"LOC106888185","s1633_S_VTA_03_ASEReadCounter.table","NW_015090842.1:10094966",3,7,4
"LOC106888185","s1633_S_VTA_03_ASEReadCounter.table","NW_015090842.1:10094985",3,8,5
"LOC106888185","s1633_S_VTA_03_ASEReadCounter.table","NW_015090842.1:10095055",1,7,6
"LOC106888185","s1633_S_VTA_03_ASEReadCounter.table","NW_015090842.1:10095062",1,6,5
"LOC106888185","s1633_S_VTA_03_ASEReadCounter.table","NW_015090842.1:10095130",1,4,3
"LOC106888185","s1633_S_VTA_03_ASEReadCounter.table","NW_015090842.1:10095265",5,18,13
"LOC106888185","s1633_S_VTA_03_ASEReadCounter.table","NW_015090842.1:10095586",10,21,11
"LOC106888185","s1633_S_VTA_03_ASEReadCounter.table","NW_015090842.1:10095593",10,21,11
"LOC106888185","s1633_S_VTA_03_ASEReadCounter.table","NW_015090842.1:10095616",6,16,10
"LOC106888185","s1633_S_VTA_03_ASEReadCounter.table","NW_015090842.1:10095662",4,11,7
"LOC106888185","s1633_S_VTA_03_ASEReadCounter.table","NW_015090842.1:10095674",3,10,7
"LOC106888185","s1633_S_VTA_03_ASEReadCounter.table","NW_015090842.1:10095786",4,7,3
"LOC106888185","s1633_S_VTA_03_ASEReadCounter.table","NW_015090842.1:10095831",7,15,8
"LOC106888185","s1633_S_VTA_03_ASEReadCounter.table","NW_015090842.1:10096230",3,13,10
"LOC106888185","s1633_S_VTA_03_ASEReadCounter.table","NW_015090842.1:10096249",6,15,9
"LOC106888185","s1633_S_VTA_03_ASEReadCounter.table","NW_015090842.1:10096272",5,14,9
"LOC106888185","s1633_S_VTA_03_ASEReadCounter.table","NW_015090842.1:10096288",5,12,7
"LOC106888185","s1633_S_VTA_03_ASEReadCounter.table","NW_015090842.1:10097248",4,10,6
"LOC106888185","s1633_S_VTA_03_ASEReadCounter.table","NW_015090842.1:10097265",4,12,8
"DPEP1","s1633_S_VTA_03_ASEReadCounter.table","NW_015090842.1:10098595",0,1,1
"DPEP1","s1633_S_VTA_03_ASEReadCounter.table","NW_015090842.1:10098597",0,1,1
"DPEP1","s1633_S_VTA_03_ASEReadCounter.table","NW_015090842.1:10098601",0,1,1
"DPEP1","s1633_S_VTA_03_ASEReadCounter.table","NW_015090842.1:10098608",0,1,1
"DPEP1","s1633_S_VTA_03_ASEReadCounter.table","NW_015090842.1:10098630",0,1,1
"DPEP1","s1633_S_VTA_03_ASEReadCounter.table","NW_015090842.1:10100044",0,1,1
"DPEP1","s1633_S_VTA_03_ASEReadCounter.table","NW_015090842.1:10100045",0,1,1
"DPEP1","s1633_S_VTA_03_ASEReadCounter.table","NW_015090842.1:10100084",0,1,1
"DPEP1","s1633_S_VTA_03_ASEReadCounter.table","NW_015090842.1:10100902",0,1,1
"DPEP1","s1633_S_VTA_03_ASEReadCounter.table","NW_015090842.1:10101072",0,1,1
"DPEP1","s1633_S_VTA_03_ASEReadCounter.table","NW_015090842.1:10101199",0,1,1
"DPEP1","s1633_S_VTA_03_ASEReadCounter.table","NW_015090842.1:10101483",0,2,2
"DPEP1","s1633_S_VTA_03_ASEReadCounter.table","NW_015090842.1:10101497",0,3,3
"DPEP1","s1633_S_VTA_03_ASEReadCounter.table","NW_015090842.1:10101525",0,2,2
"DPEP1","s1633_S_VTA_03_ASEReadCounter.table","NW_015090842.1:10101875",0,1,1
"CHMP1A","s1633_S_VTA_03_ASEReadCounter.table","NW_015090842.1:10102901",78,168,90
"CHMP1A","s1633_S_VTA_03_ASEReadCounter.table","NW_015090842.1:10102961",76,195,119
"CHMP1A","s1633_S_VTA_03_ASEReadCounter.table","NW_015090842.1:10102996",44,160,116
"CHMP1A","s1633_S_VTA_03_ASEReadCounter.table","NW_015090842.1:10103004",48,165,117
"CHMP1A","s1633_S_VTA_03_ASEReadCounter.table","NW_015090842.1:10103006",48,164,116
"CHMP1A","s1633_S_VTA_03_ASEReadCounter.table","NW_015090842.1:10103052",84,218,134
"CHMP1A","s1633_S_VTA_03_ASEReadCounter.table","NW_015090842.1:10103095",103,227,124
"CHMP1A","s1633_S_VTA_03_ASEReadCounter.table","NW_015090842.1:10103096",104,229,125
"CHMP1A","s1633_S_VTA_03_ASEReadCounter.table","NW_015090842.1:10103152",96,173,77
"CHMP1A","s1633_S_VTA_03_ASEReadCounter.table","NW_015090842.1:10103334",55,132,77
"CHMP1A","s1633_S_VTA_03_ASEReadCounter.table","NW_015090842.1:10103373",26,108,82
"CHMP1A","s1633_S_VTA_03_ASEReadCounter.table","NW_015090842.1:10103408",45,140,95
"CHMP1A","s1633_S_VTA_03_ASEReadCounter.table","NW_015090842.1:10103412",45,138,93
"CHMP1A","s1633_S_VTA_03_ASEReadCounter.table","NW_015090842.1:10103512",69,168,99
"CHMP1A","s1633_S_VTA_03_ASEReadCounter.table","NW_015090842.1:10103513",69,169,100
"CHMP1A","s1633_S_VTA_03_ASEReadCounter.table","NW_015090842.1:10103583",46,111,65
"CHMP1A","s1633_S_VTA_03_ASEReadCounter.table","NW_015090842.1:10103614",38,103,65
"CHMP1A","s1633_S_VTA_03_ASEReadCounter.table","NW_015090842.1:10103657",47,118,71
"CHMP1A","s1633_S_VTA_03_ASEReadCounter.table","NW_015090842.1:10103669",45,113,68
"CHMP1A","s1633_S_VTA_03_ASEReadCounter.table","NW_015090842.1:10103674",46,108,62
"CHMP1A","s1633_S_VTA_03_ASEReadCounter.table","NW_015090842.1:10103677",42,103,61
"CHMP1A","s1633_S_VTA_03_ASEReadCounter.table","NW_015090842.1:10103729",60,112,52
"CHMP1A","s1633_S_VTA_03_ASEReadCounter.table","NW_015090842.1:10103758",57,110,53
"CHMP1A","s1633_S_VTA_03_ASEReadCounter.table","NW_015090842.1:10103761",58,112,54
"CHMP1A","s1633_S_VTA_03_ASEReadCounter.table","NW_015090842.1:10103788",52,124,72
"CHMP1A","s1633_S_VTA_03_ASEReadCounter.table","NW_015090842.1:10103789",54,127,73
"CHMP1A","s1633_S_VTA_03_ASEReadCounter.table","NW_015090842.1:10103790",51,126,75
"CHMP1A","s1633_S_VTA_03_ASEReadCounter.table","NW_015090842.1:10103950",57,124,67
"CHMP1A","s1633_S_VTA_03_ASEReadCounter.table","NW_015090842.1:10104335",47,94,47
"CHMP1A","s1633_S_VTA_03_ASEReadCounter.table","NW_015090842.1:10104429",55,104,49
"CHMP1A","s1633_S_VTA_03_ASEReadCounter.table","NW_015090842.1:10104532",57,116,59
"CHMP1A","s1633_S_VTA_03_ASEReadCounter.table","NW_015090842.1:10104633",46,95,49
"CHMP1A","s1633_S_VTA_03_ASEReadCounter.table","NW_015090842.1:10104759",33,72,39
"CHMP1A","s1633_S_VTA_03_ASEReadCounter.table","NW_015090842.1:10104794",41,90,49
"CHMP1A","s1633_S_VTA_03_ASEReadCounter.table","NW_015090842.1:10104844",27,68,41
"CHMP1A","s1633_S_VTA_03_ASEReadCounter.table","NW_015090842.1:10106290",39,78,39
"CHMP1A","s1633_S_VTA_03_ASEReadCounter.table","NW_015090842.1:10106335",49,91,42
"CHMP1A","s1633_S_VTA_03_ASEReadCounter.table","NW_015090842.1:10106383",73,138,65
"CHMP1A","s1633_S_VTA_03_ASEReadCounter.table","NW_015090842.1:10106747",55,109,54
"CHMP1A","s1633_S_VTA_03_ASEReadCounter.table","NW_015090842.1:10107404",40,88,48
"CHMP1A","s1633_S_VTA_03_ASEReadCounter.table","NW_015090842.1:10107410",43,92,49
"CHMP1A","s1633_S_VTA_03_ASEReadCounter.table","NW_015090842.1:10107876",36,81,45
"CDK10","s1633_S_VTA_03_ASEReadCounter.table","NW_015090842.1:10109030",7,7,0
"CDK10","s1633_S_VTA_03_ASEReadCounter.table","NW_015090842.1:10109963",37,98,61
"CDK10","s1633_S_VTA_03_ASEReadCounter.table","NW_015090842.1:10110887",30,89,59
"CDK10","s1633_S_VTA_03_ASEReadCounter.table","NW_015090842.1:10111254",25,76,51
"CDK10","s1633_S_VTA_03_ASEReadCounter.table","NW_015090842.1:10111380",24,83,59
"CDK10","s1633_S_VTA_03_ASEReadCounter.table","NW_015090842.1:10111395",27,83,56
"CDK10","s1633_S_VTA_03_ASEReadCounter.table","NW_015090842.1:10111437",14,69,55
"CDK10","s1633_S_VTA_03_ASEReadCounter.table","NW_015090842.1:10111798",25,80,55
"CDK10","s1633_S_VTA_03_ASEReadCounter.table","NW_015090842.1:10111840",32,95,63
"CDK10","s1633_S_VTA_03_ASEReadCounter.table","NW_015090842.1:10112031",47,132,85
"CDK10","s1633_S_VTA_03_ASEReadCounter.table","NW_015090842.1:10112285",43,133,90
"CDK10","s1633_S_VTA_03_ASEReadCounter.table","NW_015090842.1:10112398",37,122,85
"CDK10","s1633_S_VTA_03_ASEReadCounter.table","NW_015090842.1:10112455",25,113,88
"CDK10","s1633_S_VTA_03_ASEReadCounter.table","NW_015090842.1:10112461",25,107,82
"CDK10","s1633_S_VTA_03_ASEReadCounter.table","NW_015090842.1:10112497",35,121,86
"CDK10","s1633_S_VTA_03_ASEReadCounter.table","NW_015090842.1:10112508",30,124,94
"CDK10","s1633_S_VTA_03_ASEReadCounter.table","NW_015090842.1:10112518",25,108,83
"CDK10","s1633_S_VTA_03_ASEReadCounter.table","NW_015090842.1:10112540",9,94,85
"CDK10","s1633_S_VTA_03_ASEReadCounter.table","NW_015090842.1:10112556",23,110,87
"CDK10","s1633_S_VTA_03_ASEReadCounter.table","NW_015090842.1:10112561",23,121,98
"CDK10","s1633_S_VTA_03_ASEReadCounter.table","NW_015090842.1:10112596",36,129,93
"CDK10","s1633_S_VTA_03_ASEReadCounter.table","NW_015090842.1:10112630",31,111,80
"CDK10","s1633_S_VTA_03_ASEReadCounter.table","NW_015090842.1:10112656",30,107,77
"CDK10","s1633_S_VTA_03_ASEReadCounter.table","NW_015090842.1:10112665",23,81,58
"CDK10","s1633_S_VTA_03_ASEReadCounter.table","NW_015090842.1:10112668",23,80,57
"CDK10","s1633_S_VTA_03_ASEReadCounter.table","NW_015090842.1:10112781",22,63,41
"CDK10","s1633_S_VTA_03_ASEReadCounter.table","NW_015090842.1:10112782",22,64,42
"CDK10","s1633_S_VTA_03_ASEReadCounter.table","NW_015090842.1:10112795",18,59,41
"CDK10","s1633_S_VTA_03_ASEReadCounter.table","NW_015090842.1:10112841",11,25,14
"CDK10","s1633_S_VTA_03_ASEReadCounter.table","NW_015090842.1:10112861",10,22,12
"SPATA2L","s1633_S_VTA_03_ASEReadCounter.table","NW_015090842.1:10113212",26,67,41
"SPATA2L","s1633_S_VTA_03_ASEReadCounter.table","NW_015090842.1:10113280",40,111,71
"SPATA2L","s1633_S_VTA_03_ASEReadCounter.table","NW_015090842.1:10113296",45,121,76
"SPATA2L","s1633_S_VTA_03_ASEReadCounter.table","NW_015090842.1:10113321",42,127,85
"SPATA2L","s1633_S_VTA_03_ASEReadCounter.table","NW_015090842.1:10113332",46,135,89
"SPATA2L","s1633_S_VTA_03_ASEReadCounter.table","NW_015090842.1:10113380",45,123,78
"SPATA2L","s1633_S_VTA_03_ASEReadCounter.table","NW_015090842.1:10113381",45,128,83
"SPATA2L","s1633_S_VTA_03_ASEReadCounter.table","NW_015090842.1:10113412",52,139,87
"SPATA2L","s1633_S_VTA_03_ASEReadCounter.table","NW_015090842.1:10113421",53,134,81
"SPATA2L","s1633_S_VTA_03_ASEReadCounter.table","NW_015090842.1:10113465",46,125,79
"SPATA2L","s1633_S_VTA_03_ASEReadCounter.table","NW_015090842.1:10113535",56,122,66
"SPATA2L","s1633_S_VTA_03_ASEReadCounter.table","NW_015090842.1:10113645",53,166,113
"SPATA2L","s1633_S_VTA_03_ASEReadCounter.table","NW_015090842.1:10113682",78,201,123
"SPATA2L","s1633_S_VTA_03_ASEReadCounter.table","NW_015090842.1:10113696",72,192,120
"SPATA2L","s1633_S_VTA_03_ASEReadCounter.table","NW_015090842.1:10113727",64,178,114
"SPATA2L","s1633_S_VTA_03_ASEReadCounter.table","NW_015090842.1:10113729",64,170,106
"SPATA2L","s1633_S_VTA_03_ASEReadCounter.table","NW_015090842.1:10113799",64,160,96
"SPATA2L","s1633_S_VTA_03_ASEReadCounter.table","NW_015090842.1:10113809",70,175,105
"SPATA2L","s1633_S_VTA_03_ASEReadCounter.table","NW_015090842.1:10113827",69,172,103
"SPATA2L","s1633_S_VTA_03_ASEReadCounter.table","NW_015090842.1:10113831",64,165,101
"SPATA2L","s1633_S_VTA_03_ASEReadCounter.table","NW_015090842.1:10113894",48,143,95
"SPATA2L","s1633_S_VTA_03_ASEReadCounter.table","NW_015090842.1:10113905",46,141,95
"SPATA2L","s1633_S_VTA_03_ASEReadCounter.table","NW_015090842.1:10113914",48,142,94
"SPATA2L","s1633_S_VTA_03_ASEReadCounter.table","NW_015090842.1:10113920",52,150,98
"SPATA2L","s1633_S_VTA_03_ASEReadCounter.table","NW_015090842.1:10113937",66,173,107
"SPATA2L","s1633_S_VTA_03_ASEReadCounter.table","NW_015090842.1:10113971",48,150,102
"SPATA2L","s1633_S_VTA_03_ASEReadCounter.table","NW_015090842.1:10113976",49,157,108
"SPATA2L","s1633_S_VTA_03_ASEReadCounter.table","NW_015090842.1:10113985",58,157,99
"SPATA2L","s1633_S_VTA_03_ASEReadCounter.table","NW_015090842.1:10113994",63,160,97
"SPATA2L","s1633_S_VTA_03_ASEReadCounter.table","NW_015090842.1:10114063",60,132,72
"SPATA2L","s1633_S_VTA_03_ASEReadCounter.table","NW_015090842.1:10114066",56,126,70
"SPATA2L","s1633_S_VTA_03_ASEReadCounter.table","NW_015090842.1:10114069",54,125,71
"SPATA2L","s1633_S_VTA_03_ASEReadCounter.table","NW_015090842.1:10114159",34,80,46
"SPATA2L","s1633_S_VTA_03_ASEReadCounter.table","NW_015090842.1:10114262",102,102,0
"SPATA2L","s1633_S_VTA_03_ASEReadCounter.table","NW_015090842.1:10114470",36,77,41
"SPATA2L","s1633_S_VTA_03_ASEReadCounter.table","NW_015090842.1:10114524",25,54,29
"VPS9D1","s1633_S_VTA_03_ASEReadCounter.table","NW_015090842.1:10116377",24,69,45
"VPS9D1","s1633_S_VTA_03_ASEReadCounter.table","NW_015090842.1:10116415",30,91,61
"VPS9D1","s1633_S_VTA_03_ASEReadCounter.table","NW_015090842.1:10116607",28,85,57
"VPS9D1","s1633_S_VTA_03_ASEReadCounter.table","NW_015090842.1:10116821",14,53,39
"VPS9D1","s1633_S_VTA_03_ASEReadCounter.table","NW_015090842.1:10116825",17,54,37
"VPS9D1","s1633_S_VTA_03_ASEReadCounter.table","NW_015090842.1:10116882",15,58,43
"VPS9D1","s1633_S_VTA_03_ASEReadCounter.table","NW_015090842.1:10116933",16,60,44
"VPS9D1","s1633_S_VTA_03_ASEReadCounter.table","NW_015090842.1:10116942",15,63,48
"VPS9D1","s1633_S_VTA_03_ASEReadCounter.table","NW_015090842.1:10117152",17,51,34
"VPS9D1","s1633_S_VTA_03_ASEReadCounter.table","NW_015090842.1:10117480",12,35,23
"VPS9D1","s1633_S_VTA_03_ASEReadCounter.table","NW_015090842.1:10117497",9,29,20
"VPS9D1","s1633_S_VTA_03_ASEReadCounter.table","NW_015090842.1:10117499",7,30,23
"VPS9D1","s1633_S_VTA_03_ASEReadCounter.table","NW_015090842.1:10117516",9,34,25
"VPS9D1","s1633_S_VTA_03_ASEReadCounter.table","NW_015090842.1:10117525",11,37,26
"VPS9D1","s1633_S_VTA_03_ASEReadCounter.table","NW_015090842.1:10117579",15,46,31
"VPS9D1","s1633_S_VTA_03_ASEReadCounter.table","NW_015090842.1:10117627",14,46,32
"VPS9D1","s1633_S_VTA_03_ASEReadCounter.table","NW_015090842.1:10117678",7,37,30
"VPS9D1","s1633_S_VTA_03_ASEReadCounter.table","NW_015090842.1:10117773",21,68,47
"VPS9D1","s1633_S_VTA_03_ASEReadCounter.table","NW_015090842.1:10117937",23,71,48
"VPS9D1","s1633_S_VTA_03_ASEReadCounter.table","NW_015090842.1:10117961",17,60,43
"VPS9D1","s1633_S_VTA_03_ASEReadCounter.table","NW_015090842.1:10118236",19,70,51
"VPS9D1","s1633_S_VTA_03_ASEReadCounter.table","NW_015090842.1:10118414",19,71,52
"VPS9D1","s1633_S_VTA_03_ASEReadCounter.table","NW_015090842.1:10118973",26,79,53
"VPS9D1","s1633_S_VTA_03_ASEReadCounter.table","NW_015090842.1:10119500",18,41,23
"ZNF276","s1633_S_VTA_03_ASEReadCounter.table","NW_015090842.1:10121760",2,4,2
"ZNF276","s1633_S_VTA_03_ASEReadCounter.table","NW_015090842.1:10121769",3,5,2
"ZNF276","s1633_S_VTA_03_ASEReadCounter.table","NW_015090842.1:10121802",4,8,4
"ZNF276","s1633_S_VTA_03_ASEReadCounter.table","NW_015090842.1:10121971",12,17,5
"ZNF276","s1633_S_VTA_03_ASEReadCounter.table","NW_015090842.1:10122161",9,9,0
"ZNF276","s1633_S_VTA_03_ASEReadCounter.table","NW_015090842.1:10122164",11,11,0
"ZNF276","s1633_S_VTA_03_ASEReadCounter.table","NW_015090842.1:10122184",8,8,0
"ZNF276","s1633_S_VTA_03_ASEReadCounter.table","NW_015090842.1:10122883",7,9,2
"ZNF276","s1633_S_VTA_03_ASEReadCounter.table","NW_015090842.1:10122997",11,18,7
"ZNF276","s1633_S_VTA_03_ASEReadCounter.table","NW_015090842.1:10123069",9,17,8
"ZNF276","s1633_S_VTA_03_ASEReadCounter.table","NW_015090842.1:10123207",19,42,23
"ZNF276","s1633_S_VTA_03_ASEReadCounter.table","NW_015090842.1:10125787",20,42,22
"ZNF276","s1633_S_VTA_03_ASEReadCounter.table","NW_015090842.1:10126309",13,39,26
"ZNF276","s1633_S_VTA_03_ASEReadCounter.table","NW_015090842.1:10126348",15,42,27
"ZNF276","s1633_S_VTA_03_ASEReadCounter.table","NW_015090842.1:10126978",20,59,39
"ZNF276","s1633_S_VTA_03_ASEReadCounter.table","NW_015090842.1:10126991",20,57,37
"ZNF276","s1633_S_VTA_03_ASEReadCounter.table","NW_015090842.1:10127023",21,54,33
"ZNF276","s1633_S_VTA_03_ASEReadCounter.table","NW_015090842.1:10127063",15,42,27
"ZNF276","s1633_S_VTA_03_ASEReadCounter.table","NW_015090842.1:10127373",18,48,30
"ZNF276","s1633_S_VTA_03_ASEReadCounter.table","NW_015090842.1:10127931",34,65,31
"ZNF276","s1633_S_VTA_03_ASEReadCounter.table","NW_015090842.1:10128070",29,68,39
"ZNF276","s1633_S_VTA_03_ASEReadCounter.table","NW_015090842.1:10128102",33,63,30
"ZNF276","s1633_S_VTA_03_ASEReadCounter.table","NW_015090842.1:10128356",17,60,43
"ZNF276","s1633_S_VTA_03_ASEReadCounter.table","NW_015090842.1:10128497",19,35,16
"FANCA","s1633_S_VTA_03_ASEReadCounter.table","NW_015090842.1:10128743",2,3,1
"FANCA","s1633_S_VTA_03_ASEReadCounter.table","NW_015090842.1:10128822",2,3,1
"FANCA","s1633_S_VTA_03_ASEReadCounter.table","NW_015090842.1:10129383",1,1,0
"FANCA","s1633_S_VTA_03_ASEReadCounter.table","NW_015090842.1:10129390",1,1,0
"FANCA","s1633_S_VTA_03_ASEReadCounter.table","NW_015090842.1:10129969",1,1,0
"FANCA","s1633_S_VTA_03_ASEReadCounter.table","NW_015090842.1:10130399",2,2,0
"FANCA","s1633_S_VTA_03_ASEReadCounter.table","NW_015090842.1:10130857",1,1,0
"FANCA","s1633_S_VTA_03_ASEReadCounter.table","NW_015090842.1:10130878",3,3,0
"FANCA","s1633_S_VTA_03_ASEReadCounter.table","NW_015090842.1:10133530",2,2,0
"FANCA","s1633_S_VTA_03_ASEReadCounter.table","NW_015090842.1:10133533",2,2,0
"FANCA","s1633_S_VTA_03_ASEReadCounter.table","NW_015090842.1:10133536",2,2,0
"FANCA","s1633_S_VTA_03_ASEReadCounter.table","NW_015090842.1:10133601",1,2,1
"FANCA","s1633_S_VTA_03_ASEReadCounter.table","NW_015090842.1:10138618",0,1,1
"FANCA","s1633_S_VTA_03_ASEReadCounter.table","NW_015090842.1:10139140",0,1,1
"FANCA","s1633_S_VTA_03_ASEReadCounter.table","NW_015090842.1:10158957",0,1,1
"FANCA","s1633_S_VTA_03_ASEReadCounter.table","NW_015090842.1:10160177",0,1,1
"SPIRE2","s1633_S_VTA_03_ASEReadCounter.table","NW_015090842.1:10172284",19,34,15
"SPIRE2","s1633_S_VTA_03_ASEReadCounter.table","NW_015090842.1:10175262",32,56,24
"SPIRE2","s1633_S_VTA_03_ASEReadCounter.table","NW_015090842.1:10175352",28,40,12
"SPIRE2","s1633_S_VTA_03_ASEReadCounter.table","NW_015090842.1:10175400",53,97,44
"SPIRE2","s1633_S_VTA_03_ASEReadCounter.table","NW_015090842.1:10175418",61,111,50
"SPIRE2","s1633_S_VTA_03_ASEReadCounter.table","NW_015090842.1:10175704",66,116,50
"SPIRE2","s1633_S_VTA_03_ASEReadCounter.table","NW_015090842.1:10176115",93,196,103
"SPIRE2","s1633_S_VTA_03_ASEReadCounter.table","NW_015090842.1:10176561",90,194,104
"SPIRE2","s1633_S_VTA_03_ASEReadCounter.table","NW_015090842.1:10176817",109,208,99
"SPIRE2","s1633_S_VTA_03_ASEReadCounter.table","NW_015090842.1:10177084",59,119,60
"SPIRE2","s1633_S_VTA_03_ASEReadCounter.table","NW_015090842.1:10177838",97,196,99
"SPIRE2","s1633_S_VTA_03_ASEReadCounter.table","NW_015090842.1:10178000",99,213,114
"SPIRE2","s1633_S_VTA_03_ASEReadCounter.table","NW_015090842.1:10178164",101,223,122
"SPIRE2","s1633_S_VTA_03_ASEReadCounter.table","NW_015090842.1:10178216",112,257,145
"SPIRE2","s1633_S_VTA_03_ASEReadCounter.table","NW_015090842.1:10178303",112,228,116
"SPIRE2","s1633_S_VTA_03_ASEReadCounter.table","NW_015090842.1:10178403",98,241,143
"SPIRE2","s1633_S_VTA_03_ASEReadCounter.table","NW_015090842.1:10178409",90,230,140
"SPIRE2","s1633_S_VTA_03_ASEReadCounter.table","NW_015090842.1:10178524",137,271,134
"SPIRE2","s1633_S_VTA_03_ASEReadCounter.table","NW_015090842.1:10178526",137,271,134
"SPIRE2","s1633_S_VTA_03_ASEReadCounter.table","NW_015090842.1:10178531",143,275,132
"SPIRE2","s1633_S_VTA_03_ASEReadCounter.table","NW_015090842.1:10178565",122,256,134
"SPIRE2","s1633_S_VTA_03_ASEReadCounter.table","NW_015090842.1:10178587",110,226,116
"SPIRE2","s1633_S_VTA_03_ASEReadCounter.table","NW_015090842.1:10178640",96,190,94
"SPIRE2","s1633_S_VTA_03_ASEReadCounter.table","NW_015090842.1:10178651",96,198,102
"SPIRE2","s1633_S_VTA_03_ASEReadCounter.table","NW_015090842.1:10178682",90,171,81
"TCF25","s1633_S_VTA_03_ASEReadCounter.table","NW_015090842.1:10180912",33,61,28
"TCF25","s1633_S_VTA_03_ASEReadCounter.table","NW_015090842.1:10180924",33,59,26
"TCF25","s1633_S_VTA_03_ASEReadCounter.table","NW_015090842.1:10180931",38,65,27
"TCF25","s1633_S_VTA_03_ASEReadCounter.table","NW_015090842.1:10185332",110,213,103
"TCF25","s1633_S_VTA_03_ASEReadCounter.table","NW_015090842.1:10196561",86,171,85
"TCF25","s1633_S_VTA_03_ASEReadCounter.table","NW_015090842.1:10197399",223,223,0
"MC1R","s1633_S_VTA_03_ASEReadCounter.table","NW_015090842.1:10201853",0,1,1
"MC1R","s1633_S_VTA_03_ASEReadCounter.table","NW_015090842.1:10201986",0,3,3
"MC1R","s1633_S_VTA_03_ASEReadCounter.table","NW_015090842.1:10202160",1,3,2
"MC1R","s1633_S_VTA_03_ASEReadCounter.table","NW_015090842.1:10202447",1,2,1
"TUBB3","s1633_S_VTA_03_ASEReadCounter.table","NW_015090842.1:10205322",0,346,346
"GAS8","s1633_S_VTA_03_ASEReadCounter.table","NW_015090842.1:10228982",10,21,11
"GAS8","s1633_S_VTA_03_ASEReadCounter.table","NW_015090842.1:10229832",15,22,7
"GAS8","s1633_S_VTA_03_ASEReadCounter.table","NW_015090842.1:10232901",45,71,26
"GAS8","s1633_S_VTA_03_ASEReadCounter.table","NW_015090842.1:10232928",42,73,31
"GAS8","s1633_S_VTA_03_ASEReadCounter.table","NW_015090842.1:10232967",38,75,37
"GAS8","s1633_S_VTA_03_ASEReadCounter.table","NW_015090842.1:10233032",24,51,27
"GAS8","s1633_S_VTA_03_ASEReadCounter.table","NW_015090842.1:10233057",25,46,21
"GAS8","s1633_S_VTA_03_ASEReadCounter.table","NW_015090842.1:10233058",25,47,22
"GAS8","s1633_S_VTA_03_ASEReadCounter.table","NW_015090842.1:10233176",20,41,21
"GAS8","s1633_S_VTA_03_ASEReadCounter.table","NW_015090842.1:10233196",16,36,20
"GAS8","s1633_S_VTA_03_ASEReadCounter.table","NW_015090842.1:10233252",10,23,13
"GAS8","s1633_S_VTA_03_ASEReadCounter.table","NW_015090842.1:10233303",6,14,8
"LOC106888094","s1633_S_VTA_03_ASEReadCounter.table","NW_015090842.1:10233334",5,12,7
"LOC106888094","s1633_S_VTA_03_ASEReadCounter.table","NW_015090842.1:10233362",7,19,12
"LOC106888094","s1633_S_VTA_03_ASEReadCounter.table","NW_015090842.1:10233373",7,21,14
"LOC106888094","s1633_S_VTA_03_ASEReadCounter.table","NW_015090842.1:10233388",10,26,16
"LOC106888094","s1633_S_VTA_03_ASEReadCounter.table","NW_015090842.1:10233402",12,26,14
"LOC106888094","s1633_S_VTA_03_ASEReadCounter.table","NW_015090842.1:10233465",16,45,29
"LOC106888094","s1633_S_VTA_03_ASEReadCounter.table","NW_015090842.1:10233803",17,50,33
"LOC106888094","s1633_S_VTA_03_ASEReadCounter.table","NW_015090842.1:10233815",17,47,30
"LOC106888094","s1633_S_VTA_03_ASEReadCounter.table","NW_015090842.1:10235484",2,6,4
"LOC106888094","s1633_S_VTA_03_ASEReadCounter.table","NW_015090842.1:10235611",1,3,2
"LOC106888094","s1633_S_VTA_03_ASEReadCounter.table","NW_015090842.1:10235977",8,8,0
"LOC106888094","s1633_S_VTA_03_ASEReadCounter.table","NW_015090842.1:10236098",3,5,2
"LOC106888094","s1633_S_VTA_03_ASEReadCounter.table","NW_015090842.1:10236161",0,2,2
"LOC106888094","s1633_S_VTA_03_ASEReadCounter.table","NW_015090842.1:10236425",0,1,1
"LOC106888094","s1633_S_VTA_03_ASEReadCounter.table","NW_015090842.1:10236426",0,1,1
"LOC106888094","s1633_S_VTA_03_ASEReadCounter.table","NW_015090842.1:10236603",0,1,1
"LOC106888173","s1633_S_VTA_03_ASEReadCounter.table","NW_015090842.1:10239596",3,13,10
"LOC106888173","s1633_S_VTA_03_ASEReadCounter.table","NW_015090842.1:10240036",6,28,22
"LOC106888173","s1633_S_VTA_03_ASEReadCounter.table","NW_015090842.1:10240095",10,30,20
"LOC106888173","s1633_S_VTA_03_ASEReadCounter.table","NW_015090842.1:10240280",14,43,29
"LOC106888173","s1633_S_VTA_03_ASEReadCounter.table","NW_015090842.1:10240557",13,40,27
"LOC106888173","s1633_S_VTA_03_ASEReadCounter.table","NW_015090842.1:10240603",14,46,32
"LOC106888173","s1633_S_VTA_03_ASEReadCounter.table","NW_015090842.1:10240609",13,46,33
"LOC106888173","s1633_S_VTA_03_ASEReadCounter.table","NW_015090842.1:10240924",9,43,34
"LOC106888173","s1633_S_VTA_03_ASEReadCounter.table","NW_015090842.1:10241037",6,44,38
"LOC106888173","s1633_S_VTA_03_ASEReadCounter.table","NW_015090842.1:10241046",8,50,42
"LOC106888173","s1633_S_VTA_03_ASEReadCounter.table","NW_015090842.1:10241058",8,46,38
"LOC106888173","s1633_S_VTA_03_ASEReadCounter.table","NW_015090842.1:10241064",9,42,33
"LOC106888173","s1633_S_VTA_03_ASEReadCounter.table","NW_015090842.1:10241163",12,51,39
"LOC106888173","s1633_S_VTA_03_ASEReadCounter.table","NW_015090842.1:10241803",10,42,32
"LOC106888173","s1633_S_VTA_03_ASEReadCounter.table","NW_015090842.1:10241827",5,35,30
"LOC106888173","s1633_S_VTA_03_ASEReadCounter.table","NW_015090842.1:10241869",12,38,26
"LOC106888173","s1633_S_VTA_03_ASEReadCounter.table","NW_015090842.1:10242079",17,44,27
"LOC106888173","s1633_S_VTA_03_ASEReadCounter.table","NW_015090842.1:10242103",18,48,30
"LOC106888173","s1633_S_VTA_03_ASEReadCounter.table","NW_015090842.1:10242157",11,48,37
"LOC106888173","s1633_S_VTA_03_ASEReadCounter.table","NW_015090842.1:10242455",15,52,37
"LOC106888173","s1633_S_VTA_03_ASEReadCounter.table","NW_015090842.1:10242481",17,63,46
"LOC106888173","s1633_S_VTA_03_ASEReadCounter.table","NW_015090842.1:10242590",14,46,32
"LOC106888173","s1633_S_VTA_03_ASEReadCounter.table","NW_015090842.1:10242794",14,37,23
"LOC106888173","s1633_S_VTA_03_ASEReadCounter.table","NW_015090842.1:10242909",9,46,37
"LOC106888173","s1633_S_VTA_03_ASEReadCounter.table","NW_015090842.1:10243094",18,53,35
"LOC106888173","s1633_S_VTA_03_ASEReadCounter.table","NW_015090842.1:10243133",10,44,34
"LOC106888173","s1633_S_VTA_03_ASEReadCounter.table","NW_015090842.1:10243273",18,58,40
"LOC106888173","s1633_S_VTA_03_ASEReadCounter.table","NW_015090842.1:10243278",19,65,46
"LOC106888173","s1633_S_VTA_03_ASEReadCounter.table","NW_015090842.1:10243281",18,63,45
"LOC106888173","s1633_S_VTA_03_ASEReadCounter.table","NW_015090842.1:10243347",39,39,0
"LOC106888173","s1633_S_VTA_03_ASEReadCounter.table","NW_015090842.1:10243353",8,34,26
"LOC106888173","s1633_S_VTA_03_ASEReadCounter.table","NW_015090842.1:10243363",7,25,18
"LOC106888173","s1633_S_VTA_03_ASEReadCounter.table","NW_015090842.1:10243365",7,26,19
"LOC106888173","s1633_S_VTA_03_ASEReadCounter.table","NW_015090842.1:10243529",17,52,35
"LOC106888173","s1633_S_VTA_03_ASEReadCounter.table","NW_015090842.1:10243566",27,70,43
"LOC106888173","s1633_S_VTA_03_ASEReadCounter.table","NW_015090842.1:10243605",23,65,42
"LOC106888173","s1633_S_VTA_03_ASEReadCounter.table","NW_015090842.1:10243614",21,61,40
"LOC106888173","s1633_S_VTA_03_ASEReadCounter.table","NW_015090842.1:10243615",21,61,40
"LOC106888173","s1633_S_VTA_03_ASEReadCounter.table","NW_015090842.1:10243640",16,56,40
"LOC106888173","s1633_S_VTA_03_ASEReadCounter.table","NW_015090842.1:10243680",9,50,41
"LOC106888173","s1633_S_VTA_03_ASEReadCounter.table","NW_015090842.1:10243742",25,65,40
"LOC106888173","s1633_S_VTA_03_ASEReadCounter.table","NW_015090842.1:10243804",20,42,22
"LOC106888173","s1633_S_VTA_03_ASEReadCounter.table","NW_015090842.1:10243913",8,18,10
"LOC106888173","s1633_S_VTA_03_ASEReadCounter.table","NW_015090842.1:10243921",8,17,9
"LOC106888384","s1633_S_VTA_03_ASEReadCounter.table","NW_015090842.1:10244998",1,1,0
"LOC106888384","s1633_S_VTA_03_ASEReadCounter.table","NW_015090842.1:10251343",1,1,0
"LOC106888384","s1633_S_VTA_03_ASEReadCounter.table","NW_015090842.1:10251344",1,1,0
"LOC106888384","s1633_S_VTA_03_ASEReadCounter.table","NW_015090842.1:10251349",1,1,0
"LOC106888384","s1633_S_VTA_03_ASEReadCounter.table","NW_015090842.1:10251354",1,4,3
"LOC106888384","s1633_S_VTA_03_ASEReadCounter.table","NW_015090842.1:10251358",1,4,3
"LOC106888384","s1633_S_VTA_03_ASEReadCounter.table","NW_015090842.1:10251369",1,4,3
"LOC106888384","s1633_S_VTA_03_ASEReadCounter.table","NW_015090842.1:10251370",1,4,3
"LOC106888384","s1633_S_VTA_03_ASEReadCounter.table","NW_015090842.1:10251375",1,4,3
"LOC106888384","s1633_S_VTA_03_ASEReadCounter.table","NW_015090842.1:10251388",0,3,3
"LOC106888384","s1633_S_VTA_03_ASEReadCounter.table","NW_015090842.1:10251390",0,3,3
"LOC106888384","s1633_S_VTA_03_ASEReadCounter.table","NW_015090842.1:10251393",0,3,3
"LOC106888384","s1633_S_VTA_03_ASEReadCounter.table","NW_015090842.1:10251399",0,3,3
"LOC106888384","s1633_S_VTA_03_ASEReadCounter.table","NW_015090842.1:10253284",1,1,0
"LOC106888384","s1633_S_VTA_03_ASEReadCounter.table","NW_015090842.1:10253605",1,1,0
"LOC106888384","s1633_S_VTA_03_ASEReadCounter.table","NW_015090842.1:10254028",2,2,0
"LOC106888384","s1633_S_VTA_03_ASEReadCounter.table","NW_015090842.1:10254263",1,1,0
"LOC106888384","s1633_S_VTA_03_ASEReadCounter.table","NW_015090842.1:10254293",1,2,1
"LOC106888384","s1633_S_VTA_03_ASEReadCounter.table","NW_015090842.1:10254570",1,3,2
"LOC106888384","s1633_S_VTA_03_ASEReadCounter.table","NW_015090842.1:10254647",1,2,1
"LOC106888384","s1633_S_VTA_03_ASEReadCounter.table","NW_015090842.1:10254663",1,2,1
"LOC106888384","s1633_S_VTA_03_ASEReadCounter.table","NW_015090842.1:10254840",0,1,1
"LOC106888384","s1633_S_VTA_03_ASEReadCounter.table","NW_015090842.1:10254854",2,2,0
"LOC106888384","s1633_S_VTA_03_ASEReadCounter.table","NW_015090842.1:10254891",3,3,0
"LOC106888384","s1633_S_VTA_03_ASEReadCounter.table","NW_015090842.1:10254900",2,3,1
"LOC106888384","s1633_S_VTA_03_ASEReadCounter.table","NW_015090842.1:10254915",2,3,1
"LOC106888384","s1633_S_VTA_03_ASEReadCounter.table","NW_015090842.1:10254965",1,1,0
"LOC106888384","s1633_S_VTA_03_ASEReadCounter.table","NW_015090842.1:10254975",1,1,0
"LOC106888384","s1633_S_VTA_03_ASEReadCounter.table","NW_015090842.1:10255306",1,2,1
"LOC106888384","s1633_S_VTA_03_ASEReadCounter.table","NW_015090842.1:10255340",3,4,1
"LOC106888384","s1633_S_VTA_03_ASEReadCounter.table","NW_015090842.1:10255410",7,8,1
"LOC106888384","s1633_S_VTA_03_ASEReadCounter.table","NW_015090842.1:10255449",6,7,1
"LOC106888384","s1633_S_VTA_03_ASEReadCounter.table","NW_015090842.1:10255496",6,6,0
"LOC106888384","s1633_S_VTA_03_ASEReadCounter.table","NW_015090842.1:10255505",4,4,0
"LOC106888384","s1633_S_VTA_03_ASEReadCounter.table","NW_015090842.1:10255531",5,5,0
"LOC106888384","s1633_S_VTA_03_ASEReadCounter.table","NW_015090842.1:10255608",6,7,1
"LOC106888384","s1633_S_VTA_03_ASEReadCounter.table","NW_015090842.1:10255614",5,7,2
"LOC106888384","s1633_S_VTA_03_ASEReadCounter.table","NW_015090842.1:10255704",4,6,2
"LOC106888384","s1633_S_VTA_03_ASEReadCounter.table","NW_015090842.1:10255731",4,5,1
"LOC106888384","s1633_S_VTA_03_ASEReadCounter.table","NW_015090842.1:10255771",3,4,1
"TANGO6","s1633_S_VTA_03_ASEReadCounter.table","NW_015090842.1:10257782",2,2,0
"TANGO6","s1633_S_VTA_03_ASEReadCounter.table","NW_015090842.1:10258162",6,12,6
"TANGO6","s1633_S_VTA_03_ASEReadCounter.table","NW_015090842.1:10258185",7,13,6
"TANGO6","s1633_S_VTA_03_ASEReadCounter.table","NW_015090842.1:10259267",12,16,4
"TANGO6","s1633_S_VTA_03_ASEReadCounter.table","NW_015090842.1:10260250",37,47,10
"TANGO6","s1633_S_VTA_03_ASEReadCounter.table","NW_015090842.1:10260979",24,39,15
"TANGO6","s1633_S_VTA_03_ASEReadCounter.table","NW_015090842.1:10261599",30,44,14
"TANGO6","s1633_S_VTA_03_ASEReadCounter.table","NW_015090842.1:10268425",39,59,20
"TANGO6","s1633_S_VTA_03_ASEReadCounter.table","NW_015090842.1:10269831",24,37,13
"TANGO6","s1633_S_VTA_03_ASEReadCounter.table","NW_015090842.1:10270813",16,25,9
"TANGO6","s1633_S_VTA_03_ASEReadCounter.table","NW_015090842.1:10273952",27,46,19
"TANGO6","s1633_S_VTA_03_ASEReadCounter.table","NW_015090842.1:10273970",33,51,18
"TANGO6","s1633_S_VTA_03_ASEReadCounter.table","NW_015090842.1:10274018",29,42,13
"TANGO6","s1633_S_VTA_03_ASEReadCounter.table","NW_015090842.1:10275974",47,57,10
"TANGO6","s1633_S_VTA_03_ASEReadCounter.table","NW_015090842.1:10275976",45,55,10
"TANGO6","s1633_S_VTA_03_ASEReadCounter.table","NW_015090842.1:10276123",42,52,10
"TANGO6","s1633_S_VTA_03_ASEReadCounter.table","NW_015090842.1:10276271",42,61,19
"TANGO6","s1633_S_VTA_03_ASEReadCounter.table","NW_015090842.1:10276272",40,59,19
"TANGO6","s1633_S_VTA_03_ASEReadCounter.table","NW_015090842.1:10276275",44,61,17
"TANGO6","s1633_S_VTA_03_ASEReadCounter.table","NW_015090842.1:10276278",46,63,17
"TANGO6","s1633_S_VTA_03_ASEReadCounter.table","NW_015090842.1:10276368",36,49,13
"TANGO6","s1633_S_VTA_03_ASEReadCounter.table","NW_015090842.1:10276373",35,50,15
"TANGO6","s1633_S_VTA_03_ASEReadCounter.table","NW_015090842.1:10276630",40,61,21
"TANGO6","s1633_S_VTA_03_ASEReadCounter.table","NW_015090842.1:10281498",42,66,24
"TANGO6","s1633_S_VTA_03_ASEReadCounter.table","NW_015090842.1:10282842",56,74,18
"TANGO6","s1633_S_VTA_03_ASEReadCounter.table","NW_015090842.1:10282863",40,58,18
"TANGO6","s1633_S_VTA_03_ASEReadCounter.table","NW_015090842.1:10282869",40,59,19
"TANGO6","s1633_S_VTA_03_ASEReadCounter.table","NW_015090842.1:10282903",38,58,20
"TANGO6","s1633_S_VTA_03_ASEReadCounter.table","NW_015090842.1:10283757",71,90,19
"TANGO6","s1633_S_VTA_03_ASEReadCounter.table","NW_015090842.1:10283785",65,85,20
"HAS3","s1633_S_VTA_03_ASEReadCounter.table","NW_015090842.1:10288093",1,1,0
"HAS3","s1633_S_VTA_03_ASEReadCounter.table","NW_015090842.1:10288364",1,2,1
"HAS3","s1633_S_VTA_03_ASEReadCounter.table","NW_015090842.1:10288405",1,2,1
"HAS3","s1633_S_VTA_03_ASEReadCounter.table","NW_015090842.1:10289469",1,4,3
"HAS3","s1633_S_VTA_03_ASEReadCounter.table","NW_015090842.1:10289708",1,1,0
"HAS3","s1633_S_VTA_03_ASEReadCounter.table","NW_015090842.1:10290375",2,2,0
"HAS3","s1633_S_VTA_03_ASEReadCounter.table","NW_015090842.1:10290395",2,2,0
"HAS3","s1633_S_VTA_03_ASEReadCounter.table","NW_015090842.1:10290561",2,3,1
"HAS3","s1633_S_VTA_03_ASEReadCounter.table","NW_015090842.1:10290609",1,2,1
"HAS3","s1633_S_VTA_03_ASEReadCounter.table","NW_015090842.1:10290927",2,3,1
"HAS3","s1633_S_VTA_03_ASEReadCounter.table","NW_015090842.1:10291004",2,2,0
"CHTF8","s1633_S_VTA_03_ASEReadCounter.table","NW_015090842.1:10291319",5,8,3
"CHTF8","s1633_S_VTA_03_ASEReadCounter.table","NW_015090842.1:10291342",4,6,2
"CHTF8","s1633_S_VTA_03_ASEReadCounter.table","NW_015090842.1:10291491",8,9,1
"CHTF8","s1633_S_VTA_03_ASEReadCounter.table","NW_015090842.1:10291520",6,8,2
"CHTF8","s1633_S_VTA_03_ASEReadCounter.table","NW_015090842.1:10291593",11,17,6
"CHTF8","s1633_S_VTA_03_ASEReadCounter.table","NW_015090842.1:10291600",9,16,7
"CHTF8","s1633_S_VTA_03_ASEReadCounter.table","NW_015090842.1:10291609",10,15,5
"CHTF8","s1633_S_VTA_03_ASEReadCounter.table","NW_015090842.1:10291639",11,16,5
"CHTF8","s1633_S_VTA_03_ASEReadCounter.table","NW_015090842.1:10291641",10,15,5
"CHTF8","s1633_S_VTA_03_ASEReadCounter.table","NW_015090842.1:10291648",11,17,6
"CHTF8","s1633_S_VTA_03_ASEReadCounter.table","NW_015090842.1:10291656",11,18,7
"CHTF8","s1633_S_VTA_03_ASEReadCounter.table","NW_015090842.1:10291675",9,17,8
"CHTF8","s1633_S_VTA_03_ASEReadCounter.table","NW_015090842.1:10291696",8,17,9
"CHTF8","s1633_S_VTA_03_ASEReadCounter.table","NW_015090842.1:10291714",6,17,11
"CHTF8","s1633_S_VTA_03_ASEReadCounter.table","NW_015090842.1:10291732",6,19,13
"CHTF8","s1633_S_VTA_03_ASEReadCounter.table","NW_015090842.1:10291755",4,17,13
"CHTF8","s1633_S_VTA_03_ASEReadCounter.table","NW_015090842.1:10291756",4,17,13
"CHTF8","s1633_S_VTA_03_ASEReadCounter.table","NW_015090842.1:10291758",4,18,14
"CHTF8","s1633_S_VTA_03_ASEReadCounter.table","NW_015090842.1:10291792",7,18,11
"CHTF8","s1633_S_VTA_03_ASEReadCounter.table","NW_015090842.1:10291895",11,21,10
"CHTF8","s1633_S_VTA_03_ASEReadCounter.table","NW_015090842.1:10292132",6,13,7
"CHTF8","s1633_S_VTA_03_ASEReadCounter.table","NW_015090842.1:10292314",8,12,4
"CHTF8","s1633_S_VTA_03_ASEReadCounter.table","NW_015090842.1:10292317",8,12,4
"CHTF8","s1633_S_VTA_03_ASEReadCounter.table","NW_015090842.1:10292928",3,3,0
"UTP4","s1633_S_VTA_03_ASEReadCounter.table","NW_015090842.1:10293146",9,14,5
"UTP4","s1633_S_VTA_03_ASEReadCounter.table","NW_015090842.1:10293151",9,15,6
"UTP4","s1633_S_VTA_03_ASEReadCounter.table","NW_015090842.1:10293191",7,14,7
"UTP4","s1633_S_VTA_03_ASEReadCounter.table","NW_015090842.1:10293362",6,17,11
"UTP4","s1633_S_VTA_03_ASEReadCounter.table","NW_015090842.1:10293430",6,14,8
"UTP4","s1633_S_VTA_03_ASEReadCounter.table","NW_015090842.1:10293625",2,9,7
"UTP4","s1633_S_VTA_03_ASEReadCounter.table","NW_015090842.1:10293684",3,8,5
"UTP4","s1633_S_VTA_03_ASEReadCounter.table","NW_015090842.1:10294093",7,17,10
"UTP4","s1633_S_VTA_03_ASEReadCounter.table","NW_015090842.1:10294568",10,22,12
"UTP4","s1633_S_VTA_03_ASEReadCounter.table","NW_015090842.1:10294622",8,21,13
"UTP4","s1633_S_VTA_03_ASEReadCounter.table","NW_015090842.1:10294632",9,24,15
"UTP4","s1633_S_VTA_03_ASEReadCounter.table","NW_015090842.1:10295238",10,20,10
"UTP4","s1633_S_VTA_03_ASEReadCounter.table","NW_015090842.1:10295880",10,19,9
"UTP4","s1633_S_VTA_03_ASEReadCounter.table","NW_015090842.1:10295884",10,20,10
"UTP4","s1633_S_VTA_03_ASEReadCounter.table","NW_015090842.1:10295903",12,21,9
"UTP4","s1633_S_VTA_03_ASEReadCounter.table","NW_015090842.1:10295906",13,21,8
"UTP4","s1633_S_VTA_03_ASEReadCounter.table","NW_015090842.1:10295915",15,25,10
"UTP4","s1633_S_VTA_03_ASEReadCounter.table","NW_015090842.1:10295938",14,24,10
"UTP4","s1633_S_VTA_03_ASEReadCounter.table","NW_015090842.1:10296175",7,22,15
"UTP4","s1633_S_VTA_03_ASEReadCounter.table","NW_015090842.1:10296660",9,23,14
"UTP4","s1633_S_VTA_03_ASEReadCounter.table","NW_015090842.1:10296679",10,20,10
"UTP4","s1633_S_VTA_03_ASEReadCounter.table","NW_015090842.1:10297193",30,57,27
"UTP4","s1633_S_VTA_03_ASEReadCounter.table","NW_015090842.1:10297220",29,54,25
"UTP4","s1633_S_VTA_03_ASEReadCounter.table","NW_015090842.1:10297307",37,59,22
"UTP4","s1633_S_VTA_03_ASEReadCounter.table","NW_015090842.1:10297558",30,54,24
"UTP4","s1633_S_VTA_03_ASEReadCounter.table","NW_015090842.1:10297943",23,46,23
"UTP4","s1633_S_VTA_03_ASEReadCounter.table","NW_015090842.1:10297979",15,39,24
"UTP4","s1633_S_VTA_03_ASEReadCounter.table","NW_015090842.1:10298022",6,22,16
"UTP4","s1633_S_VTA_03_ASEReadCounter.table","NW_015090842.1:10298079",3,8,5
"UTP4","s1633_S_VTA_03_ASEReadCounter.table","NW_015090842.1:10298081",3,8,5
"UTP4","s1633_S_VTA_03_ASEReadCounter.table","NW_015090842.1:10298082",2,7,5
"SNTB2","s1633_S_VTA_03_ASEReadCounter.table","NW_015090842.1:10298928",1,2,1
"SNTB2","s1633_S_VTA_03_ASEReadCounter.table","NW_015090842.1:10303506",0,1,1
"SNTB2","s1633_S_VTA_03_ASEReadCounter.table","NW_015090842.1:10303524",1,2,1
"SNTB2","s1633_S_VTA_03_ASEReadCounter.table","NW_015090842.1:10304059",3,5,2
"SNTB2","s1633_S_VTA_03_ASEReadCounter.table","NW_015090842.1:10304089",2,4,2
"SNTB2","s1633_S_VTA_03_ASEReadCounter.table","NW_015090842.1:10305069",1,2,1
"SNTB2","s1633_S_VTA_03_ASEReadCounter.table","NW_015090842.1:10305099",0,1,1
"SNTB2","s1633_S_VTA_03_ASEReadCounter.table","NW_015090842.1:10305451",1,2,1
"SNTB2","s1633_S_VTA_03_ASEReadCounter.table","NW_015090842.1:10305547",2,3,1
"SNTB2","s1633_S_VTA_03_ASEReadCounter.table","NW_015090842.1:10305847",5,6,1
"SNTB2","s1633_S_VTA_03_ASEReadCounter.table","NW_015090842.1:10305911",3,4,1
"SNTB2","s1633_S_VTA_03_ASEReadCounter.table","NW_015090842.1:10306173",3,3,0
"SNTB2","s1633_S_VTA_03_ASEReadCounter.table","NW_015090842.1:10306275",3,3,0
"SNTB2","s1633_S_VTA_03_ASEReadCounter.table","NW_015090842.1:10306457",3,4,1
"SNTB2","s1633_S_VTA_03_ASEReadCounter.table","NW_015090842.1:10306496",2,3,1
"SNTB2","s1633_S_VTA_03_ASEReadCounter.table","NW_015090842.1:10306499",2,3,1
"VPS4A","s1633_S_VTA_03_ASEReadCounter.table","NW_015090842.1:10308566",73,146,73
"VPS4A","s1633_S_VTA_03_ASEReadCounter.table","NW_015090842.1:10308573",73,154,81
"VPS4A","s1633_S_VTA_03_ASEReadCounter.table","NW_015090842.1:10308856",88,221,133
"VPS4A","s1633_S_VTA_03_ASEReadCounter.table","NW_015090842.1:10309056",123,282,159
"VPS4A","s1633_S_VTA_03_ASEReadCounter.table","NW_015090842.1:10309089",155,336,181
"VPS4A","s1633_S_VTA_03_ASEReadCounter.table","NW_015090842.1:10309392",134,299,165
"VPS4A","s1633_S_VTA_03_ASEReadCounter.table","NW_015090842.1:10309413",133,298,165
"VPS4A","s1633_S_VTA_03_ASEReadCounter.table","NW_015090842.1:10309467",140,328,188
"VPS4A","s1633_S_VTA_03_ASEReadCounter.table","NW_015090842.1:10310230",189,423,234
"VPS4A","s1633_S_VTA_03_ASEReadCounter.table","NW_015090842.1:10310425",163,350,187
"VPS4A","s1633_S_VTA_03_ASEReadCounter.table","NW_015090842.1:10310639",182,400,218
"VPS4A","s1633_S_VTA_03_ASEReadCounter.table","NW_015090842.1:10310640",398,398,0
"VPS4A","s1633_S_VTA_03_ASEReadCounter.table","NW_015090842.1:10310687",191,411,220
"VPS4A","s1633_S_VTA_03_ASEReadCounter.table","NW_015090842.1:10310734",170,350,180
"VPS4A","s1633_S_VTA_03_ASEReadCounter.table","NW_015090842.1:10310737",170,348,178
"VPS4A","s1633_S_VTA_03_ASEReadCounter.table","NW_015090842.1:10310746",189,360,171
"VPS4A","s1633_S_VTA_03_ASEReadCounter.table","NW_015090842.1:10310767",185,361,176
"VPS4A","s1633_S_VTA_03_ASEReadCounter.table","NW_015090842.1:10310995",177,392,215
"VPS4A","s1633_S_VTA_03_ASEReadCounter.table","NW_015090842.1:10311004",175,384,209
"VPS4A","s1633_S_VTA_03_ASEReadCounter.table","NW_015090842.1:10311007",173,391,218
"VPS4A","s1633_S_VTA_03_ASEReadCounter.table","NW_015090842.1:10311013",190,409,219
"VPS4A","s1633_S_VTA_03_ASEReadCounter.table","NW_015090842.1:10311022",177,397,220
"VPS4A","s1633_S_VTA_03_ASEReadCounter.table","NW_015090842.1:10311023",177,392,215
"VPS4A","s1633_S_VTA_03_ASEReadCounter.table","NW_015090842.1:10311426",169,398,229
"VPS4A","s1633_S_VTA_03_ASEReadCounter.table","NW_015090842.1:10311489",4,16,12
"VPS4A","s1633_S_VTA_03_ASEReadCounter.table","NW_015090842.1:10311490",3,12,9
"VPS4A","s1633_S_VTA_03_ASEReadCounter.table","NW_015090842.1:10311525",7,17,10
"VPS4A","s1633_S_VTA_03_ASEReadCounter.table","NW_015090842.1:10311529",7,26,19
"VPS4A","s1633_S_VTA_03_ASEReadCounter.table","NW_015090842.1:10311530",7,29,22
"VPS4A","s1633_S_VTA_03_ASEReadCounter.table","NW_015090842.1:10311552",26,53,27
"VPS4A","s1633_S_VTA_03_ASEReadCounter.table","NW_015090842.1:10311689",20,48,28
"VPS4A","s1633_S_VTA_03_ASEReadCounter.table","NW_015090842.1:10311700",30,54,24
"VPS4A","s1633_S_VTA_03_ASEReadCounter.table","NW_015090842.1:10311701",28,50,22
"VPS4A","s1633_S_VTA_03_ASEReadCounter.table","NW_015090842.1:10311703",29,55,26
"COG8","s1633_S_VTA_03_ASEReadCounter.table","NW_015090842.1:10313487",20,41,21
"COG8","s1633_S_VTA_03_ASEReadCounter.table","NW_015090842.1:10313559",24,45,21
"COG8","s1633_S_VTA_03_ASEReadCounter.table","NW_015090842.1:10313579",22,49,27
"COG8","s1633_S_VTA_03_ASEReadCounter.table","NW_015090842.1:10313665",24,45,21
"COG8","s1633_S_VTA_03_ASEReadCounter.table","NW_015090842.1:10313681",25,40,15
"COG8","s1633_S_VTA_03_ASEReadCounter.table","NW_015090842.1:10313768",32,59,27
"COG8","s1633_S_VTA_03_ASEReadCounter.table","NW_015090842.1:10313775",29,56,27
"COG8","s1633_S_VTA_03_ASEReadCounter.table","NW_015090842.1:10313811",27,50,23
"COG8","s1633_S_VTA_03_ASEReadCounter.table","NW_015090842.1:10313858",23,44,21
"COG8","s1633_S_VTA_03_ASEReadCounter.table","NW_015090842.1:10313859",43,44,1
"COG8","s1633_S_VTA_03_ASEReadCounter.table","NW_015090842.1:10314100",35,71,36
"COG8","s1633_S_VTA_03_ASEReadCounter.table","NW_015090842.1:10314213",29,57,28
"COG8","s1633_S_VTA_03_ASEReadCounter.table","NW_015090842.1:10315093",20,38,18
"COG8","s1633_S_VTA_03_ASEReadCounter.table","NW_015090842.1:10315162",16,35,19
"COG8","s1633_S_VTA_03_ASEReadCounter.table","NW_015090842.1:10315285",21,46,25
"COG8","s1633_S_VTA_03_ASEReadCounter.table","NW_015090842.1:10315360",19,33,14
"COG8","s1633_S_VTA_03_ASEReadCounter.table","NW_015090842.1:10315369",18,34,16
"COG8","s1633_S_VTA_03_ASEReadCounter.table","NW_015090842.1:10315508",7,10,3
"COG8","s1633_S_VTA_03_ASEReadCounter.table","NW_015090842.1:10315624",6,25,19
"COG8","s1633_S_VTA_03_ASEReadCounter.table","NW_015090842.1:10315693",6,25,19
"COG8","s1633_S_VTA_03_ASEReadCounter.table","NW_015090842.1:10315698",7,26,19
"COG8","s1633_S_VTA_03_ASEReadCounter.table","NW_015090842.1:10315768",9,27,18
"COG8","s1633_S_VTA_03_ASEReadCounter.table","NW_015090842.1:10315769",9,27,18
"COG8","s1633_S_VTA_03_ASEReadCounter.table","NW_015090842.1:10315784",9,24,15
"COG8","s1633_S_VTA_03_ASEReadCounter.table","NW_015090842.1:10316093",10,31,21
"COG8","s1633_S_VTA_03_ASEReadCounter.table","NW_015090842.1:10316133",8,27,19
"NIP7","s1633_S_VTA_03_ASEReadCounter.table","NW_015090842.1:10316759",12,26,14
"NIP7","s1633_S_VTA_03_ASEReadCounter.table","NW_015090842.1:10316967",99,215,116
"NIP7","s1633_S_VTA_03_ASEReadCounter.table","NW_015090842.1:10316995",111,233,122
"NIP7","s1633_S_VTA_03_ASEReadCounter.table","NW_015090842.1:10317240",157,348,191
"NIP7","s1633_S_VTA_03_ASEReadCounter.table","NW_015090842.1:10317247",159,348,189
"NIP7","s1633_S_VTA_03_ASEReadCounter.table","NW_015090842.1:10317264",147,311,164
"NIP7","s1633_S_VTA_03_ASEReadCounter.table","NW_015090842.1:10317433",183,383,200
"NIP7","s1633_S_VTA_03_ASEReadCounter.table","NW_015090842.1:10317738",170,374,204
"NIP7","s1633_S_VTA_03_ASEReadCounter.table","NW_015090842.1:10317769",175,371,196
"NIP7","s1633_S_VTA_03_ASEReadCounter.table","NW_015090842.1:10317808",127,266,139
"NIP7","s1633_S_VTA_03_ASEReadCounter.table","NW_015090842.1:10317870",74,188,114
"NIP7","s1633_S_VTA_03_ASEReadCounter.table","NW_015090842.1:10317871",74,182,108
"NIP7","s1633_S_VTA_03_ASEReadCounter.table","NW_015090842.1:10317898",43,129,86
"NIP7","s1633_S_VTA_03_ASEReadCounter.table","NW_015090842.1:10317911",39,109,70
"TMED6","s1633_S_VTA_03_ASEReadCounter.table","NW_015090842.1:10318514",0,1,1
"TERF2","s1633_S_VTA_03_ASEReadCounter.table","NW_015090842.1:10321768",24,52,28
"TERF2","s1633_S_VTA_03_ASEReadCounter.table","NW_015090842.1:10321777",25,50,25
"TERF2","s1633_S_VTA_03_ASEReadCounter.table","NW_015090842.1:10321805",27,63,36
"TERF2","s1633_S_VTA_03_ASEReadCounter.table","NW_015090842.1:10321878",38,87,49
"TERF2","s1633_S_VTA_03_ASEReadCounter.table","NW_015090842.1:10321893",41,85,44
"TERF2","s1633_S_VTA_03_ASEReadCounter.table","NW_015090842.1:10321897",38,76,38
"TERF2","s1633_S_VTA_03_ASEReadCounter.table","NW_015090842.1:10321908",31,71,40
"TERF2","s1633_S_VTA_03_ASEReadCounter.table","NW_015090842.1:10322001",51,106,55
"TERF2","s1633_S_VTA_03_ASEReadCounter.table","NW_015090842.1:10322035",35,79,44
"TERF2","s1633_S_VTA_03_ASEReadCounter.table","NW_015090842.1:10322051",32,87,55
"TERF2","s1633_S_VTA_03_ASEReadCounter.table","NW_015090842.1:10322137",31,78,47
"TERF2","s1633_S_VTA_03_ASEReadCounter.table","NW_015090842.1:10322144",34,76,42
"TERF2","s1633_S_VTA_03_ASEReadCounter.table","NW_015090842.1:10322388",24,74,50
"TERF2","s1633_S_VTA_03_ASEReadCounter.table","NW_015090842.1:10322396",24,72,48
"TERF2","s1633_S_VTA_03_ASEReadCounter.table","NW_015090842.1:10322502",29,92,63
"TERF2","s1633_S_VTA_03_ASEReadCounter.table","NW_015090842.1:10322504",28,94,66
"TERF2","s1633_S_VTA_03_ASEReadCounter.table","NW_015090842.1:10322510",29,97,68
"TERF2","s1633_S_VTA_03_ASEReadCounter.table","NW_015090842.1:10323580",45,94,49
"TERF2","s1633_S_VTA_03_ASEReadCounter.table","NW_015090842.1:10324314",33,78,45
"TERF2","s1633_S_VTA_03_ASEReadCounter.table","NW_015090842.1:10326832",20,46,26
"TERF2","s1633_S_VTA_03_ASEReadCounter.table","NW_015090842.1:10327787",13,28,15
"TERF2","s1633_S_VTA_03_ASEReadCounter.table","NW_015090842.1:10328588",12,27,15
"TERF2","s1633_S_VTA_03_ASEReadCounter.table","NW_015090842.1:10328644",8,26,18
"TERF2","s1633_S_VTA_03_ASEReadCounter.table","NW_015090842.1:10329813",6,22,16
"TERF2","s1633_S_VTA_03_ASEReadCounter.table","NW_015090842.1:10330749",6,16,10
"TERF2","s1633_S_VTA_03_ASEReadCounter.table","NW_015090842.1:10330789",7,21,14
"CYB5B","s1633_S_VTA_03_ASEReadCounter.table","NW_015090842.1:10336595",4,11,7
"CYB5B","s1633_S_VTA_03_ASEReadCounter.table","NW_015090842.1:10336667",31,76,45
"CYB5B","s1633_S_VTA_03_ASEReadCounter.table","NW_015090842.1:10336689",49,115,66
"CYB5B","s1633_S_VTA_03_ASEReadCounter.table","NW_015090842.1:10336728",87,199,112
"CYB5B","s1633_S_VTA_03_ASEReadCounter.table","NW_015090842.1:10345068",87,194,107
"CYB5B","s1633_S_VTA_03_ASEReadCounter.table","NW_015090842.1:10348800",144,296,152
"CYB5B","s1633_S_VTA_03_ASEReadCounter.table","NW_015090842.1:10349046",116,244,128
"CYB5B","s1633_S_VTA_03_ASEReadCounter.table","NW_015090842.1:10349119",61,176,115
"CYB5B","s1633_S_VTA_03_ASEReadCounter.table","NW_015090842.1:10349146",35,169,134
"CYB5B","s1633_S_VTA_03_ASEReadCounter.table","NW_015090842.1:10349157",59,197,138
"CYB5B","s1633_S_VTA_03_ASEReadCounter.table","NW_015090842.1:10349263",208,208,0
