"gene","id","snp","ref_count","total_count","alt_count"
"CENPN","s1640_S_PIT_01_ASEReadCounter.table","NW_015090842.1:5801612",1,3,2
"CENPN","s1640_S_PIT_01_ASEReadCounter.table","NW_015090842.1:5801618",2,4,2
"CENPN","s1640_S_PIT_01_ASEReadCounter.table","NW_015090842.1:5801623",2,4,2
"CENPN","s1640_S_PIT_01_ASEReadCounter.table","NW_015090842.1:5801631",2,4,2
"CENPN","s1640_S_PIT_01_ASEReadCounter.table","NW_015090842.1:5801632",2,4,2
"CENPN","s1640_S_PIT_01_ASEReadCounter.table","NW_015090842.1:5801655",2,3,1
"CENPN","s1640_S_PIT_01_ASEReadCounter.table","NW_015090842.1:5801670",2,3,1
"CENPN","s1640_S_PIT_01_ASEReadCounter.table","NW_015090842.1:5801674",2,3,1
"CENPN","s1640_S_PIT_01_ASEReadCounter.table","NW_015090842.1:5801692",3,4,1
"CENPN","s1640_S_PIT_01_ASEReadCounter.table","NW_015090842.1:5802008",2,7,5
"CENPN","s1640_S_PIT_01_ASEReadCounter.table","NW_015090842.1:5802012",2,7,5
"CENPN","s1640_S_PIT_01_ASEReadCounter.table","NW_015090842.1:5802087",3,10,7
"CENPN","s1640_S_PIT_01_ASEReadCounter.table","NW_015090842.1:5810113",4,4,0
"CENPN","s1640_S_PIT_01_ASEReadCounter.table","NW_015090842.1:5810147",8,8,0
"CENPN","s1640_S_PIT_01_ASEReadCounter.table","NW_015090842.1:5810148",7,7,0
"ATMIN","s1640_S_PIT_01_ASEReadCounter.table","NW_015090842.1:5818789",11,14,3
"ATMIN","s1640_S_PIT_01_ASEReadCounter.table","NW_015090842.1:5819958",15,28,13
"ATMIN","s1640_S_PIT_01_ASEReadCounter.table","NW_015090842.1:5820004",17,29,12
"ATMIN","s1640_S_PIT_01_ASEReadCounter.table","NW_015090842.1:5820217",15,21,6
"ATMIN","s1640_S_PIT_01_ASEReadCounter.table","NW_015090842.1:5820250",14,22,8
"ATMIN","s1640_S_PIT_01_ASEReadCounter.table","NW_015090842.1:5820298",14,18,4
"ATMIN","s1640_S_PIT_01_ASEReadCounter.table","NW_015090842.1:5820417",16,26,10
"ATMIN","s1640_S_PIT_01_ASEReadCounter.table","NW_015090842.1:5820421",14,24,10
"ATMIN","s1640_S_PIT_01_ASEReadCounter.table","NW_015090842.1:5820448",16,27,11
"ATMIN","s1640_S_PIT_01_ASEReadCounter.table","NW_015090842.1:5820457",16,30,14
"ATMIN","s1640_S_PIT_01_ASEReadCounter.table","NW_015090842.1:5820510",9,18,9
"ATMIN","s1640_S_PIT_01_ASEReadCounter.table","NW_015090842.1:5820673",11,19,8
"ATMIN","s1640_S_PIT_01_ASEReadCounter.table","NW_015090842.1:5820754",13,22,9
"ATMIN","s1640_S_PIT_01_ASEReadCounter.table","NW_015090842.1:5820820",12,23,11
"ATMIN","s1640_S_PIT_01_ASEReadCounter.table","NW_015090842.1:5820865",16,30,14
"ATMIN","s1640_S_PIT_01_ASEReadCounter.table","NW_015090842.1:5820889",12,30,18
"ATMIN","s1640_S_PIT_01_ASEReadCounter.table","NW_015090842.1:5820891",13,31,18
"ATMIN","s1640_S_PIT_01_ASEReadCounter.table","NW_015090842.1:5820997",25,43,18
"ATMIN","s1640_S_PIT_01_ASEReadCounter.table","NW_015090842.1:5821063",20,38,18
"ATMIN","s1640_S_PIT_01_ASEReadCounter.table","NW_015090842.1:5821132",24,35,11
"ATMIN","s1640_S_PIT_01_ASEReadCounter.table","NW_015090842.1:5821645",17,31,14
"ATMIN","s1640_S_PIT_01_ASEReadCounter.table","NW_015090842.1:5825066",17,33,16
"ATMIN","s1640_S_PIT_01_ASEReadCounter.table","NW_015090842.1:5825106",18,36,18
"ATMIN","s1640_S_PIT_01_ASEReadCounter.table","NW_015090842.1:5825122",19,38,19
"ATMIN","s1640_S_PIT_01_ASEReadCounter.table","NW_015090842.1:5825178",23,44,21
"ATMIN","s1640_S_PIT_01_ASEReadCounter.table","NW_015090842.1:5825194",22,40,18
"ATMIN","s1640_S_PIT_01_ASEReadCounter.table","NW_015090842.1:5825195",22,40,18
"ATMIN","s1640_S_PIT_01_ASEReadCounter.table","NW_015090842.1:5825220",21,42,21
"ATMIN","s1640_S_PIT_01_ASEReadCounter.table","NW_015090842.1:5825240",22,42,20
"ATMIN","s1640_S_PIT_01_ASEReadCounter.table","NW_015090842.1:5825303",29,57,28
"ATMIN","s1640_S_PIT_01_ASEReadCounter.table","NW_015090842.1:5825304",32,59,27
"ATMIN","s1640_S_PIT_01_ASEReadCounter.table","NW_015090842.1:5825310",32,58,26
"ATMIN","s1640_S_PIT_01_ASEReadCounter.table","NW_015090842.1:5825406",20,42,22
"ATMIN","s1640_S_PIT_01_ASEReadCounter.table","NW_015090842.1:5825415",21,43,22
"ATMIN","s1640_S_PIT_01_ASEReadCounter.table","NW_015090842.1:5825438",22,43,21
"ATMIN","s1640_S_PIT_01_ASEReadCounter.table","NW_015090842.1:5825485",20,37,17
"ATMIN","s1640_S_PIT_01_ASEReadCounter.table","NW_015090842.1:5825524",16,40,24
"ATMIN","s1640_S_PIT_01_ASEReadCounter.table","NW_015090842.1:5825557",9,38,29
"ATMIN","s1640_S_PIT_01_ASEReadCounter.table","NW_015090842.1:5825571",9,37,28
"ATMIN","s1640_S_PIT_01_ASEReadCounter.table","NW_015090842.1:5825579",11,40,29
"ATMIN","s1640_S_PIT_01_ASEReadCounter.table","NW_015090842.1:5825590",10,29,19
"ATMIN","s1640_S_PIT_01_ASEReadCounter.table","NW_015090842.1:5825689",28,49,21
"ATMIN","s1640_S_PIT_01_ASEReadCounter.table","NW_015090842.1:5825703",32,52,20
"ATMIN","s1640_S_PIT_01_ASEReadCounter.table","NW_015090842.1:5825787",22,32,10
"ATMIN","s1640_S_PIT_01_ASEReadCounter.table","NW_015090842.1:5825833",24,41,17
"ATMIN","s1640_S_PIT_01_ASEReadCounter.table","NW_015090842.1:5825841",20,39,19
"ATMIN","s1640_S_PIT_01_ASEReadCounter.table","NW_015090842.1:5825895",24,46,22
"ATMIN","s1640_S_PIT_01_ASEReadCounter.table","NW_015090842.1:5825984",23,43,20
"ATMIN","s1640_S_PIT_01_ASEReadCounter.table","NW_015090842.1:5826162",24,41,17
"ATMIN","s1640_S_PIT_01_ASEReadCounter.table","NW_015090842.1:5826194",23,45,22
"ATMIN","s1640_S_PIT_01_ASEReadCounter.table","NW_015090842.1:5826235",27,47,20
"ATMIN","s1640_S_PIT_01_ASEReadCounter.table","NW_015090842.1:5826245",24,41,17
"ATMIN","s1640_S_PIT_01_ASEReadCounter.table","NW_015090842.1:5826335",6,17,11
"ATMIN","s1640_S_PIT_01_ASEReadCounter.table","NW_015090842.1:5826417",26,42,16
"ATMIN","s1640_S_PIT_01_ASEReadCounter.table","NW_015090842.1:5826431",19,42,23
"ATMIN","s1640_S_PIT_01_ASEReadCounter.table","NW_015090842.1:5826438",20,39,19
"ATMIN","s1640_S_PIT_01_ASEReadCounter.table","NW_015090842.1:5826463",26,45,19
"ATMIN","s1640_S_PIT_01_ASEReadCounter.table","NW_015090842.1:5826502",14,38,24
"ATMIN","s1640_S_PIT_01_ASEReadCounter.table","NW_015090842.1:5826511",16,39,23
"ATMIN","s1640_S_PIT_01_ASEReadCounter.table","NW_015090842.1:5826659",29,56,27
"ATMIN","s1640_S_PIT_01_ASEReadCounter.table","NW_015090842.1:5826701",27,49,22
"ATMIN","s1640_S_PIT_01_ASEReadCounter.table","NW_015090842.1:5826702",27,49,22
"ATMIN","s1640_S_PIT_01_ASEReadCounter.table","NW_015090842.1:5826732",30,49,19
"ATMIN","s1640_S_PIT_01_ASEReadCounter.table","NW_015090842.1:5826745",27,47,20
"ATMIN","s1640_S_PIT_01_ASEReadCounter.table","NW_015090842.1:5826835",25,43,18
"ATMIN","s1640_S_PIT_01_ASEReadCounter.table","NW_015090842.1:5826910",22,37,15
"ATMIN","s1640_S_PIT_01_ASEReadCounter.table","NW_015090842.1:5826942",18,42,24
"ATMIN","s1640_S_PIT_01_ASEReadCounter.table","NW_015090842.1:5827193",29,57,28
"ATMIN","s1640_S_PIT_01_ASEReadCounter.table","NW_015090842.1:5827196",29,59,30
"ATMIN","s1640_S_PIT_01_ASEReadCounter.table","NW_015090842.1:5827269",27,59,32
"ATMIN","s1640_S_PIT_01_ASEReadCounter.table","NW_015090842.1:5827315",26,52,26
"ATMIN","s1640_S_PIT_01_ASEReadCounter.table","NW_015090842.1:5827316",26,52,26
"ATMIN","s1640_S_PIT_01_ASEReadCounter.table","NW_015090842.1:5827333",27,51,24
"PPP1R3E","s1640_S_PIT_01_ASEReadCounter.table","NW_015090842.1:5837733",13,24,11
"PPP1R3E","s1640_S_PIT_01_ASEReadCounter.table","NW_015090842.1:5837947",6,21,15
"PKD1L2","s1640_S_PIT_01_ASEReadCounter.table","NW_015090842.1:5867509",0,2,2
"PKD1L2","s1640_S_PIT_01_ASEReadCounter.table","NW_015090842.1:5867597",1,2,1
"PKD1L2","s1640_S_PIT_01_ASEReadCounter.table","NW_015090842.1:5867600",1,1,0
"PKD1L2","s1640_S_PIT_01_ASEReadCounter.table","NW_015090842.1:5867788",2,3,1
"PKD1L2","s1640_S_PIT_01_ASEReadCounter.table","NW_015090842.1:5867843",2,3,1
"BCO1","s1640_S_PIT_01_ASEReadCounter.table","NW_015090842.1:5915610",2,2,0
"BCO1","s1640_S_PIT_01_ASEReadCounter.table","NW_015090842.1:5915646",2,4,2
"BCO1","s1640_S_PIT_01_ASEReadCounter.table","NW_015090842.1:5917836",2,5,3
"BCO1","s1640_S_PIT_01_ASEReadCounter.table","NW_015090842.1:5917912",13,22,9
"BCO1","s1640_S_PIT_01_ASEReadCounter.table","NW_015090842.1:5917941",20,28,8
"BCO1","s1640_S_PIT_01_ASEReadCounter.table","NW_015090842.1:5917971",28,37,9
"BCO1","s1640_S_PIT_01_ASEReadCounter.table","NW_015090842.1:5921679",29,37,8
"BCO1","s1640_S_PIT_01_ASEReadCounter.table","NW_015090842.1:5921726",25,31,6
"BCO1","s1640_S_PIT_01_ASEReadCounter.table","NW_015090842.1:5925669",14,18,4
"BCO1","s1640_S_PIT_01_ASEReadCounter.table","NW_015090842.1:5925753",13,17,4
"BCO1","s1640_S_PIT_01_ASEReadCounter.table","NW_015090842.1:5926937",15,18,3
"BCO1","s1640_S_PIT_01_ASEReadCounter.table","NW_015090842.1:5927921",21,28,7
"BCO1","s1640_S_PIT_01_ASEReadCounter.table","NW_015090842.1:5927948",21,29,8
"BCO1","s1640_S_PIT_01_ASEReadCounter.table","NW_015090842.1:5927968",22,29,7
"BCO1","s1640_S_PIT_01_ASEReadCounter.table","NW_015090842.1:5928052",19,25,6
"BCO1","s1640_S_PIT_01_ASEReadCounter.table","NW_015090842.1:5932726",30,41,11
"BCO1","s1640_S_PIT_01_ASEReadCounter.table","NW_015090842.1:5932801",18,25,7
"BCO1","s1640_S_PIT_01_ASEReadCounter.table","NW_015090842.1:5934558",20,27,7
"BCO1","s1640_S_PIT_01_ASEReadCounter.table","NW_015090842.1:5934575",22,30,8
"BCO1","s1640_S_PIT_01_ASEReadCounter.table","NW_015090842.1:5934608",24,33,9
"BCO1","s1640_S_PIT_01_ASEReadCounter.table","NW_015090842.1:5934647",25,34,9
"BCO1","s1640_S_PIT_01_ASEReadCounter.table","NW_015090842.1:5934725",15,23,8
"BCO1","s1640_S_PIT_01_ASEReadCounter.table","NW_015090842.1:5934726",15,24,9
"BCO1","s1640_S_PIT_01_ASEReadCounter.table","NW_015090842.1:5934733",15,26,11
"BCO1","s1640_S_PIT_01_ASEReadCounter.table","NW_015090842.1:5934821",14,25,11
"BCO1","s1640_S_PIT_01_ASEReadCounter.table","NW_015090842.1:5934826",14,27,13
"BCO1","s1640_S_PIT_01_ASEReadCounter.table","NW_015090842.1:5934844",11,21,10
"BCO1","s1640_S_PIT_01_ASEReadCounter.table","NW_015090842.1:5934958",17,25,8
"BCO1","s1640_S_PIT_01_ASEReadCounter.table","NW_015090842.1:5934976",20,27,7
"GAN","s1640_S_PIT_01_ASEReadCounter.table","NW_015090842.1:5953759",6,14,8
"GAN","s1640_S_PIT_01_ASEReadCounter.table","NW_015090842.1:5957502",3,12,9
"GAN","s1640_S_PIT_01_ASEReadCounter.table","NW_015090842.1:5957578",5,12,7
"GAN","s1640_S_PIT_01_ASEReadCounter.table","NW_015090842.1:5965028",11,17,6
"GAN","s1640_S_PIT_01_ASEReadCounter.table","NW_015090842.1:5966047",10,18,8
"GAN","s1640_S_PIT_01_ASEReadCounter.table","NW_015090842.1:5966126",2,8,6
"GAN","s1640_S_PIT_01_ASEReadCounter.table","NW_015090842.1:5966127",3,9,6
"GAN","s1640_S_PIT_01_ASEReadCounter.table","NW_015090842.1:5966162",9,16,7
"GAN","s1640_S_PIT_01_ASEReadCounter.table","NW_015090842.1:5966483",7,14,7
"CMIP","s1640_S_PIT_01_ASEReadCounter.table","NW_015090842.1:6109159",20,29,9
"CMIP","s1640_S_PIT_01_ASEReadCounter.table","NW_015090842.1:6109166",17,25,8
"CMIP","s1640_S_PIT_01_ASEReadCounter.table","NW_015090842.1:6114641",14,36,22
"CMIP","s1640_S_PIT_01_ASEReadCounter.table","NW_015090842.1:6114751",14,30,16
"CMIP","s1640_S_PIT_01_ASEReadCounter.table","NW_015090842.1:6114824",15,26,11
"CMIP","s1640_S_PIT_01_ASEReadCounter.table","NW_015090842.1:6128998",22,46,24
"CMIP","s1640_S_PIT_01_ASEReadCounter.table","NW_015090842.1:6130562",47,84,37
"CMIP","s1640_S_PIT_01_ASEReadCounter.table","NW_015090842.1:6132522",25,47,22
"CMIP","s1640_S_PIT_01_ASEReadCounter.table","NW_015090842.1:6134088",24,51,27
"CMIP","s1640_S_PIT_01_ASEReadCounter.table","NW_015090842.1:6138265",43,81,38
"CMIP","s1640_S_PIT_01_ASEReadCounter.table","NW_015090842.1:6138300",42,82,40
"CMIP","s1640_S_PIT_01_ASEReadCounter.table","NW_015090842.1:6138342",41,77,36
"CMIP","s1640_S_PIT_01_ASEReadCounter.table","NW_015090842.1:6138343",39,76,37
"CMIP","s1640_S_PIT_01_ASEReadCounter.table","NW_015090842.1:6138345",41,78,37
"CMIP","s1640_S_PIT_01_ASEReadCounter.table","NW_015090842.1:6138647",23,47,24
"CMIP","s1640_S_PIT_01_ASEReadCounter.table","NW_015090842.1:6138745",33,54,21
"CMIP","s1640_S_PIT_01_ASEReadCounter.table","NW_015090842.1:6138832",7,24,17
"CMIP","s1640_S_PIT_01_ASEReadCounter.table","NW_015090842.1:6138967",19,43,24
"CMIP","s1640_S_PIT_01_ASEReadCounter.table","NW_015090842.1:6139131",10,20,10
"CMIP","s1640_S_PIT_01_ASEReadCounter.table","NW_015090842.1:6139163",2,9,7
"CMIP","s1640_S_PIT_01_ASEReadCounter.table","NW_015090842.1:6139360",11,17,6
"CMIP","s1640_S_PIT_01_ASEReadCounter.table","NW_015090842.1:6139572",6,13,7
"CMIP","s1640_S_PIT_01_ASEReadCounter.table","NW_015090842.1:6139773",13,23,10
"PLCG2","s1640_S_PIT_01_ASEReadCounter.table","NW_015090842.1:6179613",4,13,9
"PLCG2","s1640_S_PIT_01_ASEReadCounter.table","NW_015090842.1:6179658",14,22,8
"PLCG2","s1640_S_PIT_01_ASEReadCounter.table","NW_015090842.1:6203766",13,22,9
"PLCG2","s1640_S_PIT_01_ASEReadCounter.table","NW_015090842.1:6203775",14,24,10
"PLCG2","s1640_S_PIT_01_ASEReadCounter.table","NW_015090842.1:6203787",13,22,9
"PLCG2","s1640_S_PIT_01_ASEReadCounter.table","NW_015090842.1:6205047",19,36,17
"PLCG2","s1640_S_PIT_01_ASEReadCounter.table","NW_015090842.1:6208541",13,32,19
"PLCG2","s1640_S_PIT_01_ASEReadCounter.table","NW_015090842.1:6209741",17,32,15
"PLCG2","s1640_S_PIT_01_ASEReadCounter.table","NW_015090842.1:6209798",15,28,13
"PLCG2","s1640_S_PIT_01_ASEReadCounter.table","NW_015090842.1:6209816",13,25,12
"PLCG2","s1640_S_PIT_01_ASEReadCounter.table","NW_015090842.1:6217547",16,48,32
"PLCG2","s1640_S_PIT_01_ASEReadCounter.table","NW_015090842.1:6218641",21,44,23
"PLCG2","s1640_S_PIT_01_ASEReadCounter.table","NW_015090842.1:6220552",21,53,32
"PLCG2","s1640_S_PIT_01_ASEReadCounter.table","NW_015090842.1:6221969",21,43,22
"PLCG2","s1640_S_PIT_01_ASEReadCounter.table","NW_015090842.1:6228672",23,39,16
"PLCG2","s1640_S_PIT_01_ASEReadCounter.table","NW_015090842.1:6228694",25,39,14
"PLCG2","s1640_S_PIT_01_ASEReadCounter.table","NW_015090842.1:6228722",26,45,19
"PLCG2","s1640_S_PIT_01_ASEReadCounter.table","NW_015090842.1:6228747",21,47,26
"PLCG2","s1640_S_PIT_01_ASEReadCounter.table","NW_015090842.1:6228835",18,50,32
"PLCG2","s1640_S_PIT_01_ASEReadCounter.table","NW_015090842.1:6228841",20,52,32
"PLCG2","s1640_S_PIT_01_ASEReadCounter.table","NW_015090842.1:6228865",20,47,27
"PLCG2","s1640_S_PIT_01_ASEReadCounter.table","NW_015090842.1:6228917",20,48,28
"PLCG2","s1640_S_PIT_01_ASEReadCounter.table","NW_015090842.1:6228926",18,45,27
"PLCG2","s1640_S_PIT_01_ASEReadCounter.table","NW_015090842.1:6228954",12,32,20
"PLCG2","s1640_S_PIT_01_ASEReadCounter.table","NW_015090842.1:6229002",18,41,23
"PLCG2","s1640_S_PIT_01_ASEReadCounter.table","NW_015090842.1:6229006",18,41,23
"PLCG2","s1640_S_PIT_01_ASEReadCounter.table","NW_015090842.1:6229081",19,33,14
"PLCG2","s1640_S_PIT_01_ASEReadCounter.table","NW_015090842.1:6229097",13,22,9
"PLCG2","s1640_S_PIT_01_ASEReadCounter.table","NW_015090842.1:6229160",17,22,5
"PLCG2","s1640_S_PIT_01_ASEReadCounter.table","NW_015090842.1:6229213",17,24,7
"PLCG2","s1640_S_PIT_01_ASEReadCounter.table","NW_015090842.1:6229231",20,32,12
"PLCG2","s1640_S_PIT_01_ASEReadCounter.table","NW_015090842.1:6229663",17,26,9
"PLCG2","s1640_S_PIT_01_ASEReadCounter.table","NW_015090842.1:6229748",19,34,15
"PLCG2","s1640_S_PIT_01_ASEReadCounter.table","NW_015090842.1:6229892",14,31,17
"PLCG2","s1640_S_PIT_01_ASEReadCounter.table","NW_015090842.1:6230248",15,28,13
"PLCG2","s1640_S_PIT_01_ASEReadCounter.table","NW_015090842.1:6230255",13,26,13
"PLCG2","s1640_S_PIT_01_ASEReadCounter.table","NW_015090842.1:6230296",14,26,12
"PLCG2","s1640_S_PIT_01_ASEReadCounter.table","NW_015090842.1:6230349",20,39,19
"PLCG2","s1640_S_PIT_01_ASEReadCounter.table","NW_015090842.1:6230381",25,43,18
"PLCG2","s1640_S_PIT_01_ASEReadCounter.table","NW_015090842.1:6230408",22,40,18
"PLCG2","s1640_S_PIT_01_ASEReadCounter.table","NW_015090842.1:6230439",16,31,15
"PLCG2","s1640_S_PIT_01_ASEReadCounter.table","NW_015090842.1:6230757",4,7,3
"PLCG2","s1640_S_PIT_01_ASEReadCounter.table","NW_015090842.1:6230758",6,9,3
"PLCG2","s1640_S_PIT_01_ASEReadCounter.table","NW_015090842.1:6230898",30,44,14
"PLCG2","s1640_S_PIT_01_ASEReadCounter.table","NW_015090842.1:6230976",22,35,13
"PLCG2","s1640_S_PIT_01_ASEReadCounter.table","NW_015090842.1:6231078",25,35,10
"PLCG2","s1640_S_PIT_01_ASEReadCounter.table","NW_015090842.1:6231138",28,42,14
"PLCG2","s1640_S_PIT_01_ASEReadCounter.table","NW_015090842.1:6231177",29,41,12
"PLCG2","s1640_S_PIT_01_ASEReadCounter.table","NW_015090842.1:6231263",20,30,10
"PLCG2","s1640_S_PIT_01_ASEReadCounter.table","NW_015090842.1:6231309",14,23,9
"SDR42E1","s1640_S_PIT_01_ASEReadCounter.table","NW_015090842.1:6235292",1,10,9
"SDR42E1","s1640_S_PIT_01_ASEReadCounter.table","NW_015090842.1:6235315",2,14,12
"SDR42E1","s1640_S_PIT_01_ASEReadCounter.table","NW_015090842.1:6235348",8,23,15
"SDR42E1","s1640_S_PIT_01_ASEReadCounter.table","NW_015090842.1:6235355",10,25,15
"SDR42E1","s1640_S_PIT_01_ASEReadCounter.table","NW_015090842.1:6235417",10,28,18
"SDR42E1","s1640_S_PIT_01_ASEReadCounter.table","NW_015090842.1:6235526",38,38,0
"SDR42E1","s1640_S_PIT_01_ASEReadCounter.table","NW_015090842.1:6235558",6,30,24
"SDR42E1","s1640_S_PIT_01_ASEReadCounter.table","NW_015090842.1:6235603",37,37,0
"SDR42E1","s1640_S_PIT_01_ASEReadCounter.table","NW_015090842.1:6235741",23,43,20
"SDR42E1","s1640_S_PIT_01_ASEReadCounter.table","NW_015090842.1:6235777",22,43,21
"SDR42E1","s1640_S_PIT_01_ASEReadCounter.table","NW_015090842.1:6235806",28,63,35
"SDR42E1","s1640_S_PIT_01_ASEReadCounter.table","NW_015090842.1:6235809",27,63,36
"SDR42E1","s1640_S_PIT_01_ASEReadCounter.table","NW_015090842.1:6235816",25,62,37
"SDR42E1","s1640_S_PIT_01_ASEReadCounter.table","NW_015090842.1:6235914",12,34,22
"SDR42E1","s1640_S_PIT_01_ASEReadCounter.table","NW_015090842.1:6235935",13,39,26
"SDR42E1","s1640_S_PIT_01_ASEReadCounter.table","NW_015090842.1:6235957",13,38,25
"SDR42E1","s1640_S_PIT_01_ASEReadCounter.table","NW_015090842.1:6236040",13,34,21
"SDR42E1","s1640_S_PIT_01_ASEReadCounter.table","NW_015090842.1:6236260",20,53,33
"SDR42E1","s1640_S_PIT_01_ASEReadCounter.table","NW_015090842.1:6236281",17,48,31
"SDR42E1","s1640_S_PIT_01_ASEReadCounter.table","NW_015090842.1:6236305",15,48,33
"SDR42E1","s1640_S_PIT_01_ASEReadCounter.table","NW_015090842.1:6236458",15,48,33
"SDR42E1","s1640_S_PIT_01_ASEReadCounter.table","NW_015090842.1:6236476",18,53,35
"SDR42E1","s1640_S_PIT_01_ASEReadCounter.table","NW_015090842.1:6236608",12,37,25
"SDR42E1","s1640_S_PIT_01_ASEReadCounter.table","NW_015090842.1:6238244",12,29,17
"SDR42E1","s1640_S_PIT_01_ASEReadCounter.table","NW_015090842.1:6238829",2,14,12
"HSD17B2","s1640_S_PIT_01_ASEReadCounter.table","NW_015090842.1:6262951",0,1,1
"HSD17B2","s1640_S_PIT_01_ASEReadCounter.table","NW_015090842.1:6262974",0,1,1
"HSD17B2","s1640_S_PIT_01_ASEReadCounter.table","NW_015090842.1:6266795",0,3,3
"HSD17B2","s1640_S_PIT_01_ASEReadCounter.table","NW_015090842.1:6266918",0,1,1
"HSD17B2","s1640_S_PIT_01_ASEReadCounter.table","NW_015090842.1:6266944",0,1,1
"HSD17B2","s1640_S_PIT_01_ASEReadCounter.table","NW_015090842.1:6266997",0,1,1
"HSD17B2","s1640_S_PIT_01_ASEReadCounter.table","NW_015090842.1:6267273",0,1,1
"HSD17B2","s1640_S_PIT_01_ASEReadCounter.table","NW_015090842.1:6267358",0,1,1
"ARY2","s1640_S_PIT_01_ASEReadCounter.table","NW_015090842.1:6305848",3,4,1
"ARY2","s1640_S_PIT_01_ASEReadCounter.table","NW_015090842.1:6305856",2,3,1
"ARY2","s1640_S_PIT_01_ASEReadCounter.table","NW_015090842.1:6305857",2,3,1
"ARY2","s1640_S_PIT_01_ASEReadCounter.table","NW_015090842.1:6306052",0,1,1
"ARY2","s1640_S_PIT_01_ASEReadCounter.table","NW_015090842.1:6306094",0,1,1
"ARY2","s1640_S_PIT_01_ASEReadCounter.table","NW_015090842.1:6306100",0,1,1
"ARY2","s1640_S_PIT_01_ASEReadCounter.table","NW_015090842.1:6306146",0,1,1
"ARY2","s1640_S_PIT_01_ASEReadCounter.table","NW_015090842.1:6306147",0,1,1
"ARY2","s1640_S_PIT_01_ASEReadCounter.table","NW_015090842.1:6306390",0,1,1
"ARY2","s1640_S_PIT_01_ASEReadCounter.table","NW_015090842.1:6306567",0,1,1
"ARY2","s1640_S_PIT_01_ASEReadCounter.table","NW_015090842.1:6306713",1,1,0
"ARY2","s1640_S_PIT_01_ASEReadCounter.table","NW_015090842.1:6306773",1,2,1
"ARY2","s1640_S_PIT_01_ASEReadCounter.table","NW_015090842.1:6307093",1,1,0
"ARY2","s1640_S_PIT_01_ASEReadCounter.table","NW_015090842.1:6307138",2,2,0
"ARY2","s1640_S_PIT_01_ASEReadCounter.table","NW_015090842.1:6307157",2,2,0
"ARY2","s1640_S_PIT_01_ASEReadCounter.table","NW_015090842.1:6307187",3,3,0
"ARY2","s1640_S_PIT_01_ASEReadCounter.table","NW_015090842.1:6307278",2,3,1
"ARY2","s1640_S_PIT_01_ASEReadCounter.table","NW_015090842.1:6307305",2,3,1
"ARY2","s1640_S_PIT_01_ASEReadCounter.table","NW_015090842.1:6307318",2,3,1
"ARY2","s1640_S_PIT_01_ASEReadCounter.table","NW_015090842.1:6307429",0,1,1
"ARY2","s1640_S_PIT_01_ASEReadCounter.table","NW_015090842.1:6307487",0,2,2
"ARYL","s1640_S_PIT_01_ASEReadCounter.table","NW_015090842.1:6313360",0,1,1
"ARYL","s1640_S_PIT_01_ASEReadCounter.table","NW_015090842.1:6313377",0,2,2
"ARYL","s1640_S_PIT_01_ASEReadCounter.table","NW_015090842.1:6313767",2,3,1
"ARY1","s1640_S_PIT_01_ASEReadCounter.table","NW_015090842.1:6313909",4,4,0
"ARY1","s1640_S_PIT_01_ASEReadCounter.table","NW_015090842.1:6314296",1,1,0
"ARY1","s1640_S_PIT_01_ASEReadCounter.table","NW_015090842.1:6314750",1,1,0
"ARY1","s1640_S_PIT_01_ASEReadCounter.table","NW_015090842.1:6314794",1,1,0
"ARY1","s1640_S_PIT_01_ASEReadCounter.table","NW_015090842.1:6314859",0,1,1
"ARY1","s1640_S_PIT_01_ASEReadCounter.table","NW_015090842.1:6314886",0,1,1
"ARY1","s1640_S_PIT_01_ASEReadCounter.table","NW_015090842.1:6314943",1,1,0
"ARY1","s1640_S_PIT_01_ASEReadCounter.table","NW_015090842.1:6315022",0,1,1
"ARY1","s1640_S_PIT_01_ASEReadCounter.table","NW_015090842.1:6315026",0,1,1
"ARY1","s1640_S_PIT_01_ASEReadCounter.table","NW_015090842.1:6315043",0,1,1
"ARY1","s1640_S_PIT_01_ASEReadCounter.table","NW_015090842.1:6315065",0,1,1
"ARY1","s1640_S_PIT_01_ASEReadCounter.table","NW_015090842.1:6315409",0,1,1
"ARY1","s1640_S_PIT_01_ASEReadCounter.table","NW_015090842.1:6315479",0,2,2
"ARY1","s1640_S_PIT_01_ASEReadCounter.table","NW_015090842.1:6318342",3,3,0
"ARY1","s1640_S_PIT_01_ASEReadCounter.table","NW_015090842.1:6318427",2,5,3
"ARY1","s1640_S_PIT_01_ASEReadCounter.table","NW_015090842.1:6318603",1,2,1
"ARY1","s1640_S_PIT_01_ASEReadCounter.table","NW_015090842.1:6318708",3,7,4
"ARY1","s1640_S_PIT_01_ASEReadCounter.table","NW_015090842.1:6318858",2,5,3
"ARY1","s1640_S_PIT_01_ASEReadCounter.table","NW_015090842.1:6318952",2,5,3
"MPHOSPH6","s1640_S_PIT_01_ASEReadCounter.table","NW_015090842.1:6324063",29,66,37
"MPHOSPH6","s1640_S_PIT_01_ASEReadCounter.table","NW_015090842.1:6324174",48,125,77
"MPHOSPH6","s1640_S_PIT_01_ASEReadCounter.table","NW_015090842.1:6324270",78,169,91
"MPHOSPH6","s1640_S_PIT_01_ASEReadCounter.table","NW_015090842.1:6324762",73,157,84
"MPHOSPH6","s1640_S_PIT_01_ASEReadCounter.table","NW_015090842.1:6324772",75,151,76
"MPHOSPH6","s1640_S_PIT_01_ASEReadCounter.table","NW_015090842.1:6324780",70,149,79
"MPHOSPH6","s1640_S_PIT_01_ASEReadCounter.table","NW_015090842.1:6324902",85,169,84
"MPHOSPH6","s1640_S_PIT_01_ASEReadCounter.table","NW_015090842.1:6324910",174,174,0
"MPHOSPH6","s1640_S_PIT_01_ASEReadCounter.table","NW_015090842.1:6325066",76,193,117
"MPHOSPH6","s1640_S_PIT_01_ASEReadCounter.table","NW_015090842.1:6325089",95,232,137
"MPHOSPH6","s1640_S_PIT_01_ASEReadCounter.table","NW_015090842.1:6325298",134,329,195
"MPHOSPH6","s1640_S_PIT_01_ASEReadCounter.table","NW_015090842.1:6325877",117,242,125
"MPHOSPH6","s1640_S_PIT_01_ASEReadCounter.table","NW_015090842.1:6326976",73,164,91
"CDH13","s1640_S_PIT_01_ASEReadCounter.table","NW_015090842.1:6662283",1,1,0
"CDH13","s1640_S_PIT_01_ASEReadCounter.table","NW_015090842.1:6693665",1,1,0
"CDH13","s1640_S_PIT_01_ASEReadCounter.table","NW_015090842.1:6693697",1,2,1
"CDH13","s1640_S_PIT_01_ASEReadCounter.table","NW_015090842.1:6693712",1,2,1
"CDH13","s1640_S_PIT_01_ASEReadCounter.table","NW_015090842.1:6693723",1,2,1
"CDH13","s1640_S_PIT_01_ASEReadCounter.table","NW_015090842.1:6693738",1,2,1
"CDH13","s1640_S_PIT_01_ASEReadCounter.table","NW_015090842.1:6823730",1,1,0
"MLYCD","s1640_S_PIT_01_ASEReadCounter.table","NW_015090842.1:7150054",27,77,50
"MLYCD","s1640_S_PIT_01_ASEReadCounter.table","NW_015090842.1:7150131",47,123,76
"MLYCD","s1640_S_PIT_01_ASEReadCounter.table","NW_015090842.1:7150585",62,138,76
"MLYCD","s1640_S_PIT_01_ASEReadCounter.table","NW_015090842.1:7150686",40,105,65
"MLYCD","s1640_S_PIT_01_ASEReadCounter.table","NW_015090842.1:7150696",47,112,65
"MLYCD","s1640_S_PIT_01_ASEReadCounter.table","NW_015090842.1:7150698",111,111,0
"MLYCD","s1640_S_PIT_01_ASEReadCounter.table","NW_015090842.1:7150869",46,114,68
"MLYCD","s1640_S_PIT_01_ASEReadCounter.table","NW_015090842.1:7151100",51,127,76
"MLYCD","s1640_S_PIT_01_ASEReadCounter.table","NW_015090842.1:7151127",53,117,64
"MLYCD","s1640_S_PIT_01_ASEReadCounter.table","NW_015090842.1:7157538",43,114,71
"MLYCD","s1640_S_PIT_01_ASEReadCounter.table","NW_015090842.1:7167662",13,50,37
"MLYCD","s1640_S_PIT_01_ASEReadCounter.table","NW_015090842.1:7167675",13,49,36
"MLYCD","s1640_S_PIT_01_ASEReadCounter.table","NW_015090842.1:7167710",18,56,38
"MLYCD","s1640_S_PIT_01_ASEReadCounter.table","NW_015090842.1:7167781",22,55,33
"MLYCD","s1640_S_PIT_01_ASEReadCounter.table","NW_015090842.1:7167803",13,34,21
"MLYCD","s1640_S_PIT_01_ASEReadCounter.table","NW_015090842.1:7167812",13,33,20
"MLYCD","s1640_S_PIT_01_ASEReadCounter.table","NW_015090842.1:7167845",12,32,20
"MLYCD","s1640_S_PIT_01_ASEReadCounter.table","NW_015090842.1:7167862",13,36,23
"MLYCD","s1640_S_PIT_01_ASEReadCounter.table","NW_015090842.1:7167929",16,35,19
"MLYCD","s1640_S_PIT_01_ASEReadCounter.table","NW_015090842.1:7167995",14,23,9
"MLYCD","s1640_S_PIT_01_ASEReadCounter.table","NW_015090842.1:7168005",14,23,9
"MLYCD","s1640_S_PIT_01_ASEReadCounter.table","NW_015090842.1:7168037",13,22,9
"HSBP1","s1640_S_PIT_01_ASEReadCounter.table","NW_015090842.1:7245192",221,369,148
"HSBP1","s1640_S_PIT_01_ASEReadCounter.table","NW_015090842.1:7245226",239,416,177
"HSBP1","s1640_S_PIT_01_ASEReadCounter.table","NW_015090842.1:7245257",211,369,158
"HSBP1","s1640_S_PIT_01_ASEReadCounter.table","NW_015090842.1:7245296",189,376,187
"HSBP1","s1640_S_PIT_01_ASEReadCounter.table","NW_015090842.1:7245389",264,479,215
"HSBP1","s1640_S_PIT_01_ASEReadCounter.table","NW_015090842.1:7245400",263,464,201
"HSBP1","s1640_S_PIT_01_ASEReadCounter.table","NW_015090842.1:7245445",251,468,217
"HSBP1","s1640_S_PIT_01_ASEReadCounter.table","NW_015090842.1:7245495",238,436,198
"HSBP1","s1640_S_PIT_01_ASEReadCounter.table","NW_015090842.1:7245515",284,491,207
"HSBP1","s1640_S_PIT_01_ASEReadCounter.table","NW_015090842.1:7245733",191,361,170
"HSBP1","s1640_S_PIT_01_ASEReadCounter.table","NW_015090842.1:7245771",232,389,157
"HSBP1","s1640_S_PIT_01_ASEReadCounter.table","NW_015090842.1:7245813",221,373,152
"HSBP1","s1640_S_PIT_01_ASEReadCounter.table","NW_015090842.1:7245926",277,461,184
"HSBP1","s1640_S_PIT_01_ASEReadCounter.table","NW_015090842.1:7245927",278,460,182
"HSBP1","s1640_S_PIT_01_ASEReadCounter.table","NW_015090842.1:7245933",276,452,176
"HSBP1","s1640_S_PIT_01_ASEReadCounter.table","NW_015090842.1:7246002",210,377,167
"HSBP1","s1640_S_PIT_01_ASEReadCounter.table","NW_015090842.1:7246094",255,436,181
"HSBP1","s1640_S_PIT_01_ASEReadCounter.table","NW_015090842.1:7246167",254,445,191
"HSBP1","s1640_S_PIT_01_ASEReadCounter.table","NW_015090842.1:7246183",251,435,184
"HSBP1","s1640_S_PIT_01_ASEReadCounter.table","NW_015090842.1:7247285",57,88,31
"HSBP1","s1640_S_PIT_01_ASEReadCounter.table","NW_015090842.1:7247651",377,794,417
"HSBP1","s1640_S_PIT_01_ASEReadCounter.table","NW_015090842.1:7247657",386,817,431
"HSBP1","s1640_S_PIT_01_ASEReadCounter.table","NW_015090842.1:7248520",267,519,252
"HSBP1","s1640_S_PIT_01_ASEReadCounter.table","NW_015090842.1:7248535",226,424,198
"KCNG4","s1640_S_PIT_01_ASEReadCounter.table","NW_015090842.1:7282481",0,1,1
"KCNG4","s1640_S_PIT_01_ASEReadCounter.table","NW_015090842.1:7282500",1,2,1
"KCNG4","s1640_S_PIT_01_ASEReadCounter.table","NW_015090842.1:7282542",1,2,1
"KCNG4","s1640_S_PIT_01_ASEReadCounter.table","NW_015090842.1:7282579",2,2,0
"KCNG4","s1640_S_PIT_01_ASEReadCounter.table","NW_015090842.1:7282630",2,2,0
"KCNG4","s1640_S_PIT_01_ASEReadCounter.table","NW_015090842.1:7282760",1,3,2
"KCNG4","s1640_S_PIT_01_ASEReadCounter.table","NW_015090842.1:7283245",0,2,2
"KCNG4","s1640_S_PIT_01_ASEReadCounter.table","NW_015090842.1:7299491",1,2,1
"WFDC1","s1640_S_PIT_01_ASEReadCounter.table","NW_015090842.1:7366517",1,1,0
"ATP2C2","s1640_S_PIT_01_ASEReadCounter.table","NW_015090842.1:7413747",2,7,5
"TLDC1","s1640_S_PIT_01_ASEReadCounter.table","NW_015090842.1:7421997",41,76,35
"COTL1","s1640_S_PIT_01_ASEReadCounter.table","NW_015090842.1:7490707",106,195,89
"COTL1","s1640_S_PIT_01_ASEReadCounter.table","NW_015090842.1:7490708",106,195,89
"COTL1","s1640_S_PIT_01_ASEReadCounter.table","NW_015090842.1:7490711",109,198,89
"COTL1","s1640_S_PIT_01_ASEReadCounter.table","NW_015090842.1:7490739",102,193,91
"COTL1","s1640_S_PIT_01_ASEReadCounter.table","NW_015090842.1:7490785",100,195,95
"COTL1","s1640_S_PIT_01_ASEReadCounter.table","NW_015090842.1:7490820",7,131,124
"COTL1","s1640_S_PIT_01_ASEReadCounter.table","NW_015090842.1:7490846",186,186,0
"COTL1","s1640_S_PIT_01_ASEReadCounter.table","NW_015090842.1:7505571",0,1,1
"KLHL36","s1640_S_PIT_01_ASEReadCounter.table","NW_015090842.1:7526337",14,36,22
"KLHL36","s1640_S_PIT_01_ASEReadCounter.table","NW_015090842.1:7537681",42,42,0
"USP10","s1640_S_PIT_01_ASEReadCounter.table","NW_015090842.1:7572213",64,133,69
"USP10","s1640_S_PIT_01_ASEReadCounter.table","NW_015090842.1:7572358",100,100,0
"CRISPLD2","s1640_S_PIT_01_ASEReadCounter.table","NW_015090842.1:7619796",0,1,1
"CRISPLD2","s1640_S_PIT_01_ASEReadCounter.table","NW_015090842.1:7630779",3,3,0
"CRISPLD2","s1640_S_PIT_01_ASEReadCounter.table","NW_015090842.1:7633611",3,3,0
"CRISPLD2","s1640_S_PIT_01_ASEReadCounter.table","NW_015090842.1:7633787",2,3,1
"CRISPLD2","s1640_S_PIT_01_ASEReadCounter.table","NW_015090842.1:7634023",2,4,2
"CRISPLD2","s1640_S_PIT_01_ASEReadCounter.table","NW_015090842.1:7634620",1,1,0
"CRISPLD2","s1640_S_PIT_01_ASEReadCounter.table","NW_015090842.1:7636315",0,1,1
"LOC106888312","s1640_S_PIT_01_ASEReadCounter.table","NW_015090842.1:7732198",1,1,0
"MTHFSD","s1640_S_PIT_01_ASEReadCounter.table","NW_015090842.1:8152578",15,27,12
"DUSP15","s1640_S_PIT_01_ASEReadCounter.table","NW_015090842.1:8422840",4,6,2
"DUSP15","s1640_S_PIT_01_ASEReadCounter.table","NW_015090842.1:8427711",0,2,2
"DUSP15","s1640_S_PIT_01_ASEReadCounter.table","NW_015090842.1:8431988",0,2,2
"EMC8","s1640_S_PIT_01_ASEReadCounter.table","NW_015090842.1:8452385",14,25,11
"GINS2","s1640_S_PIT_01_ASEReadCounter.table","NW_015090842.1:8467469",65,65,0
"GINS2","s1640_S_PIT_01_ASEReadCounter.table","NW_015090842.1:8470290",58,109,51
"GINS2","s1640_S_PIT_01_ASEReadCounter.table","NW_015090842.1:8470305",58,104,46
"GINS2","s1640_S_PIT_01_ASEReadCounter.table","NW_015090842.1:8470376",54,104,50
"GINS2","s1640_S_PIT_01_ASEReadCounter.table","NW_015090842.1:8471057",4,15,11
"GSE1","s1640_S_PIT_01_ASEReadCounter.table","NW_015090842.1:8483570",18,18,0
"KIAA0513","s1640_S_PIT_01_ASEReadCounter.table","NW_015090842.1:8674736",134,134,0
"KIAA0513","s1640_S_PIT_01_ASEReadCounter.table","NW_015090842.1:8687268",2,2,0
"KIAA0513","s1640_S_PIT_01_ASEReadCounter.table","NW_015090842.1:8693655",69,69,0
"ZCCHC14","s1640_S_PIT_01_ASEReadCounter.table","NW_015090842.1:8750189",72,72,0
"JPH3","s1640_S_PIT_01_ASEReadCounter.table","NW_015090842.1:8872294",14,30,16
"KLHDC4","s1640_S_PIT_01_ASEReadCounter.table","NW_015090842.1:8891175",177,177,0
"KLHDC4","s1640_S_PIT_01_ASEReadCounter.table","NW_015090842.1:8905251",50,103,53
"KLHDC4","s1640_S_PIT_01_ASEReadCounter.table","NW_015090842.1:8919630",9,18,9
"SLC7A5","s1640_S_PIT_01_ASEReadCounter.table","NW_015090842.1:8940382",208,208,0
"SLC7A5","s1640_S_PIT_01_ASEReadCounter.table","NW_015090842.1:8941818",207,207,0
"SLC7A5","s1640_S_PIT_01_ASEReadCounter.table","NW_015090842.1:8944655",158,158,0
"CA5A","s1640_S_PIT_01_ASEReadCounter.table","NW_015090842.1:8989479",33,89,56
"CA5A","s1640_S_PIT_01_ASEReadCounter.table","NW_015090842.1:8989562",53,136,83
"CA5A","s1640_S_PIT_01_ASEReadCounter.table","NW_015090842.1:8989609",73,154,81
"CA5A","s1640_S_PIT_01_ASEReadCounter.table","NW_015090842.1:8989693",63,173,110
"CA5A","s1640_S_PIT_01_ASEReadCounter.table","NW_015090842.1:8989702",70,174,104
"CA5A","s1640_S_PIT_01_ASEReadCounter.table","NW_015090842.1:8989746",78,195,117
"CA5A","s1640_S_PIT_01_ASEReadCounter.table","NW_015090842.1:8989880",76,181,105
"CA5A","s1640_S_PIT_01_ASEReadCounter.table","NW_015090842.1:8989885",79,183,104
"CA5A","s1640_S_PIT_01_ASEReadCounter.table","NW_015090842.1:8989929",77,180,103
"CA5A","s1640_S_PIT_01_ASEReadCounter.table","NW_015090842.1:8990002",56,158,102
"CA5A","s1640_S_PIT_01_ASEReadCounter.table","NW_015090842.1:8990004",57,161,104
"CA5A","s1640_S_PIT_01_ASEReadCounter.table","NW_015090842.1:8990005",56,165,109
"CA5A","s1640_S_PIT_01_ASEReadCounter.table","NW_015090842.1:8990017",66,165,99
"CA5A","s1640_S_PIT_01_ASEReadCounter.table","NW_015090842.1:8990043",53,137,84
"CA5A","s1640_S_PIT_01_ASEReadCounter.table","NW_015090842.1:8990080",49,138,89
"CA5A","s1640_S_PIT_01_ASEReadCounter.table","NW_015090842.1:8990084",52,139,87
"CA5A","s1640_S_PIT_01_ASEReadCounter.table","NW_015090842.1:8990090",56,148,92
"CA5A","s1640_S_PIT_01_ASEReadCounter.table","NW_015090842.1:8990095",50,145,95
"CA5A","s1640_S_PIT_01_ASEReadCounter.table","NW_015090842.1:8990111",35,124,89
"CA5A","s1640_S_PIT_01_ASEReadCounter.table","NW_015090842.1:8990112",35,121,86
"CA5A","s1640_S_PIT_01_ASEReadCounter.table","NW_015090842.1:8990115",39,124,85
"CA5A","s1640_S_PIT_01_ASEReadCounter.table","NW_015090842.1:8990166",44,112,68
"CA5A","s1640_S_PIT_01_ASEReadCounter.table","NW_015090842.1:8990169",45,113,68
"CA5A","s1640_S_PIT_01_ASEReadCounter.table","NW_015090842.1:8990222",35,105,70
"CA5A","s1640_S_PIT_01_ASEReadCounter.table","NW_015090842.1:8990289",40,125,85
"CA5A","s1640_S_PIT_01_ASEReadCounter.table","NW_015090842.1:8990314",39,128,89
"CA5A","s1640_S_PIT_01_ASEReadCounter.table","NW_015090842.1:8990361",35,102,67
"CA5A","s1640_S_PIT_01_ASEReadCounter.table","NW_015090842.1:8990368",36,102,66
"CA5A","s1640_S_PIT_01_ASEReadCounter.table","NW_015090842.1:8990429",49,118,69
"CA5A","s1640_S_PIT_01_ASEReadCounter.table","NW_015090842.1:8990466",36,92,56
"CA5A","s1640_S_PIT_01_ASEReadCounter.table","NW_015090842.1:8990663",61,129,68
"CA5A","s1640_S_PIT_01_ASEReadCounter.table","NW_015090842.1:8990797",37,95,58
"CA5A","s1640_S_PIT_01_ASEReadCounter.table","NW_015090842.1:8990836",57,116,59
"CA5A","s1640_S_PIT_01_ASEReadCounter.table","NW_015090842.1:8990842",54,114,60
"CA5A","s1640_S_PIT_01_ASEReadCounter.table","NW_015090842.1:8990851",56,113,57
"CA5A","s1640_S_PIT_01_ASEReadCounter.table","NW_015090842.1:8990918",41,111,70
"CA5A","s1640_S_PIT_01_ASEReadCounter.table","NW_015090842.1:8990921",38,116,78
"CA5A","s1640_S_PIT_01_ASEReadCounter.table","NW_015090842.1:8990942",44,113,69
"CA5A","s1640_S_PIT_01_ASEReadCounter.table","NW_015090842.1:8991001",44,140,96
"CA5A","s1640_S_PIT_01_ASEReadCounter.table","NW_015090842.1:8991038",44,133,89
"CA5A","s1640_S_PIT_01_ASEReadCounter.table","NW_015090842.1:8991149",50,138,88
"CA5A","s1640_S_PIT_01_ASEReadCounter.table","NW_015090842.1:8991176",50,143,93
"CA5A","s1640_S_PIT_01_ASEReadCounter.table","NW_015090842.1:8991241",47,142,95
"CA5A","s1640_S_PIT_01_ASEReadCounter.table","NW_015090842.1:8991262",43,124,81
"CA5A","s1640_S_PIT_01_ASEReadCounter.table","NW_015090842.1:8991316",50,61,11
"CA5A","s1640_S_PIT_01_ASEReadCounter.table","NW_015090842.1:8991319",45,57,12
"CA5A","s1640_S_PIT_01_ASEReadCounter.table","NW_015090842.1:8991330",49,55,6
"CA5A","s1640_S_PIT_01_ASEReadCounter.table","NW_015090842.1:8991334",47,59,12
"CA5A","s1640_S_PIT_01_ASEReadCounter.table","NW_015090842.1:8991362",47,97,50
"CA5A","s1640_S_PIT_01_ASEReadCounter.table","NW_015090842.1:8991368",48,101,53
"CA5A","s1640_S_PIT_01_ASEReadCounter.table","NW_015090842.1:8991390",45,101,56
"CA5A","s1640_S_PIT_01_ASEReadCounter.table","NW_015090842.1:8991395",47,110,63
"CA5A","s1640_S_PIT_01_ASEReadCounter.table","NW_015090842.1:8991422",44,115,71
"CA5A","s1640_S_PIT_01_ASEReadCounter.table","NW_015090842.1:8991467",49,113,64
"CA5A","s1640_S_PIT_01_ASEReadCounter.table","NW_015090842.1:8991576",31,91,60
"CA5A","s1640_S_PIT_01_ASEReadCounter.table","NW_015090842.1:8991587",36,104,68
"CA5A","s1640_S_PIT_01_ASEReadCounter.table","NW_015090842.1:8991655",42,126,84
"CA5A","s1640_S_PIT_01_ASEReadCounter.table","NW_015090842.1:8991717",44,114,70
"CA5A","s1640_S_PIT_01_ASEReadCounter.table","NW_015090842.1:8991726",40,116,76
"CA5A","s1640_S_PIT_01_ASEReadCounter.table","NW_015090842.1:8991799",41,114,73
"CA5A","s1640_S_PIT_01_ASEReadCounter.table","NW_015090842.1:8991809",36,106,70
"CA5A","s1640_S_PIT_01_ASEReadCounter.table","NW_015090842.1:8991848",28,98,70
"CA5A","s1640_S_PIT_01_ASEReadCounter.table","NW_015090842.1:8991849",28,99,71
"CA5A","s1640_S_PIT_01_ASEReadCounter.table","NW_015090842.1:8991927",29,99,70
"CA5A","s1640_S_PIT_01_ASEReadCounter.table","NW_015090842.1:8991941",28,99,71
"CA5A","s1640_S_PIT_01_ASEReadCounter.table","NW_015090842.1:8992121",29,99,70
"CA5A","s1640_S_PIT_01_ASEReadCounter.table","NW_015090842.1:8992224",24,80,56
"CA5A","s1640_S_PIT_01_ASEReadCounter.table","NW_015090842.1:9002570",29,81,52
"CA5A","s1640_S_PIT_01_ASEReadCounter.table","NW_015090842.1:9002600",29,84,55
"CA5A","s1640_S_PIT_01_ASEReadCounter.table","NW_015090842.1:9004312",34,74,40
"CA5A","s1640_S_PIT_01_ASEReadCounter.table","NW_015090842.1:9004506",1,1,0
"CA5A","s1640_S_PIT_01_ASEReadCounter.table","NW_015090842.1:9004523",1,1,0
"CA5A","s1640_S_PIT_01_ASEReadCounter.table","NW_015090842.1:9004530",1,1,0
"CA5A","s1640_S_PIT_01_ASEReadCounter.table","NW_015090842.1:9004556",2,2,0
"CA5A","s1640_S_PIT_01_ASEReadCounter.table","NW_015090842.1:9004620",2,4,2
"CA5A","s1640_S_PIT_01_ASEReadCounter.table","NW_015090842.1:9005116",5,8,3
"CA5A","s1640_S_PIT_01_ASEReadCounter.table","NW_015090842.1:9005120",5,8,3
"CA5A","s1640_S_PIT_01_ASEReadCounter.table","NW_015090842.1:9005140",7,9,2
"CA5A","s1640_S_PIT_01_ASEReadCounter.table","NW_015090842.1:9005152",8,9,1
"CA5A","s1640_S_PIT_01_ASEReadCounter.table","NW_015090842.1:9011011",0,1,1
"BANP","s1640_S_PIT_01_ASEReadCounter.table","NW_015090842.1:9033407",13,27,14
"BANP","s1640_S_PIT_01_ASEReadCounter.table","NW_015090842.1:9033409",12,27,15
"BANP","s1640_S_PIT_01_ASEReadCounter.table","NW_015090842.1:9033420",14,35,21
"BANP","s1640_S_PIT_01_ASEReadCounter.table","NW_015090842.1:9055284",16,40,24
"ZC3H18","s1640_S_PIT_01_ASEReadCounter.table","NW_015090842.1:9528933",24,49,25
"MVD","s1640_S_PIT_01_ASEReadCounter.table","NW_015090842.1:9550690",31,31,0
"MVD","s1640_S_PIT_01_ASEReadCounter.table","NW_015090842.1:9550691",31,31,0
"MVD","s1640_S_PIT_01_ASEReadCounter.table","NW_015090842.1:9550699",36,36,0
"MVD","s1640_S_PIT_01_ASEReadCounter.table","NW_015090842.1:9550701",36,36,0
"MVD","s1640_S_PIT_01_ASEReadCounter.table","NW_015090842.1:9552202",75,75,0
"MVD","s1640_S_PIT_01_ASEReadCounter.table","NW_015090842.1:9552223",66,66,0
"MVD","s1640_S_PIT_01_ASEReadCounter.table","NW_015090842.1:9552533",59,59,0
"MVD","s1640_S_PIT_01_ASEReadCounter.table","NW_015090842.1:9552644",21,40,19
"PIEZO1","s1640_S_PIT_01_ASEReadCounter.table","NW_015090842.1:9577447",3,8,5
"PIEZO1","s1640_S_PIT_01_ASEReadCounter.table","NW_015090842.1:9579101",7,8,1
"PIEZO1","s1640_S_PIT_01_ASEReadCounter.table","NW_015090842.1:9582630",2,5,3
"PIEZO1","s1640_S_PIT_01_ASEReadCounter.table","NW_015090842.1:9582976",3,5,2
"PIEZO1","s1640_S_PIT_01_ASEReadCounter.table","NW_015090842.1:9583326",7,7,0
"CDT1","s1640_S_PIT_01_ASEReadCounter.table","NW_015090842.1:9596711",4,9,5
"CDT1","s1640_S_PIT_01_ASEReadCounter.table","NW_015090842.1:9597033",21,21,0
"CDT1","s1640_S_PIT_01_ASEReadCounter.table","NW_015090842.1:9597756",7,21,14
"CDT1","s1640_S_PIT_01_ASEReadCounter.table","NW_015090842.1:9598873",32,32,0
"ACSF3","s1640_S_PIT_01_ASEReadCounter.table","NW_015090842.1:9776737",16,26,10
"ACSF3","s1640_S_PIT_01_ASEReadCounter.table","NW_015090842.1:9809639",53,53,0
"ACSF3","s1640_S_PIT_01_ASEReadCounter.table","NW_015090842.1:9834743",49,92,43
"ACSF3","s1640_S_PIT_01_ASEReadCounter.table","NW_015090842.1:9834762",85,86,1
"ACSF3","s1640_S_PIT_01_ASEReadCounter.table","NW_015090842.1:9834852",43,84,41
"ACSF3","s1640_S_PIT_01_ASEReadCounter.table","NW_015090842.1:9834861",38,72,34
"ACSF3","s1640_S_PIT_01_ASEReadCounter.table","NW_015090842.1:9839359",16,36,20
"ACSF3","s1640_S_PIT_01_ASEReadCounter.table","NW_015090842.1:9839378",18,37,19
"ACSF3","s1640_S_PIT_01_ASEReadCounter.table","NW_015090842.1:9839455",11,36,25
"ACSF3","s1640_S_PIT_01_ASEReadCounter.table","NW_015090842.1:9839457",12,35,23
"ACSF3","s1640_S_PIT_01_ASEReadCounter.table","NW_015090842.1:9839489",11,27,16
"ACSF3","s1640_S_PIT_01_ASEReadCounter.table","NW_015090842.1:9839500",9,22,13
"ACSF3","s1640_S_PIT_01_ASEReadCounter.table","NW_015090842.1:9839501",9,22,13
"ACSF3","s1640_S_PIT_01_ASEReadCounter.table","NW_015090842.1:9839504",10,23,13
"ACSF3","s1640_S_PIT_01_ASEReadCounter.table","NW_015090842.1:9839512",9,18,9
"ACSF3","s1640_S_PIT_01_ASEReadCounter.table","NW_015090842.1:9839527",8,17,9
"ACSF3","s1640_S_PIT_01_ASEReadCounter.table","NW_015090842.1:9839533",7,11,4
"ACSF3","s1640_S_PIT_01_ASEReadCounter.table","NW_015090842.1:9839535",7,12,5
"ACSF3","s1640_S_PIT_01_ASEReadCounter.table","NW_015090842.1:9839545",5,10,5
"ACSF3","s1640_S_PIT_01_ASEReadCounter.table","NW_015090842.1:9839550",4,9,5
"ACSF3","s1640_S_PIT_01_ASEReadCounter.table","NW_015090842.1:9839551",4,9,5
"CDH15","s1640_S_PIT_01_ASEReadCounter.table","NW_015090842.1:9848531",1,1,0
"CDH15","s1640_S_PIT_01_ASEReadCounter.table","NW_015090842.1:9848552",1,1,0
"CDH15","s1640_S_PIT_01_ASEReadCounter.table","NW_015090842.1:9849086",1,1,0
"CDH15","s1640_S_PIT_01_ASEReadCounter.table","NW_015090842.1:9849119",1,1,0
"CDH15","s1640_S_PIT_01_ASEReadCounter.table","NW_015090842.1:9849140",1,1,0
"SLC22A31","s1640_S_PIT_01_ASEReadCounter.table","NW_015090842.1:9851032",1,1,0
"SLC22A31","s1640_S_PIT_01_ASEReadCounter.table","NW_015090842.1:9851053",1,1,0
"SLC22A31","s1640_S_PIT_01_ASEReadCounter.table","NW_015090842.1:9851130",4,4,0
"SLC22A31","s1640_S_PIT_01_ASEReadCounter.table","NW_015090842.1:9851139",5,5,0
"SLC22A31","s1640_S_PIT_01_ASEReadCounter.table","NW_015090842.1:9851265",4,7,3
"SLC22A31","s1640_S_PIT_01_ASEReadCounter.table","NW_015090842.1:9851302",4,6,2
"SLC22A31","s1640_S_PIT_01_ASEReadCounter.table","NW_015090842.1:9851303",4,6,2
"SLC22A31","s1640_S_PIT_01_ASEReadCounter.table","NW_015090842.1:9851305",4,6,2
"SLC22A31","s1640_S_PIT_01_ASEReadCounter.table","NW_015090842.1:9851343",5,6,1
"SLC22A31","s1640_S_PIT_01_ASEReadCounter.table","NW_015090842.1:9851344",5,6,1
"SLC22A31","s1640_S_PIT_01_ASEReadCounter.table","NW_015090842.1:9851381",8,11,3
"SLC22A31","s1640_S_PIT_01_ASEReadCounter.table","NW_015090842.1:9851421",9,13,4
"SLC22A31","s1640_S_PIT_01_ASEReadCounter.table","NW_015090842.1:9851526",9,14,5
"SLC22A31","s1640_S_PIT_01_ASEReadCounter.table","NW_015090842.1:9851589",5,14,9
"SLC22A31","s1640_S_PIT_01_ASEReadCounter.table","NW_015090842.1:9851712",10,18,8
"SLC22A31","s1640_S_PIT_01_ASEReadCounter.table","NW_015090842.1:9851899",9,16,7
"SLC22A31","s1640_S_PIT_01_ASEReadCounter.table","NW_015090842.1:9852139",9,15,6
"SLC22A31","s1640_S_PIT_01_ASEReadCounter.table","NW_015090842.1:9852380",20,25,5
"SLC22A31","s1640_S_PIT_01_ASEReadCounter.table","NW_015090842.1:9852431",8,14,6
"SLC22A31","s1640_S_PIT_01_ASEReadCounter.table","NW_015090842.1:9852630",14,22,8
"SLC22A31","s1640_S_PIT_01_ASEReadCounter.table","NW_015090842.1:9852711",7,14,7
"SLC22A31","s1640_S_PIT_01_ASEReadCounter.table","NW_015090842.1:9852742",6,12,6
"SLC22A31","s1640_S_PIT_01_ASEReadCounter.table","NW_015090842.1:9853099",12,15,3
"SLC22A31","s1640_S_PIT_01_ASEReadCounter.table","NW_015090842.1:9853102",12,14,2
"SLC22A31","s1640_S_PIT_01_ASEReadCounter.table","NW_015090842.1:9853421",12,12,0
"SLC22A31","s1640_S_PIT_01_ASEReadCounter.table","NW_015090842.1:9853457",13,13,0
"SLC22A31","s1640_S_PIT_01_ASEReadCounter.table","NW_015090842.1:9853502",10,10,0
"ANKRD11","s1640_S_PIT_01_ASEReadCounter.table","NW_015090842.1:9858863",7,15,8
"ANKRD11","s1640_S_PIT_01_ASEReadCounter.table","NW_015090842.1:9859101",61,131,70
"ANKRD11","s1640_S_PIT_01_ASEReadCounter.table","NW_015090842.1:9859352",102,217,115
"ANKRD11","s1640_S_PIT_01_ASEReadCounter.table","NW_015090842.1:9859381",51,147,96
"ANKRD11","s1640_S_PIT_01_ASEReadCounter.table","NW_015090842.1:9859527",36,103,67
"ANKRD11","s1640_S_PIT_01_ASEReadCounter.table","NW_015090842.1:9859529",35,100,65
"ANKRD11","s1640_S_PIT_01_ASEReadCounter.table","NW_015090842.1:9859679",84,172,88
"ANKRD11","s1640_S_PIT_01_ASEReadCounter.table","NW_015090842.1:9861097",107,199,92
"ANKRD11","s1640_S_PIT_01_ASEReadCounter.table","NW_015090842.1:9862571",60,121,61
"ANKRD11","s1640_S_PIT_01_ASEReadCounter.table","NW_015090842.1:9866071",0,67,67
"ANKRD11","s1640_S_PIT_01_ASEReadCounter.table","NW_015090842.1:9866200",0,60,60
"ANKRD11","s1640_S_PIT_01_ASEReadCounter.table","NW_015090842.1:9867391",36,66,30
"ANKRD11","s1640_S_PIT_01_ASEReadCounter.table","NW_015090842.1:9867472",62,113,51
"ANKRD11","s1640_S_PIT_01_ASEReadCounter.table","NW_015090842.1:9867559",61,118,57
"ANKRD11","s1640_S_PIT_01_ASEReadCounter.table","NW_015090842.1:9867934",65,113,48
"ANKRD11","s1640_S_PIT_01_ASEReadCounter.table","NW_015090842.1:9868093",50,108,58
"ANKRD11","s1640_S_PIT_01_ASEReadCounter.table","NW_015090842.1:9868222",54,103,49
"ANKRD11","s1640_S_PIT_01_ASEReadCounter.table","NW_015090842.1:9868327",57,111,54
"ANKRD11","s1640_S_PIT_01_ASEReadCounter.table","NW_015090842.1:9868414",59,133,74
"ANKRD11","s1640_S_PIT_01_ASEReadCounter.table","NW_015090842.1:9868441",58,122,64
"ANKRD11","s1640_S_PIT_01_ASEReadCounter.table","NW_015090842.1:9868444",58,129,71
"ANKRD11","s1640_S_PIT_01_ASEReadCounter.table","NW_015090842.1:9868519",66,145,79
"ANKRD11","s1640_S_PIT_01_ASEReadCounter.table","NW_015090842.1:9868609",67,154,87
"ANKRD11","s1640_S_PIT_01_ASEReadCounter.table","NW_015090842.1:9868666",79,158,79
"ANKRD11","s1640_S_PIT_01_ASEReadCounter.table","NW_015090842.1:9869431",63,108,45
"ANKRD11","s1640_S_PIT_01_ASEReadCounter.table","NW_015090842.1:9869578",99,178,79
"ANKRD11","s1640_S_PIT_01_ASEReadCounter.table","NW_015090842.1:9869734",89,162,73
"ANKRD11","s1640_S_PIT_01_ASEReadCounter.table","NW_015090842.1:9870070",53,125,72
"ANKRD11","s1640_S_PIT_01_ASEReadCounter.table","NW_015090842.1:9870349",61,120,59
"ANKRD11","s1640_S_PIT_01_ASEReadCounter.table","NW_015090842.1:9870604",72,121,49
"ANKRD11","s1640_S_PIT_01_ASEReadCounter.table","NW_015090842.1:9870613",80,135,55
"ANKRD11","s1640_S_PIT_01_ASEReadCounter.table","NW_015090842.1:9870685",87,151,64
"ANKRD11","s1640_S_PIT_01_ASEReadCounter.table","NW_015090842.1:9870847",74,142,68
"ANKRD11","s1640_S_PIT_01_ASEReadCounter.table","NW_015090842.1:9871103",67,119,52
"ANKRD11","s1640_S_PIT_01_ASEReadCounter.table","NW_015090842.1:9871165",60,122,62
"ANKRD11","s1640_S_PIT_01_ASEReadCounter.table","NW_015090842.1:9871820",30,73,43
"ANKRD11","s1640_S_PIT_01_ASEReadCounter.table","NW_015090842.1:9871994",92,92,0
"ANKRD11","s1640_S_PIT_01_ASEReadCounter.table","NW_015090842.1:9872118",43,90,47
"SPG7","s1640_S_PIT_01_ASEReadCounter.table","NW_015090842.1:10051190",105,207,102
"SPG7","s1640_S_PIT_01_ASEReadCounter.table","NW_015090842.1:10051218",114,241,127
"SPG7","s1640_S_PIT_01_ASEReadCounter.table","NW_015090842.1:10052348",136,259,123
"SPG7","s1640_S_PIT_01_ASEReadCounter.table","NW_015090842.1:10052366",134,260,126
"SPG7","s1640_S_PIT_01_ASEReadCounter.table","NW_015090842.1:10065173",116,247,131
"SPG7","s1640_S_PIT_01_ASEReadCounter.table","NW_015090842.1:10065215",102,219,117
"SPG7","s1640_S_PIT_01_ASEReadCounter.table","NW_015090842.1:10066301",77,166,89
"SPG7","s1640_S_PIT_01_ASEReadCounter.table","NW_015090842.1:10066365",99,202,103
"SPG7","s1640_S_PIT_01_ASEReadCounter.table","NW_015090842.1:10069752",99,223,124
"SPG7","s1640_S_PIT_01_ASEReadCounter.table","NW_015090842.1:10069800",106,246,140
"SPG7","s1640_S_PIT_01_ASEReadCounter.table","NW_015090842.1:10071192",123,272,149
"SPG7","s1640_S_PIT_01_ASEReadCounter.table","NW_015090842.1:10071204",125,261,136
"SPG7","s1640_S_PIT_01_ASEReadCounter.table","NW_015090842.1:10071219",120,256,136
"SPG7","s1640_S_PIT_01_ASEReadCounter.table","NW_015090842.1:10071967",100,211,111
"SPG7","s1640_S_PIT_01_ASEReadCounter.table","NW_015090842.1:10075109",167,296,129
"SPG7","s1640_S_PIT_01_ASEReadCounter.table","NW_015090842.1:10075114",185,311,126
"SPG7","s1640_S_PIT_01_ASEReadCounter.table","NW_015090842.1:10075198",159,257,98
"SPG7","s1640_S_PIT_01_ASEReadCounter.table","NW_015090842.1:10075487",69,164,95
"SPG7","s1640_S_PIT_01_ASEReadCounter.table","NW_015090842.1:10075488",69,167,98
"SPG7","s1640_S_PIT_01_ASEReadCounter.table","NW_015090842.1:10075548",45,118,73
"RPL13","s1640_S_PIT_01_ASEReadCounter.table","NW_015090842.1:10076979",1,1,0
"RPL13","s1640_S_PIT_01_ASEReadCounter.table","NW_015090842.1:10077387",805,1743,938
"RPL13","s1640_S_PIT_01_ASEReadCounter.table","NW_015090842.1:10077978",1127,2370,1243
"RPL13","s1640_S_PIT_01_ASEReadCounter.table","NW_015090842.1:10077992",1131,2309,1178
"CPNE7","s1640_S_PIT_01_ASEReadCounter.table","NW_015090842.1:10084001",1,1,0
"CPNE7","s1640_S_PIT_01_ASEReadCounter.table","NW_015090842.1:10084892",1,1,0
"CPNE7","s1640_S_PIT_01_ASEReadCounter.table","NW_015090842.1:10084921",1,1,0
"CPNE7","s1640_S_PIT_01_ASEReadCounter.table","NW_015090842.1:10084935",1,1,0
"CPNE7","s1640_S_PIT_01_ASEReadCounter.table","NW_015090842.1:10085000",1,2,1
"CPNE7","s1640_S_PIT_01_ASEReadCounter.table","NW_015090842.1:10085089",1,2,1
"CPNE7","s1640_S_PIT_01_ASEReadCounter.table","NW_015090842.1:10085096",2,3,1
"CPNE7","s1640_S_PIT_01_ASEReadCounter.table","NW_015090842.1:10085126",2,2,0
"CPNE7","s1640_S_PIT_01_ASEReadCounter.table","NW_015090842.1:10085180",1,1,0
"CPNE7","s1640_S_PIT_01_ASEReadCounter.table","NW_015090842.1:10085201",2,2,0
"CPNE7","s1640_S_PIT_01_ASEReadCounter.table","NW_015090842.1:10088134",5,5,0
"CPNE7","s1640_S_PIT_01_ASEReadCounter.table","NW_015090842.1:10088146",4,4,0
"CPNE7","s1640_S_PIT_01_ASEReadCounter.table","NW_015090842.1:10088940",4,4,0
"CPNE7","s1640_S_PIT_01_ASEReadCounter.table","NW_015090842.1:10088965",3,3,0
"CPNE7","s1640_S_PIT_01_ASEReadCounter.table","NW_015090842.1:10088967",3,3,0
"CPNE7","s1640_S_PIT_01_ASEReadCounter.table","NW_015090842.1:10088973",2,2,0
"CPNE7","s1640_S_PIT_01_ASEReadCounter.table","NW_015090842.1:10090924",4,5,1
"CPNE7","s1640_S_PIT_01_ASEReadCounter.table","NW_015090842.1:10090930",4,5,1
"CPNE7","s1640_S_PIT_01_ASEReadCounter.table","NW_015090842.1:10091075",6,6,0
"CPNE7","s1640_S_PIT_01_ASEReadCounter.table","NW_015090842.1:10091389",3,4,1
"CPNE7","s1640_S_PIT_01_ASEReadCounter.table","NW_015090842.1:10091407",4,5,1
"CPNE7","s1640_S_PIT_01_ASEReadCounter.table","NW_015090842.1:10091530",1,1,0
"CPNE7","s1640_S_PIT_01_ASEReadCounter.table","NW_015090842.1:10091875",1,1,0
"CPNE7","s1640_S_PIT_01_ASEReadCounter.table","NW_015090842.1:10091983",1,1,0
"CPNE7","s1640_S_PIT_01_ASEReadCounter.table","NW_015090842.1:10091997",1,1,0
"LOC106888185","s1640_S_PIT_01_ASEReadCounter.table","NW_015090842.1:10094965",2,14,12
"LOC106888185","s1640_S_PIT_01_ASEReadCounter.table","NW_015090842.1:10094966",2,14,12
"LOC106888185","s1640_S_PIT_01_ASEReadCounter.table","NW_015090842.1:10094985",2,16,14
"LOC106888185","s1640_S_PIT_01_ASEReadCounter.table","NW_015090842.1:10095055",1,14,13
"LOC106888185","s1640_S_PIT_01_ASEReadCounter.table","NW_015090842.1:10095062",1,15,14
"LOC106888185","s1640_S_PIT_01_ASEReadCounter.table","NW_015090842.1:10095130",3,17,14
"LOC106888185","s1640_S_PIT_01_ASEReadCounter.table","NW_015090842.1:10095265",44,84,40
"LOC106888185","s1640_S_PIT_01_ASEReadCounter.table","NW_015090842.1:10095586",34,92,58
"LOC106888185","s1640_S_PIT_01_ASEReadCounter.table","NW_015090842.1:10095593",40,96,56
"LOC106888185","s1640_S_PIT_01_ASEReadCounter.table","NW_015090842.1:10095616",37,80,43
"LOC106888185","s1640_S_PIT_01_ASEReadCounter.table","NW_015090842.1:10095662",33,63,30
"LOC106888185","s1640_S_PIT_01_ASEReadCounter.table","NW_015090842.1:10095674",28,53,25
"LOC106888185","s1640_S_PIT_01_ASEReadCounter.table","NW_015090842.1:10095786",28,55,27
"LOC106888185","s1640_S_PIT_01_ASEReadCounter.table","NW_015090842.1:10095831",32,58,26
"LOC106888185","s1640_S_PIT_01_ASEReadCounter.table","NW_015090842.1:10096230",31,73,42
"LOC106888185","s1640_S_PIT_01_ASEReadCounter.table","NW_015090842.1:10096249",40,80,40
"LOC106888185","s1640_S_PIT_01_ASEReadCounter.table","NW_015090842.1:10096272",38,79,41
"LOC106888185","s1640_S_PIT_01_ASEReadCounter.table","NW_015090842.1:10096288",41,82,41
"LOC106888185","s1640_S_PIT_01_ASEReadCounter.table","NW_015090842.1:10097248",40,88,48
"LOC106888185","s1640_S_PIT_01_ASEReadCounter.table","NW_015090842.1:10097265",50,105,55
"LOC106888185","s1640_S_PIT_01_ASEReadCounter.table","NW_015090842.1:10097446",4,13,9
"DPEP1","s1640_S_PIT_01_ASEReadCounter.table","NW_015090842.1:10098017",0,2,2
"DPEP1","s1640_S_PIT_01_ASEReadCounter.table","NW_015090842.1:10098518",0,4,4
"DPEP1","s1640_S_PIT_01_ASEReadCounter.table","NW_015090842.1:10098595",0,3,3
"DPEP1","s1640_S_PIT_01_ASEReadCounter.table","NW_015090842.1:10098597",0,3,3
"DPEP1","s1640_S_PIT_01_ASEReadCounter.table","NW_015090842.1:10098601",0,3,3
"DPEP1","s1640_S_PIT_01_ASEReadCounter.table","NW_015090842.1:10098608",0,3,3
"DPEP1","s1640_S_PIT_01_ASEReadCounter.table","NW_015090842.1:10098630",0,3,3
"DPEP1","s1640_S_PIT_01_ASEReadCounter.table","NW_015090842.1:10098659",0,2,2
"DPEP1","s1640_S_PIT_01_ASEReadCounter.table","NW_015090842.1:10099765",0,1,1
"DPEP1","s1640_S_PIT_01_ASEReadCounter.table","NW_015090842.1:10099985",0,4,4
"DPEP1","s1640_S_PIT_01_ASEReadCounter.table","NW_015090842.1:10099986",0,4,4
"DPEP1","s1640_S_PIT_01_ASEReadCounter.table","NW_015090842.1:10099991",0,4,4
"DPEP1","s1640_S_PIT_01_ASEReadCounter.table","NW_015090842.1:10100044",0,7,7
"DPEP1","s1640_S_PIT_01_ASEReadCounter.table","NW_015090842.1:10100045",0,7,7
"DPEP1","s1640_S_PIT_01_ASEReadCounter.table","NW_015090842.1:10100084",0,6,6
"DPEP1","s1640_S_PIT_01_ASEReadCounter.table","NW_015090842.1:10100295",0,6,6
"DPEP1","s1640_S_PIT_01_ASEReadCounter.table","NW_015090842.1:10100529",0,12,12
"DPEP1","s1640_S_PIT_01_ASEReadCounter.table","NW_015090842.1:10100893",0,7,7
"DPEP1","s1640_S_PIT_01_ASEReadCounter.table","NW_015090842.1:10100902",0,7,7
"DPEP1","s1640_S_PIT_01_ASEReadCounter.table","NW_015090842.1:10101072",1,10,9
"DPEP1","s1640_S_PIT_01_ASEReadCounter.table","NW_015090842.1:10101199",1,7,6
"DPEP1","s1640_S_PIT_01_ASEReadCounter.table","NW_015090842.1:10101483",1,8,7
"DPEP1","s1640_S_PIT_01_ASEReadCounter.table","NW_015090842.1:10101497",1,8,7
"DPEP1","s1640_S_PIT_01_ASEReadCounter.table","NW_015090842.1:10101525",0,11,11
"DPEP1","s1640_S_PIT_01_ASEReadCounter.table","NW_015090842.1:10101875",0,8,8
"DPEP1","s1640_S_PIT_01_ASEReadCounter.table","NW_015090842.1:10101913",0,9,9
"DPEP1","s1640_S_PIT_01_ASEReadCounter.table","NW_015090842.1:10101996",0,6,6
"DPEP1","s1640_S_PIT_01_ASEReadCounter.table","NW_015090842.1:10102014",0,6,6
"DPEP1","s1640_S_PIT_01_ASEReadCounter.table","NW_015090842.1:10102035",0,4,4
"DPEP1","s1640_S_PIT_01_ASEReadCounter.table","NW_015090842.1:10102076",0,1,1
"DPEP1","s1640_S_PIT_01_ASEReadCounter.table","NW_015090842.1:10102077",0,1,1
"CHMP1A","s1640_S_PIT_01_ASEReadCounter.table","NW_015090842.1:10102901",60,162,102
"CHMP1A","s1640_S_PIT_01_ASEReadCounter.table","NW_015090842.1:10102961",57,189,132
"CHMP1A","s1640_S_PIT_01_ASEReadCounter.table","NW_015090842.1:10102996",54,180,126
"CHMP1A","s1640_S_PIT_01_ASEReadCounter.table","NW_015090842.1:10103004",57,184,127
"CHMP1A","s1640_S_PIT_01_ASEReadCounter.table","NW_015090842.1:10103006",55,184,129
"CHMP1A","s1640_S_PIT_01_ASEReadCounter.table","NW_015090842.1:10103052",83,213,130
"CHMP1A","s1640_S_PIT_01_ASEReadCounter.table","NW_015090842.1:10103095",82,211,129
"CHMP1A","s1640_S_PIT_01_ASEReadCounter.table","NW_015090842.1:10103096",82,212,130
"CHMP1A","s1640_S_PIT_01_ASEReadCounter.table","NW_015090842.1:10103152",61,157,96
"CHMP1A","s1640_S_PIT_01_ASEReadCounter.table","NW_015090842.1:10103334",59,166,107
"CHMP1A","s1640_S_PIT_01_ASEReadCounter.table","NW_015090842.1:10103373",40,149,109
"CHMP1A","s1640_S_PIT_01_ASEReadCounter.table","NW_015090842.1:10103408",61,176,115
"CHMP1A","s1640_S_PIT_01_ASEReadCounter.table","NW_015090842.1:10103412",61,172,111
"CHMP1A","s1640_S_PIT_01_ASEReadCounter.table","NW_015090842.1:10103512",98,238,140
"CHMP1A","s1640_S_PIT_01_ASEReadCounter.table","NW_015090842.1:10103513",98,242,144
"CHMP1A","s1640_S_PIT_01_ASEReadCounter.table","NW_015090842.1:10103583",84,179,95
"CHMP1A","s1640_S_PIT_01_ASEReadCounter.table","NW_015090842.1:10103614",89,187,98
"CHMP1A","s1640_S_PIT_01_ASEReadCounter.table","NW_015090842.1:10103657",83,184,101
"CHMP1A","s1640_S_PIT_01_ASEReadCounter.table","NW_015090842.1:10103669",72,170,98
"CHMP1A","s1640_S_PIT_01_ASEReadCounter.table","NW_015090842.1:10103674",73,165,92
"CHMP1A","s1640_S_PIT_01_ASEReadCounter.table","NW_015090842.1:10103677",69,160,91
"CHMP1A","s1640_S_PIT_01_ASEReadCounter.table","NW_015090842.1:10103729",104,211,107
"CHMP1A","s1640_S_PIT_01_ASEReadCounter.table","NW_015090842.1:10103758",108,206,98
"CHMP1A","s1640_S_PIT_01_ASEReadCounter.table","NW_015090842.1:10103761",105,206,101
"CHMP1A","s1640_S_PIT_01_ASEReadCounter.table","NW_015090842.1:10103788",114,254,140
"CHMP1A","s1640_S_PIT_01_ASEReadCounter.table","NW_015090842.1:10103789",117,255,138
"CHMP1A","s1640_S_PIT_01_ASEReadCounter.table","NW_015090842.1:10103790",115,255,140
"CHMP1A","s1640_S_PIT_01_ASEReadCounter.table","NW_015090842.1:10103950",99,220,121
"CHMP1A","s1640_S_PIT_01_ASEReadCounter.table","NW_015090842.1:10104335",76,179,103
"CHMP1A","s1640_S_PIT_01_ASEReadCounter.table","NW_015090842.1:10104429",120,239,119
"CHMP1A","s1640_S_PIT_01_ASEReadCounter.table","NW_015090842.1:10104532",120,232,112
"CHMP1A","s1640_S_PIT_01_ASEReadCounter.table","NW_015090842.1:10104633",98,211,113
"CHMP1A","s1640_S_PIT_01_ASEReadCounter.table","NW_015090842.1:10104759",87,216,129
"CHMP1A","s1640_S_PIT_01_ASEReadCounter.table","NW_015090842.1:10104794",105,231,126
"CHMP1A","s1640_S_PIT_01_ASEReadCounter.table","NW_015090842.1:10104844",65,166,101
"CHMP1A","s1640_S_PIT_01_ASEReadCounter.table","NW_015090842.1:10106290",99,208,109
"CHMP1A","s1640_S_PIT_01_ASEReadCounter.table","NW_015090842.1:10106335",120,239,119
"CHMP1A","s1640_S_PIT_01_ASEReadCounter.table","NW_015090842.1:10106383",134,282,148
"CHMP1A","s1640_S_PIT_01_ASEReadCounter.table","NW_015090842.1:10106747",138,281,143
"CHMP1A","s1640_S_PIT_01_ASEReadCounter.table","NW_015090842.1:10107404",136,286,150
"CHMP1A","s1640_S_PIT_01_ASEReadCounter.table","NW_015090842.1:10107410",142,291,149
"CHMP1A","s1640_S_PIT_01_ASEReadCounter.table","NW_015090842.1:10107876",135,261,126
"CDK10","s1640_S_PIT_01_ASEReadCounter.table","NW_015090842.1:10109030",13,14,1
"CDK10","s1640_S_PIT_01_ASEReadCounter.table","NW_015090842.1:10109963",48,106,58
"CDK10","s1640_S_PIT_01_ASEReadCounter.table","NW_015090842.1:10110887",38,77,39
"CDK10","s1640_S_PIT_01_ASEReadCounter.table","NW_015090842.1:10111254",27,76,49
"CDK10","s1640_S_PIT_01_ASEReadCounter.table","NW_015090842.1:10111380",26,87,61
"CDK10","s1640_S_PIT_01_ASEReadCounter.table","NW_015090842.1:10111395",28,85,57
"CDK10","s1640_S_PIT_01_ASEReadCounter.table","NW_015090842.1:10111437",14,69,55
"CDK10","s1640_S_PIT_01_ASEReadCounter.table","NW_015090842.1:10111798",39,103,64
"CDK10","s1640_S_PIT_01_ASEReadCounter.table","NW_015090842.1:10111840",38,106,68
"CDK10","s1640_S_PIT_01_ASEReadCounter.table","NW_015090842.1:10112031",41,91,50
"CDK10","s1640_S_PIT_01_ASEReadCounter.table","NW_015090842.1:10112285",38,91,53
"CDK10","s1640_S_PIT_01_ASEReadCounter.table","NW_015090842.1:10112398",48,108,60
"CDK10","s1640_S_PIT_01_ASEReadCounter.table","NW_015090842.1:10112455",42,95,53
"CDK10","s1640_S_PIT_01_ASEReadCounter.table","NW_015090842.1:10112461",42,90,48
"CDK10","s1640_S_PIT_01_ASEReadCounter.table","NW_015090842.1:10112497",28,72,44
"CDK10","s1640_S_PIT_01_ASEReadCounter.table","NW_015090842.1:10112508",20,68,48
"CDK10","s1640_S_PIT_01_ASEReadCounter.table","NW_015090842.1:10112518",15,60,45
"CDK10","s1640_S_PIT_01_ASEReadCounter.table","NW_015090842.1:10112540",6,49,43
"CDK10","s1640_S_PIT_01_ASEReadCounter.table","NW_015090842.1:10112556",18,64,46
"CDK10","s1640_S_PIT_01_ASEReadCounter.table","NW_015090842.1:10112561",21,74,53
"CDK10","s1640_S_PIT_01_ASEReadCounter.table","NW_015090842.1:10112596",32,82,50
"CDK10","s1640_S_PIT_01_ASEReadCounter.table","NW_015090842.1:10112630",27,67,40
"CDK10","s1640_S_PIT_01_ASEReadCounter.table","NW_015090842.1:10112656",31,72,41
"CDK10","s1640_S_PIT_01_ASEReadCounter.table","NW_015090842.1:10112665",21,56,35
"CDK10","s1640_S_PIT_01_ASEReadCounter.table","NW_015090842.1:10112668",20,54,34
"CDK10","s1640_S_PIT_01_ASEReadCounter.table","NW_015090842.1:10112781",16,41,25
"CDK10","s1640_S_PIT_01_ASEReadCounter.table","NW_015090842.1:10112782",16,41,25
"CDK10","s1640_S_PIT_01_ASEReadCounter.table","NW_015090842.1:10112795",14,38,24
"CDK10","s1640_S_PIT_01_ASEReadCounter.table","NW_015090842.1:10112841",4,10,6
"CDK10","s1640_S_PIT_01_ASEReadCounter.table","NW_015090842.1:10112861",3,10,7
"SPATA2L","s1640_S_PIT_01_ASEReadCounter.table","NW_015090842.1:10113212",12,25,13
"SPATA2L","s1640_S_PIT_01_ASEReadCounter.table","NW_015090842.1:10113280",29,55,26
"SPATA2L","s1640_S_PIT_01_ASEReadCounter.table","NW_015090842.1:10113296",33,58,25
"SPATA2L","s1640_S_PIT_01_ASEReadCounter.table","NW_015090842.1:10113321",35,65,30
"SPATA2L","s1640_S_PIT_01_ASEReadCounter.table","NW_015090842.1:10113332",35,71,36
"SPATA2L","s1640_S_PIT_01_ASEReadCounter.table","NW_015090842.1:10113380",23,55,32
"SPATA2L","s1640_S_PIT_01_ASEReadCounter.table","NW_015090842.1:10113381",23,59,36
"SPATA2L","s1640_S_PIT_01_ASEReadCounter.table","NW_015090842.1:10113412",34,77,43
"SPATA2L","s1640_S_PIT_01_ASEReadCounter.table","NW_015090842.1:10113421",32,75,43
"SPATA2L","s1640_S_PIT_01_ASEReadCounter.table","NW_015090842.1:10113465",31,72,41
"SPATA2L","s1640_S_PIT_01_ASEReadCounter.table","NW_015090842.1:10113535",44,80,36
"SPATA2L","s1640_S_PIT_01_ASEReadCounter.table","NW_015090842.1:10113645",31,82,51
"SPATA2L","s1640_S_PIT_01_ASEReadCounter.table","NW_015090842.1:10113682",31,84,53
"SPATA2L","s1640_S_PIT_01_ASEReadCounter.table","NW_015090842.1:10113696",32,84,52
"SPATA2L","s1640_S_PIT_01_ASEReadCounter.table","NW_015090842.1:10113727",38,102,64
"SPATA2L","s1640_S_PIT_01_ASEReadCounter.table","NW_015090842.1:10113729",99,99,0
"SPATA2L","s1640_S_PIT_01_ASEReadCounter.table","NW_015090842.1:10113799",54,113,59
"SPATA2L","s1640_S_PIT_01_ASEReadCounter.table","NW_015090842.1:10113809",54,119,65
"SPATA2L","s1640_S_PIT_01_ASEReadCounter.table","NW_015090842.1:10113827",54,119,65
"SPATA2L","s1640_S_PIT_01_ASEReadCounter.table","NW_015090842.1:10113831",53,119,66
"SPATA2L","s1640_S_PIT_01_ASEReadCounter.table","NW_015090842.1:10113894",32,90,58
"SPATA2L","s1640_S_PIT_01_ASEReadCounter.table","NW_015090842.1:10113905",30,83,53
"SPATA2L","s1640_S_PIT_01_ASEReadCounter.table","NW_015090842.1:10113914",28,82,54
"SPATA2L","s1640_S_PIT_01_ASEReadCounter.table","NW_015090842.1:10113920",35,90,55
"SPATA2L","s1640_S_PIT_01_ASEReadCounter.table","NW_015090842.1:10113937",45,103,58
"SPATA2L","s1640_S_PIT_01_ASEReadCounter.table","NW_015090842.1:10113971",40,96,56
"SPATA2L","s1640_S_PIT_01_ASEReadCounter.table","NW_015090842.1:10113976",44,104,60
"SPATA2L","s1640_S_PIT_01_ASEReadCounter.table","NW_015090842.1:10113985",48,95,47
"SPATA2L","s1640_S_PIT_01_ASEReadCounter.table","NW_015090842.1:10113994",56,112,56
"SPATA2L","s1640_S_PIT_01_ASEReadCounter.table","NW_015090842.1:10114063",37,89,52
"SPATA2L","s1640_S_PIT_01_ASEReadCounter.table","NW_015090842.1:10114066",35,86,51
"SPATA2L","s1640_S_PIT_01_ASEReadCounter.table","NW_015090842.1:10114069",35,87,52
"SPATA2L","s1640_S_PIT_01_ASEReadCounter.table","NW_015090842.1:10114159",36,68,32
"SPATA2L","s1640_S_PIT_01_ASEReadCounter.table","NW_015090842.1:10114262",88,88,0
"SPATA2L","s1640_S_PIT_01_ASEReadCounter.table","NW_015090842.1:10114470",30,71,41
"SPATA2L","s1640_S_PIT_01_ASEReadCounter.table","NW_015090842.1:10114524",20,39,19
"VPS9D1","s1640_S_PIT_01_ASEReadCounter.table","NW_015090842.1:10116377",17,36,19
"VPS9D1","s1640_S_PIT_01_ASEReadCounter.table","NW_015090842.1:10116415",21,40,19
"VPS9D1","s1640_S_PIT_01_ASEReadCounter.table","NW_015090842.1:10116607",28,43,15
"VPS9D1","s1640_S_PIT_01_ASEReadCounter.table","NW_015090842.1:10116821",23,47,24
"VPS9D1","s1640_S_PIT_01_ASEReadCounter.table","NW_015090842.1:10116825",23,43,20
"VPS9D1","s1640_S_PIT_01_ASEReadCounter.table","NW_015090842.1:10116882",25,47,22
"VPS9D1","s1640_S_PIT_01_ASEReadCounter.table","NW_015090842.1:10116933",22,47,25
"VPS9D1","s1640_S_PIT_01_ASEReadCounter.table","NW_015090842.1:10116942",24,49,25
"VPS9D1","s1640_S_PIT_01_ASEReadCounter.table","NW_015090842.1:10117152",15,36,21
"VPS9D1","s1640_S_PIT_01_ASEReadCounter.table","NW_015090842.1:10117480",19,35,16
"VPS9D1","s1640_S_PIT_01_ASEReadCounter.table","NW_015090842.1:10117497",17,31,14
"VPS9D1","s1640_S_PIT_01_ASEReadCounter.table","NW_015090842.1:10117499",16,30,14
"VPS9D1","s1640_S_PIT_01_ASEReadCounter.table","NW_015090842.1:10117516",19,38,19
"VPS9D1","s1640_S_PIT_01_ASEReadCounter.table","NW_015090842.1:10117525",18,36,18
"VPS9D1","s1640_S_PIT_01_ASEReadCounter.table","NW_015090842.1:10117579",12,30,18
"VPS9D1","s1640_S_PIT_01_ASEReadCounter.table","NW_015090842.1:10117627",12,31,19
"VPS9D1","s1640_S_PIT_01_ASEReadCounter.table","NW_015090842.1:10117678",11,34,23
"VPS9D1","s1640_S_PIT_01_ASEReadCounter.table","NW_015090842.1:10117773",18,39,21
"VPS9D1","s1640_S_PIT_01_ASEReadCounter.table","NW_015090842.1:10117937",22,42,20
"VPS9D1","s1640_S_PIT_01_ASEReadCounter.table","NW_015090842.1:10117961",20,37,17
"VPS9D1","s1640_S_PIT_01_ASEReadCounter.table","NW_015090842.1:10118236",18,44,26
"VPS9D1","s1640_S_PIT_01_ASEReadCounter.table","NW_015090842.1:10118414",29,55,26
"VPS9D1","s1640_S_PIT_01_ASEReadCounter.table","NW_015090842.1:10118973",31,53,22
"VPS9D1","s1640_S_PIT_01_ASEReadCounter.table","NW_015090842.1:10119500",28,50,22
"ZNF276","s1640_S_PIT_01_ASEReadCounter.table","NW_015090842.1:10121760",7,18,11
"ZNF276","s1640_S_PIT_01_ASEReadCounter.table","NW_015090842.1:10121769",7,18,11
"ZNF276","s1640_S_PIT_01_ASEReadCounter.table","NW_015090842.1:10121802",10,22,12
"ZNF276","s1640_S_PIT_01_ASEReadCounter.table","NW_015090842.1:10121971",19,37,18
"ZNF276","s1640_S_PIT_01_ASEReadCounter.table","NW_015090842.1:10122161",37,37,0
"ZNF276","s1640_S_PIT_01_ASEReadCounter.table","NW_015090842.1:10122164",35,35,0
"ZNF276","s1640_S_PIT_01_ASEReadCounter.table","NW_015090842.1:10122184",39,39,0
"ZNF276","s1640_S_PIT_01_ASEReadCounter.table","NW_015090842.1:10122883",18,30,12
"ZNF276","s1640_S_PIT_01_ASEReadCounter.table","NW_015090842.1:10122997",19,38,19
"ZNF276","s1640_S_PIT_01_ASEReadCounter.table","NW_015090842.1:10123069",17,39,22
"ZNF276","s1640_S_PIT_01_ASEReadCounter.table","NW_015090842.1:10123207",27,50,23
"ZNF276","s1640_S_PIT_01_ASEReadCounter.table","NW_015090842.1:10125787",36,63,27
"ZNF276","s1640_S_PIT_01_ASEReadCounter.table","NW_015090842.1:10126309",53,90,37
"ZNF276","s1640_S_PIT_01_ASEReadCounter.table","NW_015090842.1:10126348",44,82,38
"ZNF276","s1640_S_PIT_01_ASEReadCounter.table","NW_015090842.1:10126978",41,77,36
"ZNF276","s1640_S_PIT_01_ASEReadCounter.table","NW_015090842.1:10126991",35,72,37
"ZNF276","s1640_S_PIT_01_ASEReadCounter.table","NW_015090842.1:10127023",38,79,41
"ZNF276","s1640_S_PIT_01_ASEReadCounter.table","NW_015090842.1:10127063",35,67,32
"ZNF276","s1640_S_PIT_01_ASEReadCounter.table","NW_015090842.1:10127373",32,71,39
"ZNF276","s1640_S_PIT_01_ASEReadCounter.table","NW_015090842.1:10127931",39,74,35
"ZNF276","s1640_S_PIT_01_ASEReadCounter.table","NW_015090842.1:10128070",42,86,44
"ZNF276","s1640_S_PIT_01_ASEReadCounter.table","NW_015090842.1:10128102",47,84,37
"ZNF276","s1640_S_PIT_01_ASEReadCounter.table","NW_015090842.1:10128356",23,64,41
"ZNF276","s1640_S_PIT_01_ASEReadCounter.table","NW_015090842.1:10128497",23,49,26
"FANCA","s1640_S_PIT_01_ASEReadCounter.table","NW_015090842.1:10128743",4,4,0
"FANCA","s1640_S_PIT_01_ASEReadCounter.table","NW_015090842.1:10128822",3,6,3
"FANCA","s1640_S_PIT_01_ASEReadCounter.table","NW_015090842.1:10129383",7,13,6
"FANCA","s1640_S_PIT_01_ASEReadCounter.table","NW_015090842.1:10129390",6,11,5
"FANCA","s1640_S_PIT_01_ASEReadCounter.table","NW_015090842.1:10129422",5,9,4
"FANCA","s1640_S_PIT_01_ASEReadCounter.table","NW_015090842.1:10129969",4,7,3
"FANCA","s1640_S_PIT_01_ASEReadCounter.table","NW_015090842.1:10130399",4,8,4
"FANCA","s1640_S_PIT_01_ASEReadCounter.table","NW_015090842.1:10130857",5,8,3
"FANCA","s1640_S_PIT_01_ASEReadCounter.table","NW_015090842.1:10130878",5,8,3
"FANCA","s1640_S_PIT_01_ASEReadCounter.table","NW_015090842.1:10133530",2,5,3
"FANCA","s1640_S_PIT_01_ASEReadCounter.table","NW_015090842.1:10133533",2,5,3
"FANCA","s1640_S_PIT_01_ASEReadCounter.table","NW_015090842.1:10133536",2,5,3
"FANCA","s1640_S_PIT_01_ASEReadCounter.table","NW_015090842.1:10133601",3,4,1
"FANCA","s1640_S_PIT_01_ASEReadCounter.table","NW_015090842.1:10134492",2,6,4
"FANCA","s1640_S_PIT_01_ASEReadCounter.table","NW_015090842.1:10136957",1,7,6
"FANCA","s1640_S_PIT_01_ASEReadCounter.table","NW_015090842.1:10136982",1,6,5
"FANCA","s1640_S_PIT_01_ASEReadCounter.table","NW_015090842.1:10136999",2,3,1
"FANCA","s1640_S_PIT_01_ASEReadCounter.table","NW_015090842.1:10137019",4,8,4
"FANCA","s1640_S_PIT_01_ASEReadCounter.table","NW_015090842.1:10137673",4,9,5
"FANCA","s1640_S_PIT_01_ASEReadCounter.table","NW_015090842.1:10138618",0,3,3
"FANCA","s1640_S_PIT_01_ASEReadCounter.table","NW_015090842.1:10139140",3,6,3
"FANCA","s1640_S_PIT_01_ASEReadCounter.table","NW_015090842.1:10140699",0,1,1
"FANCA","s1640_S_PIT_01_ASEReadCounter.table","NW_015090842.1:10141234",1,2,1
"FANCA","s1640_S_PIT_01_ASEReadCounter.table","NW_015090842.1:10145030",1,3,2
"FANCA","s1640_S_PIT_01_ASEReadCounter.table","NW_015090842.1:10150518",2,5,3
"FANCA","s1640_S_PIT_01_ASEReadCounter.table","NW_015090842.1:10152863",1,2,1
"FANCA","s1640_S_PIT_01_ASEReadCounter.table","NW_015090842.1:10154490",5,5,0
"FANCA","s1640_S_PIT_01_ASEReadCounter.table","NW_015090842.1:10158162",8,9,1
"FANCA","s1640_S_PIT_01_ASEReadCounter.table","NW_015090842.1:10158957",6,6,0
"FANCA","s1640_S_PIT_01_ASEReadCounter.table","NW_015090842.1:10160177",1,2,1
"FANCA","s1640_S_PIT_01_ASEReadCounter.table","NW_015090842.1:10163667",2,2,0
"FANCA","s1640_S_PIT_01_ASEReadCounter.table","NW_015090842.1:10164257",0,2,2
"FANCA","s1640_S_PIT_01_ASEReadCounter.table","NW_015090842.1:10165331",1,1,0
"SPIRE2","s1640_S_PIT_01_ASEReadCounter.table","NW_015090842.1:10172284",14,22,8
"SPIRE2","s1640_S_PIT_01_ASEReadCounter.table","NW_015090842.1:10175262",13,39,26
"SPIRE2","s1640_S_PIT_01_ASEReadCounter.table","NW_015090842.1:10175352",15,22,7
"SPIRE2","s1640_S_PIT_01_ASEReadCounter.table","NW_015090842.1:10175400",39,71,32
"SPIRE2","s1640_S_PIT_01_ASEReadCounter.table","NW_015090842.1:10175418",42,79,37
"SPIRE2","s1640_S_PIT_01_ASEReadCounter.table","NW_015090842.1:10175704",32,73,41
"SPIRE2","s1640_S_PIT_01_ASEReadCounter.table","NW_015090842.1:10176115",48,99,51
"SPIRE2","s1640_S_PIT_01_ASEReadCounter.table","NW_015090842.1:10176561",58,110,52
"SPIRE2","s1640_S_PIT_01_ASEReadCounter.table","NW_015090842.1:10176817",61,107,46
"SPIRE2","s1640_S_PIT_01_ASEReadCounter.table","NW_015090842.1:10177084",38,67,29
"SPIRE2","s1640_S_PIT_01_ASEReadCounter.table","NW_015090842.1:10177838",48,91,43
"SPIRE2","s1640_S_PIT_01_ASEReadCounter.table","NW_015090842.1:10178000",56,92,36
"SPIRE2","s1640_S_PIT_01_ASEReadCounter.table","NW_015090842.1:10178164",56,100,44
"SPIRE2","s1640_S_PIT_01_ASEReadCounter.table","NW_015090842.1:10178216",56,105,49
"SPIRE2","s1640_S_PIT_01_ASEReadCounter.table","NW_015090842.1:10178303",43,84,41
"SPIRE2","s1640_S_PIT_01_ASEReadCounter.table","NW_015090842.1:10178403",44,85,41
"SPIRE2","s1640_S_PIT_01_ASEReadCounter.table","NW_015090842.1:10178409",43,80,37
"SPIRE2","s1640_S_PIT_01_ASEReadCounter.table","NW_015090842.1:10178524",31,62,31
"SPIRE2","s1640_S_PIT_01_ASEReadCounter.table","NW_015090842.1:10178526",32,62,30
"SPIRE2","s1640_S_PIT_01_ASEReadCounter.table","NW_015090842.1:10178531",32,63,31
"SPIRE2","s1640_S_PIT_01_ASEReadCounter.table","NW_015090842.1:10178565",26,61,35
"SPIRE2","s1640_S_PIT_01_ASEReadCounter.table","NW_015090842.1:10178587",25,55,30
"SPIRE2","s1640_S_PIT_01_ASEReadCounter.table","NW_015090842.1:10178640",17,34,17
"SPIRE2","s1640_S_PIT_01_ASEReadCounter.table","NW_015090842.1:10178651",21,41,20
"SPIRE2","s1640_S_PIT_01_ASEReadCounter.table","NW_015090842.1:10178682",19,37,18
"TCF25","s1640_S_PIT_01_ASEReadCounter.table","NW_015090842.1:10180912",40,87,47
"TCF25","s1640_S_PIT_01_ASEReadCounter.table","NW_015090842.1:10180924",43,88,45
"TCF25","s1640_S_PIT_01_ASEReadCounter.table","NW_015090842.1:10180931",44,88,44
"TCF25","s1640_S_PIT_01_ASEReadCounter.table","NW_015090842.1:10185332",102,194,92
"TCF25","s1640_S_PIT_01_ASEReadCounter.table","NW_015090842.1:10196561",85,168,83
"TCF25","s1640_S_PIT_01_ASEReadCounter.table","NW_015090842.1:10197399",187,187,0
"MC1R","s1640_S_PIT_01_ASEReadCounter.table","NW_015090842.1:10202160",1,1,0
"GAS8","s1640_S_PIT_01_ASEReadCounter.table","NW_015090842.1:10228982",48,94,46
"GAS8","s1640_S_PIT_01_ASEReadCounter.table","NW_015090842.1:10229832",38,81,43
"GAS8","s1640_S_PIT_01_ASEReadCounter.table","NW_015090842.1:10232901",43,75,32
"GAS8","s1640_S_PIT_01_ASEReadCounter.table","NW_015090842.1:10232928",47,79,32
"GAS8","s1640_S_PIT_01_ASEReadCounter.table","NW_015090842.1:10232967",38,78,40
"GAS8","s1640_S_PIT_01_ASEReadCounter.table","NW_015090842.1:10233032",28,57,29
"GAS8","s1640_S_PIT_01_ASEReadCounter.table","NW_015090842.1:10233057",26,44,18
"GAS8","s1640_S_PIT_01_ASEReadCounter.table","NW_015090842.1:10233058",26,43,17
"GAS8","s1640_S_PIT_01_ASEReadCounter.table","NW_015090842.1:10233176",23,37,14
"GAS8","s1640_S_PIT_01_ASEReadCounter.table","NW_015090842.1:10233196",23,38,15
"GAS8","s1640_S_PIT_01_ASEReadCounter.table","NW_015090842.1:10233252",16,23,7
"GAS8","s1640_S_PIT_01_ASEReadCounter.table","NW_015090842.1:10233303",7,9,2
"LOC106888094","s1640_S_PIT_01_ASEReadCounter.table","NW_015090842.1:10233334",1,6,5
"LOC106888094","s1640_S_PIT_01_ASEReadCounter.table","NW_015090842.1:10233362",4,12,8
"LOC106888094","s1640_S_PIT_01_ASEReadCounter.table","NW_015090842.1:10233373",4,15,11
"LOC106888094","s1640_S_PIT_01_ASEReadCounter.table","NW_015090842.1:10233388",5,20,15
"LOC106888094","s1640_S_PIT_01_ASEReadCounter.table","NW_015090842.1:10233402",7,21,14
"LOC106888094","s1640_S_PIT_01_ASEReadCounter.table","NW_015090842.1:10233465",10,24,14
"LOC106888094","s1640_S_PIT_01_ASEReadCounter.table","NW_015090842.1:10233803",13,35,22
"LOC106888094","s1640_S_PIT_01_ASEReadCounter.table","NW_015090842.1:10233815",8,24,16
"LOC106888094","s1640_S_PIT_01_ASEReadCounter.table","NW_015090842.1:10235484",0,2,2
"LOC106888094","s1640_S_PIT_01_ASEReadCounter.table","NW_015090842.1:10235611",1,4,3
"LOC106888094","s1640_S_PIT_01_ASEReadCounter.table","NW_015090842.1:10235977",2,2,0
"LOC106888094","s1640_S_PIT_01_ASEReadCounter.table","NW_015090842.1:10236098",0,1,1
"LOC106888094","s1640_S_PIT_01_ASEReadCounter.table","NW_015090842.1:10236161",1,4,3
"LOC106888094","s1640_S_PIT_01_ASEReadCounter.table","NW_015090842.1:10236380",0,2,2
"LOC106888094","s1640_S_PIT_01_ASEReadCounter.table","NW_015090842.1:10236388",0,2,2
"LOC106888094","s1640_S_PIT_01_ASEReadCounter.table","NW_015090842.1:10236425",0,3,3
"LOC106888094","s1640_S_PIT_01_ASEReadCounter.table","NW_015090842.1:10236426",0,3,3
"LOC106888094","s1640_S_PIT_01_ASEReadCounter.table","NW_015090842.1:10236603",0,2,2
"LOC106888173","s1640_S_PIT_01_ASEReadCounter.table","NW_015090842.1:10239596",3,10,7
"LOC106888173","s1640_S_PIT_01_ASEReadCounter.table","NW_015090842.1:10240036",29,45,16
"LOC106888173","s1640_S_PIT_01_ASEReadCounter.table","NW_015090842.1:10240095",44,66,22
"LOC106888173","s1640_S_PIT_01_ASEReadCounter.table","NW_015090842.1:10240280",39,66,27
"LOC106888173","s1640_S_PIT_01_ASEReadCounter.table","NW_015090842.1:10240557",63,90,27
"LOC106888173","s1640_S_PIT_01_ASEReadCounter.table","NW_015090842.1:10240603",65,84,19
"LOC106888173","s1640_S_PIT_01_ASEReadCounter.table","NW_015090842.1:10240609",65,84,19
"LOC106888173","s1640_S_PIT_01_ASEReadCounter.table","NW_015090842.1:10240924",50,68,18
"LOC106888173","s1640_S_PIT_01_ASEReadCounter.table","NW_015090842.1:10241037",38,58,20
"LOC106888173","s1640_S_PIT_01_ASEReadCounter.table","NW_015090842.1:10241046",49,70,21
"LOC106888173","s1640_S_PIT_01_ASEReadCounter.table","NW_015090842.1:10241058",57,78,21
"LOC106888173","s1640_S_PIT_01_ASEReadCounter.table","NW_015090842.1:10241064",61,86,25
"LOC106888173","s1640_S_PIT_01_ASEReadCounter.table","NW_015090842.1:10241163",45,75,30
"LOC106888173","s1640_S_PIT_01_ASEReadCounter.table","NW_015090842.1:10241803",57,89,32
"LOC106888173","s1640_S_PIT_01_ASEReadCounter.table","NW_015090842.1:10241827",58,87,29
"LOC106888173","s1640_S_PIT_01_ASEReadCounter.table","NW_015090842.1:10241869",65,93,28
"LOC106888173","s1640_S_PIT_01_ASEReadCounter.table","NW_015090842.1:10242079",54,77,23
"LOC106888173","s1640_S_PIT_01_ASEReadCounter.table","NW_015090842.1:10242103",61,85,24
"LOC106888173","s1640_S_PIT_01_ASEReadCounter.table","NW_015090842.1:10242157",59,90,31
"LOC106888173","s1640_S_PIT_01_ASEReadCounter.table","NW_015090842.1:10242455",63,93,30
"LOC106888173","s1640_S_PIT_01_ASEReadCounter.table","NW_015090842.1:10242481",62,90,28
"LOC106888173","s1640_S_PIT_01_ASEReadCounter.table","NW_015090842.1:10242590",58,81,23
"LOC106888173","s1640_S_PIT_01_ASEReadCounter.table","NW_015090842.1:10242794",56,86,30
"LOC106888173","s1640_S_PIT_01_ASEReadCounter.table","NW_015090842.1:10242909",52,75,23
"LOC106888173","s1640_S_PIT_01_ASEReadCounter.table","NW_015090842.1:10243094",71,94,23
"LOC106888173","s1640_S_PIT_01_ASEReadCounter.table","NW_015090842.1:10243133",63,81,18
"LOC106888173","s1640_S_PIT_01_ASEReadCounter.table","NW_015090842.1:10243273",83,104,21
"LOC106888173","s1640_S_PIT_01_ASEReadCounter.table","NW_015090842.1:10243278",91,115,24
"LOC106888173","s1640_S_PIT_01_ASEReadCounter.table","NW_015090842.1:10243281",87,112,25
"LOC106888173","s1640_S_PIT_01_ASEReadCounter.table","NW_015090842.1:10243347",77,77,0
"LOC106888173","s1640_S_PIT_01_ASEReadCounter.table","NW_015090842.1:10243353",54,66,12
"LOC106888173","s1640_S_PIT_01_ASEReadCounter.table","NW_015090842.1:10243363",44,52,8
"LOC106888173","s1640_S_PIT_01_ASEReadCounter.table","NW_015090842.1:10243365",43,53,10
"LOC106888173","s1640_S_PIT_01_ASEReadCounter.table","NW_015090842.1:10243529",34,48,14
"LOC106888173","s1640_S_PIT_01_ASEReadCounter.table","NW_015090842.1:10243566",59,84,25
"LOC106888173","s1640_S_PIT_01_ASEReadCounter.table","NW_015090842.1:10243605",65,95,30
"LOC106888173","s1640_S_PIT_01_ASEReadCounter.table","NW_015090842.1:10243614",59,90,31
"LOC106888173","s1640_S_PIT_01_ASEReadCounter.table","NW_015090842.1:10243615",58,87,29
"LOC106888173","s1640_S_PIT_01_ASEReadCounter.table","NW_015090842.1:10243640",50,77,27
"LOC106888173","s1640_S_PIT_01_ASEReadCounter.table","NW_015090842.1:10243680",53,73,20
"LOC106888173","s1640_S_PIT_01_ASEReadCounter.table","NW_015090842.1:10243742",71,91,20
"LOC106888173","s1640_S_PIT_01_ASEReadCounter.table","NW_015090842.1:10243804",54,65,11
"LOC106888173","s1640_S_PIT_01_ASEReadCounter.table","NW_015090842.1:10243913",18,25,7
"LOC106888173","s1640_S_PIT_01_ASEReadCounter.table","NW_015090842.1:10243921",17,25,8
"LOC106888384","s1640_S_PIT_01_ASEReadCounter.table","NW_015090842.1:10244714",2,6,4
"LOC106888384","s1640_S_PIT_01_ASEReadCounter.table","NW_015090842.1:10244998",6,12,6
"LOC106888384","s1640_S_PIT_01_ASEReadCounter.table","NW_015090842.1:10250743",9,16,7
"LOC106888384","s1640_S_PIT_01_ASEReadCounter.table","NW_015090842.1:10250771",10,20,10
"LOC106888384","s1640_S_PIT_01_ASEReadCounter.table","NW_015090842.1:10251343",12,12,0
"LOC106888384","s1640_S_PIT_01_ASEReadCounter.table","NW_015090842.1:10251344",13,13,0
"LOC106888384","s1640_S_PIT_01_ASEReadCounter.table","NW_015090842.1:10251349",12,12,0
"LOC106888384","s1640_S_PIT_01_ASEReadCounter.table","NW_015090842.1:10251354",9,21,12
"LOC106888384","s1640_S_PIT_01_ASEReadCounter.table","NW_015090842.1:10251358",6,17,11
"LOC106888384","s1640_S_PIT_01_ASEReadCounter.table","NW_015090842.1:10251369",2,18,16
"LOC106888384","s1640_S_PIT_01_ASEReadCounter.table","NW_015090842.1:10251370",5,17,12
"LOC106888384","s1640_S_PIT_01_ASEReadCounter.table","NW_015090842.1:10251375",5,17,12
"LOC106888384","s1640_S_PIT_01_ASEReadCounter.table","NW_015090842.1:10251388",1,11,10
"LOC106888384","s1640_S_PIT_01_ASEReadCounter.table","NW_015090842.1:10251390",1,12,11
"LOC106888384","s1640_S_PIT_01_ASEReadCounter.table","NW_015090842.1:10251393",1,12,11
"LOC106888384","s1640_S_PIT_01_ASEReadCounter.table","NW_015090842.1:10251399",0,10,10
"LOC106888384","s1640_S_PIT_01_ASEReadCounter.table","NW_015090842.1:10251492",3,3,0
"LOC106888384","s1640_S_PIT_01_ASEReadCounter.table","NW_015090842.1:10253165",7,18,11
"LOC106888384","s1640_S_PIT_01_ASEReadCounter.table","NW_015090842.1:10253284",5,22,17
"LOC106888384","s1640_S_PIT_01_ASEReadCounter.table","NW_015090842.1:10253605",8,16,8
"LOC106888384","s1640_S_PIT_01_ASEReadCounter.table","NW_015090842.1:10254028",9,20,11
"LOC106888384","s1640_S_PIT_01_ASEReadCounter.table","NW_015090842.1:10254227",6,18,12
"LOC106888384","s1640_S_PIT_01_ASEReadCounter.table","NW_015090842.1:10254233",4,17,13
"LOC106888384","s1640_S_PIT_01_ASEReadCounter.table","NW_015090842.1:10254263",7,22,15
"LOC106888384","s1640_S_PIT_01_ASEReadCounter.table","NW_015090842.1:10254293",7,20,13
"LOC106888384","s1640_S_PIT_01_ASEReadCounter.table","NW_015090842.1:10254570",6,16,10
"LOC106888384","s1640_S_PIT_01_ASEReadCounter.table","NW_015090842.1:10254647",6,13,7
"LOC106888384","s1640_S_PIT_01_ASEReadCounter.table","NW_015090842.1:10254663",6,11,5
"LOC106888384","s1640_S_PIT_01_ASEReadCounter.table","NW_015090842.1:10254840",1,5,4
"LOC106888384","s1640_S_PIT_01_ASEReadCounter.table","NW_015090842.1:10254854",7,7,0
"LOC106888384","s1640_S_PIT_01_ASEReadCounter.table","NW_015090842.1:10254891",13,13,0
"LOC106888384","s1640_S_PIT_01_ASEReadCounter.table","NW_015090842.1:10254900",4,12,8
"LOC106888384","s1640_S_PIT_01_ASEReadCounter.table","NW_015090842.1:10254915",4,12,8
"LOC106888384","s1640_S_PIT_01_ASEReadCounter.table","NW_015090842.1:10254965",4,4,0
"LOC106888384","s1640_S_PIT_01_ASEReadCounter.table","NW_015090842.1:10254975",0,4,4
"LOC106888384","s1640_S_PIT_01_ASEReadCounter.table","NW_015090842.1:10255077",5,17,12
"LOC106888384","s1640_S_PIT_01_ASEReadCounter.table","NW_015090842.1:10255117",3,13,10
"LOC106888384","s1640_S_PIT_01_ASEReadCounter.table","NW_015090842.1:10255138",2,10,8
"LOC106888384","s1640_S_PIT_01_ASEReadCounter.table","NW_015090842.1:10255139",2,10,8
"LOC106888384","s1640_S_PIT_01_ASEReadCounter.table","NW_015090842.1:10255209",3,12,9
"LOC106888384","s1640_S_PIT_01_ASEReadCounter.table","NW_015090842.1:10255211",3,11,8
"LOC106888384","s1640_S_PIT_01_ASEReadCounter.table","NW_015090842.1:10255236",4,11,7
"LOC106888384","s1640_S_PIT_01_ASEReadCounter.table","NW_015090842.1:10255262",6,14,8
"LOC106888384","s1640_S_PIT_01_ASEReadCounter.table","NW_015090842.1:10255264",6,16,10
"LOC106888384","s1640_S_PIT_01_ASEReadCounter.table","NW_015090842.1:10255306",9,22,13
"LOC106888384","s1640_S_PIT_01_ASEReadCounter.table","NW_015090842.1:10255340",8,22,14
"LOC106888384","s1640_S_PIT_01_ASEReadCounter.table","NW_015090842.1:10255410",7,18,11
"LOC106888384","s1640_S_PIT_01_ASEReadCounter.table","NW_015090842.1:10255449",6,16,10
"LOC106888384","s1640_S_PIT_01_ASEReadCounter.table","NW_015090842.1:10255496",9,23,14
"LOC106888384","s1640_S_PIT_01_ASEReadCounter.table","NW_015090842.1:10255505",8,23,15
"LOC106888384","s1640_S_PIT_01_ASEReadCounter.table","NW_015090842.1:10255531",7,22,15
"LOC106888384","s1640_S_PIT_01_ASEReadCounter.table","NW_015090842.1:10255608",5,17,12
"LOC106888384","s1640_S_PIT_01_ASEReadCounter.table","NW_015090842.1:10255614",6,17,11
"LOC106888384","s1640_S_PIT_01_ASEReadCounter.table","NW_015090842.1:10255704",4,17,13
"LOC106888384","s1640_S_PIT_01_ASEReadCounter.table","NW_015090842.1:10255731",4,16,12
"LOC106888384","s1640_S_PIT_01_ASEReadCounter.table","NW_015090842.1:10255771",2,8,6
"TANGO6","s1640_S_PIT_01_ASEReadCounter.table","NW_015090842.1:10257782",6,11,5
"TANGO6","s1640_S_PIT_01_ASEReadCounter.table","NW_015090842.1:10258162",14,21,7
"TANGO6","s1640_S_PIT_01_ASEReadCounter.table","NW_015090842.1:10258185",10,17,7
"TANGO6","s1640_S_PIT_01_ASEReadCounter.table","NW_015090842.1:10259267",19,35,16
"TANGO6","s1640_S_PIT_01_ASEReadCounter.table","NW_015090842.1:10260250",37,73,36
"TANGO6","s1640_S_PIT_01_ASEReadCounter.table","NW_015090842.1:10260979",24,46,22
"TANGO6","s1640_S_PIT_01_ASEReadCounter.table","NW_015090842.1:10261599",25,52,27
"TANGO6","s1640_S_PIT_01_ASEReadCounter.table","NW_015090842.1:10268425",34,68,34
"TANGO6","s1640_S_PIT_01_ASEReadCounter.table","NW_015090842.1:10269831",34,66,32
"TANGO6","s1640_S_PIT_01_ASEReadCounter.table","NW_015090842.1:10270813",31,66,35
"TANGO6","s1640_S_PIT_01_ASEReadCounter.table","NW_015090842.1:10273952",18,34,16
"TANGO6","s1640_S_PIT_01_ASEReadCounter.table","NW_015090842.1:10273970",22,48,26
"TANGO6","s1640_S_PIT_01_ASEReadCounter.table","NW_015090842.1:10274018",19,45,26
"TANGO6","s1640_S_PIT_01_ASEReadCounter.table","NW_015090842.1:10275974",31,54,23
"TANGO6","s1640_S_PIT_01_ASEReadCounter.table","NW_015090842.1:10275976",31,53,22
"TANGO6","s1640_S_PIT_01_ASEReadCounter.table","NW_015090842.1:10276123",22,45,23
"TANGO6","s1640_S_PIT_01_ASEReadCounter.table","NW_015090842.1:10276271",17,38,21
"TANGO6","s1640_S_PIT_01_ASEReadCounter.table","NW_015090842.1:10276272",15,36,21
"TANGO6","s1640_S_PIT_01_ASEReadCounter.table","NW_015090842.1:10276275",18,39,21
"TANGO6","s1640_S_PIT_01_ASEReadCounter.table","NW_015090842.1:10276278",18,38,20
"TANGO6","s1640_S_PIT_01_ASEReadCounter.table","NW_015090842.1:10276368",16,25,9
"TANGO6","s1640_S_PIT_01_ASEReadCounter.table","NW_015090842.1:10276373",17,29,12
"TANGO6","s1640_S_PIT_01_ASEReadCounter.table","NW_015090842.1:10276630",15,27,12
"TANGO6","s1640_S_PIT_01_ASEReadCounter.table","NW_015090842.1:10281498",29,45,16
"TANGO6","s1640_S_PIT_01_ASEReadCounter.table","NW_015090842.1:10282842",24,40,16
"TANGO6","s1640_S_PIT_01_ASEReadCounter.table","NW_015090842.1:10282863",15,31,16
"TANGO6","s1640_S_PIT_01_ASEReadCounter.table","NW_015090842.1:10282869",17,33,16
"TANGO6","s1640_S_PIT_01_ASEReadCounter.table","NW_015090842.1:10282903",15,36,21
"TANGO6","s1640_S_PIT_01_ASEReadCounter.table","NW_015090842.1:10283757",21,36,15
"TANGO6","s1640_S_PIT_01_ASEReadCounter.table","NW_015090842.1:10283785",21,37,16
"HAS3","s1640_S_PIT_01_ASEReadCounter.table","NW_015090842.1:10290927",0,1,1
"HAS3","s1640_S_PIT_01_ASEReadCounter.table","NW_015090842.1:10291004",0,1,1
"CHTF8","s1640_S_PIT_01_ASEReadCounter.table","NW_015090842.1:10291319",1,3,2
"CHTF8","s1640_S_PIT_01_ASEReadCounter.table","NW_015090842.1:10291342",4,6,2
"CHTF8","s1640_S_PIT_01_ASEReadCounter.table","NW_015090842.1:10291491",13,21,8
"CHTF8","s1640_S_PIT_01_ASEReadCounter.table","NW_015090842.1:10291520",20,28,8
"CHTF8","s1640_S_PIT_01_ASEReadCounter.table","NW_015090842.1:10291593",25,41,16
"CHTF8","s1640_S_PIT_01_ASEReadCounter.table","NW_015090842.1:10291600",21,36,15
"CHTF8","s1640_S_PIT_01_ASEReadCounter.table","NW_015090842.1:10291609",22,37,15
"CHTF8","s1640_S_PIT_01_ASEReadCounter.table","NW_015090842.1:10291639",29,46,17
"CHTF8","s1640_S_PIT_01_ASEReadCounter.table","NW_015090842.1:10291641",28,44,16
"CHTF8","s1640_S_PIT_01_ASEReadCounter.table","NW_015090842.1:10291648",33,49,16
"CHTF8","s1640_S_PIT_01_ASEReadCounter.table","NW_015090842.1:10291656",31,50,19
"CHTF8","s1640_S_PIT_01_ASEReadCounter.table","NW_015090842.1:10291675",34,52,18
"CHTF8","s1640_S_PIT_01_ASEReadCounter.table","NW_015090842.1:10291696",34,50,16
"CHTF8","s1640_S_PIT_01_ASEReadCounter.table","NW_015090842.1:10291714",39,56,17
"CHTF8","s1640_S_PIT_01_ASEReadCounter.table","NW_015090842.1:10291732",35,52,17
"CHTF8","s1640_S_PIT_01_ASEReadCounter.table","NW_015090842.1:10291755",25,44,19
"CHTF8","s1640_S_PIT_01_ASEReadCounter.table","NW_015090842.1:10291756",26,45,19
"CHTF8","s1640_S_PIT_01_ASEReadCounter.table","NW_015090842.1:10291758",26,45,19
"CHTF8","s1640_S_PIT_01_ASEReadCounter.table","NW_015090842.1:10291792",26,47,21
"CHTF8","s1640_S_PIT_01_ASEReadCounter.table","NW_015090842.1:10291895",21,36,15
"CHTF8","s1640_S_PIT_01_ASEReadCounter.table","NW_015090842.1:10292132",26,49,23
"CHTF8","s1640_S_PIT_01_ASEReadCounter.table","NW_015090842.1:10292314",19,41,22
"CHTF8","s1640_S_PIT_01_ASEReadCounter.table","NW_015090842.1:10292317",18,39,21
"CHTF8","s1640_S_PIT_01_ASEReadCounter.table","NW_015090842.1:10292928",4,9,5
"UTP4","s1640_S_PIT_01_ASEReadCounter.table","NW_015090842.1:10293146",50,98,48
"UTP4","s1640_S_PIT_01_ASEReadCounter.table","NW_015090842.1:10293151",51,97,46
"UTP4","s1640_S_PIT_01_ASEReadCounter.table","NW_015090842.1:10293191",31,62,31
"UTP4","s1640_S_PIT_01_ASEReadCounter.table","NW_015090842.1:10293362",33,73,40
"UTP4","s1640_S_PIT_01_ASEReadCounter.table","NW_015090842.1:10293430",38,75,37
"UTP4","s1640_S_PIT_01_ASEReadCounter.table","NW_015090842.1:10293625",27,63,36
"UTP4","s1640_S_PIT_01_ASEReadCounter.table","NW_015090842.1:10293684",41,79,38
"UTP4","s1640_S_PIT_01_ASEReadCounter.table","NW_015090842.1:10294093",28,56,28
"UTP4","s1640_S_PIT_01_ASEReadCounter.table","NW_015090842.1:10294568",22,53,31
"UTP4","s1640_S_PIT_01_ASEReadCounter.table","NW_015090842.1:10294622",23,51,28
"UTP4","s1640_S_PIT_01_ASEReadCounter.table","NW_015090842.1:10294632",21,45,24
"UTP4","s1640_S_PIT_01_ASEReadCounter.table","NW_015090842.1:10295238",28,59,31
"UTP4","s1640_S_PIT_01_ASEReadCounter.table","NW_015090842.1:10295880",29,63,34
"UTP4","s1640_S_PIT_01_ASEReadCounter.table","NW_015090842.1:10295884",26,63,37
"UTP4","s1640_S_PIT_01_ASEReadCounter.table","NW_015090842.1:10295903",27,58,31
"UTP4","s1640_S_PIT_01_ASEReadCounter.table","NW_015090842.1:10295906",26,55,29
"UTP4","s1640_S_PIT_01_ASEReadCounter.table","NW_015090842.1:10295915",28,56,28
"UTP4","s1640_S_PIT_01_ASEReadCounter.table","NW_015090842.1:10295938",29,49,20
"UTP4","s1640_S_PIT_01_ASEReadCounter.table","NW_015090842.1:10296175",22,61,39
"UTP4","s1640_S_PIT_01_ASEReadCounter.table","NW_015090842.1:10296660",48,75,27
"UTP4","s1640_S_PIT_01_ASEReadCounter.table","NW_015090842.1:10296679",48,74,26
"UTP4","s1640_S_PIT_01_ASEReadCounter.table","NW_015090842.1:10297193",34,62,28
"UTP4","s1640_S_PIT_01_ASEReadCounter.table","NW_015090842.1:10297220",38,66,28
"UTP4","s1640_S_PIT_01_ASEReadCounter.table","NW_015090842.1:10297307",36,71,35
"UTP4","s1640_S_PIT_01_ASEReadCounter.table","NW_015090842.1:10297558",38,72,34
"UTP4","s1640_S_PIT_01_ASEReadCounter.table","NW_015090842.1:10297943",20,48,28
"UTP4","s1640_S_PIT_01_ASEReadCounter.table","NW_015090842.1:10297979",21,41,20
"UTP4","s1640_S_PIT_01_ASEReadCounter.table","NW_015090842.1:10298022",11,21,10
"UTP4","s1640_S_PIT_01_ASEReadCounter.table","NW_015090842.1:10298079",0,4,4
"UTP4","s1640_S_PIT_01_ASEReadCounter.table","NW_015090842.1:10298081",0,2,2
"UTP4","s1640_S_PIT_01_ASEReadCounter.table","NW_015090842.1:10298082",0,3,3
"SNTB2","s1640_S_PIT_01_ASEReadCounter.table","NW_015090842.1:10298905",4,4,0
"SNTB2","s1640_S_PIT_01_ASEReadCounter.table","NW_015090842.1:10298928",5,7,2
"SNTB2","s1640_S_PIT_01_ASEReadCounter.table","NW_015090842.1:10303506",23,48,25
"SNTB2","s1640_S_PIT_01_ASEReadCounter.table","NW_015090842.1:10303524",21,39,18
"SNTB2","s1640_S_PIT_01_ASEReadCounter.table","NW_015090842.1:10304059",16,39,23
"SNTB2","s1640_S_PIT_01_ASEReadCounter.table","NW_015090842.1:10304089",19,39,20
"SNTB2","s1640_S_PIT_01_ASEReadCounter.table","NW_015090842.1:10304167",16,28,12
"SNTB2","s1640_S_PIT_01_ASEReadCounter.table","NW_015090842.1:10304176",12,26,14
"SNTB2","s1640_S_PIT_01_ASEReadCounter.table","NW_015090842.1:10305069",21,44,23
"SNTB2","s1640_S_PIT_01_ASEReadCounter.table","NW_015090842.1:10305099",23,47,24
"SNTB2","s1640_S_PIT_01_ASEReadCounter.table","NW_015090842.1:10305451",15,28,13
"SNTB2","s1640_S_PIT_01_ASEReadCounter.table","NW_015090842.1:10305547",14,38,24
"SNTB2","s1640_S_PIT_01_ASEReadCounter.table","NW_015090842.1:10305847",15,38,23
"SNTB2","s1640_S_PIT_01_ASEReadCounter.table","NW_015090842.1:10305911",22,46,24
"SNTB2","s1640_S_PIT_01_ASEReadCounter.table","NW_015090842.1:10306173",26,41,15
"SNTB2","s1640_S_PIT_01_ASEReadCounter.table","NW_015090842.1:10306275",15,26,11
"SNTB2","s1640_S_PIT_01_ASEReadCounter.table","NW_015090842.1:10306457",16,28,12
"SNTB2","s1640_S_PIT_01_ASEReadCounter.table","NW_015090842.1:10306496",20,32,12
"SNTB2","s1640_S_PIT_01_ASEReadCounter.table","NW_015090842.1:10306499",20,31,11
"VPS4A","s1640_S_PIT_01_ASEReadCounter.table","NW_015090842.1:10308566",94,196,102
"VPS4A","s1640_S_PIT_01_ASEReadCounter.table","NW_015090842.1:10308573",97,204,107
"VPS4A","s1640_S_PIT_01_ASEReadCounter.table","NW_015090842.1:10308856",147,314,167
"VPS4A","s1640_S_PIT_01_ASEReadCounter.table","NW_015090842.1:10309056",139,364,225
"VPS4A","s1640_S_PIT_01_ASEReadCounter.table","NW_015090842.1:10309089",173,390,217
"VPS4A","s1640_S_PIT_01_ASEReadCounter.table","NW_015090842.1:10309392",163,351,188
"VPS4A","s1640_S_PIT_01_ASEReadCounter.table","NW_015090842.1:10309413",171,369,198
"VPS4A","s1640_S_PIT_01_ASEReadCounter.table","NW_015090842.1:10309467",171,392,221
"VPS4A","s1640_S_PIT_01_ASEReadCounter.table","NW_015090842.1:10310230",172,389,217
"VPS4A","s1640_S_PIT_01_ASEReadCounter.table","NW_015090842.1:10310425",160,366,206
"VPS4A","s1640_S_PIT_01_ASEReadCounter.table","NW_015090842.1:10310639",185,430,245
"VPS4A","s1640_S_PIT_01_ASEReadCounter.table","NW_015090842.1:10310640",186,429,243
"VPS4A","s1640_S_PIT_01_ASEReadCounter.table","NW_015090842.1:10310687",183,408,225
"VPS4A","s1640_S_PIT_01_ASEReadCounter.table","NW_015090842.1:10310734",141,307,166
"VPS4A","s1640_S_PIT_01_ASEReadCounter.table","NW_015090842.1:10310737",153,322,169
"VPS4A","s1640_S_PIT_01_ASEReadCounter.table","NW_015090842.1:10310746",148,308,160
"VPS4A","s1640_S_PIT_01_ASEReadCounter.table","NW_015090842.1:10310767",175,336,161
"VPS4A","s1640_S_PIT_01_ASEReadCounter.table","NW_015090842.1:10310995",149,333,184
"VPS4A","s1640_S_PIT_01_ASEReadCounter.table","NW_015090842.1:10311004",156,338,182
"VPS4A","s1640_S_PIT_01_ASEReadCounter.table","NW_015090842.1:10311007",158,346,188
"VPS4A","s1640_S_PIT_01_ASEReadCounter.table","NW_015090842.1:10311013",172,358,186
"VPS4A","s1640_S_PIT_01_ASEReadCounter.table","NW_015090842.1:10311022",148,335,187
"VPS4A","s1640_S_PIT_01_ASEReadCounter.table","NW_015090842.1:10311023",149,337,188
"VPS4A","s1640_S_PIT_01_ASEReadCounter.table","NW_015090842.1:10311426",168,383,215
"VPS4A","s1640_S_PIT_01_ASEReadCounter.table","NW_015090842.1:10311489",2,12,10
"VPS4A","s1640_S_PIT_01_ASEReadCounter.table","NW_015090842.1:10311490",3,7,4
"VPS4A","s1640_S_PIT_01_ASEReadCounter.table","NW_015090842.1:10311525",8,20,12
"VPS4A","s1640_S_PIT_01_ASEReadCounter.table","NW_015090842.1:10311529",8,24,16
"VPS4A","s1640_S_PIT_01_ASEReadCounter.table","NW_015090842.1:10311530",8,26,18
"VPS4A","s1640_S_PIT_01_ASEReadCounter.table","NW_015090842.1:10311552",26,55,29
"VPS4A","s1640_S_PIT_01_ASEReadCounter.table","NW_015090842.1:10311689",22,48,26
"VPS4A","s1640_S_PIT_01_ASEReadCounter.table","NW_015090842.1:10311700",28,52,24
"VPS4A","s1640_S_PIT_01_ASEReadCounter.table","NW_015090842.1:10311701",29,53,24
"VPS4A","s1640_S_PIT_01_ASEReadCounter.table","NW_015090842.1:10311703",29,53,24
"COG8","s1640_S_PIT_01_ASEReadCounter.table","NW_015090842.1:10313487",30,61,31
"COG8","s1640_S_PIT_01_ASEReadCounter.table","NW_015090842.1:10313559",46,85,39
"COG8","s1640_S_PIT_01_ASEReadCounter.table","NW_015090842.1:10313579",47,83,36
"COG8","s1640_S_PIT_01_ASEReadCounter.table","NW_015090842.1:10313665",41,79,38
"COG8","s1640_S_PIT_01_ASEReadCounter.table","NW_015090842.1:10313681",39,82,43
"COG8","s1640_S_PIT_01_ASEReadCounter.table","NW_015090842.1:10313768",49,95,46
"COG8","s1640_S_PIT_01_ASEReadCounter.table","NW_015090842.1:10313775",50,88,38
"COG8","s1640_S_PIT_01_ASEReadCounter.table","NW_015090842.1:10313811",39,69,30
"COG8","s1640_S_PIT_01_ASEReadCounter.table","NW_015090842.1:10313858",28,51,23
"COG8","s1640_S_PIT_01_ASEReadCounter.table","NW_015090842.1:10313859",51,51,0
"COG8","s1640_S_PIT_01_ASEReadCounter.table","NW_015090842.1:10314100",39,69,30
"COG8","s1640_S_PIT_01_ASEReadCounter.table","NW_015090842.1:10314213",50,90,40
"COG8","s1640_S_PIT_01_ASEReadCounter.table","NW_015090842.1:10315093",38,67,29
"COG8","s1640_S_PIT_01_ASEReadCounter.table","NW_015090842.1:10315162",35,65,30
"COG8","s1640_S_PIT_01_ASEReadCounter.table","NW_015090842.1:10315285",47,93,46
"COG8","s1640_S_PIT_01_ASEReadCounter.table","NW_015090842.1:10315360",28,59,31
"COG8","s1640_S_PIT_01_ASEReadCounter.table","NW_015090842.1:10315369",30,64,34
"COG8","s1640_S_PIT_01_ASEReadCounter.table","NW_015090842.1:10315508",19,42,23
"COG8","s1640_S_PIT_01_ASEReadCounter.table","NW_015090842.1:10315624",28,65,37
"COG8","s1640_S_PIT_01_ASEReadCounter.table","NW_015090842.1:10315693",39,86,47
"COG8","s1640_S_PIT_01_ASEReadCounter.table","NW_015090842.1:10315698",42,87,45
"COG8","s1640_S_PIT_01_ASEReadCounter.table","NW_015090842.1:10315768",36,72,36
"COG8","s1640_S_PIT_01_ASEReadCounter.table","NW_015090842.1:10315769",36,71,35
"COG8","s1640_S_PIT_01_ASEReadCounter.table","NW_015090842.1:10315784",33,66,33
"COG8","s1640_S_PIT_01_ASEReadCounter.table","NW_015090842.1:10316093",35,55,20
"COG8","s1640_S_PIT_01_ASEReadCounter.table","NW_015090842.1:10316133",33,56,23
"NIP7","s1640_S_PIT_01_ASEReadCounter.table","NW_015090842.1:10316759",16,39,23
"NIP7","s1640_S_PIT_01_ASEReadCounter.table","NW_015090842.1:10316967",85,186,101
"NIP7","s1640_S_PIT_01_ASEReadCounter.table","NW_015090842.1:10316995",106,208,102
"NIP7","s1640_S_PIT_01_ASEReadCounter.table","NW_015090842.1:10317240",141,255,114
"NIP7","s1640_S_PIT_01_ASEReadCounter.table","NW_015090842.1:10317247",138,246,108
"NIP7","s1640_S_PIT_01_ASEReadCounter.table","NW_015090842.1:10317264",122,206,84
"NIP7","s1640_S_PIT_01_ASEReadCounter.table","NW_015090842.1:10317433",142,277,135
"NIP7","s1640_S_PIT_01_ASEReadCounter.table","NW_015090842.1:10317738",91,199,108
"NIP7","s1640_S_PIT_01_ASEReadCounter.table","NW_015090842.1:10317769",102,209,107
"NIP7","s1640_S_PIT_01_ASEReadCounter.table","NW_015090842.1:10317808",69,140,71
"NIP7","s1640_S_PIT_01_ASEReadCounter.table","NW_015090842.1:10317870",43,96,53
"NIP7","s1640_S_PIT_01_ASEReadCounter.table","NW_015090842.1:10317871",44,97,53
"NIP7","s1640_S_PIT_01_ASEReadCounter.table","NW_015090842.1:10317898",32,70,38
"NIP7","s1640_S_PIT_01_ASEReadCounter.table","NW_015090842.1:10317911",29,58,29
"TMED6","s1640_S_PIT_01_ASEReadCounter.table","NW_015090842.1:10318514",1,1,0
"TERF2","s1640_S_PIT_01_ASEReadCounter.table","NW_015090842.1:10321768",16,44,28
"TERF2","s1640_S_PIT_01_ASEReadCounter.table","NW_015090842.1:10321777",16,43,27
"TERF2","s1640_S_PIT_01_ASEReadCounter.table","NW_015090842.1:10321805",16,47,31
"TERF2","s1640_S_PIT_01_ASEReadCounter.table","NW_015090842.1:10321878",28,76,48
"TERF2","s1640_S_PIT_01_ASEReadCounter.table","NW_015090842.1:10321893",4,74,70
"TERF2","s1640_S_PIT_01_ASEReadCounter.table","NW_015090842.1:10321897",29,68,39
"TERF2","s1640_S_PIT_01_ASEReadCounter.table","NW_015090842.1:10321908",29,66,37
"TERF2","s1640_S_PIT_01_ASEReadCounter.table","NW_015090842.1:10322001",41,106,65
"TERF2","s1640_S_PIT_01_ASEReadCounter.table","NW_015090842.1:10322035",36,89,53
"TERF2","s1640_S_PIT_01_ASEReadCounter.table","NW_015090842.1:10322051",36,94,58
"TERF2","s1640_S_PIT_01_ASEReadCounter.table","NW_015090842.1:10322137",41,80,39
"TERF2","s1640_S_PIT_01_ASEReadCounter.table","NW_015090842.1:10322144",43,81,38
"TERF2","s1640_S_PIT_01_ASEReadCounter.table","NW_015090842.1:10322388",35,94,59
"TERF2","s1640_S_PIT_01_ASEReadCounter.table","NW_015090842.1:10322396",35,92,57
"TERF2","s1640_S_PIT_01_ASEReadCounter.table","NW_015090842.1:10322502",51,119,68
"TERF2","s1640_S_PIT_01_ASEReadCounter.table","NW_015090842.1:10322504",51,120,69
"TERF2","s1640_S_PIT_01_ASEReadCounter.table","NW_015090842.1:10322510",50,121,71
"TERF2","s1640_S_PIT_01_ASEReadCounter.table","NW_015090842.1:10323580",60,131,71
"TERF2","s1640_S_PIT_01_ASEReadCounter.table","NW_015090842.1:10324314",45,113,68
"TERF2","s1640_S_PIT_01_ASEReadCounter.table","NW_015090842.1:10326832",45,87,42
"TERF2","s1640_S_PIT_01_ASEReadCounter.table","NW_015090842.1:10327787",36,78,42
"TERF2","s1640_S_PIT_01_ASEReadCounter.table","NW_015090842.1:10328588",45,106,61
"TERF2","s1640_S_PIT_01_ASEReadCounter.table","NW_015090842.1:10328644",41,96,55
"TERF2","s1640_S_PIT_01_ASEReadCounter.table","NW_015090842.1:10329813",36,72,36
"TERF2","s1640_S_PIT_01_ASEReadCounter.table","NW_015090842.1:10330749",36,84,48
"TERF2","s1640_S_PIT_01_ASEReadCounter.table","NW_015090842.1:10330789",46,96,50
"CYB5B","s1640_S_PIT_01_ASEReadCounter.table","NW_015090842.1:10336595",7,28,21
"CYB5B","s1640_S_PIT_01_ASEReadCounter.table","NW_015090842.1:10336667",102,247,145
"CYB5B","s1640_S_PIT_01_ASEReadCounter.table","NW_015090842.1:10336689",157,376,219
"CYB5B","s1640_S_PIT_01_ASEReadCounter.table","NW_015090842.1:10336728",216,514,298
"CYB5B","s1640_S_PIT_01_ASEReadCounter.table","NW_015090842.1:10345068",217,552,335
"CYB5B","s1640_S_PIT_01_ASEReadCounter.table","NW_015090842.1:10348800",255,618,363
"CYB5B","s1640_S_PIT_01_ASEReadCounter.table","NW_015090842.1:10349046",215,491,276
"CYB5B","s1640_S_PIT_01_ASEReadCounter.table","NW_015090842.1:10349119",137,382,245
"CYB5B","s1640_S_PIT_01_ASEReadCounter.table","NW_015090842.1:10349146",78,317,239
"CYB5B","s1640_S_PIT_01_ASEReadCounter.table","NW_015090842.1:10349157",124,364,240
"CYB5B","s1640_S_PIT_01_ASEReadCounter.table","NW_015090842.1:10349263",289,289,0
