"gene","id","snp","ref_count","total_count","alt_count"
"CENPN","s1670_SAT_M_BLOOD_ASEReadCounter.table","NW_015090842.1:5801632",0,1,1
"CENPN","s1670_SAT_M_BLOOD_ASEReadCounter.table","NW_015090842.1:5801655",0,2,2
"CENPN","s1670_SAT_M_BLOOD_ASEReadCounter.table","NW_015090842.1:5801670",0,2,2
"CENPN","s1670_SAT_M_BLOOD_ASEReadCounter.table","NW_015090842.1:5801674",0,2,2
"CENPN","s1670_SAT_M_BLOOD_ASEReadCounter.table","NW_015090842.1:5801692",0,2,2
"CENPN","s1670_SAT_M_BLOOD_ASEReadCounter.table","NW_015090842.1:5802008",1,8,7
"CENPN","s1670_SAT_M_BLOOD_ASEReadCounter.table","NW_015090842.1:5802012",1,8,7
"CENPN","s1670_SAT_M_BLOOD_ASEReadCounter.table","NW_015090842.1:5802087",1,7,6
"CENPN","s1670_SAT_M_BLOOD_ASEReadCounter.table","NW_015090842.1:5810113",1,1,0
"CENPN","s1670_SAT_M_BLOOD_ASEReadCounter.table","NW_015090842.1:5810147",1,1,0
"CENPN","s1670_SAT_M_BLOOD_ASEReadCounter.table","NW_015090842.1:5810148",1,1,0
"ATMIN","s1670_SAT_M_BLOOD_ASEReadCounter.table","NW_015090842.1:5818789",17,32,15
"ATMIN","s1670_SAT_M_BLOOD_ASEReadCounter.table","NW_015090842.1:5819958",22,50,28
"ATMIN","s1670_SAT_M_BLOOD_ASEReadCounter.table","NW_015090842.1:5820004",29,55,26
"ATMIN","s1670_SAT_M_BLOOD_ASEReadCounter.table","NW_015090842.1:5820217",26,45,19
"ATMIN","s1670_SAT_M_BLOOD_ASEReadCounter.table","NW_015090842.1:5820250",30,45,15
"ATMIN","s1670_SAT_M_BLOOD_ASEReadCounter.table","NW_015090842.1:5820298",32,46,14
"ATMIN","s1670_SAT_M_BLOOD_ASEReadCounter.table","NW_015090842.1:5820417",27,38,11
"ATMIN","s1670_SAT_M_BLOOD_ASEReadCounter.table","NW_015090842.1:5820421",23,35,12
"ATMIN","s1670_SAT_M_BLOOD_ASEReadCounter.table","NW_015090842.1:5820448",23,31,8
"ATMIN","s1670_SAT_M_BLOOD_ASEReadCounter.table","NW_015090842.1:5820457",19,30,11
"ATMIN","s1670_SAT_M_BLOOD_ASEReadCounter.table","NW_015090842.1:5820510",27,45,18
"ATMIN","s1670_SAT_M_BLOOD_ASEReadCounter.table","NW_015090842.1:5820673",29,47,18
"ATMIN","s1670_SAT_M_BLOOD_ASEReadCounter.table","NW_015090842.1:5820754",16,36,20
"ATMIN","s1670_SAT_M_BLOOD_ASEReadCounter.table","NW_015090842.1:5820820",23,45,22
"ATMIN","s1670_SAT_M_BLOOD_ASEReadCounter.table","NW_015090842.1:5820865",29,53,24
"ATMIN","s1670_SAT_M_BLOOD_ASEReadCounter.table","NW_015090842.1:5820889",21,44,23
"ATMIN","s1670_SAT_M_BLOOD_ASEReadCounter.table","NW_015090842.1:5820891",21,44,23
"ATMIN","s1670_SAT_M_BLOOD_ASEReadCounter.table","NW_015090842.1:5820997",35,51,16
"ATMIN","s1670_SAT_M_BLOOD_ASEReadCounter.table","NW_015090842.1:5821063",33,48,15
"ATMIN","s1670_SAT_M_BLOOD_ASEReadCounter.table","NW_015090842.1:5821132",29,50,21
"ATMIN","s1670_SAT_M_BLOOD_ASEReadCounter.table","NW_015090842.1:5821645",30,55,25
"ATMIN","s1670_SAT_M_BLOOD_ASEReadCounter.table","NW_015090842.1:5825066",22,38,16
"ATMIN","s1670_SAT_M_BLOOD_ASEReadCounter.table","NW_015090842.1:5825106",26,47,21
"ATMIN","s1670_SAT_M_BLOOD_ASEReadCounter.table","NW_015090842.1:5825122",26,47,21
"ATMIN","s1670_SAT_M_BLOOD_ASEReadCounter.table","NW_015090842.1:5825178",32,56,24
"ATMIN","s1670_SAT_M_BLOOD_ASEReadCounter.table","NW_015090842.1:5825194",29,53,24
"ATMIN","s1670_SAT_M_BLOOD_ASEReadCounter.table","NW_015090842.1:5825195",29,53,24
"ATMIN","s1670_SAT_M_BLOOD_ASEReadCounter.table","NW_015090842.1:5825220",29,45,16
"ATMIN","s1670_SAT_M_BLOOD_ASEReadCounter.table","NW_015090842.1:5825240",32,49,17
"ATMIN","s1670_SAT_M_BLOOD_ASEReadCounter.table","NW_015090842.1:5825303",25,46,21
"ATMIN","s1670_SAT_M_BLOOD_ASEReadCounter.table","NW_015090842.1:5825304",25,46,21
"ATMIN","s1670_SAT_M_BLOOD_ASEReadCounter.table","NW_015090842.1:5825310",24,45,21
"ATMIN","s1670_SAT_M_BLOOD_ASEReadCounter.table","NW_015090842.1:5825406",23,37,14
"ATMIN","s1670_SAT_M_BLOOD_ASEReadCounter.table","NW_015090842.1:5825415",24,38,14
"ATMIN","s1670_SAT_M_BLOOD_ASEReadCounter.table","NW_015090842.1:5825438",22,37,15
"ATMIN","s1670_SAT_M_BLOOD_ASEReadCounter.table","NW_015090842.1:5825485",21,39,18
"ATMIN","s1670_SAT_M_BLOOD_ASEReadCounter.table","NW_015090842.1:5825524",20,37,17
"ATMIN","s1670_SAT_M_BLOOD_ASEReadCounter.table","NW_015090842.1:5825557",16,28,12
"ATMIN","s1670_SAT_M_BLOOD_ASEReadCounter.table","NW_015090842.1:5825571",19,35,16
"ATMIN","s1670_SAT_M_BLOOD_ASEReadCounter.table","NW_015090842.1:5825579",17,33,16
"ATMIN","s1670_SAT_M_BLOOD_ASEReadCounter.table","NW_015090842.1:5825590",18,34,16
"ATMIN","s1670_SAT_M_BLOOD_ASEReadCounter.table","NW_015090842.1:5825689",23,44,21
"ATMIN","s1670_SAT_M_BLOOD_ASEReadCounter.table","NW_015090842.1:5825703",25,45,20
"ATMIN","s1670_SAT_M_BLOOD_ASEReadCounter.table","NW_015090842.1:5825787",21,40,19
"ATMIN","s1670_SAT_M_BLOOD_ASEReadCounter.table","NW_015090842.1:5825833",21,45,24
"ATMIN","s1670_SAT_M_BLOOD_ASEReadCounter.table","NW_015090842.1:5825841",20,43,23
"ATMIN","s1670_SAT_M_BLOOD_ASEReadCounter.table","NW_015090842.1:5825895",24,47,23
"ATMIN","s1670_SAT_M_BLOOD_ASEReadCounter.table","NW_015090842.1:5825984",28,44,16
"ATMIN","s1670_SAT_M_BLOOD_ASEReadCounter.table","NW_015090842.1:5826162",28,42,14
"ATMIN","s1670_SAT_M_BLOOD_ASEReadCounter.table","NW_015090842.1:5826194",29,45,16
"ATMIN","s1670_SAT_M_BLOOD_ASEReadCounter.table","NW_015090842.1:5826235",30,48,18
"ATMIN","s1670_SAT_M_BLOOD_ASEReadCounter.table","NW_015090842.1:5826245",28,46,18
"ATMIN","s1670_SAT_M_BLOOD_ASEReadCounter.table","NW_015090842.1:5826335",12,21,9
"ATMIN","s1670_SAT_M_BLOOD_ASEReadCounter.table","NW_015090842.1:5826417",22,25,3
"ATMIN","s1670_SAT_M_BLOOD_ASEReadCounter.table","NW_015090842.1:5826431",21,25,4
"ATMIN","s1670_SAT_M_BLOOD_ASEReadCounter.table","NW_015090842.1:5826438",17,22,5
"ATMIN","s1670_SAT_M_BLOOD_ASEReadCounter.table","NW_015090842.1:5826463",24,37,13
"ATMIN","s1670_SAT_M_BLOOD_ASEReadCounter.table","NW_015090842.1:5826502",24,39,15
"ATMIN","s1670_SAT_M_BLOOD_ASEReadCounter.table","NW_015090842.1:5826511",24,39,15
"ATMIN","s1670_SAT_M_BLOOD_ASEReadCounter.table","NW_015090842.1:5826659",24,36,12
"ATMIN","s1670_SAT_M_BLOOD_ASEReadCounter.table","NW_015090842.1:5826701",22,38,16
"ATMIN","s1670_SAT_M_BLOOD_ASEReadCounter.table","NW_015090842.1:5826702",22,38,16
"ATMIN","s1670_SAT_M_BLOOD_ASEReadCounter.table","NW_015090842.1:5826732",25,40,15
"ATMIN","s1670_SAT_M_BLOOD_ASEReadCounter.table","NW_015090842.1:5826745",26,44,18
"ATMIN","s1670_SAT_M_BLOOD_ASEReadCounter.table","NW_015090842.1:5826835",26,45,19
"ATMIN","s1670_SAT_M_BLOOD_ASEReadCounter.table","NW_015090842.1:5826910",26,36,10
"ATMIN","s1670_SAT_M_BLOOD_ASEReadCounter.table","NW_015090842.1:5826942",27,40,13
"ATMIN","s1670_SAT_M_BLOOD_ASEReadCounter.table","NW_015090842.1:5827193",26,49,23
"ATMIN","s1670_SAT_M_BLOOD_ASEReadCounter.table","NW_015090842.1:5827196",24,49,25
"ATMIN","s1670_SAT_M_BLOOD_ASEReadCounter.table","NW_015090842.1:5827269",24,45,21
"ATMIN","s1670_SAT_M_BLOOD_ASEReadCounter.table","NW_015090842.1:5827315",21,35,14
"ATMIN","s1670_SAT_M_BLOOD_ASEReadCounter.table","NW_015090842.1:5827316",21,37,16
"ATMIN","s1670_SAT_M_BLOOD_ASEReadCounter.table","NW_015090842.1:5827333",19,36,17
"BCO1","s1670_SAT_M_BLOOD_ASEReadCounter.table","NW_015090842.1:5917836",1,1,0
"BCO1","s1670_SAT_M_BLOOD_ASEReadCounter.table","NW_015090842.1:5917912",1,1,0
"BCO1","s1670_SAT_M_BLOOD_ASEReadCounter.table","NW_015090842.1:5917941",2,2,0
"BCO1","s1670_SAT_M_BLOOD_ASEReadCounter.table","NW_015090842.1:5917971",2,2,0
"BCO1","s1670_SAT_M_BLOOD_ASEReadCounter.table","NW_015090842.1:5921679",1,1,0
"BCO1","s1670_SAT_M_BLOOD_ASEReadCounter.table","NW_015090842.1:5921726",1,1,0
"BCO1","s1670_SAT_M_BLOOD_ASEReadCounter.table","NW_015090842.1:5925753",1,1,0
"BCO1","s1670_SAT_M_BLOOD_ASEReadCounter.table","NW_015090842.1:5927921",1,1,0
"BCO1","s1670_SAT_M_BLOOD_ASEReadCounter.table","NW_015090842.1:5927948",1,1,0
"BCO1","s1670_SAT_M_BLOOD_ASEReadCounter.table","NW_015090842.1:5927968",1,1,0
"BCO1","s1670_SAT_M_BLOOD_ASEReadCounter.table","NW_015090842.1:5928052",1,1,0
"BCO1","s1670_SAT_M_BLOOD_ASEReadCounter.table","NW_015090842.1:5934558",2,2,0
"BCO1","s1670_SAT_M_BLOOD_ASEReadCounter.table","NW_015090842.1:5934575",2,2,0
"BCO1","s1670_SAT_M_BLOOD_ASEReadCounter.table","NW_015090842.1:5934608",2,2,0
"BCO1","s1670_SAT_M_BLOOD_ASEReadCounter.table","NW_015090842.1:5934647",2,2,0
"BCO1","s1670_SAT_M_BLOOD_ASEReadCounter.table","NW_015090842.1:5934725",2,2,0
"BCO1","s1670_SAT_M_BLOOD_ASEReadCounter.table","NW_015090842.1:5934726",2,2,0
"BCO1","s1670_SAT_M_BLOOD_ASEReadCounter.table","NW_015090842.1:5934821",2,2,0
"BCO1","s1670_SAT_M_BLOOD_ASEReadCounter.table","NW_015090842.1:5934826",2,2,0
"BCO1","s1670_SAT_M_BLOOD_ASEReadCounter.table","NW_015090842.1:5934844",1,1,0
"BCO1","s1670_SAT_M_BLOOD_ASEReadCounter.table","NW_015090842.1:5934958",1,1,0
"BCO1","s1670_SAT_M_BLOOD_ASEReadCounter.table","NW_015090842.1:5934976",1,1,0
"GAN","s1670_SAT_M_BLOOD_ASEReadCounter.table","NW_015090842.1:5966483",1,1,0
"CMIP","s1670_SAT_M_BLOOD_ASEReadCounter.table","NW_015090842.1:6109159",23,30,7
"CMIP","s1670_SAT_M_BLOOD_ASEReadCounter.table","NW_015090842.1:6109166",22,31,9
"CMIP","s1670_SAT_M_BLOOD_ASEReadCounter.table","NW_015090842.1:6114641",23,33,10
"CMIP","s1670_SAT_M_BLOOD_ASEReadCounter.table","NW_015090842.1:6114751",23,34,11
"CMIP","s1670_SAT_M_BLOOD_ASEReadCounter.table","NW_015090842.1:6114824",17,27,10
"CMIP","s1670_SAT_M_BLOOD_ASEReadCounter.table","NW_015090842.1:6128998",27,42,15
"CMIP","s1670_SAT_M_BLOOD_ASEReadCounter.table","NW_015090842.1:6130562",16,34,18
"CMIP","s1670_SAT_M_BLOOD_ASEReadCounter.table","NW_015090842.1:6132522",15,27,12
"CMIP","s1670_SAT_M_BLOOD_ASEReadCounter.table","NW_015090842.1:6134088",20,37,17
"CMIP","s1670_SAT_M_BLOOD_ASEReadCounter.table","NW_015090842.1:6138265",23,32,9
"CMIP","s1670_SAT_M_BLOOD_ASEReadCounter.table","NW_015090842.1:6138300",20,30,10
"CMIP","s1670_SAT_M_BLOOD_ASEReadCounter.table","NW_015090842.1:6138342",22,35,13
"CMIP","s1670_SAT_M_BLOOD_ASEReadCounter.table","NW_015090842.1:6138343",22,34,12
"CMIP","s1670_SAT_M_BLOOD_ASEReadCounter.table","NW_015090842.1:6138345",22,34,12
"CMIP","s1670_SAT_M_BLOOD_ASEReadCounter.table","NW_015090842.1:6138647",16,27,11
"CMIP","s1670_SAT_M_BLOOD_ASEReadCounter.table","NW_015090842.1:6138745",18,28,10
"CMIP","s1670_SAT_M_BLOOD_ASEReadCounter.table","NW_015090842.1:6138832",3,9,6
"CMIP","s1670_SAT_M_BLOOD_ASEReadCounter.table","NW_015090842.1:6138967",16,23,7
"CMIP","s1670_SAT_M_BLOOD_ASEReadCounter.table","NW_015090842.1:6139131",7,12,5
"CMIP","s1670_SAT_M_BLOOD_ASEReadCounter.table","NW_015090842.1:6139163",15,17,2
"CMIP","s1670_SAT_M_BLOOD_ASEReadCounter.table","NW_015090842.1:6139360",1,2,1
"CMIP","s1670_SAT_M_BLOOD_ASEReadCounter.table","NW_015090842.1:6139572",4,4,0
"CMIP","s1670_SAT_M_BLOOD_ASEReadCounter.table","NW_015090842.1:6139773",10,10,0
"PLCG2","s1670_SAT_M_BLOOD_ASEReadCounter.table","NW_015090842.1:6179613",4,17,13
"PLCG2","s1670_SAT_M_BLOOD_ASEReadCounter.table","NW_015090842.1:6179658",8,23,15
"PLCG2","s1670_SAT_M_BLOOD_ASEReadCounter.table","NW_015090842.1:6203766",11,88,77
"PLCG2","s1670_SAT_M_BLOOD_ASEReadCounter.table","NW_015090842.1:6203775",11,86,75
"PLCG2","s1670_SAT_M_BLOOD_ASEReadCounter.table","NW_015090842.1:6203787",12,84,72
"PLCG2","s1670_SAT_M_BLOOD_ASEReadCounter.table","NW_015090842.1:6205047",9,78,69
"PLCG2","s1670_SAT_M_BLOOD_ASEReadCounter.table","NW_015090842.1:6208541",4,70,66
"PLCG2","s1670_SAT_M_BLOOD_ASEReadCounter.table","NW_015090842.1:6209741",4,72,68
"PLCG2","s1670_SAT_M_BLOOD_ASEReadCounter.table","NW_015090842.1:6209798",6,72,66
"PLCG2","s1670_SAT_M_BLOOD_ASEReadCounter.table","NW_015090842.1:6209816",5,72,67
"PLCG2","s1670_SAT_M_BLOOD_ASEReadCounter.table","NW_015090842.1:6217547",4,97,93
"PLCG2","s1670_SAT_M_BLOOD_ASEReadCounter.table","NW_015090842.1:6218641",6,78,72
"PLCG2","s1670_SAT_M_BLOOD_ASEReadCounter.table","NW_015090842.1:6220552",8,98,90
"PLCG2","s1670_SAT_M_BLOOD_ASEReadCounter.table","NW_015090842.1:6221969",6,82,76
"PLCG2","s1670_SAT_M_BLOOD_ASEReadCounter.table","NW_015090842.1:6228672",7,72,65
"PLCG2","s1670_SAT_M_BLOOD_ASEReadCounter.table","NW_015090842.1:6228694",7,75,68
"PLCG2","s1670_SAT_M_BLOOD_ASEReadCounter.table","NW_015090842.1:6228722",6,87,81
"PLCG2","s1670_SAT_M_BLOOD_ASEReadCounter.table","NW_015090842.1:6228747",7,104,97
"PLCG2","s1670_SAT_M_BLOOD_ASEReadCounter.table","NW_015090842.1:6228835",3,109,106
"PLCG2","s1670_SAT_M_BLOOD_ASEReadCounter.table","NW_015090842.1:6228841",4,112,108
"PLCG2","s1670_SAT_M_BLOOD_ASEReadCounter.table","NW_015090842.1:6228865",5,105,100
"PLCG2","s1670_SAT_M_BLOOD_ASEReadCounter.table","NW_015090842.1:6228917",6,113,107
"PLCG2","s1670_SAT_M_BLOOD_ASEReadCounter.table","NW_015090842.1:6228926",5,104,99
"PLCG2","s1670_SAT_M_BLOOD_ASEReadCounter.table","NW_015090842.1:6228954",4,84,80
"PLCG2","s1670_SAT_M_BLOOD_ASEReadCounter.table","NW_015090842.1:6229002",6,88,82
"PLCG2","s1670_SAT_M_BLOOD_ASEReadCounter.table","NW_015090842.1:6229006",5,83,78
"PLCG2","s1670_SAT_M_BLOOD_ASEReadCounter.table","NW_015090842.1:6229081",4,62,58
"PLCG2","s1670_SAT_M_BLOOD_ASEReadCounter.table","NW_015090842.1:6229097",2,51,49
"PLCG2","s1670_SAT_M_BLOOD_ASEReadCounter.table","NW_015090842.1:6229160",3,38,35
"PLCG2","s1670_SAT_M_BLOOD_ASEReadCounter.table","NW_015090842.1:6229213",3,43,40
"PLCG2","s1670_SAT_M_BLOOD_ASEReadCounter.table","NW_015090842.1:6229231",5,57,52
"PLCG2","s1670_SAT_M_BLOOD_ASEReadCounter.table","NW_015090842.1:6229663",6,34,28
"PLCG2","s1670_SAT_M_BLOOD_ASEReadCounter.table","NW_015090842.1:6229748",6,35,29
"PLCG2","s1670_SAT_M_BLOOD_ASEReadCounter.table","NW_015090842.1:6229892",6,45,39
"PLCG2","s1670_SAT_M_BLOOD_ASEReadCounter.table","NW_015090842.1:6230248",3,38,35
"PLCG2","s1670_SAT_M_BLOOD_ASEReadCounter.table","NW_015090842.1:6230255",3,37,34
"PLCG2","s1670_SAT_M_BLOOD_ASEReadCounter.table","NW_015090842.1:6230296",2,22,20
"PLCG2","s1670_SAT_M_BLOOD_ASEReadCounter.table","NW_015090842.1:6230349",5,36,31
"PLCG2","s1670_SAT_M_BLOOD_ASEReadCounter.table","NW_015090842.1:6230381",3,33,30
"PLCG2","s1670_SAT_M_BLOOD_ASEReadCounter.table","NW_015090842.1:6230408",1,38,37
"PLCG2","s1670_SAT_M_BLOOD_ASEReadCounter.table","NW_015090842.1:6230439",1,35,34
"PLCG2","s1670_SAT_M_BLOOD_ASEReadCounter.table","NW_015090842.1:6230757",2,15,13
"PLCG2","s1670_SAT_M_BLOOD_ASEReadCounter.table","NW_015090842.1:6230758",2,16,14
"PLCG2","s1670_SAT_M_BLOOD_ASEReadCounter.table","NW_015090842.1:6230898",8,32,24
"PLCG2","s1670_SAT_M_BLOOD_ASEReadCounter.table","NW_015090842.1:6230976",8,35,27
"PLCG2","s1670_SAT_M_BLOOD_ASEReadCounter.table","NW_015090842.1:6231078",3,44,41
"PLCG2","s1670_SAT_M_BLOOD_ASEReadCounter.table","NW_015090842.1:6231138",4,40,36
"PLCG2","s1670_SAT_M_BLOOD_ASEReadCounter.table","NW_015090842.1:6231177",4,39,35
"PLCG2","s1670_SAT_M_BLOOD_ASEReadCounter.table","NW_015090842.1:6231263",4,35,31
"PLCG2","s1670_SAT_M_BLOOD_ASEReadCounter.table","NW_015090842.1:6231309",2,14,12
"SDR42E1","s1670_SAT_M_BLOOD_ASEReadCounter.table","NW_015090842.1:6235292",0,7,7
"SDR42E1","s1670_SAT_M_BLOOD_ASEReadCounter.table","NW_015090842.1:6235315",0,8,8
"SDR42E1","s1670_SAT_M_BLOOD_ASEReadCounter.table","NW_015090842.1:6235348",0,7,7
"SDR42E1","s1670_SAT_M_BLOOD_ASEReadCounter.table","NW_015090842.1:6235355",0,7,7
"SDR42E1","s1670_SAT_M_BLOOD_ASEReadCounter.table","NW_015090842.1:6235417",0,9,9
"SDR42E1","s1670_SAT_M_BLOOD_ASEReadCounter.table","NW_015090842.1:6235526",8,8,0
"SDR42E1","s1670_SAT_M_BLOOD_ASEReadCounter.table","NW_015090842.1:6235558",0,6,6
"SDR42E1","s1670_SAT_M_BLOOD_ASEReadCounter.table","NW_015090842.1:6235603",9,9,0
"SDR42E1","s1670_SAT_M_BLOOD_ASEReadCounter.table","NW_015090842.1:6235741",1,11,10
"SDR42E1","s1670_SAT_M_BLOOD_ASEReadCounter.table","NW_015090842.1:6235777",1,8,7
"SDR42E1","s1670_SAT_M_BLOOD_ASEReadCounter.table","NW_015090842.1:6235806",1,42,41
"SDR42E1","s1670_SAT_M_BLOOD_ASEReadCounter.table","NW_015090842.1:6235809",1,41,40
"SDR42E1","s1670_SAT_M_BLOOD_ASEReadCounter.table","NW_015090842.1:6235816",2,42,40
"SDR42E1","s1670_SAT_M_BLOOD_ASEReadCounter.table","NW_015090842.1:6235914",1,38,37
"SDR42E1","s1670_SAT_M_BLOOD_ASEReadCounter.table","NW_015090842.1:6235935",1,39,38
"SDR42E1","s1670_SAT_M_BLOOD_ASEReadCounter.table","NW_015090842.1:6235957",1,36,35
"SDR42E1","s1670_SAT_M_BLOOD_ASEReadCounter.table","NW_015090842.1:6236040",0,34,34
"SDR42E1","s1670_SAT_M_BLOOD_ASEReadCounter.table","NW_015090842.1:6236260",0,38,38
"SDR42E1","s1670_SAT_M_BLOOD_ASEReadCounter.table","NW_015090842.1:6236281",0,34,34
"SDR42E1","s1670_SAT_M_BLOOD_ASEReadCounter.table","NW_015090842.1:6236305",0,31,31
"SDR42E1","s1670_SAT_M_BLOOD_ASEReadCounter.table","NW_015090842.1:6236458",0,52,52
"SDR42E1","s1670_SAT_M_BLOOD_ASEReadCounter.table","NW_015090842.1:6236476",0,58,58
"SDR42E1","s1670_SAT_M_BLOOD_ASEReadCounter.table","NW_015090842.1:6236608",0,33,33
"SDR42E1","s1670_SAT_M_BLOOD_ASEReadCounter.table","NW_015090842.1:6238244",0,15,15
"SDR42E1","s1670_SAT_M_BLOOD_ASEReadCounter.table","NW_015090842.1:6238829",0,1,1
"HSD17B2","s1670_SAT_M_BLOOD_ASEReadCounter.table","NW_015090842.1:6257616",0,25,25
"HSD17B2","s1670_SAT_M_BLOOD_ASEReadCounter.table","NW_015090842.1:6257670",0,29,29
"HSD17B2","s1670_SAT_M_BLOOD_ASEReadCounter.table","NW_015090842.1:6257684",0,29,29
"HSD17B2","s1670_SAT_M_BLOOD_ASEReadCounter.table","NW_015090842.1:6257829",0,28,28
"HSD17B2","s1670_SAT_M_BLOOD_ASEReadCounter.table","NW_015090842.1:6262951",1,35,34
"HSD17B2","s1670_SAT_M_BLOOD_ASEReadCounter.table","NW_015090842.1:6262974",1,41,40
"HSD17B2","s1670_SAT_M_BLOOD_ASEReadCounter.table","NW_015090842.1:6266125",1,32,31
"HSD17B2","s1670_SAT_M_BLOOD_ASEReadCounter.table","NW_015090842.1:6266135",1,35,34
"HSD17B2","s1670_SAT_M_BLOOD_ASEReadCounter.table","NW_015090842.1:6266795",0,52,52
"HSD17B2","s1670_SAT_M_BLOOD_ASEReadCounter.table","NW_015090842.1:6266918",1,48,47
"HSD17B2","s1670_SAT_M_BLOOD_ASEReadCounter.table","NW_015090842.1:6266944",0,49,49
"HSD17B2","s1670_SAT_M_BLOOD_ASEReadCounter.table","NW_015090842.1:6266997",0,41,41
"HSD17B2","s1670_SAT_M_BLOOD_ASEReadCounter.table","NW_015090842.1:6267053",0,40,40
"HSD17B2","s1670_SAT_M_BLOOD_ASEReadCounter.table","NW_015090842.1:6267196",0,24,24
"HSD17B2","s1670_SAT_M_BLOOD_ASEReadCounter.table","NW_015090842.1:6267273",0,46,46
"HSD17B2","s1670_SAT_M_BLOOD_ASEReadCounter.table","NW_015090842.1:6267358",0,48,48
"HSD17B2","s1670_SAT_M_BLOOD_ASEReadCounter.table","NW_015090842.1:6267674",0,37,37
"HSD17B2","s1670_SAT_M_BLOOD_ASEReadCounter.table","NW_015090842.1:6267913",0,43,43
"HSD17B2","s1670_SAT_M_BLOOD_ASEReadCounter.table","NW_015090842.1:6268098",0,43,43
"HSD17B2","s1670_SAT_M_BLOOD_ASEReadCounter.table","NW_015090842.1:6268180",0,43,43
"HSD17B2","s1670_SAT_M_BLOOD_ASEReadCounter.table","NW_015090842.1:6268203",0,46,46
"ARY2","s1670_SAT_M_BLOOD_ASEReadCounter.table","NW_015090842.1:6303922",1,9,8
"ARY2","s1670_SAT_M_BLOOD_ASEReadCounter.table","NW_015090842.1:6303954",2,10,8
"ARY2","s1670_SAT_M_BLOOD_ASEReadCounter.table","NW_015090842.1:6303979",2,14,12
"ARY2","s1670_SAT_M_BLOOD_ASEReadCounter.table","NW_015090842.1:6305848",3,19,16
"ARY2","s1670_SAT_M_BLOOD_ASEReadCounter.table","NW_015090842.1:6305856",3,19,16
"ARY2","s1670_SAT_M_BLOOD_ASEReadCounter.table","NW_015090842.1:6305857",3,19,16
"ARY2","s1670_SAT_M_BLOOD_ASEReadCounter.table","NW_015090842.1:6306017",2,16,14
"ARY2","s1670_SAT_M_BLOOD_ASEReadCounter.table","NW_015090842.1:6306052",4,12,8
"ARY2","s1670_SAT_M_BLOOD_ASEReadCounter.table","NW_015090842.1:6306094",3,12,9
"ARY2","s1670_SAT_M_BLOOD_ASEReadCounter.table","NW_015090842.1:6306100",3,12,9
"ARY2","s1670_SAT_M_BLOOD_ASEReadCounter.table","NW_015090842.1:6306146",1,18,17
"ARY2","s1670_SAT_M_BLOOD_ASEReadCounter.table","NW_015090842.1:6306147",1,18,17
"ARY2","s1670_SAT_M_BLOOD_ASEReadCounter.table","NW_015090842.1:6306390",3,12,9
"ARY2","s1670_SAT_M_BLOOD_ASEReadCounter.table","NW_015090842.1:6306567",1,7,6
"ARY2","s1670_SAT_M_BLOOD_ASEReadCounter.table","NW_015090842.1:6306705",1,6,5
"ARY2","s1670_SAT_M_BLOOD_ASEReadCounter.table","NW_015090842.1:6306713",6,6,0
"ARY2","s1670_SAT_M_BLOOD_ASEReadCounter.table","NW_015090842.1:6306773",0,4,4
"ARY2","s1670_SAT_M_BLOOD_ASEReadCounter.table","NW_015090842.1:6307039",0,2,2
"ARY2","s1670_SAT_M_BLOOD_ASEReadCounter.table","NW_015090842.1:6307043",0,2,2
"ARY2","s1670_SAT_M_BLOOD_ASEReadCounter.table","NW_015090842.1:6307093",0,2,2
"ARY2","s1670_SAT_M_BLOOD_ASEReadCounter.table","NW_015090842.1:6307138",1,2,1
"ARY2","s1670_SAT_M_BLOOD_ASEReadCounter.table","NW_015090842.1:6307157",1,3,2
"ARY2","s1670_SAT_M_BLOOD_ASEReadCounter.table","NW_015090842.1:6307187",1,3,2
"ARY2","s1670_SAT_M_BLOOD_ASEReadCounter.table","NW_015090842.1:6307278",2,12,10
"ARY2","s1670_SAT_M_BLOOD_ASEReadCounter.table","NW_015090842.1:6307305",2,12,10
"ARY2","s1670_SAT_M_BLOOD_ASEReadCounter.table","NW_015090842.1:6307318",0,8,8
"ARY2","s1670_SAT_M_BLOOD_ASEReadCounter.table","NW_015090842.1:6307429",2,8,6
"ARY2","s1670_SAT_M_BLOOD_ASEReadCounter.table","NW_015090842.1:6307670",2,4,2
"ARYL","s1670_SAT_M_BLOOD_ASEReadCounter.table","NW_015090842.1:6313360",0,3,3
"ARYL","s1670_SAT_M_BLOOD_ASEReadCounter.table","NW_015090842.1:6313377",0,2,2
"ARYL","s1670_SAT_M_BLOOD_ASEReadCounter.table","NW_015090842.1:6313767",1,4,3
"ARY1","s1670_SAT_M_BLOOD_ASEReadCounter.table","NW_015090842.1:6313909",2,2,0
"ARY1","s1670_SAT_M_BLOOD_ASEReadCounter.table","NW_015090842.1:6314296",2,3,1
"ARY1","s1670_SAT_M_BLOOD_ASEReadCounter.table","NW_015090842.1:6314541",2,6,4
"ARY1","s1670_SAT_M_BLOOD_ASEReadCounter.table","NW_015090842.1:6314597",1,4,3
"ARY1","s1670_SAT_M_BLOOD_ASEReadCounter.table","NW_015090842.1:6314750",2,4,2
"ARY1","s1670_SAT_M_BLOOD_ASEReadCounter.table","NW_015090842.1:6314794",2,4,2
"ARY1","s1670_SAT_M_BLOOD_ASEReadCounter.table","NW_015090842.1:6314827",2,6,4
"ARY1","s1670_SAT_M_BLOOD_ASEReadCounter.table","NW_015090842.1:6314843",1,4,3
"ARY1","s1670_SAT_M_BLOOD_ASEReadCounter.table","NW_015090842.1:6314859",1,5,4
"ARY1","s1670_SAT_M_BLOOD_ASEReadCounter.table","NW_015090842.1:6314886",1,6,5
"ARY1","s1670_SAT_M_BLOOD_ASEReadCounter.table","NW_015090842.1:6314943",4,4,0
"ARY1","s1670_SAT_M_BLOOD_ASEReadCounter.table","NW_015090842.1:6314949",4,4,0
"ARY1","s1670_SAT_M_BLOOD_ASEReadCounter.table","NW_015090842.1:6315022",0,3,3
"ARY1","s1670_SAT_M_BLOOD_ASEReadCounter.table","NW_015090842.1:6315026",0,3,3
"ARY1","s1670_SAT_M_BLOOD_ASEReadCounter.table","NW_015090842.1:6315043",0,3,3
"ARY1","s1670_SAT_M_BLOOD_ASEReadCounter.table","NW_015090842.1:6315065",0,3,3
"ARY1","s1670_SAT_M_BLOOD_ASEReadCounter.table","NW_015090842.1:6315409",2,3,1
"ARY1","s1670_SAT_M_BLOOD_ASEReadCounter.table","NW_015090842.1:6315479",0,1,1
"ARY1","s1670_SAT_M_BLOOD_ASEReadCounter.table","NW_015090842.1:6318342",6,10,4
"ARY1","s1670_SAT_M_BLOOD_ASEReadCounter.table","NW_015090842.1:6318427",8,13,5
"ARY1","s1670_SAT_M_BLOOD_ASEReadCounter.table","NW_015090842.1:6318603",6,8,2
"ARY1","s1670_SAT_M_BLOOD_ASEReadCounter.table","NW_015090842.1:6318708",2,6,4
"ARY1","s1670_SAT_M_BLOOD_ASEReadCounter.table","NW_015090842.1:6318858",6,11,5
"ARY1","s1670_SAT_M_BLOOD_ASEReadCounter.table","NW_015090842.1:6318952",6,9,3
"MPHOSPH6","s1670_SAT_M_BLOOD_ASEReadCounter.table","NW_015090842.1:6324063",25,59,34
"MPHOSPH6","s1670_SAT_M_BLOOD_ASEReadCounter.table","NW_015090842.1:6324174",32,88,56
"MPHOSPH6","s1670_SAT_M_BLOOD_ASEReadCounter.table","NW_015090842.1:6324270",65,135,70
"MPHOSPH6","s1670_SAT_M_BLOOD_ASEReadCounter.table","NW_015090842.1:6324762",104,252,148
"MPHOSPH6","s1670_SAT_M_BLOOD_ASEReadCounter.table","NW_015090842.1:6324772",111,237,126
"MPHOSPH6","s1670_SAT_M_BLOOD_ASEReadCounter.table","NW_015090842.1:6324780",94,216,122
"MPHOSPH6","s1670_SAT_M_BLOOD_ASEReadCounter.table","NW_015090842.1:6324902",104,248,144
"MPHOSPH6","s1670_SAT_M_BLOOD_ASEReadCounter.table","NW_015090842.1:6324910",245,245,0
"MPHOSPH6","s1670_SAT_M_BLOOD_ASEReadCounter.table","NW_015090842.1:6325066",111,255,144
"MPHOSPH6","s1670_SAT_M_BLOOD_ASEReadCounter.table","NW_015090842.1:6325089",116,275,159
"MPHOSPH6","s1670_SAT_M_BLOOD_ASEReadCounter.table","NW_015090842.1:6325298",182,399,217
"MPHOSPH6","s1670_SAT_M_BLOOD_ASEReadCounter.table","NW_015090842.1:6325877",164,374,210
"MPHOSPH6","s1670_SAT_M_BLOOD_ASEReadCounter.table","NW_015090842.1:6326976",96,279,183
"MLYCD","s1670_SAT_M_BLOOD_ASEReadCounter.table","NW_015090842.1:7150054",21,43,22
"MLYCD","s1670_SAT_M_BLOOD_ASEReadCounter.table","NW_015090842.1:7150131",40,79,39
"MLYCD","s1670_SAT_M_BLOOD_ASEReadCounter.table","NW_015090842.1:7150585",40,83,43
"MLYCD","s1670_SAT_M_BLOOD_ASEReadCounter.table","NW_015090842.1:7150686",34,61,27
"MLYCD","s1670_SAT_M_BLOOD_ASEReadCounter.table","NW_015090842.1:7150696",38,68,30
"MLYCD","s1670_SAT_M_BLOOD_ASEReadCounter.table","NW_015090842.1:7150698",68,68,0
"MLYCD","s1670_SAT_M_BLOOD_ASEReadCounter.table","NW_015090842.1:7150869",33,63,30
"MLYCD","s1670_SAT_M_BLOOD_ASEReadCounter.table","NW_015090842.1:7151100",41,75,34
"MLYCD","s1670_SAT_M_BLOOD_ASEReadCounter.table","NW_015090842.1:7151127",44,78,34
"MLYCD","s1670_SAT_M_BLOOD_ASEReadCounter.table","NW_015090842.1:7157538",36,75,39
"MLYCD","s1670_SAT_M_BLOOD_ASEReadCounter.table","NW_015090842.1:7167662",18,37,19
"MLYCD","s1670_SAT_M_BLOOD_ASEReadCounter.table","NW_015090842.1:7167675",18,38,20
"MLYCD","s1670_SAT_M_BLOOD_ASEReadCounter.table","NW_015090842.1:7167710",16,38,22
"MLYCD","s1670_SAT_M_BLOOD_ASEReadCounter.table","NW_015090842.1:7167781",17,37,20
"MLYCD","s1670_SAT_M_BLOOD_ASEReadCounter.table","NW_015090842.1:7167803",12,26,14
"MLYCD","s1670_SAT_M_BLOOD_ASEReadCounter.table","NW_015090842.1:7167812",13,26,13
"MLYCD","s1670_SAT_M_BLOOD_ASEReadCounter.table","NW_015090842.1:7167845",10,25,15
"MLYCD","s1670_SAT_M_BLOOD_ASEReadCounter.table","NW_015090842.1:7167862",12,27,15
"MLYCD","s1670_SAT_M_BLOOD_ASEReadCounter.table","NW_015090842.1:7167929",12,28,16
"MLYCD","s1670_SAT_M_BLOOD_ASEReadCounter.table","NW_015090842.1:7167995",6,17,11
"MLYCD","s1670_SAT_M_BLOOD_ASEReadCounter.table","NW_015090842.1:7168005",5,16,11
"MLYCD","s1670_SAT_M_BLOOD_ASEReadCounter.table","NW_015090842.1:7168037",4,9,5
"HSBP1","s1670_SAT_M_BLOOD_ASEReadCounter.table","NW_015090842.1:7245192",36,45,9
"HSBP1","s1670_SAT_M_BLOOD_ASEReadCounter.table","NW_015090842.1:7245226",40,60,20
"HSBP1","s1670_SAT_M_BLOOD_ASEReadCounter.table","NW_015090842.1:7245257",21,42,21
"HSBP1","s1670_SAT_M_BLOOD_ASEReadCounter.table","NW_015090842.1:7245296",21,41,20
"HSBP1","s1670_SAT_M_BLOOD_ASEReadCounter.table","NW_015090842.1:7245389",33,49,16
"HSBP1","s1670_SAT_M_BLOOD_ASEReadCounter.table","NW_015090842.1:7245400",35,52,17
"HSBP1","s1670_SAT_M_BLOOD_ASEReadCounter.table","NW_015090842.1:7245445",40,68,28
"HSBP1","s1670_SAT_M_BLOOD_ASEReadCounter.table","NW_015090842.1:7245495",44,70,26
"HSBP1","s1670_SAT_M_BLOOD_ASEReadCounter.table","NW_015090842.1:7245515",46,66,20
"HSBP1","s1670_SAT_M_BLOOD_ASEReadCounter.table","NW_015090842.1:7245733",26,45,19
"HSBP1","s1670_SAT_M_BLOOD_ASEReadCounter.table","NW_015090842.1:7245771",33,52,19
"HSBP1","s1670_SAT_M_BLOOD_ASEReadCounter.table","NW_015090842.1:7245813",31,46,15
"HSBP1","s1670_SAT_M_BLOOD_ASEReadCounter.table","NW_015090842.1:7245926",35,53,18
"HSBP1","s1670_SAT_M_BLOOD_ASEReadCounter.table","NW_015090842.1:7245927",35,53,18
"HSBP1","s1670_SAT_M_BLOOD_ASEReadCounter.table","NW_015090842.1:7245933",36,50,14
"HSBP1","s1670_SAT_M_BLOOD_ASEReadCounter.table","NW_015090842.1:7246002",31,45,14
"HSBP1","s1670_SAT_M_BLOOD_ASEReadCounter.table","NW_015090842.1:7246094",40,64,24
"HSBP1","s1670_SAT_M_BLOOD_ASEReadCounter.table","NW_015090842.1:7246167",29,52,23
"HSBP1","s1670_SAT_M_BLOOD_ASEReadCounter.table","NW_015090842.1:7246183",34,57,23
"HSBP1","s1670_SAT_M_BLOOD_ASEReadCounter.table","NW_015090842.1:7247285",18,25,7
"HSBP1","s1670_SAT_M_BLOOD_ASEReadCounter.table","NW_015090842.1:7247651",131,255,124
"HSBP1","s1670_SAT_M_BLOOD_ASEReadCounter.table","NW_015090842.1:7247657",131,254,123
"HSBP1","s1670_SAT_M_BLOOD_ASEReadCounter.table","NW_015090842.1:7248520",98,177,79
"HSBP1","s1670_SAT_M_BLOOD_ASEReadCounter.table","NW_015090842.1:7248535",85,150,65
"TLDC1","s1670_SAT_M_BLOOD_ASEReadCounter.table","NW_015090842.1:7421997",6,7,1
"COTL1","s1670_SAT_M_BLOOD_ASEReadCounter.table","NW_015090842.1:7490707",18,34,16
"COTL1","s1670_SAT_M_BLOOD_ASEReadCounter.table","NW_015090842.1:7490708",18,34,16
"COTL1","s1670_SAT_M_BLOOD_ASEReadCounter.table","NW_015090842.1:7490711",18,34,16
"COTL1","s1670_SAT_M_BLOOD_ASEReadCounter.table","NW_015090842.1:7490739",17,31,14
"COTL1","s1670_SAT_M_BLOOD_ASEReadCounter.table","NW_015090842.1:7490785",24,36,12
"COTL1","s1670_SAT_M_BLOOD_ASEReadCounter.table","NW_015090842.1:7490820",30,34,4
"COTL1","s1670_SAT_M_BLOOD_ASEReadCounter.table","NW_015090842.1:7490846",23,36,13
"USP10","s1670_SAT_M_BLOOD_ASEReadCounter.table","NW_015090842.1:7572213",54,96,42
"USP10","s1670_SAT_M_BLOOD_ASEReadCounter.table","NW_015090842.1:7572358",62,62,0
"CRISPLD2","s1670_SAT_M_BLOOD_ASEReadCounter.table","NW_015090842.1:7630779",1,1,0
"CRISPLD2","s1670_SAT_M_BLOOD_ASEReadCounter.table","NW_015090842.1:7633787",0,1,1
"CRISPLD2","s1670_SAT_M_BLOOD_ASEReadCounter.table","NW_015090842.1:7634023",0,2,2
"CRISPLD2","s1670_SAT_M_BLOOD_ASEReadCounter.table","NW_015090842.1:7634620",1,1,0
"LOC106888312","s1670_SAT_M_BLOOD_ASEReadCounter.table","NW_015090842.1:7732198",2,2,0
"EMC8","s1670_SAT_M_BLOOD_ASEReadCounter.table","NW_015090842.1:8452385",7,17,10
"GINS2","s1670_SAT_M_BLOOD_ASEReadCounter.table","NW_015090842.1:8467469",10,10,0
"GINS2","s1670_SAT_M_BLOOD_ASEReadCounter.table","NW_015090842.1:8470290",18,21,3
"GINS2","s1670_SAT_M_BLOOD_ASEReadCounter.table","NW_015090842.1:8470305",16,20,4
"GINS2","s1670_SAT_M_BLOOD_ASEReadCounter.table","NW_015090842.1:8470376",10,17,7
"GSE1","s1670_SAT_M_BLOOD_ASEReadCounter.table","NW_015090842.1:8483570",1,1,0
"KIAA0513","s1670_SAT_M_BLOOD_ASEReadCounter.table","NW_015090842.1:8674736",2,2,0
"ZCCHC14","s1670_SAT_M_BLOOD_ASEReadCounter.table","NW_015090842.1:8750189",14,14,0
"KLHDC4","s1670_SAT_M_BLOOD_ASEReadCounter.table","NW_015090842.1:8891175",21,42,21
"KLHDC4","s1670_SAT_M_BLOOD_ASEReadCounter.table","NW_015090842.1:8905251",11,28,17
"KLHDC4","s1670_SAT_M_BLOOD_ASEReadCounter.table","NW_015090842.1:8919630",0,2,2
"SLC7A5","s1670_SAT_M_BLOOD_ASEReadCounter.table","NW_015090842.1:8940382",2,2,0
"SLC7A5","s1670_SAT_M_BLOOD_ASEReadCounter.table","NW_015090842.1:8941818",10,10,0
"SLC7A5","s1670_SAT_M_BLOOD_ASEReadCounter.table","NW_015090842.1:8944655",10,10,0
"CA5A","s1670_SAT_M_BLOOD_ASEReadCounter.table","NW_015090842.1:8989479",1,2,1
"CA5A","s1670_SAT_M_BLOOD_ASEReadCounter.table","NW_015090842.1:8989562",5,7,2
"CA5A","s1670_SAT_M_BLOOD_ASEReadCounter.table","NW_015090842.1:8989609",8,11,3
"CA5A","s1670_SAT_M_BLOOD_ASEReadCounter.table","NW_015090842.1:8989693",5,12,7
"CA5A","s1670_SAT_M_BLOOD_ASEReadCounter.table","NW_015090842.1:8989702",6,13,7
"CA5A","s1670_SAT_M_BLOOD_ASEReadCounter.table","NW_015090842.1:8989746",10,18,8
"CA5A","s1670_SAT_M_BLOOD_ASEReadCounter.table","NW_015090842.1:8989880",5,12,7
"CA5A","s1670_SAT_M_BLOOD_ASEReadCounter.table","NW_015090842.1:8989885",5,12,7
"CA5A","s1670_SAT_M_BLOOD_ASEReadCounter.table","NW_015090842.1:8989929",5,12,7
"CA5A","s1670_SAT_M_BLOOD_ASEReadCounter.table","NW_015090842.1:8990002",6,15,9
"CA5A","s1670_SAT_M_BLOOD_ASEReadCounter.table","NW_015090842.1:8990004",6,16,10
"CA5A","s1670_SAT_M_BLOOD_ASEReadCounter.table","NW_015090842.1:8990005",6,17,11
"CA5A","s1670_SAT_M_BLOOD_ASEReadCounter.table","NW_015090842.1:8990017",5,15,10
"CA5A","s1670_SAT_M_BLOOD_ASEReadCounter.table","NW_015090842.1:8990043",1,6,5
"CA5A","s1670_SAT_M_BLOOD_ASEReadCounter.table","NW_015090842.1:8990080",2,7,5
"CA5A","s1670_SAT_M_BLOOD_ASEReadCounter.table","NW_015090842.1:8990084",2,7,5
"CA5A","s1670_SAT_M_BLOOD_ASEReadCounter.table","NW_015090842.1:8990090",2,7,5
"CA5A","s1670_SAT_M_BLOOD_ASEReadCounter.table","NW_015090842.1:8990095",2,7,5
"CA5A","s1670_SAT_M_BLOOD_ASEReadCounter.table","NW_015090842.1:8990111",2,4,2
"CA5A","s1670_SAT_M_BLOOD_ASEReadCounter.table","NW_015090842.1:8990112",2,6,4
"CA5A","s1670_SAT_M_BLOOD_ASEReadCounter.table","NW_015090842.1:8990115",3,7,4
"CA5A","s1670_SAT_M_BLOOD_ASEReadCounter.table","NW_015090842.1:8990166",3,7,4
"CA5A","s1670_SAT_M_BLOOD_ASEReadCounter.table","NW_015090842.1:8990169",4,8,4
"CA5A","s1670_SAT_M_BLOOD_ASEReadCounter.table","NW_015090842.1:8990222",2,7,5
"CA5A","s1670_SAT_M_BLOOD_ASEReadCounter.table","NW_015090842.1:8990289",8,12,4
"CA5A","s1670_SAT_M_BLOOD_ASEReadCounter.table","NW_015090842.1:8990314",8,13,5
"CA5A","s1670_SAT_M_BLOOD_ASEReadCounter.table","NW_015090842.1:8990361",7,14,7
"CA5A","s1670_SAT_M_BLOOD_ASEReadCounter.table","NW_015090842.1:8990368",7,14,7
"CA5A","s1670_SAT_M_BLOOD_ASEReadCounter.table","NW_015090842.1:8990429",5,9,4
"CA5A","s1670_SAT_M_BLOOD_ASEReadCounter.table","NW_015090842.1:8990466",6,7,1
"CA5A","s1670_SAT_M_BLOOD_ASEReadCounter.table","NW_015090842.1:8990663",4,5,1
"CA5A","s1670_SAT_M_BLOOD_ASEReadCounter.table","NW_015090842.1:8990797",5,10,5
"CA5A","s1670_SAT_M_BLOOD_ASEReadCounter.table","NW_015090842.1:8990836",6,10,4
"CA5A","s1670_SAT_M_BLOOD_ASEReadCounter.table","NW_015090842.1:8990842",6,11,5
"CA5A","s1670_SAT_M_BLOOD_ASEReadCounter.table","NW_015090842.1:8990851",6,11,5
"CA5A","s1670_SAT_M_BLOOD_ASEReadCounter.table","NW_015090842.1:8990918",4,14,10
"CA5A","s1670_SAT_M_BLOOD_ASEReadCounter.table","NW_015090842.1:8990921",3,13,10
"CA5A","s1670_SAT_M_BLOOD_ASEReadCounter.table","NW_015090842.1:8990942",5,13,8
"CA5A","s1670_SAT_M_BLOOD_ASEReadCounter.table","NW_015090842.1:8991001",4,12,8
"CA5A","s1670_SAT_M_BLOOD_ASEReadCounter.table","NW_015090842.1:8991038",1,8,7
"CA5A","s1670_SAT_M_BLOOD_ASEReadCounter.table","NW_015090842.1:8991149",5,11,6
"CA5A","s1670_SAT_M_BLOOD_ASEReadCounter.table","NW_015090842.1:8991176",6,14,8
"CA5A","s1670_SAT_M_BLOOD_ASEReadCounter.table","NW_015090842.1:8991241",4,13,9
"CA5A","s1670_SAT_M_BLOOD_ASEReadCounter.table","NW_015090842.1:8991262",5,12,7
"CA5A","s1670_SAT_M_BLOOD_ASEReadCounter.table","NW_015090842.1:8991316",5,6,1
"CA5A","s1670_SAT_M_BLOOD_ASEReadCounter.table","NW_015090842.1:8991319",5,6,1
"CA5A","s1670_SAT_M_BLOOD_ASEReadCounter.table","NW_015090842.1:8991330",5,5,0
"CA5A","s1670_SAT_M_BLOOD_ASEReadCounter.table","NW_015090842.1:8991334",5,6,1
"CA5A","s1670_SAT_M_BLOOD_ASEReadCounter.table","NW_015090842.1:8991362",4,9,5
"CA5A","s1670_SAT_M_BLOOD_ASEReadCounter.table","NW_015090842.1:8991368",4,8,4
"CA5A","s1670_SAT_M_BLOOD_ASEReadCounter.table","NW_015090842.1:8991390",3,8,5
"CA5A","s1670_SAT_M_BLOOD_ASEReadCounter.table","NW_015090842.1:8991395",3,8,5
"CA5A","s1670_SAT_M_BLOOD_ASEReadCounter.table","NW_015090842.1:8991422",3,9,6
"CA5A","s1670_SAT_M_BLOOD_ASEReadCounter.table","NW_015090842.1:8991467",5,9,4
"CA5A","s1670_SAT_M_BLOOD_ASEReadCounter.table","NW_015090842.1:8991576",3,3,0
"CA5A","s1670_SAT_M_BLOOD_ASEReadCounter.table","NW_015090842.1:8991587",5,7,2
"CA5A","s1670_SAT_M_BLOOD_ASEReadCounter.table","NW_015090842.1:8991655",9,16,7
"CA5A","s1670_SAT_M_BLOOD_ASEReadCounter.table","NW_015090842.1:8991717",7,12,5
"CA5A","s1670_SAT_M_BLOOD_ASEReadCounter.table","NW_015090842.1:8991726",5,10,5
"CA5A","s1670_SAT_M_BLOOD_ASEReadCounter.table","NW_015090842.1:8991799",8,13,5
"CA5A","s1670_SAT_M_BLOOD_ASEReadCounter.table","NW_015090842.1:8991809",8,12,4
"CA5A","s1670_SAT_M_BLOOD_ASEReadCounter.table","NW_015090842.1:8991848",10,14,4
"CA5A","s1670_SAT_M_BLOOD_ASEReadCounter.table","NW_015090842.1:8991849",10,14,4
"CA5A","s1670_SAT_M_BLOOD_ASEReadCounter.table","NW_015090842.1:8991927",6,9,3
"CA5A","s1670_SAT_M_BLOOD_ASEReadCounter.table","NW_015090842.1:8991941",5,8,3
"CA5A","s1670_SAT_M_BLOOD_ASEReadCounter.table","NW_015090842.1:8992121",2,4,2
"CA5A","s1670_SAT_M_BLOOD_ASEReadCounter.table","NW_015090842.1:8992224",3,8,5
"CA5A","s1670_SAT_M_BLOOD_ASEReadCounter.table","NW_015090842.1:9002570",4,7,3
"CA5A","s1670_SAT_M_BLOOD_ASEReadCounter.table","NW_015090842.1:9002600",4,7,3
"CA5A","s1670_SAT_M_BLOOD_ASEReadCounter.table","NW_015090842.1:9004312",3,5,2
"CA5A","s1670_SAT_M_BLOOD_ASEReadCounter.table","NW_015090842.1:9004506",1,1,0
"CA5A","s1670_SAT_M_BLOOD_ASEReadCounter.table","NW_015090842.1:9004523",1,1,0
"CA5A","s1670_SAT_M_BLOOD_ASEReadCounter.table","NW_015090842.1:9004530",1,1,0
"CA5A","s1670_SAT_M_BLOOD_ASEReadCounter.table","NW_015090842.1:9004556",1,1,0
"BANP","s1670_SAT_M_BLOOD_ASEReadCounter.table","NW_015090842.1:9033407",40,95,55
"BANP","s1670_SAT_M_BLOOD_ASEReadCounter.table","NW_015090842.1:9033409",40,94,54
"BANP","s1670_SAT_M_BLOOD_ASEReadCounter.table","NW_015090842.1:9033420",43,102,59
"BANP","s1670_SAT_M_BLOOD_ASEReadCounter.table","NW_015090842.1:9055284",52,91,39
"ZC3H18","s1670_SAT_M_BLOOD_ASEReadCounter.table","NW_015090842.1:9528933",23,48,25
"MVD","s1670_SAT_M_BLOOD_ASEReadCounter.table","NW_015090842.1:9550690",3,3,0
"MVD","s1670_SAT_M_BLOOD_ASEReadCounter.table","NW_015090842.1:9550691",2,2,0
"MVD","s1670_SAT_M_BLOOD_ASEReadCounter.table","NW_015090842.1:9550699",3,3,0
"MVD","s1670_SAT_M_BLOOD_ASEReadCounter.table","NW_015090842.1:9550701",3,3,0
"MVD","s1670_SAT_M_BLOOD_ASEReadCounter.table","NW_015090842.1:9552202",14,14,0
"MVD","s1670_SAT_M_BLOOD_ASEReadCounter.table","NW_015090842.1:9552223",14,14,0
"MVD","s1670_SAT_M_BLOOD_ASEReadCounter.table","NW_015090842.1:9552533",9,9,0
"MVD","s1670_SAT_M_BLOOD_ASEReadCounter.table","NW_015090842.1:9552644",0,7,7
"PIEZO1","s1670_SAT_M_BLOOD_ASEReadCounter.table","NW_015090842.1:9579101",0,1,1
"PIEZO1","s1670_SAT_M_BLOOD_ASEReadCounter.table","NW_015090842.1:9582630",2,2,0
"PIEZO1","s1670_SAT_M_BLOOD_ASEReadCounter.table","NW_015090842.1:9582976",0,2,2
"PIEZO1","s1670_SAT_M_BLOOD_ASEReadCounter.table","NW_015090842.1:9583326",1,1,0
"CDT1","s1670_SAT_M_BLOOD_ASEReadCounter.table","NW_015090842.1:9597033",1,1,0
"CDT1","s1670_SAT_M_BLOOD_ASEReadCounter.table","NW_015090842.1:9597756",0,1,1
"ACSF3","s1670_SAT_M_BLOOD_ASEReadCounter.table","NW_015090842.1:9776737",9,15,6
"ACSF3","s1670_SAT_M_BLOOD_ASEReadCounter.table","NW_015090842.1:9809639",48,48,0
"ACSF3","s1670_SAT_M_BLOOD_ASEReadCounter.table","NW_015090842.1:9834743",22,51,29
"ACSF3","s1670_SAT_M_BLOOD_ASEReadCounter.table","NW_015090842.1:9834762",50,50,0
"ACSF3","s1670_SAT_M_BLOOD_ASEReadCounter.table","NW_015090842.1:9834852",21,49,28
"ACSF3","s1670_SAT_M_BLOOD_ASEReadCounter.table","NW_015090842.1:9834861",22,46,24
"ACSF3","s1670_SAT_M_BLOOD_ASEReadCounter.table","NW_015090842.1:9839359",18,46,28
"ACSF3","s1670_SAT_M_BLOOD_ASEReadCounter.table","NW_015090842.1:9839378",17,37,20
"ACSF3","s1670_SAT_M_BLOOD_ASEReadCounter.table","NW_015090842.1:9839455",13,40,27
"ACSF3","s1670_SAT_M_BLOOD_ASEReadCounter.table","NW_015090842.1:9839457",13,38,25
"ACSF3","s1670_SAT_M_BLOOD_ASEReadCounter.table","NW_015090842.1:9839489",7,27,20
"ACSF3","s1670_SAT_M_BLOOD_ASEReadCounter.table","NW_015090842.1:9839500",5,22,17
"ACSF3","s1670_SAT_M_BLOOD_ASEReadCounter.table","NW_015090842.1:9839501",5,22,17
"ACSF3","s1670_SAT_M_BLOOD_ASEReadCounter.table","NW_015090842.1:9839504",5,21,16
"ACSF3","s1670_SAT_M_BLOOD_ASEReadCounter.table","NW_015090842.1:9839512",2,10,8
"ACSF3","s1670_SAT_M_BLOOD_ASEReadCounter.table","NW_015090842.1:9839527",3,9,6
"ACSF3","s1670_SAT_M_BLOOD_ASEReadCounter.table","NW_015090842.1:9839533",2,8,6
"ACSF3","s1670_SAT_M_BLOOD_ASEReadCounter.table","NW_015090842.1:9839535",2,8,6
"ACSF3","s1670_SAT_M_BLOOD_ASEReadCounter.table","NW_015090842.1:9839545",1,4,3
"ACSF3","s1670_SAT_M_BLOOD_ASEReadCounter.table","NW_015090842.1:9839550",1,4,3
"ACSF3","s1670_SAT_M_BLOOD_ASEReadCounter.table","NW_015090842.1:9839551",1,4,3
"SLC22A31","s1670_SAT_M_BLOOD_ASEReadCounter.table","NW_015090842.1:9851265",1,1,0
"SLC22A31","s1670_SAT_M_BLOOD_ASEReadCounter.table","NW_015090842.1:9851302",1,1,0
"SLC22A31","s1670_SAT_M_BLOOD_ASEReadCounter.table","NW_015090842.1:9851303",1,1,0
"SLC22A31","s1670_SAT_M_BLOOD_ASEReadCounter.table","NW_015090842.1:9851305",1,1,0
"SLC22A31","s1670_SAT_M_BLOOD_ASEReadCounter.table","NW_015090842.1:9851343",1,1,0
"SLC22A31","s1670_SAT_M_BLOOD_ASEReadCounter.table","NW_015090842.1:9851344",1,1,0
"ANKRD11","s1670_SAT_M_BLOOD_ASEReadCounter.table","NW_015090842.1:9858863",11,18,7
"ANKRD11","s1670_SAT_M_BLOOD_ASEReadCounter.table","NW_015090842.1:9859101",83,146,63
"ANKRD11","s1670_SAT_M_BLOOD_ASEReadCounter.table","NW_015090842.1:9859352",118,208,90
"ANKRD11","s1670_SAT_M_BLOOD_ASEReadCounter.table","NW_015090842.1:9859381",80,138,58
"ANKRD11","s1670_SAT_M_BLOOD_ASEReadCounter.table","NW_015090842.1:9859527",57,103,46
"ANKRD11","s1670_SAT_M_BLOOD_ASEReadCounter.table","NW_015090842.1:9859529",61,107,46
"ANKRD11","s1670_SAT_M_BLOOD_ASEReadCounter.table","NW_015090842.1:9859679",117,222,105
"ANKRD11","s1670_SAT_M_BLOOD_ASEReadCounter.table","NW_015090842.1:9861097",129,232,103
"ANKRD11","s1670_SAT_M_BLOOD_ASEReadCounter.table","NW_015090842.1:9862571",85,157,72
"ANKRD11","s1670_SAT_M_BLOOD_ASEReadCounter.table","NW_015090842.1:9866071",0,91,91
"ANKRD11","s1670_SAT_M_BLOOD_ASEReadCounter.table","NW_015090842.1:9866200",0,95,95
"ANKRD11","s1670_SAT_M_BLOOD_ASEReadCounter.table","NW_015090842.1:9867391",73,133,60
"ANKRD11","s1670_SAT_M_BLOOD_ASEReadCounter.table","NW_015090842.1:9867472",84,178,94
"ANKRD11","s1670_SAT_M_BLOOD_ASEReadCounter.table","NW_015090842.1:9867559",97,195,98
"ANKRD11","s1670_SAT_M_BLOOD_ASEReadCounter.table","NW_015090842.1:9867934",115,214,99
"ANKRD11","s1670_SAT_M_BLOOD_ASEReadCounter.table","NW_015090842.1:9868093",108,210,102
"ANKRD11","s1670_SAT_M_BLOOD_ASEReadCounter.table","NW_015090842.1:9868222",131,217,86
"ANKRD11","s1670_SAT_M_BLOOD_ASEReadCounter.table","NW_015090842.1:9868327",118,219,101
"ANKRD11","s1670_SAT_M_BLOOD_ASEReadCounter.table","NW_015090842.1:9868414",133,245,112
"ANKRD11","s1670_SAT_M_BLOOD_ASEReadCounter.table","NW_015090842.1:9868441",129,236,107
"ANKRD11","s1670_SAT_M_BLOOD_ASEReadCounter.table","NW_015090842.1:9868444",123,234,111
"ANKRD11","s1670_SAT_M_BLOOD_ASEReadCounter.table","NW_015090842.1:9868519",145,273,128
"ANKRD11","s1670_SAT_M_BLOOD_ASEReadCounter.table","NW_015090842.1:9868609",130,243,113
"ANKRD11","s1670_SAT_M_BLOOD_ASEReadCounter.table","NW_015090842.1:9868666",140,272,132
"ANKRD11","s1670_SAT_M_BLOOD_ASEReadCounter.table","NW_015090842.1:9869431",152,282,130
"ANKRD11","s1670_SAT_M_BLOOD_ASEReadCounter.table","NW_015090842.1:9869578",162,314,152
"ANKRD11","s1670_SAT_M_BLOOD_ASEReadCounter.table","NW_015090842.1:9869734",216,412,196
"ANKRD11","s1670_SAT_M_BLOOD_ASEReadCounter.table","NW_015090842.1:9870070",138,284,146
"ANKRD11","s1670_SAT_M_BLOOD_ASEReadCounter.table","NW_015090842.1:9870349",159,309,150
"ANKRD11","s1670_SAT_M_BLOOD_ASEReadCounter.table","NW_015090842.1:9870604",162,291,129
"ANKRD11","s1670_SAT_M_BLOOD_ASEReadCounter.table","NW_015090842.1:9870613",173,310,137
"ANKRD11","s1670_SAT_M_BLOOD_ASEReadCounter.table","NW_015090842.1:9870685",203,399,196
"ANKRD11","s1670_SAT_M_BLOOD_ASEReadCounter.table","NW_015090842.1:9870847",169,328,159
"ANKRD11","s1670_SAT_M_BLOOD_ASEReadCounter.table","NW_015090842.1:9871103",156,268,112
"ANKRD11","s1670_SAT_M_BLOOD_ASEReadCounter.table","NW_015090842.1:9871165",149,284,135
"ANKRD11","s1670_SAT_M_BLOOD_ASEReadCounter.table","NW_015090842.1:9871820",95,202,107
"ANKRD11","s1670_SAT_M_BLOOD_ASEReadCounter.table","NW_015090842.1:9871994",241,241,0
"ANKRD11","s1670_SAT_M_BLOOD_ASEReadCounter.table","NW_015090842.1:9872118",150,290,140
"SPG7","s1670_SAT_M_BLOOD_ASEReadCounter.table","NW_015090842.1:10051190",40,79,39
"SPG7","s1670_SAT_M_BLOOD_ASEReadCounter.table","NW_015090842.1:10051218",45,83,38
"SPG7","s1670_SAT_M_BLOOD_ASEReadCounter.table","NW_015090842.1:10052348",38,67,29
"SPG7","s1670_SAT_M_BLOOD_ASEReadCounter.table","NW_015090842.1:10052366",37,66,29
"SPG7","s1670_SAT_M_BLOOD_ASEReadCounter.table","NW_015090842.1:10065173",44,76,32
"SPG7","s1670_SAT_M_BLOOD_ASEReadCounter.table","NW_015090842.1:10065215",42,68,26
"SPG7","s1670_SAT_M_BLOOD_ASEReadCounter.table","NW_015090842.1:10066301",32,57,25
"SPG7","s1670_SAT_M_BLOOD_ASEReadCounter.table","NW_015090842.1:10066365",35,72,37
"SPG7","s1670_SAT_M_BLOOD_ASEReadCounter.table","NW_015090842.1:10069752",50,93,43
"SPG7","s1670_SAT_M_BLOOD_ASEReadCounter.table","NW_015090842.1:10069800",52,98,46
"SPG7","s1670_SAT_M_BLOOD_ASEReadCounter.table","NW_015090842.1:10071192",37,79,42
"SPG7","s1670_SAT_M_BLOOD_ASEReadCounter.table","NW_015090842.1:10071204",39,74,35
"SPG7","s1670_SAT_M_BLOOD_ASEReadCounter.table","NW_015090842.1:10071219",35,69,34
"SPG7","s1670_SAT_M_BLOOD_ASEReadCounter.table","NW_015090842.1:10071967",36,64,28
"SPG7","s1670_SAT_M_BLOOD_ASEReadCounter.table","NW_015090842.1:10075109",43,69,26
"SPG7","s1670_SAT_M_BLOOD_ASEReadCounter.table","NW_015090842.1:10075114",44,68,24
"SPG7","s1670_SAT_M_BLOOD_ASEReadCounter.table","NW_015090842.1:10075198",32,59,27
"SPG7","s1670_SAT_M_BLOOD_ASEReadCounter.table","NW_015090842.1:10075487",27,44,17
"SPG7","s1670_SAT_M_BLOOD_ASEReadCounter.table","NW_015090842.1:10075488",27,44,17
"SPG7","s1670_SAT_M_BLOOD_ASEReadCounter.table","NW_015090842.1:10075548",20,30,10
"RPL13","s1670_SAT_M_BLOOD_ASEReadCounter.table","NW_015090842.1:10076979",18,28,10
"RPL13","s1670_SAT_M_BLOOD_ASEReadCounter.table","NW_015090842.1:10077387",440,1085,645
"RPL13","s1670_SAT_M_BLOOD_ASEReadCounter.table","NW_015090842.1:10077978",640,1479,839
"RPL13","s1670_SAT_M_BLOOD_ASEReadCounter.table","NW_015090842.1:10077992",616,1422,806
"CHMP1A","s1670_SAT_M_BLOOD_ASEReadCounter.table","NW_015090842.1:10102901",24,57,33
"CHMP1A","s1670_SAT_M_BLOOD_ASEReadCounter.table","NW_015090842.1:10102961",42,93,51
"CHMP1A","s1670_SAT_M_BLOOD_ASEReadCounter.table","NW_015090842.1:10102996",41,92,51
"CHMP1A","s1670_SAT_M_BLOOD_ASEReadCounter.table","NW_015090842.1:10103004",42,95,53
"CHMP1A","s1670_SAT_M_BLOOD_ASEReadCounter.table","NW_015090842.1:10103006",42,97,55
"CHMP1A","s1670_SAT_M_BLOOD_ASEReadCounter.table","NW_015090842.1:10103052",49,106,57
"CHMP1A","s1670_SAT_M_BLOOD_ASEReadCounter.table","NW_015090842.1:10103095",43,108,65
"CHMP1A","s1670_SAT_M_BLOOD_ASEReadCounter.table","NW_015090842.1:10103096",44,108,64
"CHMP1A","s1670_SAT_M_BLOOD_ASEReadCounter.table","NW_015090842.1:10103152",39,92,53
"CHMP1A","s1670_SAT_M_BLOOD_ASEReadCounter.table","NW_015090842.1:10103334",36,72,36
"CHMP1A","s1670_SAT_M_BLOOD_ASEReadCounter.table","NW_015090842.1:10103373",26,71,45
"CHMP1A","s1670_SAT_M_BLOOD_ASEReadCounter.table","NW_015090842.1:10103408",39,102,63
"CHMP1A","s1670_SAT_M_BLOOD_ASEReadCounter.table","NW_015090842.1:10103412",45,110,65
"CHMP1A","s1670_SAT_M_BLOOD_ASEReadCounter.table","NW_015090842.1:10103512",65,123,58
"CHMP1A","s1670_SAT_M_BLOOD_ASEReadCounter.table","NW_015090842.1:10103513",64,122,58
"CHMP1A","s1670_SAT_M_BLOOD_ASEReadCounter.table","NW_015090842.1:10103583",49,100,51
"CHMP1A","s1670_SAT_M_BLOOD_ASEReadCounter.table","NW_015090842.1:10103614",42,101,59
"CHMP1A","s1670_SAT_M_BLOOD_ASEReadCounter.table","NW_015090842.1:10103657",47,109,62
"CHMP1A","s1670_SAT_M_BLOOD_ASEReadCounter.table","NW_015090842.1:10103669",40,99,59
"CHMP1A","s1670_SAT_M_BLOOD_ASEReadCounter.table","NW_015090842.1:10103674",41,98,57
"CHMP1A","s1670_SAT_M_BLOOD_ASEReadCounter.table","NW_015090842.1:10103677",34,92,58
"CHMP1A","s1670_SAT_M_BLOOD_ASEReadCounter.table","NW_015090842.1:10103729",60,118,58
"CHMP1A","s1670_SAT_M_BLOOD_ASEReadCounter.table","NW_015090842.1:10103758",63,117,54
"CHMP1A","s1670_SAT_M_BLOOD_ASEReadCounter.table","NW_015090842.1:10103761",63,122,59
"CHMP1A","s1670_SAT_M_BLOOD_ASEReadCounter.table","NW_015090842.1:10103788",79,154,75
"CHMP1A","s1670_SAT_M_BLOOD_ASEReadCounter.table","NW_015090842.1:10103789",79,156,77
"CHMP1A","s1670_SAT_M_BLOOD_ASEReadCounter.table","NW_015090842.1:10103790",78,155,77
"CHMP1A","s1670_SAT_M_BLOOD_ASEReadCounter.table","NW_015090842.1:10103950",63,121,58
"CHMP1A","s1670_SAT_M_BLOOD_ASEReadCounter.table","NW_015090842.1:10104335",44,98,54
"CHMP1A","s1670_SAT_M_BLOOD_ASEReadCounter.table","NW_015090842.1:10104429",56,127,71
"CHMP1A","s1670_SAT_M_BLOOD_ASEReadCounter.table","NW_015090842.1:10104532",59,127,68
"CHMP1A","s1670_SAT_M_BLOOD_ASEReadCounter.table","NW_015090842.1:10104633",54,128,74
"CHMP1A","s1670_SAT_M_BLOOD_ASEReadCounter.table","NW_015090842.1:10104759",46,105,59
"CHMP1A","s1670_SAT_M_BLOOD_ASEReadCounter.table","NW_015090842.1:10104794",58,128,70
"CHMP1A","s1670_SAT_M_BLOOD_ASEReadCounter.table","NW_015090842.1:10104844",57,111,54
"CHMP1A","s1670_SAT_M_BLOOD_ASEReadCounter.table","NW_015090842.1:10106290",52,117,65
"CHMP1A","s1670_SAT_M_BLOOD_ASEReadCounter.table","NW_015090842.1:10106335",58,113,55
"CHMP1A","s1670_SAT_M_BLOOD_ASEReadCounter.table","NW_015090842.1:10106383",75,146,71
"CHMP1A","s1670_SAT_M_BLOOD_ASEReadCounter.table","NW_015090842.1:10106747",67,136,69
"CHMP1A","s1670_SAT_M_BLOOD_ASEReadCounter.table","NW_015090842.1:10107404",79,155,76
"CHMP1A","s1670_SAT_M_BLOOD_ASEReadCounter.table","NW_015090842.1:10107410",89,161,72
"CHMP1A","s1670_SAT_M_BLOOD_ASEReadCounter.table","NW_015090842.1:10107876",45,111,66
"CDK10","s1670_SAT_M_BLOOD_ASEReadCounter.table","NW_015090842.1:10109030",16,18,2
"CDK10","s1670_SAT_M_BLOOD_ASEReadCounter.table","NW_015090842.1:10109963",74,143,69
"CDK10","s1670_SAT_M_BLOOD_ASEReadCounter.table","NW_015090842.1:10110887",85,169,84
"CDK10","s1670_SAT_M_BLOOD_ASEReadCounter.table","NW_015090842.1:10111254",58,132,74
"CDK10","s1670_SAT_M_BLOOD_ASEReadCounter.table","NW_015090842.1:10111380",65,159,94
"CDK10","s1670_SAT_M_BLOOD_ASEReadCounter.table","NW_015090842.1:10111395",71,160,89
"CDK10","s1670_SAT_M_BLOOD_ASEReadCounter.table","NW_015090842.1:10111437",88,192,104
"CDK10","s1670_SAT_M_BLOOD_ASEReadCounter.table","NW_015090842.1:10111798",79,154,75
"CDK10","s1670_SAT_M_BLOOD_ASEReadCounter.table","NW_015090842.1:10111840",82,168,86
"CDK10","s1670_SAT_M_BLOOD_ASEReadCounter.table","NW_015090842.1:10112031",91,187,96
"CDK10","s1670_SAT_M_BLOOD_ASEReadCounter.table","NW_015090842.1:10112285",61,119,58
"CDK10","s1670_SAT_M_BLOOD_ASEReadCounter.table","NW_015090842.1:10112398",81,144,63
"CDK10","s1670_SAT_M_BLOOD_ASEReadCounter.table","NW_015090842.1:10112455",72,145,73
"CDK10","s1670_SAT_M_BLOOD_ASEReadCounter.table","NW_015090842.1:10112461",60,126,66
"CDK10","s1670_SAT_M_BLOOD_ASEReadCounter.table","NW_015090842.1:10112497",56,112,56
"CDK10","s1670_SAT_M_BLOOD_ASEReadCounter.table","NW_015090842.1:10112508",55,116,61
"CDK10","s1670_SAT_M_BLOOD_ASEReadCounter.table","NW_015090842.1:10112518",51,100,49
"CDK10","s1670_SAT_M_BLOOD_ASEReadCounter.table","NW_015090842.1:10112540",52,103,51
"CDK10","s1670_SAT_M_BLOOD_ASEReadCounter.table","NW_015090842.1:10112556",48,105,57
"CDK10","s1670_SAT_M_BLOOD_ASEReadCounter.table","NW_015090842.1:10112561",52,116,64
"CDK10","s1670_SAT_M_BLOOD_ASEReadCounter.table","NW_015090842.1:10112596",42,107,65
"CDK10","s1670_SAT_M_BLOOD_ASEReadCounter.table","NW_015090842.1:10112630",36,88,52
"CDK10","s1670_SAT_M_BLOOD_ASEReadCounter.table","NW_015090842.1:10112656",39,89,50
"CDK10","s1670_SAT_M_BLOOD_ASEReadCounter.table","NW_015090842.1:10112665",34,75,41
"CDK10","s1670_SAT_M_BLOOD_ASEReadCounter.table","NW_015090842.1:10112668",35,75,40
"CDK10","s1670_SAT_M_BLOOD_ASEReadCounter.table","NW_015090842.1:10112781",21,39,18
"CDK10","s1670_SAT_M_BLOOD_ASEReadCounter.table","NW_015090842.1:10112782",19,37,18
"CDK10","s1670_SAT_M_BLOOD_ASEReadCounter.table","NW_015090842.1:10112795",18,37,19
"CDK10","s1670_SAT_M_BLOOD_ASEReadCounter.table","NW_015090842.1:10112841",7,12,5
"CDK10","s1670_SAT_M_BLOOD_ASEReadCounter.table","NW_015090842.1:10112861",6,10,4
"SPATA2L","s1670_SAT_M_BLOOD_ASEReadCounter.table","NW_015090842.1:10113212",0,4,4
"SPATA2L","s1670_SAT_M_BLOOD_ASEReadCounter.table","NW_015090842.1:10113280",1,8,7
"SPATA2L","s1670_SAT_M_BLOOD_ASEReadCounter.table","NW_015090842.1:10113296",1,8,7
"SPATA2L","s1670_SAT_M_BLOOD_ASEReadCounter.table","NW_015090842.1:10113321",1,6,5
"SPATA2L","s1670_SAT_M_BLOOD_ASEReadCounter.table","NW_015090842.1:10113332",1,8,7
"SPATA2L","s1670_SAT_M_BLOOD_ASEReadCounter.table","NW_015090842.1:10113380",2,9,7
"SPATA2L","s1670_SAT_M_BLOOD_ASEReadCounter.table","NW_015090842.1:10113381",2,9,7
"SPATA2L","s1670_SAT_M_BLOOD_ASEReadCounter.table","NW_015090842.1:10113412",2,12,10
"SPATA2L","s1670_SAT_M_BLOOD_ASEReadCounter.table","NW_015090842.1:10113421",2,12,10
"SPATA2L","s1670_SAT_M_BLOOD_ASEReadCounter.table","NW_015090842.1:10113465",2,15,13
"SPATA2L","s1670_SAT_M_BLOOD_ASEReadCounter.table","NW_015090842.1:10113535",5,17,12
"SPATA2L","s1670_SAT_M_BLOOD_ASEReadCounter.table","NW_015090842.1:10113645",3,22,19
"SPATA2L","s1670_SAT_M_BLOOD_ASEReadCounter.table","NW_015090842.1:10113682",2,23,21
"SPATA2L","s1670_SAT_M_BLOOD_ASEReadCounter.table","NW_015090842.1:10113696",5,22,17
"SPATA2L","s1670_SAT_M_BLOOD_ASEReadCounter.table","NW_015090842.1:10113727",6,23,17
"SPATA2L","s1670_SAT_M_BLOOD_ASEReadCounter.table","NW_015090842.1:10113729",6,23,17
"SPATA2L","s1670_SAT_M_BLOOD_ASEReadCounter.table","NW_015090842.1:10113799",6,23,17
"SPATA2L","s1670_SAT_M_BLOOD_ASEReadCounter.table","NW_015090842.1:10113809",7,24,17
"SPATA2L","s1670_SAT_M_BLOOD_ASEReadCounter.table","NW_015090842.1:10113827",7,25,18
"SPATA2L","s1670_SAT_M_BLOOD_ASEReadCounter.table","NW_015090842.1:10113831",6,24,18
"SPATA2L","s1670_SAT_M_BLOOD_ASEReadCounter.table","NW_015090842.1:10113894",7,20,13
"SPATA2L","s1670_SAT_M_BLOOD_ASEReadCounter.table","NW_015090842.1:10113905",3,18,15
"SPATA2L","s1670_SAT_M_BLOOD_ASEReadCounter.table","NW_015090842.1:10113914",4,17,13
"SPATA2L","s1670_SAT_M_BLOOD_ASEReadCounter.table","NW_015090842.1:10113920",5,18,13
"SPATA2L","s1670_SAT_M_BLOOD_ASEReadCounter.table","NW_015090842.1:10113937",7,18,11
"SPATA2L","s1670_SAT_M_BLOOD_ASEReadCounter.table","NW_015090842.1:10113971",6,18,12
"SPATA2L","s1670_SAT_M_BLOOD_ASEReadCounter.table","NW_015090842.1:10113976",5,17,12
"SPATA2L","s1670_SAT_M_BLOOD_ASEReadCounter.table","NW_015090842.1:10113985",4,15,11
"SPATA2L","s1670_SAT_M_BLOOD_ASEReadCounter.table","NW_015090842.1:10113994",5,17,12
"SPATA2L","s1670_SAT_M_BLOOD_ASEReadCounter.table","NW_015090842.1:10114063",6,22,16
"SPATA2L","s1670_SAT_M_BLOOD_ASEReadCounter.table","NW_015090842.1:10114066",6,22,16
"SPATA2L","s1670_SAT_M_BLOOD_ASEReadCounter.table","NW_015090842.1:10114069",6,22,16
"SPATA2L","s1670_SAT_M_BLOOD_ASEReadCounter.table","NW_015090842.1:10114159",2,17,15
"SPATA2L","s1670_SAT_M_BLOOD_ASEReadCounter.table","NW_015090842.1:10114262",11,11,0
"SPATA2L","s1670_SAT_M_BLOOD_ASEReadCounter.table","NW_015090842.1:10114470",1,5,4
"SPATA2L","s1670_SAT_M_BLOOD_ASEReadCounter.table","NW_015090842.1:10114524",3,7,4
"VPS9D1","s1670_SAT_M_BLOOD_ASEReadCounter.table","NW_015090842.1:10117773",0,1,1
"VPS9D1","s1670_SAT_M_BLOOD_ASEReadCounter.table","NW_015090842.1:10117937",0,1,1
"VPS9D1","s1670_SAT_M_BLOOD_ASEReadCounter.table","NW_015090842.1:10117961",0,1,1
"VPS9D1","s1670_SAT_M_BLOOD_ASEReadCounter.table","NW_015090842.1:10118236",0,1,1
"VPS9D1","s1670_SAT_M_BLOOD_ASEReadCounter.table","NW_015090842.1:10118973",1,1,0
"VPS9D1","s1670_SAT_M_BLOOD_ASEReadCounter.table","NW_015090842.1:10119500",1,1,0
"ZNF276","s1670_SAT_M_BLOOD_ASEReadCounter.table","NW_015090842.1:10121760",1,8,7
"ZNF276","s1670_SAT_M_BLOOD_ASEReadCounter.table","NW_015090842.1:10121769",1,7,6
"ZNF276","s1670_SAT_M_BLOOD_ASEReadCounter.table","NW_015090842.1:10121802",6,12,6
"ZNF276","s1670_SAT_M_BLOOD_ASEReadCounter.table","NW_015090842.1:10121971",12,24,12
"ZNF276","s1670_SAT_M_BLOOD_ASEReadCounter.table","NW_015090842.1:10122161",24,24,0
"ZNF276","s1670_SAT_M_BLOOD_ASEReadCounter.table","NW_015090842.1:10122164",22,22,0
"ZNF276","s1670_SAT_M_BLOOD_ASEReadCounter.table","NW_015090842.1:10122184",26,26,0
"ZNF276","s1670_SAT_M_BLOOD_ASEReadCounter.table","NW_015090842.1:10122883",13,23,10
"ZNF276","s1670_SAT_M_BLOOD_ASEReadCounter.table","NW_015090842.1:10122997",13,30,17
"ZNF276","s1670_SAT_M_BLOOD_ASEReadCounter.table","NW_015090842.1:10123069",16,36,20
"ZNF276","s1670_SAT_M_BLOOD_ASEReadCounter.table","NW_015090842.1:10123207",27,44,17
"ZNF276","s1670_SAT_M_BLOOD_ASEReadCounter.table","NW_015090842.1:10125787",30,47,17
"ZNF276","s1670_SAT_M_BLOOD_ASEReadCounter.table","NW_015090842.1:10126309",24,41,17
"ZNF276","s1670_SAT_M_BLOOD_ASEReadCounter.table","NW_015090842.1:10126348",19,41,22
"ZNF276","s1670_SAT_M_BLOOD_ASEReadCounter.table","NW_015090842.1:10126978",27,44,17
"ZNF276","s1670_SAT_M_BLOOD_ASEReadCounter.table","NW_015090842.1:10126991",27,41,14
"ZNF276","s1670_SAT_M_BLOOD_ASEReadCounter.table","NW_015090842.1:10127023",25,41,16
"ZNF276","s1670_SAT_M_BLOOD_ASEReadCounter.table","NW_015090842.1:10127063",23,43,20
"ZNF276","s1670_SAT_M_BLOOD_ASEReadCounter.table","NW_015090842.1:10127373",20,39,19
"ZNF276","s1670_SAT_M_BLOOD_ASEReadCounter.table","NW_015090842.1:10127931",30,57,27
"ZNF276","s1670_SAT_M_BLOOD_ASEReadCounter.table","NW_015090842.1:10128070",29,62,33
"ZNF276","s1670_SAT_M_BLOOD_ASEReadCounter.table","NW_015090842.1:10128102",31,64,33
"ZNF276","s1670_SAT_M_BLOOD_ASEReadCounter.table","NW_015090842.1:10128356",25,44,19
"ZNF276","s1670_SAT_M_BLOOD_ASEReadCounter.table","NW_015090842.1:10128497",14,33,19
"FANCA","s1670_SAT_M_BLOOD_ASEReadCounter.table","NW_015090842.1:10128822",1,1,0
"FANCA","s1670_SAT_M_BLOOD_ASEReadCounter.table","NW_015090842.1:10129383",1,3,2
"FANCA","s1670_SAT_M_BLOOD_ASEReadCounter.table","NW_015090842.1:10129390",1,3,2
"FANCA","s1670_SAT_M_BLOOD_ASEReadCounter.table","NW_015090842.1:10129422",0,1,1
"FANCA","s1670_SAT_M_BLOOD_ASEReadCounter.table","NW_015090842.1:10130399",1,1,0
"SPIRE2","s1670_SAT_M_BLOOD_ASEReadCounter.table","NW_015090842.1:10177084",1,1,0
"TCF25","s1670_SAT_M_BLOOD_ASEReadCounter.table","NW_015090842.1:10180912",23,47,24
"TCF25","s1670_SAT_M_BLOOD_ASEReadCounter.table","NW_015090842.1:10180924",23,43,20
"TCF25","s1670_SAT_M_BLOOD_ASEReadCounter.table","NW_015090842.1:10180931",24,45,21
"TCF25","s1670_SAT_M_BLOOD_ASEReadCounter.table","NW_015090842.1:10185332",63,128,65
"TCF25","s1670_SAT_M_BLOOD_ASEReadCounter.table","NW_015090842.1:10196561",52,86,34
"TCF25","s1670_SAT_M_BLOOD_ASEReadCounter.table","NW_015090842.1:10197399",102,102,0
"GAS8","s1670_SAT_M_BLOOD_ASEReadCounter.table","NW_015090842.1:10228982",1,5,4
"GAS8","s1670_SAT_M_BLOOD_ASEReadCounter.table","NW_015090842.1:10229832",2,3,1
"GAS8","s1670_SAT_M_BLOOD_ASEReadCounter.table","NW_015090842.1:10232901",1,2,1
"GAS8","s1670_SAT_M_BLOOD_ASEReadCounter.table","NW_015090842.1:10232928",1,2,1
"GAS8","s1670_SAT_M_BLOOD_ASEReadCounter.table","NW_015090842.1:10232967",1,1,0
"GAS8","s1670_SAT_M_BLOOD_ASEReadCounter.table","NW_015090842.1:10233032",1,1,0
"GAS8","s1670_SAT_M_BLOOD_ASEReadCounter.table","NW_015090842.1:10233057",1,1,0
"GAS8","s1670_SAT_M_BLOOD_ASEReadCounter.table","NW_015090842.1:10233058",1,1,0
"GAS8","s1670_SAT_M_BLOOD_ASEReadCounter.table","NW_015090842.1:10233196",1,1,0
"GAS8","s1670_SAT_M_BLOOD_ASEReadCounter.table","NW_015090842.1:10233252",1,1,0
"LOC106888173","s1670_SAT_M_BLOOD_ASEReadCounter.table","NW_015090842.1:10241803",1,1,0
"LOC106888173","s1670_SAT_M_BLOOD_ASEReadCounter.table","NW_015090842.1:10241827",1,1,0
"LOC106888173","s1670_SAT_M_BLOOD_ASEReadCounter.table","NW_015090842.1:10241869",1,1,0
"LOC106888173","s1670_SAT_M_BLOOD_ASEReadCounter.table","NW_015090842.1:10242079",1,1,0
"LOC106888384","s1670_SAT_M_BLOOD_ASEReadCounter.table","NW_015090842.1:10255608",0,1,1
"LOC106888384","s1670_SAT_M_BLOOD_ASEReadCounter.table","NW_015090842.1:10255614",0,1,1
"LOC106888384","s1670_SAT_M_BLOOD_ASEReadCounter.table","NW_015090842.1:10255704",42,43,1
"LOC106888384","s1670_SAT_M_BLOOD_ASEReadCounter.table","NW_015090842.1:10255731",53,54,1
"LOC106888384","s1670_SAT_M_BLOOD_ASEReadCounter.table","NW_015090842.1:10255771",69,69,0
"TANGO6","s1670_SAT_M_BLOOD_ASEReadCounter.table","NW_015090842.1:10257782",11,17,6
"TANGO6","s1670_SAT_M_BLOOD_ASEReadCounter.table","NW_015090842.1:10258162",12,20,8
"TANGO6","s1670_SAT_M_BLOOD_ASEReadCounter.table","NW_015090842.1:10258185",14,27,13
"TANGO6","s1670_SAT_M_BLOOD_ASEReadCounter.table","NW_015090842.1:10259267",17,24,7
"TANGO6","s1670_SAT_M_BLOOD_ASEReadCounter.table","NW_015090842.1:10260250",28,40,12
"TANGO6","s1670_SAT_M_BLOOD_ASEReadCounter.table","NW_015090842.1:10260979",28,44,16
"TANGO6","s1670_SAT_M_BLOOD_ASEReadCounter.table","NW_015090842.1:10261599",24,38,14
"TANGO6","s1670_SAT_M_BLOOD_ASEReadCounter.table","NW_015090842.1:10268425",28,46,18
"TANGO6","s1670_SAT_M_BLOOD_ASEReadCounter.table","NW_015090842.1:10269831",23,42,19
"TANGO6","s1670_SAT_M_BLOOD_ASEReadCounter.table","NW_015090842.1:10270813",33,45,12
"TANGO6","s1670_SAT_M_BLOOD_ASEReadCounter.table","NW_015090842.1:10273952",12,17,5
"TANGO6","s1670_SAT_M_BLOOD_ASEReadCounter.table","NW_015090842.1:10273970",12,19,7
"TANGO6","s1670_SAT_M_BLOOD_ASEReadCounter.table","NW_015090842.1:10274018",16,22,6
"TANGO6","s1670_SAT_M_BLOOD_ASEReadCounter.table","NW_015090842.1:10275974",12,24,12
"TANGO6","s1670_SAT_M_BLOOD_ASEReadCounter.table","NW_015090842.1:10275976",12,24,12
"TANGO6","s1670_SAT_M_BLOOD_ASEReadCounter.table","NW_015090842.1:10276123",21,31,10
"TANGO6","s1670_SAT_M_BLOOD_ASEReadCounter.table","NW_015090842.1:10276271",12,24,12
"TANGO6","s1670_SAT_M_BLOOD_ASEReadCounter.table","NW_015090842.1:10276272",11,23,12
"TANGO6","s1670_SAT_M_BLOOD_ASEReadCounter.table","NW_015090842.1:10276275",14,26,12
"TANGO6","s1670_SAT_M_BLOOD_ASEReadCounter.table","NW_015090842.1:10276278",14,26,12
"TANGO6","s1670_SAT_M_BLOOD_ASEReadCounter.table","NW_015090842.1:10276368",18,25,7
"TANGO6","s1670_SAT_M_BLOOD_ASEReadCounter.table","NW_015090842.1:10276373",15,21,6
"TANGO6","s1670_SAT_M_BLOOD_ASEReadCounter.table","NW_015090842.1:10276630",21,31,10
"TANGO6","s1670_SAT_M_BLOOD_ASEReadCounter.table","NW_015090842.1:10281498",14,20,6
"TANGO6","s1670_SAT_M_BLOOD_ASEReadCounter.table","NW_015090842.1:10282842",19,26,7
"TANGO6","s1670_SAT_M_BLOOD_ASEReadCounter.table","NW_015090842.1:10282863",13,16,3
"TANGO6","s1670_SAT_M_BLOOD_ASEReadCounter.table","NW_015090842.1:10282869",10,13,3
"TANGO6","s1670_SAT_M_BLOOD_ASEReadCounter.table","NW_015090842.1:10282903",9,10,1
"TANGO6","s1670_SAT_M_BLOOD_ASEReadCounter.table","NW_015090842.1:10283757",17,22,5
"TANGO6","s1670_SAT_M_BLOOD_ASEReadCounter.table","NW_015090842.1:10283785",16,21,5
"HAS3","s1670_SAT_M_BLOOD_ASEReadCounter.table","NW_015090842.1:10288266",1,1,0
"HAS3","s1670_SAT_M_BLOOD_ASEReadCounter.table","NW_015090842.1:10288274",1,1,0
"HAS3","s1670_SAT_M_BLOOD_ASEReadCounter.table","NW_015090842.1:10288405",1,1,0
"HAS3","s1670_SAT_M_BLOOD_ASEReadCounter.table","NW_015090842.1:10290375",0,1,1
"HAS3","s1670_SAT_M_BLOOD_ASEReadCounter.table","NW_015090842.1:10290561",0,1,1
"CHTF8","s1670_SAT_M_BLOOD_ASEReadCounter.table","NW_015090842.1:10291319",0,1,1
"CHTF8","s1670_SAT_M_BLOOD_ASEReadCounter.table","NW_015090842.1:10291342",0,1,1
"CHTF8","s1670_SAT_M_BLOOD_ASEReadCounter.table","NW_015090842.1:10291491",2,4,2
"CHTF8","s1670_SAT_M_BLOOD_ASEReadCounter.table","NW_015090842.1:10291520",1,2,1
"CHTF8","s1670_SAT_M_BLOOD_ASEReadCounter.table","NW_015090842.1:10291593",1,1,0
"CHTF8","s1670_SAT_M_BLOOD_ASEReadCounter.table","NW_015090842.1:10291600",1,1,0
"CHTF8","s1670_SAT_M_BLOOD_ASEReadCounter.table","NW_015090842.1:10291609",1,1,0
"CHTF8","s1670_SAT_M_BLOOD_ASEReadCounter.table","NW_015090842.1:10291639",2,3,1
"CHTF8","s1670_SAT_M_BLOOD_ASEReadCounter.table","NW_015090842.1:10291641",2,3,1
"CHTF8","s1670_SAT_M_BLOOD_ASEReadCounter.table","NW_015090842.1:10291648",2,3,1
"CHTF8","s1670_SAT_M_BLOOD_ASEReadCounter.table","NW_015090842.1:10291656",2,3,1
"CHTF8","s1670_SAT_M_BLOOD_ASEReadCounter.table","NW_015090842.1:10291675",3,4,1
"CHTF8","s1670_SAT_M_BLOOD_ASEReadCounter.table","NW_015090842.1:10291696",3,4,1
"CHTF8","s1670_SAT_M_BLOOD_ASEReadCounter.table","NW_015090842.1:10291714",3,6,3
"CHTF8","s1670_SAT_M_BLOOD_ASEReadCounter.table","NW_015090842.1:10291732",4,7,3
"CHTF8","s1670_SAT_M_BLOOD_ASEReadCounter.table","NW_015090842.1:10291755",2,5,3
"CHTF8","s1670_SAT_M_BLOOD_ASEReadCounter.table","NW_015090842.1:10291756",2,5,3
"CHTF8","s1670_SAT_M_BLOOD_ASEReadCounter.table","NW_015090842.1:10291758",2,5,3
"CHTF8","s1670_SAT_M_BLOOD_ASEReadCounter.table","NW_015090842.1:10291792",2,6,4
"CHTF8","s1670_SAT_M_BLOOD_ASEReadCounter.table","NW_015090842.1:10291895",2,6,4
"CHTF8","s1670_SAT_M_BLOOD_ASEReadCounter.table","NW_015090842.1:10292132",2,2,0
"CHTF8","s1670_SAT_M_BLOOD_ASEReadCounter.table","NW_015090842.1:10292314",1,1,0
"CHTF8","s1670_SAT_M_BLOOD_ASEReadCounter.table","NW_015090842.1:10292317",1,1,0
"CHTF8","s1670_SAT_M_BLOOD_ASEReadCounter.table","NW_015090842.1:10292928",1,1,0
"UTP4","s1670_SAT_M_BLOOD_ASEReadCounter.table","NW_015090842.1:10293146",2,4,2
"UTP4","s1670_SAT_M_BLOOD_ASEReadCounter.table","NW_015090842.1:10293151",2,4,2
"UTP4","s1670_SAT_M_BLOOD_ASEReadCounter.table","NW_015090842.1:10293191",2,5,3
"UTP4","s1670_SAT_M_BLOOD_ASEReadCounter.table","NW_015090842.1:10293362",1,6,5
"UTP4","s1670_SAT_M_BLOOD_ASEReadCounter.table","NW_015090842.1:10293430",1,7,6
"UTP4","s1670_SAT_M_BLOOD_ASEReadCounter.table","NW_015090842.1:10293625",5,5,0
"UTP4","s1670_SAT_M_BLOOD_ASEReadCounter.table","NW_015090842.1:10293684",5,7,2
"UTP4","s1670_SAT_M_BLOOD_ASEReadCounter.table","NW_015090842.1:10294093",3,8,5
"UTP4","s1670_SAT_M_BLOOD_ASEReadCounter.table","NW_015090842.1:10294568",0,3,3
"UTP4","s1670_SAT_M_BLOOD_ASEReadCounter.table","NW_015090842.1:10294622",2,5,3
"UTP4","s1670_SAT_M_BLOOD_ASEReadCounter.table","NW_015090842.1:10294632",2,6,4
"UTP4","s1670_SAT_M_BLOOD_ASEReadCounter.table","NW_015090842.1:10295238",4,8,4
"UTP4","s1670_SAT_M_BLOOD_ASEReadCounter.table","NW_015090842.1:10295880",2,4,2
"UTP4","s1670_SAT_M_BLOOD_ASEReadCounter.table","NW_015090842.1:10295884",2,4,2
"UTP4","s1670_SAT_M_BLOOD_ASEReadCounter.table","NW_015090842.1:10295903",1,3,2
"UTP4","s1670_SAT_M_BLOOD_ASEReadCounter.table","NW_015090842.1:10295906",1,3,2
"UTP4","s1670_SAT_M_BLOOD_ASEReadCounter.table","NW_015090842.1:10295915",1,3,2
"UTP4","s1670_SAT_M_BLOOD_ASEReadCounter.table","NW_015090842.1:10295938",0,2,2
"UTP4","s1670_SAT_M_BLOOD_ASEReadCounter.table","NW_015090842.1:10296175",3,4,1
"UTP4","s1670_SAT_M_BLOOD_ASEReadCounter.table","NW_015090842.1:10296660",2,5,3
"UTP4","s1670_SAT_M_BLOOD_ASEReadCounter.table","NW_015090842.1:10296679",4,8,4
"UTP4","s1670_SAT_M_BLOOD_ASEReadCounter.table","NW_015090842.1:10297193",6,13,7
"UTP4","s1670_SAT_M_BLOOD_ASEReadCounter.table","NW_015090842.1:10297220",7,14,7
"UTP4","s1670_SAT_M_BLOOD_ASEReadCounter.table","NW_015090842.1:10297307",3,10,7
"UTP4","s1670_SAT_M_BLOOD_ASEReadCounter.table","NW_015090842.1:10297558",1,10,9
"UTP4","s1670_SAT_M_BLOOD_ASEReadCounter.table","NW_015090842.1:10297943",2,7,5
"UTP4","s1670_SAT_M_BLOOD_ASEReadCounter.table","NW_015090842.1:10297979",4,12,8
"UTP4","s1670_SAT_M_BLOOD_ASEReadCounter.table","NW_015090842.1:10298022",4,11,7
"UTP4","s1670_SAT_M_BLOOD_ASEReadCounter.table","NW_015090842.1:10298079",1,1,0
"UTP4","s1670_SAT_M_BLOOD_ASEReadCounter.table","NW_015090842.1:10298081",1,1,0
"UTP4","s1670_SAT_M_BLOOD_ASEReadCounter.table","NW_015090842.1:10298082",1,1,0
"SNTB2","s1670_SAT_M_BLOOD_ASEReadCounter.table","NW_015090842.1:10305451",1,2,1
"SNTB2","s1670_SAT_M_BLOOD_ASEReadCounter.table","NW_015090842.1:10305847",1,2,1
"SNTB2","s1670_SAT_M_BLOOD_ASEReadCounter.table","NW_015090842.1:10305911",1,1,0
"SNTB2","s1670_SAT_M_BLOOD_ASEReadCounter.table","NW_015090842.1:10306457",1,1,0
"SNTB2","s1670_SAT_M_BLOOD_ASEReadCounter.table","NW_015090842.1:10306496",1,1,0
"SNTB2","s1670_SAT_M_BLOOD_ASEReadCounter.table","NW_015090842.1:10306499",1,1,0
"VPS4A","s1670_SAT_M_BLOOD_ASEReadCounter.table","NW_015090842.1:10308566",48,130,82
"VPS4A","s1670_SAT_M_BLOOD_ASEReadCounter.table","NW_015090842.1:10308573",50,134,84
"VPS4A","s1670_SAT_M_BLOOD_ASEReadCounter.table","NW_015090842.1:10308856",76,199,123
"VPS4A","s1670_SAT_M_BLOOD_ASEReadCounter.table","NW_015090842.1:10309056",68,173,105
"VPS4A","s1670_SAT_M_BLOOD_ASEReadCounter.table","NW_015090842.1:10309089",80,217,137
"VPS4A","s1670_SAT_M_BLOOD_ASEReadCounter.table","NW_015090842.1:10309392",79,216,137
"VPS4A","s1670_SAT_M_BLOOD_ASEReadCounter.table","NW_015090842.1:10309413",87,221,134
"VPS4A","s1670_SAT_M_BLOOD_ASEReadCounter.table","NW_015090842.1:10309467",104,263,159
"VPS4A","s1670_SAT_M_BLOOD_ASEReadCounter.table","NW_015090842.1:10310230",113,290,177
"VPS4A","s1670_SAT_M_BLOOD_ASEReadCounter.table","NW_015090842.1:10310425",87,219,132
"VPS4A","s1670_SAT_M_BLOOD_ASEReadCounter.table","NW_015090842.1:10310639",98,234,136
"VPS4A","s1670_SAT_M_BLOOD_ASEReadCounter.table","NW_015090842.1:10310640",231,231,0
"VPS4A","s1670_SAT_M_BLOOD_ASEReadCounter.table","NW_015090842.1:10310687",108,228,120
"VPS4A","s1670_SAT_M_BLOOD_ASEReadCounter.table","NW_015090842.1:10310734",85,179,94
"VPS4A","s1670_SAT_M_BLOOD_ASEReadCounter.table","NW_015090842.1:10310737",88,181,93
"VPS4A","s1670_SAT_M_BLOOD_ASEReadCounter.table","NW_015090842.1:10310746",91,184,93
"VPS4A","s1670_SAT_M_BLOOD_ASEReadCounter.table","NW_015090842.1:10310767",88,194,106
"VPS4A","s1670_SAT_M_BLOOD_ASEReadCounter.table","NW_015090842.1:10310995",87,192,105
"VPS4A","s1670_SAT_M_BLOOD_ASEReadCounter.table","NW_015090842.1:10311004",86,188,102
"VPS4A","s1670_SAT_M_BLOOD_ASEReadCounter.table","NW_015090842.1:10311007",85,188,103
"VPS4A","s1670_SAT_M_BLOOD_ASEReadCounter.table","NW_015090842.1:10311013",84,190,106
"VPS4A","s1670_SAT_M_BLOOD_ASEReadCounter.table","NW_015090842.1:10311022",77,185,108
"VPS4A","s1670_SAT_M_BLOOD_ASEReadCounter.table","NW_015090842.1:10311023",77,181,104
"VPS4A","s1670_SAT_M_BLOOD_ASEReadCounter.table","NW_015090842.1:10311426",111,231,120
"VPS4A","s1670_SAT_M_BLOOD_ASEReadCounter.table","NW_015090842.1:10311489",1,3,2
"VPS4A","s1670_SAT_M_BLOOD_ASEReadCounter.table","NW_015090842.1:10311490",1,2,1
"VPS4A","s1670_SAT_M_BLOOD_ASEReadCounter.table","NW_015090842.1:10311525",0,1,1
"VPS4A","s1670_SAT_M_BLOOD_ASEReadCounter.table","NW_015090842.1:10311529",0,4,4
"VPS4A","s1670_SAT_M_BLOOD_ASEReadCounter.table","NW_015090842.1:10311530",0,4,4
"VPS4A","s1670_SAT_M_BLOOD_ASEReadCounter.table","NW_015090842.1:10311552",5,11,6
"VPS4A","s1670_SAT_M_BLOOD_ASEReadCounter.table","NW_015090842.1:10311689",7,19,12
"VPS4A","s1670_SAT_M_BLOOD_ASEReadCounter.table","NW_015090842.1:10311700",9,21,12
"VPS4A","s1670_SAT_M_BLOOD_ASEReadCounter.table","NW_015090842.1:10311701",9,21,12
"VPS4A","s1670_SAT_M_BLOOD_ASEReadCounter.table","NW_015090842.1:10311703",9,21,12
"COG8","s1670_SAT_M_BLOOD_ASEReadCounter.table","NW_015090842.1:10313487",4,10,6
"COG8","s1670_SAT_M_BLOOD_ASEReadCounter.table","NW_015090842.1:10313559",8,15,7
"COG8","s1670_SAT_M_BLOOD_ASEReadCounter.table","NW_015090842.1:10313579",6,14,8
"COG8","s1670_SAT_M_BLOOD_ASEReadCounter.table","NW_015090842.1:10313665",5,14,9
"COG8","s1670_SAT_M_BLOOD_ASEReadCounter.table","NW_015090842.1:10313681",5,19,14
"COG8","s1670_SAT_M_BLOOD_ASEReadCounter.table","NW_015090842.1:10313768",14,32,18
"COG8","s1670_SAT_M_BLOOD_ASEReadCounter.table","NW_015090842.1:10313775",14,31,17
"COG8","s1670_SAT_M_BLOOD_ASEReadCounter.table","NW_015090842.1:10313811",11,32,21
"COG8","s1670_SAT_M_BLOOD_ASEReadCounter.table","NW_015090842.1:10313858",12,32,20
"COG8","s1670_SAT_M_BLOOD_ASEReadCounter.table","NW_015090842.1:10313859",31,31,0
"COG8","s1670_SAT_M_BLOOD_ASEReadCounter.table","NW_015090842.1:10314100",15,31,16
"COG8","s1670_SAT_M_BLOOD_ASEReadCounter.table","NW_015090842.1:10314213",14,35,21
"COG8","s1670_SAT_M_BLOOD_ASEReadCounter.table","NW_015090842.1:10315093",11,20,9
"COG8","s1670_SAT_M_BLOOD_ASEReadCounter.table","NW_015090842.1:10315162",9,22,13
"COG8","s1670_SAT_M_BLOOD_ASEReadCounter.table","NW_015090842.1:10315285",15,39,24
"COG8","s1670_SAT_M_BLOOD_ASEReadCounter.table","NW_015090842.1:10315360",16,33,17
"COG8","s1670_SAT_M_BLOOD_ASEReadCounter.table","NW_015090842.1:10315369",16,34,18
"COG8","s1670_SAT_M_BLOOD_ASEReadCounter.table","NW_015090842.1:10315508",6,15,9
"COG8","s1670_SAT_M_BLOOD_ASEReadCounter.table","NW_015090842.1:10315624",22,45,23
"COG8","s1670_SAT_M_BLOOD_ASEReadCounter.table","NW_015090842.1:10315693",12,34,22
"COG8","s1670_SAT_M_BLOOD_ASEReadCounter.table","NW_015090842.1:10315698",13,35,22
"COG8","s1670_SAT_M_BLOOD_ASEReadCounter.table","NW_015090842.1:10315768",8,29,21
"COG8","s1670_SAT_M_BLOOD_ASEReadCounter.table","NW_015090842.1:10315769",8,29,21
"COG8","s1670_SAT_M_BLOOD_ASEReadCounter.table","NW_015090842.1:10315784",7,24,17
"COG8","s1670_SAT_M_BLOOD_ASEReadCounter.table","NW_015090842.1:10316093",10,24,14
"COG8","s1670_SAT_M_BLOOD_ASEReadCounter.table","NW_015090842.1:10316133",9,20,11
"NIP7","s1670_SAT_M_BLOOD_ASEReadCounter.table","NW_015090842.1:10316759",4,6,2
"NIP7","s1670_SAT_M_BLOOD_ASEReadCounter.table","NW_015090842.1:10316967",9,33,24
"NIP7","s1670_SAT_M_BLOOD_ASEReadCounter.table","NW_015090842.1:10316995",9,39,30
"NIP7","s1670_SAT_M_BLOOD_ASEReadCounter.table","NW_015090842.1:10317240",27,63,36
"NIP7","s1670_SAT_M_BLOOD_ASEReadCounter.table","NW_015090842.1:10317247",26,62,36
"NIP7","s1670_SAT_M_BLOOD_ASEReadCounter.table","NW_015090842.1:10317264",24,55,31
"NIP7","s1670_SAT_M_BLOOD_ASEReadCounter.table","NW_015090842.1:10317433",18,49,31
"NIP7","s1670_SAT_M_BLOOD_ASEReadCounter.table","NW_015090842.1:10317738",18,52,34
"NIP7","s1670_SAT_M_BLOOD_ASEReadCounter.table","NW_015090842.1:10317769",18,61,43
"NIP7","s1670_SAT_M_BLOOD_ASEReadCounter.table","NW_015090842.1:10317808",8,34,26
"NIP7","s1670_SAT_M_BLOOD_ASEReadCounter.table","NW_015090842.1:10317870",3,13,10
"NIP7","s1670_SAT_M_BLOOD_ASEReadCounter.table","NW_015090842.1:10317871",3,13,10
"NIP7","s1670_SAT_M_BLOOD_ASEReadCounter.table","NW_015090842.1:10317898",0,5,5
"NIP7","s1670_SAT_M_BLOOD_ASEReadCounter.table","NW_015090842.1:10317911",0,3,3
"TMED6","s1670_SAT_M_BLOOD_ASEReadCounter.table","NW_015090842.1:10318514",4,7,3
"TMED6","s1670_SAT_M_BLOOD_ASEReadCounter.table","NW_015090842.1:10318731",3,13,10
"TERF2","s1670_SAT_M_BLOOD_ASEReadCounter.table","NW_015090842.1:10321768",64,117,53
"TERF2","s1670_SAT_M_BLOOD_ASEReadCounter.table","NW_015090842.1:10321777",59,109,50
"TERF2","s1670_SAT_M_BLOOD_ASEReadCounter.table","NW_015090842.1:10321805",59,101,42
"TERF2","s1670_SAT_M_BLOOD_ASEReadCounter.table","NW_015090842.1:10321878",68,127,59
"TERF2","s1670_SAT_M_BLOOD_ASEReadCounter.table","NW_015090842.1:10321893",12,125,113
"TERF2","s1670_SAT_M_BLOOD_ASEReadCounter.table","NW_015090842.1:10321897",69,121,52
"TERF2","s1670_SAT_M_BLOOD_ASEReadCounter.table","NW_015090842.1:10321908",65,111,46
"TERF2","s1670_SAT_M_BLOOD_ASEReadCounter.table","NW_015090842.1:10322001",98,196,98
"TERF2","s1670_SAT_M_BLOOD_ASEReadCounter.table","NW_015090842.1:10322035",81,169,88
"TERF2","s1670_SAT_M_BLOOD_ASEReadCounter.table","NW_015090842.1:10322051",82,173,91
"TERF2","s1670_SAT_M_BLOOD_ASEReadCounter.table","NW_015090842.1:10322137",81,152,71
"TERF2","s1670_SAT_M_BLOOD_ASEReadCounter.table","NW_015090842.1:10322144",90,156,66
"TERF2","s1670_SAT_M_BLOOD_ASEReadCounter.table","NW_015090842.1:10322388",69,163,94
"TERF2","s1670_SAT_M_BLOOD_ASEReadCounter.table","NW_015090842.1:10322396",60,147,87
"TERF2","s1670_SAT_M_BLOOD_ASEReadCounter.table","NW_015090842.1:10322502",111,190,79
"TERF2","s1670_SAT_M_BLOOD_ASEReadCounter.table","NW_015090842.1:10322504",110,189,79
"TERF2","s1670_SAT_M_BLOOD_ASEReadCounter.table","NW_015090842.1:10322510",112,197,85
"TERF2","s1670_SAT_M_BLOOD_ASEReadCounter.table","NW_015090842.1:10323580",117,217,100
"TERF2","s1670_SAT_M_BLOOD_ASEReadCounter.table","NW_015090842.1:10324314",109,194,85
"TERF2","s1670_SAT_M_BLOOD_ASEReadCounter.table","NW_015090842.1:10326832",90,175,85
"TERF2","s1670_SAT_M_BLOOD_ASEReadCounter.table","NW_015090842.1:10327787",73,148,75
"TERF2","s1670_SAT_M_BLOOD_ASEReadCounter.table","NW_015090842.1:10328588",98,189,91
"TERF2","s1670_SAT_M_BLOOD_ASEReadCounter.table","NW_015090842.1:10328644",81,159,78
"TERF2","s1670_SAT_M_BLOOD_ASEReadCounter.table","NW_015090842.1:10329813",79,148,69
"TERF2","s1670_SAT_M_BLOOD_ASEReadCounter.table","NW_015090842.1:10330749",56,120,64
"TERF2","s1670_SAT_M_BLOOD_ASEReadCounter.table","NW_015090842.1:10330789",61,119,58
"CYB5B","s1670_SAT_M_BLOOD_ASEReadCounter.table","NW_015090842.1:10336667",0,1,1
"CYB5B","s1670_SAT_M_BLOOD_ASEReadCounter.table","NW_015090842.1:10336689",0,1,1
"CYB5B","s1670_SAT_M_BLOOD_ASEReadCounter.table","NW_015090842.1:10336728",1,2,1
"CYB5B","s1670_SAT_M_BLOOD_ASEReadCounter.table","NW_015090842.1:10345068",2,5,3
"CYB5B","s1670_SAT_M_BLOOD_ASEReadCounter.table","NW_015090842.1:10348800",2,3,1
"CYB5B","s1670_SAT_M_BLOOD_ASEReadCounter.table","NW_015090842.1:10349046",1,2,1
"CYB5B","s1670_SAT_M_BLOOD_ASEReadCounter.table","NW_015090842.1:10349119",0,2,2
"CYB5B","s1670_SAT_M_BLOOD_ASEReadCounter.table","NW_015090842.1:10349146",0,2,2
"CYB5B","s1670_SAT_M_BLOOD_ASEReadCounter.table","NW_015090842.1:10349157",0,2,2
"CYB5B","s1670_SAT_M_BLOOD_ASEReadCounter.table","NW_015090842.1:10349263",3,3,0
