"gene","id","snp","ref_count","total_count","alt_count"
"CENPN","s1680_S_ADR_01_ASEReadCounter.table","NW_015090842.1:5801612",0,2,2
"CENPN","s1680_S_ADR_01_ASEReadCounter.table","NW_015090842.1:5801618",0,2,2
"CENPN","s1680_S_ADR_01_ASEReadCounter.table","NW_015090842.1:5801623",1,3,2
"CENPN","s1680_S_ADR_01_ASEReadCounter.table","NW_015090842.1:5801631",3,5,2
"CENPN","s1680_S_ADR_01_ASEReadCounter.table","NW_015090842.1:5801632",3,5,2
"CENPN","s1680_S_ADR_01_ASEReadCounter.table","NW_015090842.1:5801655",7,13,6
"CENPN","s1680_S_ADR_01_ASEReadCounter.table","NW_015090842.1:5801670",7,13,6
"CENPN","s1680_S_ADR_01_ASEReadCounter.table","NW_015090842.1:5801674",7,13,6
"CENPN","s1680_S_ADR_01_ASEReadCounter.table","NW_015090842.1:5801692",7,13,6
"CENPN","s1680_S_ADR_01_ASEReadCounter.table","NW_015090842.1:5802008",4,10,6
"CENPN","s1680_S_ADR_01_ASEReadCounter.table","NW_015090842.1:5802012",4,10,6
"CENPN","s1680_S_ADR_01_ASEReadCounter.table","NW_015090842.1:5802087",6,20,14
"CENPN","s1680_S_ADR_01_ASEReadCounter.table","NW_015090842.1:5810113",4,4,0
"CENPN","s1680_S_ADR_01_ASEReadCounter.table","NW_015090842.1:5810147",8,8,0
"CENPN","s1680_S_ADR_01_ASEReadCounter.table","NW_015090842.1:5810148",9,9,0
"ATMIN","s1680_S_ADR_01_ASEReadCounter.table","NW_015090842.1:5818789",14,22,8
"ATMIN","s1680_S_ADR_01_ASEReadCounter.table","NW_015090842.1:5819958",11,30,19
"ATMIN","s1680_S_ADR_01_ASEReadCounter.table","NW_015090842.1:5820004",15,26,11
"ATMIN","s1680_S_ADR_01_ASEReadCounter.table","NW_015090842.1:5820217",13,21,8
"ATMIN","s1680_S_ADR_01_ASEReadCounter.table","NW_015090842.1:5820250",20,28,8
"ATMIN","s1680_S_ADR_01_ASEReadCounter.table","NW_015090842.1:5820298",20,24,4
"ATMIN","s1680_S_ADR_01_ASEReadCounter.table","NW_015090842.1:5820417",7,12,5
"ATMIN","s1680_S_ADR_01_ASEReadCounter.table","NW_015090842.1:5820421",10,15,5
"ATMIN","s1680_S_ADR_01_ASEReadCounter.table","NW_015090842.1:5820448",12,18,6
"ATMIN","s1680_S_ADR_01_ASEReadCounter.table","NW_015090842.1:5820457",12,19,7
"ATMIN","s1680_S_ADR_01_ASEReadCounter.table","NW_015090842.1:5820510",14,25,11
"ATMIN","s1680_S_ADR_01_ASEReadCounter.table","NW_015090842.1:5820673",16,22,6
"ATMIN","s1680_S_ADR_01_ASEReadCounter.table","NW_015090842.1:5820754",10,16,6
"ATMIN","s1680_S_ADR_01_ASEReadCounter.table","NW_015090842.1:5820820",11,17,6
"ATMIN","s1680_S_ADR_01_ASEReadCounter.table","NW_015090842.1:5820865",7,10,3
"ATMIN","s1680_S_ADR_01_ASEReadCounter.table","NW_015090842.1:5820889",11,16,5
"ATMIN","s1680_S_ADR_01_ASEReadCounter.table","NW_015090842.1:5820891",11,16,5
"ATMIN","s1680_S_ADR_01_ASEReadCounter.table","NW_015090842.1:5820997",11,19,8
"ATMIN","s1680_S_ADR_01_ASEReadCounter.table","NW_015090842.1:5821063",17,29,12
"ATMIN","s1680_S_ADR_01_ASEReadCounter.table","NW_015090842.1:5821132",20,32,12
"ATMIN","s1680_S_ADR_01_ASEReadCounter.table","NW_015090842.1:5821645",18,34,16
"ATMIN","s1680_S_ADR_01_ASEReadCounter.table","NW_015090842.1:5825066",17,30,13
"ATMIN","s1680_S_ADR_01_ASEReadCounter.table","NW_015090842.1:5825106",22,35,13
"ATMIN","s1680_S_ADR_01_ASEReadCounter.table","NW_015090842.1:5825122",20,31,11
"ATMIN","s1680_S_ADR_01_ASEReadCounter.table","NW_015090842.1:5825178",16,27,11
"ATMIN","s1680_S_ADR_01_ASEReadCounter.table","NW_015090842.1:5825194",18,29,11
"ATMIN","s1680_S_ADR_01_ASEReadCounter.table","NW_015090842.1:5825195",18,29,11
"ATMIN","s1680_S_ADR_01_ASEReadCounter.table","NW_015090842.1:5825220",14,26,12
"ATMIN","s1680_S_ADR_01_ASEReadCounter.table","NW_015090842.1:5825240",19,28,9
"ATMIN","s1680_S_ADR_01_ASEReadCounter.table","NW_015090842.1:5825303",19,30,11
"ATMIN","s1680_S_ADR_01_ASEReadCounter.table","NW_015090842.1:5825304",19,33,14
"ATMIN","s1680_S_ADR_01_ASEReadCounter.table","NW_015090842.1:5825310",17,31,14
"ATMIN","s1680_S_ADR_01_ASEReadCounter.table","NW_015090842.1:5825406",17,31,14
"ATMIN","s1680_S_ADR_01_ASEReadCounter.table","NW_015090842.1:5825415",16,31,15
"ATMIN","s1680_S_ADR_01_ASEReadCounter.table","NW_015090842.1:5825438",19,30,11
"ATMIN","s1680_S_ADR_01_ASEReadCounter.table","NW_015090842.1:5825485",21,32,11
"ATMIN","s1680_S_ADR_01_ASEReadCounter.table","NW_015090842.1:5825524",19,28,9
"ATMIN","s1680_S_ADR_01_ASEReadCounter.table","NW_015090842.1:5825557",14,27,13
"ATMIN","s1680_S_ADR_01_ASEReadCounter.table","NW_015090842.1:5825571",10,23,13
"ATMIN","s1680_S_ADR_01_ASEReadCounter.table","NW_015090842.1:5825579",8,19,11
"ATMIN","s1680_S_ADR_01_ASEReadCounter.table","NW_015090842.1:5825590",8,18,10
"ATMIN","s1680_S_ADR_01_ASEReadCounter.table","NW_015090842.1:5825689",15,29,14
"ATMIN","s1680_S_ADR_01_ASEReadCounter.table","NW_015090842.1:5825703",18,34,16
"ATMIN","s1680_S_ADR_01_ASEReadCounter.table","NW_015090842.1:5825787",16,29,13
"ATMIN","s1680_S_ADR_01_ASEReadCounter.table","NW_015090842.1:5825833",20,33,13
"ATMIN","s1680_S_ADR_01_ASEReadCounter.table","NW_015090842.1:5825841",21,30,9
"ATMIN","s1680_S_ADR_01_ASEReadCounter.table","NW_015090842.1:5825895",19,33,14
"ATMIN","s1680_S_ADR_01_ASEReadCounter.table","NW_015090842.1:5825984",17,34,17
"ATMIN","s1680_S_ADR_01_ASEReadCounter.table","NW_015090842.1:5826162",17,34,17
"ATMIN","s1680_S_ADR_01_ASEReadCounter.table","NW_015090842.1:5826194",16,34,18
"ATMIN","s1680_S_ADR_01_ASEReadCounter.table","NW_015090842.1:5826235",19,36,17
"ATMIN","s1680_S_ADR_01_ASEReadCounter.table","NW_015090842.1:5826245",19,39,20
"ATMIN","s1680_S_ADR_01_ASEReadCounter.table","NW_015090842.1:5826335",9,20,11
"ATMIN","s1680_S_ADR_01_ASEReadCounter.table","NW_015090842.1:5826417",15,24,9
"ATMIN","s1680_S_ADR_01_ASEReadCounter.table","NW_015090842.1:5826431",14,29,15
"ATMIN","s1680_S_ADR_01_ASEReadCounter.table","NW_015090842.1:5826438",15,26,11
"ATMIN","s1680_S_ADR_01_ASEReadCounter.table","NW_015090842.1:5826463",24,38,14
"ATMIN","s1680_S_ADR_01_ASEReadCounter.table","NW_015090842.1:5826502",20,40,20
"ATMIN","s1680_S_ADR_01_ASEReadCounter.table","NW_015090842.1:5826511",17,37,20
"ATMIN","s1680_S_ADR_01_ASEReadCounter.table","NW_015090842.1:5826659",26,41,15
"ATMIN","s1680_S_ADR_01_ASEReadCounter.table","NW_015090842.1:5826701",26,40,14
"ATMIN","s1680_S_ADR_01_ASEReadCounter.table","NW_015090842.1:5826702",25,40,15
"ATMIN","s1680_S_ADR_01_ASEReadCounter.table","NW_015090842.1:5826732",25,42,17
"ATMIN","s1680_S_ADR_01_ASEReadCounter.table","NW_015090842.1:5826745",25,40,15
"ATMIN","s1680_S_ADR_01_ASEReadCounter.table","NW_015090842.1:5826835",22,40,18
"ATMIN","s1680_S_ADR_01_ASEReadCounter.table","NW_015090842.1:5826910",22,33,11
"ATMIN","s1680_S_ADR_01_ASEReadCounter.table","NW_015090842.1:5826942",12,33,21
"ATMIN","s1680_S_ADR_01_ASEReadCounter.table","NW_015090842.1:5827193",22,40,18
"ATMIN","s1680_S_ADR_01_ASEReadCounter.table","NW_015090842.1:5827196",22,41,19
"ATMIN","s1680_S_ADR_01_ASEReadCounter.table","NW_015090842.1:5827269",15,39,24
"ATMIN","s1680_S_ADR_01_ASEReadCounter.table","NW_015090842.1:5827315",8,27,19
"ATMIN","s1680_S_ADR_01_ASEReadCounter.table","NW_015090842.1:5827316",8,31,23
"ATMIN","s1680_S_ADR_01_ASEReadCounter.table","NW_015090842.1:5827333",8,31,23
"PPP1R3E","s1680_S_ADR_01_ASEReadCounter.table","NW_015090842.1:5837733",12,21,9
"PPP1R3E","s1680_S_ADR_01_ASEReadCounter.table","NW_015090842.1:5837947",11,20,9
"PKD1L2","s1680_S_ADR_01_ASEReadCounter.table","NW_015090842.1:5867597",1,2,1
"PKD1L2","s1680_S_ADR_01_ASEReadCounter.table","NW_015090842.1:5867600",1,2,1
"PKD1L2","s1680_S_ADR_01_ASEReadCounter.table","NW_015090842.1:5867660",2,3,1
"PKD1L2","s1680_S_ADR_01_ASEReadCounter.table","NW_015090842.1:5867675",2,2,0
"PKD1L2","s1680_S_ADR_01_ASEReadCounter.table","NW_015090842.1:5867788",2,2,0
"PKD1L2","s1680_S_ADR_01_ASEReadCounter.table","NW_015090842.1:5867843",1,2,1
"PKD1L2","s1680_S_ADR_01_ASEReadCounter.table","NW_015090842.1:5872948",1,1,0
"BCO1","s1680_S_ADR_01_ASEReadCounter.table","NW_015090842.1:5915610",1,1,0
"BCO1","s1680_S_ADR_01_ASEReadCounter.table","NW_015090842.1:5917836",1,1,0
"BCO1","s1680_S_ADR_01_ASEReadCounter.table","NW_015090842.1:5917912",33,50,17
"BCO1","s1680_S_ADR_01_ASEReadCounter.table","NW_015090842.1:5917941",44,67,23
"BCO1","s1680_S_ADR_01_ASEReadCounter.table","NW_015090842.1:5917971",45,67,22
"BCO1","s1680_S_ADR_01_ASEReadCounter.table","NW_015090842.1:5921679",41,71,30
"BCO1","s1680_S_ADR_01_ASEReadCounter.table","NW_015090842.1:5921726",39,64,25
"BCO1","s1680_S_ADR_01_ASEReadCounter.table","NW_015090842.1:5925669",33,47,14
"BCO1","s1680_S_ADR_01_ASEReadCounter.table","NW_015090842.1:5925753",29,48,19
"BCO1","s1680_S_ADR_01_ASEReadCounter.table","NW_015090842.1:5926937",30,49,19
"BCO1","s1680_S_ADR_01_ASEReadCounter.table","NW_015090842.1:5927921",36,57,21
"BCO1","s1680_S_ADR_01_ASEReadCounter.table","NW_015090842.1:5927948",37,59,22
"BCO1","s1680_S_ADR_01_ASEReadCounter.table","NW_015090842.1:5927968",39,60,21
"BCO1","s1680_S_ADR_01_ASEReadCounter.table","NW_015090842.1:5928052",39,56,17
"BCO1","s1680_S_ADR_01_ASEReadCounter.table","NW_015090842.1:5932726",56,90,34
"BCO1","s1680_S_ADR_01_ASEReadCounter.table","NW_015090842.1:5932801",37,63,26
"BCO1","s1680_S_ADR_01_ASEReadCounter.table","NW_015090842.1:5934558",41,63,22
"BCO1","s1680_S_ADR_01_ASEReadCounter.table","NW_015090842.1:5934575",43,65,22
"BCO1","s1680_S_ADR_01_ASEReadCounter.table","NW_015090842.1:5934608",47,67,20
"BCO1","s1680_S_ADR_01_ASEReadCounter.table","NW_015090842.1:5934647",40,56,16
"BCO1","s1680_S_ADR_01_ASEReadCounter.table","NW_015090842.1:5934725",37,55,18
"BCO1","s1680_S_ADR_01_ASEReadCounter.table","NW_015090842.1:5934726",36,54,18
"BCO1","s1680_S_ADR_01_ASEReadCounter.table","NW_015090842.1:5934733",40,56,16
"BCO1","s1680_S_ADR_01_ASEReadCounter.table","NW_015090842.1:5934821",35,49,14
"BCO1","s1680_S_ADR_01_ASEReadCounter.table","NW_015090842.1:5934826",32,45,13
"BCO1","s1680_S_ADR_01_ASEReadCounter.table","NW_015090842.1:5934844",22,36,14
"BCO1","s1680_S_ADR_01_ASEReadCounter.table","NW_015090842.1:5934958",29,42,13
"BCO1","s1680_S_ADR_01_ASEReadCounter.table","NW_015090842.1:5934976",23,35,12
"GAN","s1680_S_ADR_01_ASEReadCounter.table","NW_015090842.1:5953759",6,14,8
"GAN","s1680_S_ADR_01_ASEReadCounter.table","NW_015090842.1:5957502",4,11,7
"GAN","s1680_S_ADR_01_ASEReadCounter.table","NW_015090842.1:5957578",3,9,6
"GAN","s1680_S_ADR_01_ASEReadCounter.table","NW_015090842.1:5965028",6,11,5
"GAN","s1680_S_ADR_01_ASEReadCounter.table","NW_015090842.1:5966047",3,10,7
"GAN","s1680_S_ADR_01_ASEReadCounter.table","NW_015090842.1:5966126",3,12,9
"GAN","s1680_S_ADR_01_ASEReadCounter.table","NW_015090842.1:5966127",3,12,9
"GAN","s1680_S_ADR_01_ASEReadCounter.table","NW_015090842.1:5966162",9,16,7
"GAN","s1680_S_ADR_01_ASEReadCounter.table","NW_015090842.1:5966483",8,16,8
"CMIP","s1680_S_ADR_01_ASEReadCounter.table","NW_015090842.1:6109159",7,14,7
"CMIP","s1680_S_ADR_01_ASEReadCounter.table","NW_015090842.1:6109166",7,14,7
"CMIP","s1680_S_ADR_01_ASEReadCounter.table","NW_015090842.1:6114641",16,19,3
"CMIP","s1680_S_ADR_01_ASEReadCounter.table","NW_015090842.1:6114751",16,26,10
"CMIP","s1680_S_ADR_01_ASEReadCounter.table","NW_015090842.1:6114824",12,19,7
"CMIP","s1680_S_ADR_01_ASEReadCounter.table","NW_015090842.1:6128998",11,24,13
"CMIP","s1680_S_ADR_01_ASEReadCounter.table","NW_015090842.1:6130562",21,47,26
"CMIP","s1680_S_ADR_01_ASEReadCounter.table","NW_015090842.1:6132522",14,32,18
"CMIP","s1680_S_ADR_01_ASEReadCounter.table","NW_015090842.1:6134088",15,26,11
"CMIP","s1680_S_ADR_01_ASEReadCounter.table","NW_015090842.1:6138265",9,25,16
"CMIP","s1680_S_ADR_01_ASEReadCounter.table","NW_015090842.1:6138300",18,36,18
"CMIP","s1680_S_ADR_01_ASEReadCounter.table","NW_015090842.1:6138342",17,26,9
"CMIP","s1680_S_ADR_01_ASEReadCounter.table","NW_015090842.1:6138343",16,26,10
"CMIP","s1680_S_ADR_01_ASEReadCounter.table","NW_015090842.1:6138345",16,26,10
"CMIP","s1680_S_ADR_01_ASEReadCounter.table","NW_015090842.1:6138647",18,23,5
"CMIP","s1680_S_ADR_01_ASEReadCounter.table","NW_015090842.1:6138745",20,33,13
"CMIP","s1680_S_ADR_01_ASEReadCounter.table","NW_015090842.1:6138832",3,9,6
"CMIP","s1680_S_ADR_01_ASEReadCounter.table","NW_015090842.1:6138967",19,26,7
"CMIP","s1680_S_ADR_01_ASEReadCounter.table","NW_015090842.1:6139131",7,14,7
"CMIP","s1680_S_ADR_01_ASEReadCounter.table","NW_015090842.1:6139163",3,8,5
"CMIP","s1680_S_ADR_01_ASEReadCounter.table","NW_015090842.1:6139360",4,6,2
"CMIP","s1680_S_ADR_01_ASEReadCounter.table","NW_015090842.1:6139572",2,4,2
"CMIP","s1680_S_ADR_01_ASEReadCounter.table","NW_015090842.1:6139773",5,12,7
"PLCG2","s1680_S_ADR_01_ASEReadCounter.table","NW_015090842.1:6179613",2,10,8
"PLCG2","s1680_S_ADR_01_ASEReadCounter.table","NW_015090842.1:6179658",6,14,8
"PLCG2","s1680_S_ADR_01_ASEReadCounter.table","NW_015090842.1:6203766",2,23,21
"PLCG2","s1680_S_ADR_01_ASEReadCounter.table","NW_015090842.1:6203775",3,23,20
"PLCG2","s1680_S_ADR_01_ASEReadCounter.table","NW_015090842.1:6203787",4,23,19
"PLCG2","s1680_S_ADR_01_ASEReadCounter.table","NW_015090842.1:6205047",10,29,19
"PLCG2","s1680_S_ADR_01_ASEReadCounter.table","NW_015090842.1:6208541",9,24,15
"PLCG2","s1680_S_ADR_01_ASEReadCounter.table","NW_015090842.1:6209741",9,29,20
"PLCG2","s1680_S_ADR_01_ASEReadCounter.table","NW_015090842.1:6209798",9,31,22
"PLCG2","s1680_S_ADR_01_ASEReadCounter.table","NW_015090842.1:6209816",9,29,20
"PLCG2","s1680_S_ADR_01_ASEReadCounter.table","NW_015090842.1:6217547",7,31,24
"PLCG2","s1680_S_ADR_01_ASEReadCounter.table","NW_015090842.1:6218641",5,22,17
"PLCG2","s1680_S_ADR_01_ASEReadCounter.table","NW_015090842.1:6220552",4,26,22
"PLCG2","s1680_S_ADR_01_ASEReadCounter.table","NW_015090842.1:6221969",8,31,23
"PLCG2","s1680_S_ADR_01_ASEReadCounter.table","NW_015090842.1:6228672",10,34,24
"PLCG2","s1680_S_ADR_01_ASEReadCounter.table","NW_015090842.1:6228694",9,32,23
"PLCG2","s1680_S_ADR_01_ASEReadCounter.table","NW_015090842.1:6228722",8,32,24
"PLCG2","s1680_S_ADR_01_ASEReadCounter.table","NW_015090842.1:6228747",4,24,20
"PLCG2","s1680_S_ADR_01_ASEReadCounter.table","NW_015090842.1:6228835",5,28,23
"PLCG2","s1680_S_ADR_01_ASEReadCounter.table","NW_015090842.1:6228841",5,30,25
"PLCG2","s1680_S_ADR_01_ASEReadCounter.table","NW_015090842.1:6228865",6,24,18
"PLCG2","s1680_S_ADR_01_ASEReadCounter.table","NW_015090842.1:6228917",9,24,15
"PLCG2","s1680_S_ADR_01_ASEReadCounter.table","NW_015090842.1:6228926",8,24,16
"PLCG2","s1680_S_ADR_01_ASEReadCounter.table","NW_015090842.1:6228954",8,21,13
"PLCG2","s1680_S_ADR_01_ASEReadCounter.table","NW_015090842.1:6229002",11,22,11
"PLCG2","s1680_S_ADR_01_ASEReadCounter.table","NW_015090842.1:6229006",11,23,12
"PLCG2","s1680_S_ADR_01_ASEReadCounter.table","NW_015090842.1:6229081",6,14,8
"PLCG2","s1680_S_ADR_01_ASEReadCounter.table","NW_015090842.1:6229097",5,10,5
"PLCG2","s1680_S_ADR_01_ASEReadCounter.table","NW_015090842.1:6229160",6,12,6
"PLCG2","s1680_S_ADR_01_ASEReadCounter.table","NW_015090842.1:6229213",7,14,7
"PLCG2","s1680_S_ADR_01_ASEReadCounter.table","NW_015090842.1:6229231",8,17,9
"PLCG2","s1680_S_ADR_01_ASEReadCounter.table","NW_015090842.1:6229663",9,20,11
"PLCG2","s1680_S_ADR_01_ASEReadCounter.table","NW_015090842.1:6229748",7,16,9
"PLCG2","s1680_S_ADR_01_ASEReadCounter.table","NW_015090842.1:6229892",11,20,9
"PLCG2","s1680_S_ADR_01_ASEReadCounter.table","NW_015090842.1:6230248",4,9,5
"PLCG2","s1680_S_ADR_01_ASEReadCounter.table","NW_015090842.1:6230255",4,9,5
"PLCG2","s1680_S_ADR_01_ASEReadCounter.table","NW_015090842.1:6230296",3,10,7
"PLCG2","s1680_S_ADR_01_ASEReadCounter.table","NW_015090842.1:6230349",10,21,11
"PLCG2","s1680_S_ADR_01_ASEReadCounter.table","NW_015090842.1:6230381",9,17,8
"PLCG2","s1680_S_ADR_01_ASEReadCounter.table","NW_015090842.1:6230408",11,24,13
"PLCG2","s1680_S_ADR_01_ASEReadCounter.table","NW_015090842.1:6230439",10,24,14
"PLCG2","s1680_S_ADR_01_ASEReadCounter.table","NW_015090842.1:6230757",3,12,9
"PLCG2","s1680_S_ADR_01_ASEReadCounter.table","NW_015090842.1:6230758",4,11,7
"PLCG2","s1680_S_ADR_01_ASEReadCounter.table","NW_015090842.1:6230898",10,17,7
"PLCG2","s1680_S_ADR_01_ASEReadCounter.table","NW_015090842.1:6230976",7,15,8
"PLCG2","s1680_S_ADR_01_ASEReadCounter.table","NW_015090842.1:6231078",7,18,11
"PLCG2","s1680_S_ADR_01_ASEReadCounter.table","NW_015090842.1:6231138",13,22,9
"PLCG2","s1680_S_ADR_01_ASEReadCounter.table","NW_015090842.1:6231177",11,17,6
"PLCG2","s1680_S_ADR_01_ASEReadCounter.table","NW_015090842.1:6231263",12,19,7
"PLCG2","s1680_S_ADR_01_ASEReadCounter.table","NW_015090842.1:6231309",8,12,4
"SDR42E1","s1680_S_ADR_01_ASEReadCounter.table","NW_015090842.1:6235292",0,11,11
"SDR42E1","s1680_S_ADR_01_ASEReadCounter.table","NW_015090842.1:6235315",0,10,10
"SDR42E1","s1680_S_ADR_01_ASEReadCounter.table","NW_015090842.1:6235348",0,13,13
"SDR42E1","s1680_S_ADR_01_ASEReadCounter.table","NW_015090842.1:6235355",0,11,11
"SDR42E1","s1680_S_ADR_01_ASEReadCounter.table","NW_015090842.1:6235417",1,15,14
"SDR42E1","s1680_S_ADR_01_ASEReadCounter.table","NW_015090842.1:6235526",17,17,0
"SDR42E1","s1680_S_ADR_01_ASEReadCounter.table","NW_015090842.1:6235558",1,12,11
"SDR42E1","s1680_S_ADR_01_ASEReadCounter.table","NW_015090842.1:6235603",17,17,0
"SDR42E1","s1680_S_ADR_01_ASEReadCounter.table","NW_015090842.1:6235741",10,24,14
"SDR42E1","s1680_S_ADR_01_ASEReadCounter.table","NW_015090842.1:6235777",9,27,18
"SDR42E1","s1680_S_ADR_01_ASEReadCounter.table","NW_015090842.1:6235806",10,34,24
"SDR42E1","s1680_S_ADR_01_ASEReadCounter.table","NW_015090842.1:6235809",9,35,26
"SDR42E1","s1680_S_ADR_01_ASEReadCounter.table","NW_015090842.1:6235816",9,34,25
"SDR42E1","s1680_S_ADR_01_ASEReadCounter.table","NW_015090842.1:6235914",8,26,18
"SDR42E1","s1680_S_ADR_01_ASEReadCounter.table","NW_015090842.1:6235935",7,25,18
"SDR42E1","s1680_S_ADR_01_ASEReadCounter.table","NW_015090842.1:6235957",7,27,20
"SDR42E1","s1680_S_ADR_01_ASEReadCounter.table","NW_015090842.1:6236040",6,25,19
"SDR42E1","s1680_S_ADR_01_ASEReadCounter.table","NW_015090842.1:6236260",5,27,22
"SDR42E1","s1680_S_ADR_01_ASEReadCounter.table","NW_015090842.1:6236281",4,21,17
"SDR42E1","s1680_S_ADR_01_ASEReadCounter.table","NW_015090842.1:6236305",5,26,21
"SDR42E1","s1680_S_ADR_01_ASEReadCounter.table","NW_015090842.1:6236458",7,30,23
"SDR42E1","s1680_S_ADR_01_ASEReadCounter.table","NW_015090842.1:6236476",9,42,33
"SDR42E1","s1680_S_ADR_01_ASEReadCounter.table","NW_015090842.1:6236608",12,27,15
"SDR42E1","s1680_S_ADR_01_ASEReadCounter.table","NW_015090842.1:6238244",6,10,4
"SDR42E1","s1680_S_ADR_01_ASEReadCounter.table","NW_015090842.1:6238829",2,6,4
"HSD17B2","s1680_S_ADR_01_ASEReadCounter.table","NW_015090842.1:6257616",0,1,1
"HSD17B2","s1680_S_ADR_01_ASEReadCounter.table","NW_015090842.1:6257670",0,1,1
"HSD17B2","s1680_S_ADR_01_ASEReadCounter.table","NW_015090842.1:6257684",0,1,1
"HSD17B2","s1680_S_ADR_01_ASEReadCounter.table","NW_015090842.1:6257829",0,2,2
"HSD17B2","s1680_S_ADR_01_ASEReadCounter.table","NW_015090842.1:6262974",0,1,1
"HSD17B2","s1680_S_ADR_01_ASEReadCounter.table","NW_015090842.1:6266125",0,1,1
"HSD17B2","s1680_S_ADR_01_ASEReadCounter.table","NW_015090842.1:6266135",0,1,1
"HSD17B2","s1680_S_ADR_01_ASEReadCounter.table","NW_015090842.1:6266795",0,1,1
"HSD17B2","s1680_S_ADR_01_ASEReadCounter.table","NW_015090842.1:6266944",0,1,1
"HSD17B2","s1680_S_ADR_01_ASEReadCounter.table","NW_015090842.1:6266997",0,1,1
"HSD17B2","s1680_S_ADR_01_ASEReadCounter.table","NW_015090842.1:6267196",0,1,1
"HSD17B2","s1680_S_ADR_01_ASEReadCounter.table","NW_015090842.1:6267358",0,2,2
"HSD17B2","s1680_S_ADR_01_ASEReadCounter.table","NW_015090842.1:6268180",1,1,0
"HSD17B2","s1680_S_ADR_01_ASEReadCounter.table","NW_015090842.1:6268203",0,1,1
"ARY2","s1680_S_ADR_01_ASEReadCounter.table","NW_015090842.1:6303922",16,42,26
"ARY2","s1680_S_ADR_01_ASEReadCounter.table","NW_015090842.1:6303954",28,73,45
"ARY2","s1680_S_ADR_01_ASEReadCounter.table","NW_015090842.1:6303979",29,77,48
"ARY2","s1680_S_ADR_01_ASEReadCounter.table","NW_015090842.1:6305848",31,78,47
"ARY2","s1680_S_ADR_01_ASEReadCounter.table","NW_015090842.1:6305856",33,79,46
"ARY2","s1680_S_ADR_01_ASEReadCounter.table","NW_015090842.1:6305857",32,78,46
"ARY2","s1680_S_ADR_01_ASEReadCounter.table","NW_015090842.1:6306017",22,61,39
"ARY2","s1680_S_ADR_01_ASEReadCounter.table","NW_015090842.1:6306052",28,73,45
"ARY2","s1680_S_ADR_01_ASEReadCounter.table","NW_015090842.1:6306094",29,76,47
"ARY2","s1680_S_ADR_01_ASEReadCounter.table","NW_015090842.1:6306100",32,81,49
"ARY2","s1680_S_ADR_01_ASEReadCounter.table","NW_015090842.1:6306146",30,68,38
"ARY2","s1680_S_ADR_01_ASEReadCounter.table","NW_015090842.1:6306147",30,67,37
"ARY2","s1680_S_ADR_01_ASEReadCounter.table","NW_015090842.1:6306390",22,59,37
"ARY2","s1680_S_ADR_01_ASEReadCounter.table","NW_015090842.1:6306567",18,57,39
"ARY2","s1680_S_ADR_01_ASEReadCounter.table","NW_015090842.1:6306705",28,80,52
"ARY2","s1680_S_ADR_01_ASEReadCounter.table","NW_015090842.1:6306713",80,80,0
"ARY2","s1680_S_ADR_01_ASEReadCounter.table","NW_015090842.1:6306773",15,60,45
"ARY2","s1680_S_ADR_01_ASEReadCounter.table","NW_015090842.1:6307039",23,54,31
"ARY2","s1680_S_ADR_01_ASEReadCounter.table","NW_015090842.1:6307043",23,53,30
"ARY2","s1680_S_ADR_01_ASEReadCounter.table","NW_015090842.1:6307093",25,52,27
"ARY2","s1680_S_ADR_01_ASEReadCounter.table","NW_015090842.1:6307138",21,63,42
"ARY2","s1680_S_ADR_01_ASEReadCounter.table","NW_015090842.1:6307157",16,61,45
"ARY2","s1680_S_ADR_01_ASEReadCounter.table","NW_015090842.1:6307187",20,60,40
"ARY2","s1680_S_ADR_01_ASEReadCounter.table","NW_015090842.1:6307278",19,47,28
"ARY2","s1680_S_ADR_01_ASEReadCounter.table","NW_015090842.1:6307305",19,55,36
"ARY2","s1680_S_ADR_01_ASEReadCounter.table","NW_015090842.1:6307318",19,61,42
"ARY2","s1680_S_ADR_01_ASEReadCounter.table","NW_015090842.1:6307429",18,52,34
"ARY2","s1680_S_ADR_01_ASEReadCounter.table","NW_015090842.1:6307487",24,59,35
"ARY2","s1680_S_ADR_01_ASEReadCounter.table","NW_015090842.1:6307670",12,30,18
"ARYL","s1680_S_ADR_01_ASEReadCounter.table","NW_015090842.1:6313360",1,1,0
"ARYL","s1680_S_ADR_01_ASEReadCounter.table","NW_015090842.1:6313377",1,2,1
"ARYL","s1680_S_ADR_01_ASEReadCounter.table","NW_015090842.1:6313767",3,7,4
"ARY1","s1680_S_ADR_01_ASEReadCounter.table","NW_015090842.1:6313909",4,4,0
"ARY1","s1680_S_ADR_01_ASEReadCounter.table","NW_015090842.1:6314296",2,2,0
"ARY1","s1680_S_ADR_01_ASEReadCounter.table","NW_015090842.1:6314541",2,3,1
"ARY1","s1680_S_ADR_01_ASEReadCounter.table","NW_015090842.1:6314597",2,3,1
"ARY1","s1680_S_ADR_01_ASEReadCounter.table","NW_015090842.1:6314750",0,1,1
"ARY1","s1680_S_ADR_01_ASEReadCounter.table","NW_015090842.1:6314794",1,2,1
"ARY1","s1680_S_ADR_01_ASEReadCounter.table","NW_015090842.1:6314827",4,5,1
"ARY1","s1680_S_ADR_01_ASEReadCounter.table","NW_015090842.1:6314843",4,4,0
"ARY1","s1680_S_ADR_01_ASEReadCounter.table","NW_015090842.1:6314859",5,6,1
"ARY1","s1680_S_ADR_01_ASEReadCounter.table","NW_015090842.1:6314886",5,6,1
"ARY1","s1680_S_ADR_01_ASEReadCounter.table","NW_015090842.1:6314943",4,5,1
"ARY1","s1680_S_ADR_01_ASEReadCounter.table","NW_015090842.1:6314949",4,4,0
"ARY1","s1680_S_ADR_01_ASEReadCounter.table","NW_015090842.1:6315022",3,5,2
"ARY1","s1680_S_ADR_01_ASEReadCounter.table","NW_015090842.1:6315026",3,5,2
"ARY1","s1680_S_ADR_01_ASEReadCounter.table","NW_015090842.1:6315043",3,5,2
"ARY1","s1680_S_ADR_01_ASEReadCounter.table","NW_015090842.1:6315065",4,6,2
"ARY1","s1680_S_ADR_01_ASEReadCounter.table","NW_015090842.1:6315409",3,3,0
"ARY1","s1680_S_ADR_01_ASEReadCounter.table","NW_015090842.1:6315479",5,5,0
"ARY1","s1680_S_ADR_01_ASEReadCounter.table","NW_015090842.1:6318342",8,13,5
"ARY1","s1680_S_ADR_01_ASEReadCounter.table","NW_015090842.1:6318427",14,18,4
"ARY1","s1680_S_ADR_01_ASEReadCounter.table","NW_015090842.1:6318603",13,17,4
"ARY1","s1680_S_ADR_01_ASEReadCounter.table","NW_015090842.1:6318708",4,7,3
"ARY1","s1680_S_ADR_01_ASEReadCounter.table","NW_015090842.1:6318858",8,10,2
"ARY1","s1680_S_ADR_01_ASEReadCounter.table","NW_015090842.1:6318952",7,9,2
"MPHOSPH6","s1680_S_ADR_01_ASEReadCounter.table","NW_015090842.1:6324063",39,66,27
"MPHOSPH6","s1680_S_ADR_01_ASEReadCounter.table","NW_015090842.1:6324174",68,136,68
"MPHOSPH6","s1680_S_ADR_01_ASEReadCounter.table","NW_015090842.1:6324270",94,174,80
"MPHOSPH6","s1680_S_ADR_01_ASEReadCounter.table","NW_015090842.1:6324762",104,203,99
"MPHOSPH6","s1680_S_ADR_01_ASEReadCounter.table","NW_015090842.1:6324772",106,192,86
"MPHOSPH6","s1680_S_ADR_01_ASEReadCounter.table","NW_015090842.1:6324780",103,193,90
"MPHOSPH6","s1680_S_ADR_01_ASEReadCounter.table","NW_015090842.1:6324902",124,238,114
"MPHOSPH6","s1680_S_ADR_01_ASEReadCounter.table","NW_015090842.1:6324910",249,249,0
"MPHOSPH6","s1680_S_ADR_01_ASEReadCounter.table","NW_015090842.1:6325066",110,247,137
"MPHOSPH6","s1680_S_ADR_01_ASEReadCounter.table","NW_015090842.1:6325089",117,277,160
"MPHOSPH6","s1680_S_ADR_01_ASEReadCounter.table","NW_015090842.1:6325298",158,361,203
"MPHOSPH6","s1680_S_ADR_01_ASEReadCounter.table","NW_015090842.1:6325877",147,291,144
"MPHOSPH6","s1680_S_ADR_01_ASEReadCounter.table","NW_015090842.1:6326976",100,226,126
"CDH13","s1680_S_ADR_01_ASEReadCounter.table","NW_015090842.1:6662283",37,62,25
"CDH13","s1680_S_ADR_01_ASEReadCounter.table","NW_015090842.1:6693665",52,83,31
"CDH13","s1680_S_ADR_01_ASEReadCounter.table","NW_015090842.1:6693697",51,74,23
"CDH13","s1680_S_ADR_01_ASEReadCounter.table","NW_015090842.1:6693712",48,71,23
"CDH13","s1680_S_ADR_01_ASEReadCounter.table","NW_015090842.1:6693723",34,53,19
"CDH13","s1680_S_ADR_01_ASEReadCounter.table","NW_015090842.1:6693738",32,49,17
"CDH13","s1680_S_ADR_01_ASEReadCounter.table","NW_015090842.1:6823730",42,69,27
"CDH13","s1680_S_ADR_01_ASEReadCounter.table","NW_015090842.1:6889713",41,65,24
"CDH13","s1680_S_ADR_01_ASEReadCounter.table","NW_015090842.1:6955167",47,75,28
"MLYCD","s1680_S_ADR_01_ASEReadCounter.table","NW_015090842.1:7150054",27,77,50
"MLYCD","s1680_S_ADR_01_ASEReadCounter.table","NW_015090842.1:7150131",56,137,81
"MLYCD","s1680_S_ADR_01_ASEReadCounter.table","NW_015090842.1:7150585",56,113,57
"MLYCD","s1680_S_ADR_01_ASEReadCounter.table","NW_015090842.1:7150686",43,93,50
"MLYCD","s1680_S_ADR_01_ASEReadCounter.table","NW_015090842.1:7150696",46,106,60
"MLYCD","s1680_S_ADR_01_ASEReadCounter.table","NW_015090842.1:7150698",107,107,0
"MLYCD","s1680_S_ADR_01_ASEReadCounter.table","NW_015090842.1:7150869",51,117,66
"MLYCD","s1680_S_ADR_01_ASEReadCounter.table","NW_015090842.1:7151100",50,122,72
"MLYCD","s1680_S_ADR_01_ASEReadCounter.table","NW_015090842.1:7151127",43,117,74
"MLYCD","s1680_S_ADR_01_ASEReadCounter.table","NW_015090842.1:7157538",52,120,68
"MLYCD","s1680_S_ADR_01_ASEReadCounter.table","NW_015090842.1:7167662",22,56,34
"MLYCD","s1680_S_ADR_01_ASEReadCounter.table","NW_015090842.1:7167675",20,52,32
"MLYCD","s1680_S_ADR_01_ASEReadCounter.table","NW_015090842.1:7167710",21,61,40
"MLYCD","s1680_S_ADR_01_ASEReadCounter.table","NW_015090842.1:7167781",24,60,36
"MLYCD","s1680_S_ADR_01_ASEReadCounter.table","NW_015090842.1:7167803",25,52,27
"MLYCD","s1680_S_ADR_01_ASEReadCounter.table","NW_015090842.1:7167812",24,50,26
"MLYCD","s1680_S_ADR_01_ASEReadCounter.table","NW_015090842.1:7167845",20,46,26
"MLYCD","s1680_S_ADR_01_ASEReadCounter.table","NW_015090842.1:7167862",18,47,29
"MLYCD","s1680_S_ADR_01_ASEReadCounter.table","NW_015090842.1:7167929",21,40,19
"MLYCD","s1680_S_ADR_01_ASEReadCounter.table","NW_015090842.1:7167995",28,44,16
"MLYCD","s1680_S_ADR_01_ASEReadCounter.table","NW_015090842.1:7168005",29,45,16
"MLYCD","s1680_S_ADR_01_ASEReadCounter.table","NW_015090842.1:7168037",24,46,22
"HSBP1","s1680_S_ADR_01_ASEReadCounter.table","NW_015090842.1:7245192",197,380,183
"HSBP1","s1680_S_ADR_01_ASEReadCounter.table","NW_015090842.1:7245226",220,442,222
"HSBP1","s1680_S_ADR_01_ASEReadCounter.table","NW_015090842.1:7245257",183,382,199
"HSBP1","s1680_S_ADR_01_ASEReadCounter.table","NW_015090842.1:7245296",163,360,197
"HSBP1","s1680_S_ADR_01_ASEReadCounter.table","NW_015090842.1:7245389",274,542,268
"HSBP1","s1680_S_ADR_01_ASEReadCounter.table","NW_015090842.1:7245400",267,512,245
"HSBP1","s1680_S_ADR_01_ASEReadCounter.table","NW_015090842.1:7245445",262,530,268
"HSBP1","s1680_S_ADR_01_ASEReadCounter.table","NW_015090842.1:7245495",238,463,225
"HSBP1","s1680_S_ADR_01_ASEReadCounter.table","NW_015090842.1:7245515",273,521,248
"HSBP1","s1680_S_ADR_01_ASEReadCounter.table","NW_015090842.1:7245733",205,388,183
"HSBP1","s1680_S_ADR_01_ASEReadCounter.table","NW_015090842.1:7245771",204,374,170
"HSBP1","s1680_S_ADR_01_ASEReadCounter.table","NW_015090842.1:7245813",206,388,182
"HSBP1","s1680_S_ADR_01_ASEReadCounter.table","NW_015090842.1:7245926",227,430,203
"HSBP1","s1680_S_ADR_01_ASEReadCounter.table","NW_015090842.1:7245927",227,430,203
"HSBP1","s1680_S_ADR_01_ASEReadCounter.table","NW_015090842.1:7245933",234,423,189
"HSBP1","s1680_S_ADR_01_ASEReadCounter.table","NW_015090842.1:7246002",162,348,186
"HSBP1","s1680_S_ADR_01_ASEReadCounter.table","NW_015090842.1:7246094",241,465,224
"HSBP1","s1680_S_ADR_01_ASEReadCounter.table","NW_015090842.1:7246167",229,428,199
"HSBP1","s1680_S_ADR_01_ASEReadCounter.table","NW_015090842.1:7246183",213,416,203
"HSBP1","s1680_S_ADR_01_ASEReadCounter.table","NW_015090842.1:7247285",33,46,13
"HSBP1","s1680_S_ADR_01_ASEReadCounter.table","NW_015090842.1:7247651",401,876,475
"HSBP1","s1680_S_ADR_01_ASEReadCounter.table","NW_015090842.1:7247657",406,892,486
"HSBP1","s1680_S_ADR_01_ASEReadCounter.table","NW_015090842.1:7248520",283,616,333
"HSBP1","s1680_S_ADR_01_ASEReadCounter.table","NW_015090842.1:7248535",234,509,275
"KCNG4","s1680_S_ADR_01_ASEReadCounter.table","NW_015090842.1:7282481",1,2,1
"KCNG4","s1680_S_ADR_01_ASEReadCounter.table","NW_015090842.1:7282500",1,1,0
"KCNG4","s1680_S_ADR_01_ASEReadCounter.table","NW_015090842.1:7282542",1,2,1
"KCNG4","s1680_S_ADR_01_ASEReadCounter.table","NW_015090842.1:7282579",1,2,1
"KCNG4","s1680_S_ADR_01_ASEReadCounter.table","NW_015090842.1:7282630",0,2,2
"KCNG4","s1680_S_ADR_01_ASEReadCounter.table","NW_015090842.1:7282760",0,2,2
"KCNG4","s1680_S_ADR_01_ASEReadCounter.table","NW_015090842.1:7283056",1,3,2
"KCNG4","s1680_S_ADR_01_ASEReadCounter.table","NW_015090842.1:7283245",2,4,2
"KCNG4","s1680_S_ADR_01_ASEReadCounter.table","NW_015090842.1:7299491",3,6,3
"KCNG4","s1680_S_ADR_01_ASEReadCounter.table","NW_015090842.1:7301195",1,1,0
"KCNG4","s1680_S_ADR_01_ASEReadCounter.table","NW_015090842.1:7301227",1,1,0
"KCNG4","s1680_S_ADR_01_ASEReadCounter.table","NW_015090842.1:7301240",1,1,0
"WFDC1","s1680_S_ADR_01_ASEReadCounter.table","NW_015090842.1:7366517",32,72,40
"ATP2C2","s1680_S_ADR_01_ASEReadCounter.table","NW_015090842.1:7413747",2,10,8
"TLDC1","s1680_S_ADR_01_ASEReadCounter.table","NW_015090842.1:7421997",114,256,142
"COTL1","s1680_S_ADR_01_ASEReadCounter.table","NW_015090842.1:7490707",243,444,201
"COTL1","s1680_S_ADR_01_ASEReadCounter.table","NW_015090842.1:7490708",245,450,205
"COTL1","s1680_S_ADR_01_ASEReadCounter.table","NW_015090842.1:7490711",257,459,202
"COTL1","s1680_S_ADR_01_ASEReadCounter.table","NW_015090842.1:7490739",258,459,201
"COTL1","s1680_S_ADR_01_ASEReadCounter.table","NW_015090842.1:7490785",304,494,190
"COTL1","s1680_S_ADR_01_ASEReadCounter.table","NW_015090842.1:7490820",26,270,244
"COTL1","s1680_S_ADR_01_ASEReadCounter.table","NW_015090842.1:7490846",478,478,0
"COTL1","s1680_S_ADR_01_ASEReadCounter.table","NW_015090842.1:7505571",0,1,1
"KLHL36","s1680_S_ADR_01_ASEReadCounter.table","NW_015090842.1:7526337",18,34,16
"KLHL36","s1680_S_ADR_01_ASEReadCounter.table","NW_015090842.1:7537681",42,42,0
"USP10","s1680_S_ADR_01_ASEReadCounter.table","NW_015090842.1:7572213",69,163,94
"USP10","s1680_S_ADR_01_ASEReadCounter.table","NW_015090842.1:7572358",129,129,0
"CRISPLD2","s1680_S_ADR_01_ASEReadCounter.table","NW_015090842.1:7619796",73,140,67
"CRISPLD2","s1680_S_ADR_01_ASEReadCounter.table","NW_015090842.1:7630779",143,143,0
"CRISPLD2","s1680_S_ADR_01_ASEReadCounter.table","NW_015090842.1:7633611",229,229,0
"CRISPLD2","s1680_S_ADR_01_ASEReadCounter.table","NW_015090842.1:7633787",113,232,119
"CRISPLD2","s1680_S_ADR_01_ASEReadCounter.table","NW_015090842.1:7634023",66,140,74
"CRISPLD2","s1680_S_ADR_01_ASEReadCounter.table","NW_015090842.1:7634620",181,181,0
"CRISPLD2","s1680_S_ADR_01_ASEReadCounter.table","NW_015090842.1:7636315",19,30,11
"LOC106888312","s1680_S_ADR_01_ASEReadCounter.table","NW_015090842.1:7732198",3,3,0
"MTHFSD","s1680_S_ADR_01_ASEReadCounter.table","NW_015090842.1:8152578",16,43,27
"DUSP15","s1680_S_ADR_01_ASEReadCounter.table","NW_015090842.1:8422840",2,4,2
"DUSP15","s1680_S_ADR_01_ASEReadCounter.table","NW_015090842.1:8431988",0,3,3
"EMC8","s1680_S_ADR_01_ASEReadCounter.table","NW_015090842.1:8452385",15,31,16
"GINS2","s1680_S_ADR_01_ASEReadCounter.table","NW_015090842.1:8467469",50,50,0
"GINS2","s1680_S_ADR_01_ASEReadCounter.table","NW_015090842.1:8470290",33,70,37
"GINS2","s1680_S_ADR_01_ASEReadCounter.table","NW_015090842.1:8470305",32,64,32
"GINS2","s1680_S_ADR_01_ASEReadCounter.table","NW_015090842.1:8470376",39,77,38
"GINS2","s1680_S_ADR_01_ASEReadCounter.table","NW_015090842.1:8471057",2,4,2
"KIAA0513","s1680_S_ADR_01_ASEReadCounter.table","NW_015090842.1:8674736",221,221,0
"KIAA0513","s1680_S_ADR_01_ASEReadCounter.table","NW_015090842.1:8687268",1,5,4
"KIAA0513","s1680_S_ADR_01_ASEReadCounter.table","NW_015090842.1:8693655",86,86,0
"ZCCHC14","s1680_S_ADR_01_ASEReadCounter.table","NW_015090842.1:8750189",57,57,0
"JPH3","s1680_S_ADR_01_ASEReadCounter.table","NW_015090842.1:8872294",10,20,10
"KLHDC4","s1680_S_ADR_01_ASEReadCounter.table","NW_015090842.1:8891175",178,178,0
"KLHDC4","s1680_S_ADR_01_ASEReadCounter.table","NW_015090842.1:8905251",44,82,38
"KLHDC4","s1680_S_ADR_01_ASEReadCounter.table","NW_015090842.1:8919630",8,16,8
"SLC7A5","s1680_S_ADR_01_ASEReadCounter.table","NW_015090842.1:8940382",79,79,0
"SLC7A5","s1680_S_ADR_01_ASEReadCounter.table","NW_015090842.1:8941818",83,83,0
"SLC7A5","s1680_S_ADR_01_ASEReadCounter.table","NW_015090842.1:8944655",70,70,0
"CA5A","s1680_S_ADR_01_ASEReadCounter.table","NW_015090842.1:8989479",52,125,73
"CA5A","s1680_S_ADR_01_ASEReadCounter.table","NW_015090842.1:8989562",81,176,95
"CA5A","s1680_S_ADR_01_ASEReadCounter.table","NW_015090842.1:8989609",91,201,110
"CA5A","s1680_S_ADR_01_ASEReadCounter.table","NW_015090842.1:8989693",99,241,142
"CA5A","s1680_S_ADR_01_ASEReadCounter.table","NW_015090842.1:8989702",103,238,135
"CA5A","s1680_S_ADR_01_ASEReadCounter.table","NW_015090842.1:8989746",112,280,168
"CA5A","s1680_S_ADR_01_ASEReadCounter.table","NW_015090842.1:8989880",71,222,151
"CA5A","s1680_S_ADR_01_ASEReadCounter.table","NW_015090842.1:8989885",71,220,149
"CA5A","s1680_S_ADR_01_ASEReadCounter.table","NW_015090842.1:8989929",88,239,151
"CA5A","s1680_S_ADR_01_ASEReadCounter.table","NW_015090842.1:8990002",73,210,137
"CA5A","s1680_S_ADR_01_ASEReadCounter.table","NW_015090842.1:8990004",74,211,137
"CA5A","s1680_S_ADR_01_ASEReadCounter.table","NW_015090842.1:8990005",69,206,137
"CA5A","s1680_S_ADR_01_ASEReadCounter.table","NW_015090842.1:8990017",74,195,121
"CA5A","s1680_S_ADR_01_ASEReadCounter.table","NW_015090842.1:8990043",62,168,106
"CA5A","s1680_S_ADR_01_ASEReadCounter.table","NW_015090842.1:8990080",52,161,109
"CA5A","s1680_S_ADR_01_ASEReadCounter.table","NW_015090842.1:8990084",55,165,110
"CA5A","s1680_S_ADR_01_ASEReadCounter.table","NW_015090842.1:8990090",60,172,112
"CA5A","s1680_S_ADR_01_ASEReadCounter.table","NW_015090842.1:8990095",60,171,111
"CA5A","s1680_S_ADR_01_ASEReadCounter.table","NW_015090842.1:8990111",61,169,108
"CA5A","s1680_S_ADR_01_ASEReadCounter.table","NW_015090842.1:8990112",61,165,104
"CA5A","s1680_S_ADR_01_ASEReadCounter.table","NW_015090842.1:8990115",68,171,103
"CA5A","s1680_S_ADR_01_ASEReadCounter.table","NW_015090842.1:8990166",78,153,75
"CA5A","s1680_S_ADR_01_ASEReadCounter.table","NW_015090842.1:8990169",83,157,74
"CA5A","s1680_S_ADR_01_ASEReadCounter.table","NW_015090842.1:8990222",59,126,67
"CA5A","s1680_S_ADR_01_ASEReadCounter.table","NW_015090842.1:8990289",62,155,93
"CA5A","s1680_S_ADR_01_ASEReadCounter.table","NW_015090842.1:8990314",72,165,93
"CA5A","s1680_S_ADR_01_ASEReadCounter.table","NW_015090842.1:8990361",70,156,86
"CA5A","s1680_S_ADR_01_ASEReadCounter.table","NW_015090842.1:8990368",71,158,87
"CA5A","s1680_S_ADR_01_ASEReadCounter.table","NW_015090842.1:8990429",65,152,87
"CA5A","s1680_S_ADR_01_ASEReadCounter.table","NW_015090842.1:8990466",53,120,67
"CA5A","s1680_S_ADR_01_ASEReadCounter.table","NW_015090842.1:8990663",83,162,79
"CA5A","s1680_S_ADR_01_ASEReadCounter.table","NW_015090842.1:8990797",53,133,80
"CA5A","s1680_S_ADR_01_ASEReadCounter.table","NW_015090842.1:8990836",60,133,73
"CA5A","s1680_S_ADR_01_ASEReadCounter.table","NW_015090842.1:8990842",62,135,73
"CA5A","s1680_S_ADR_01_ASEReadCounter.table","NW_015090842.1:8990851",54,122,68
"CA5A","s1680_S_ADR_01_ASEReadCounter.table","NW_015090842.1:8990918",62,148,86
"CA5A","s1680_S_ADR_01_ASEReadCounter.table","NW_015090842.1:8990921",57,144,87
"CA5A","s1680_S_ADR_01_ASEReadCounter.table","NW_015090842.1:8990942",75,157,82
"CA5A","s1680_S_ADR_01_ASEReadCounter.table","NW_015090842.1:8991001",77,198,121
"CA5A","s1680_S_ADR_01_ASEReadCounter.table","NW_015090842.1:8991038",66,180,114
"CA5A","s1680_S_ADR_01_ASEReadCounter.table","NW_015090842.1:8991149",90,201,111
"CA5A","s1680_S_ADR_01_ASEReadCounter.table","NW_015090842.1:8991176",88,188,100
"CA5A","s1680_S_ADR_01_ASEReadCounter.table","NW_015090842.1:8991241",90,190,100
"CA5A","s1680_S_ADR_01_ASEReadCounter.table","NW_015090842.1:8991262",87,170,83
"CA5A","s1680_S_ADR_01_ASEReadCounter.table","NW_015090842.1:8991316",85,94,9
"CA5A","s1680_S_ADR_01_ASEReadCounter.table","NW_015090842.1:8991319",77,84,7
"CA5A","s1680_S_ADR_01_ASEReadCounter.table","NW_015090842.1:8991330",71,75,4
"CA5A","s1680_S_ADR_01_ASEReadCounter.table","NW_015090842.1:8991334",70,75,5
"CA5A","s1680_S_ADR_01_ASEReadCounter.table","NW_015090842.1:8991362",74,142,68
"CA5A","s1680_S_ADR_01_ASEReadCounter.table","NW_015090842.1:8991368",74,143,69
"CA5A","s1680_S_ADR_01_ASEReadCounter.table","NW_015090842.1:8991390",76,155,79
"CA5A","s1680_S_ADR_01_ASEReadCounter.table","NW_015090842.1:8991395",80,165,85
"CA5A","s1680_S_ADR_01_ASEReadCounter.table","NW_015090842.1:8991422",74,168,94
"CA5A","s1680_S_ADR_01_ASEReadCounter.table","NW_015090842.1:8991467",70,144,74
"CA5A","s1680_S_ADR_01_ASEReadCounter.table","NW_015090842.1:8991576",49,134,85
"CA5A","s1680_S_ADR_01_ASEReadCounter.table","NW_015090842.1:8991587",62,158,96
"CA5A","s1680_S_ADR_01_ASEReadCounter.table","NW_015090842.1:8991655",67,169,102
"CA5A","s1680_S_ADR_01_ASEReadCounter.table","NW_015090842.1:8991717",44,134,90
"CA5A","s1680_S_ADR_01_ASEReadCounter.table","NW_015090842.1:8991726",54,148,94
"CA5A","s1680_S_ADR_01_ASEReadCounter.table","NW_015090842.1:8991799",65,156,91
"CA5A","s1680_S_ADR_01_ASEReadCounter.table","NW_015090842.1:8991809",53,133,80
"CA5A","s1680_S_ADR_01_ASEReadCounter.table","NW_015090842.1:8991848",44,136,92
"CA5A","s1680_S_ADR_01_ASEReadCounter.table","NW_015090842.1:8991849",45,138,93
"CA5A","s1680_S_ADR_01_ASEReadCounter.table","NW_015090842.1:8991927",54,133,79
"CA5A","s1680_S_ADR_01_ASEReadCounter.table","NW_015090842.1:8991941",50,124,74
"CA5A","s1680_S_ADR_01_ASEReadCounter.table","NW_015090842.1:8992121",47,137,90
"CA5A","s1680_S_ADR_01_ASEReadCounter.table","NW_015090842.1:8992224",57,134,77
"CA5A","s1680_S_ADR_01_ASEReadCounter.table","NW_015090842.1:9002570",51,110,59
"CA5A","s1680_S_ADR_01_ASEReadCounter.table","NW_015090842.1:9002600",49,106,57
"CA5A","s1680_S_ADR_01_ASEReadCounter.table","NW_015090842.1:9004312",38,82,44
"CA5A","s1680_S_ADR_01_ASEReadCounter.table","NW_015090842.1:9004506",2,2,0
"CA5A","s1680_S_ADR_01_ASEReadCounter.table","NW_015090842.1:9004523",3,3,0
"CA5A","s1680_S_ADR_01_ASEReadCounter.table","NW_015090842.1:9004530",3,3,0
"CA5A","s1680_S_ADR_01_ASEReadCounter.table","NW_015090842.1:9004556",3,3,0
"CA5A","s1680_S_ADR_01_ASEReadCounter.table","NW_015090842.1:9004620",2,2,0
"CA5A","s1680_S_ADR_01_ASEReadCounter.table","NW_015090842.1:9005116",1,1,0
"CA5A","s1680_S_ADR_01_ASEReadCounter.table","NW_015090842.1:9005120",1,1,0
"CA5A","s1680_S_ADR_01_ASEReadCounter.table","NW_015090842.1:9005140",2,2,0
"CA5A","s1680_S_ADR_01_ASEReadCounter.table","NW_015090842.1:9005152",3,3,0
"CA5A","s1680_S_ADR_01_ASEReadCounter.table","NW_015090842.1:9011011",1,2,1
"CA5A","s1680_S_ADR_01_ASEReadCounter.table","NW_015090842.1:9011189",1,1,0
"CA5A","s1680_S_ADR_01_ASEReadCounter.table","NW_015090842.1:9011194",1,1,0
"BANP","s1680_S_ADR_01_ASEReadCounter.table","NW_015090842.1:9033407",11,32,21
"BANP","s1680_S_ADR_01_ASEReadCounter.table","NW_015090842.1:9033409",11,30,19
"BANP","s1680_S_ADR_01_ASEReadCounter.table","NW_015090842.1:9033420",13,35,22
"BANP","s1680_S_ADR_01_ASEReadCounter.table","NW_015090842.1:9055284",17,30,13
"CIDEC","s1680_S_ADR_01_ASEReadCounter.table","NW_015090842.1:9481199",3,6,3
"ZC3H18","s1680_S_ADR_01_ASEReadCounter.table","NW_015090842.1:9528933",28,59,31
"MVD","s1680_S_ADR_01_ASEReadCounter.table","NW_015090842.1:9550690",701,701,0
"MVD","s1680_S_ADR_01_ASEReadCounter.table","NW_015090842.1:9550691",696,696,0
"MVD","s1680_S_ADR_01_ASEReadCounter.table","NW_015090842.1:9550699",843,843,0
"MVD","s1680_S_ADR_01_ASEReadCounter.table","NW_015090842.1:9550701",837,840,3
"MVD","s1680_S_ADR_01_ASEReadCounter.table","NW_015090842.1:9552202",1679,1679,0
"MVD","s1680_S_ADR_01_ASEReadCounter.table","NW_015090842.1:9552223",1581,1582,1
"MVD","s1680_S_ADR_01_ASEReadCounter.table","NW_015090842.1:9552533",1354,1354,0
"MVD","s1680_S_ADR_01_ASEReadCounter.table","NW_015090842.1:9552644",483,1125,642
"PIEZO1","s1680_S_ADR_01_ASEReadCounter.table","NW_015090842.1:9577447",21,32,11
"PIEZO1","s1680_S_ADR_01_ASEReadCounter.table","NW_015090842.1:9579101",16,32,16
"PIEZO1","s1680_S_ADR_01_ASEReadCounter.table","NW_015090842.1:9582630",8,15,7
"PIEZO1","s1680_S_ADR_01_ASEReadCounter.table","NW_015090842.1:9582976",6,13,7
"PIEZO1","s1680_S_ADR_01_ASEReadCounter.table","NW_015090842.1:9583326",11,11,0
"CDT1","s1680_S_ADR_01_ASEReadCounter.table","NW_015090842.1:9596711",5,13,8
"CDT1","s1680_S_ADR_01_ASEReadCounter.table","NW_015090842.1:9597033",21,21,0
"CDT1","s1680_S_ADR_01_ASEReadCounter.table","NW_015090842.1:9597756",14,27,13
"CDT1","s1680_S_ADR_01_ASEReadCounter.table","NW_015090842.1:9598873",36,36,0
"ACSF3","s1680_S_ADR_01_ASEReadCounter.table","NW_015090842.1:9776737",34,61,27
"ACSF3","s1680_S_ADR_01_ASEReadCounter.table","NW_015090842.1:9809639",105,105,0
"ACSF3","s1680_S_ADR_01_ASEReadCounter.table","NW_015090842.1:9834743",72,132,60
"ACSF3","s1680_S_ADR_01_ASEReadCounter.table","NW_015090842.1:9834762",115,115,0
"ACSF3","s1680_S_ADR_01_ASEReadCounter.table","NW_015090842.1:9834852",75,134,59
"ACSF3","s1680_S_ADR_01_ASEReadCounter.table","NW_015090842.1:9834861",63,120,57
"ACSF3","s1680_S_ADR_01_ASEReadCounter.table","NW_015090842.1:9839359",41,75,34
"ACSF3","s1680_S_ADR_01_ASEReadCounter.table","NW_015090842.1:9839378",41,75,34
"ACSF3","s1680_S_ADR_01_ASEReadCounter.table","NW_015090842.1:9839455",29,72,43
"ACSF3","s1680_S_ADR_01_ASEReadCounter.table","NW_015090842.1:9839457",29,72,43
"ACSF3","s1680_S_ADR_01_ASEReadCounter.table","NW_015090842.1:9839489",24,59,35
"ACSF3","s1680_S_ADR_01_ASEReadCounter.table","NW_015090842.1:9839500",19,44,25
"ACSF3","s1680_S_ADR_01_ASEReadCounter.table","NW_015090842.1:9839501",19,46,27
"ACSF3","s1680_S_ADR_01_ASEReadCounter.table","NW_015090842.1:9839504",20,47,27
"ACSF3","s1680_S_ADR_01_ASEReadCounter.table","NW_015090842.1:9839512",17,40,23
"ACSF3","s1680_S_ADR_01_ASEReadCounter.table","NW_015090842.1:9839527",14,32,18
"ACSF3","s1680_S_ADR_01_ASEReadCounter.table","NW_015090842.1:9839533",7,24,17
"ACSF3","s1680_S_ADR_01_ASEReadCounter.table","NW_015090842.1:9839535",8,25,17
"ACSF3","s1680_S_ADR_01_ASEReadCounter.table","NW_015090842.1:9839545",4,19,15
"ACSF3","s1680_S_ADR_01_ASEReadCounter.table","NW_015090842.1:9839550",2,16,14
"ACSF3","s1680_S_ADR_01_ASEReadCounter.table","NW_015090842.1:9839551",2,16,14
"CDH15","s1680_S_ADR_01_ASEReadCounter.table","NW_015090842.1:9848265",0,1,1
"CDH15","s1680_S_ADR_01_ASEReadCounter.table","NW_015090842.1:9848531",2,3,1
"CDH15","s1680_S_ADR_01_ASEReadCounter.table","NW_015090842.1:9848552",2,2,0
"CDH15","s1680_S_ADR_01_ASEReadCounter.table","NW_015090842.1:9849086",0,1,1
"CDH15","s1680_S_ADR_01_ASEReadCounter.table","NW_015090842.1:9849473",1,1,0
"SLC22A31","s1680_S_ADR_01_ASEReadCounter.table","NW_015090842.1:9851130",11,18,7
"SLC22A31","s1680_S_ADR_01_ASEReadCounter.table","NW_015090842.1:9851139",13,20,7
"SLC22A31","s1680_S_ADR_01_ASEReadCounter.table","NW_015090842.1:9851265",24,33,9
"SLC22A31","s1680_S_ADR_01_ASEReadCounter.table","NW_015090842.1:9851302",21,28,7
"SLC22A31","s1680_S_ADR_01_ASEReadCounter.table","NW_015090842.1:9851303",22,29,7
"SLC22A31","s1680_S_ADR_01_ASEReadCounter.table","NW_015090842.1:9851305",21,29,8
"SLC22A31","s1680_S_ADR_01_ASEReadCounter.table","NW_015090842.1:9851343",23,27,4
"SLC22A31","s1680_S_ADR_01_ASEReadCounter.table","NW_015090842.1:9851344",24,28,4
"SLC22A31","s1680_S_ADR_01_ASEReadCounter.table","NW_015090842.1:9851381",27,38,11
"SLC22A31","s1680_S_ADR_01_ASEReadCounter.table","NW_015090842.1:9851421",33,48,15
"SLC22A31","s1680_S_ADR_01_ASEReadCounter.table","NW_015090842.1:9851526",32,46,14
"SLC22A31","s1680_S_ADR_01_ASEReadCounter.table","NW_015090842.1:9851589",39,56,17
"SLC22A31","s1680_S_ADR_01_ASEReadCounter.table","NW_015090842.1:9851712",49,70,21
"SLC22A31","s1680_S_ADR_01_ASEReadCounter.table","NW_015090842.1:9851899",44,59,15
"SLC22A31","s1680_S_ADR_01_ASEReadCounter.table","NW_015090842.1:9852139",60,78,18
"SLC22A31","s1680_S_ADR_01_ASEReadCounter.table","NW_015090842.1:9852380",63,87,24
"SLC22A31","s1680_S_ADR_01_ASEReadCounter.table","NW_015090842.1:9852431",49,63,14
"SLC22A31","s1680_S_ADR_01_ASEReadCounter.table","NW_015090842.1:9852630",35,49,14
"SLC22A31","s1680_S_ADR_01_ASEReadCounter.table","NW_015090842.1:9852711",23,40,17
"SLC22A31","s1680_S_ADR_01_ASEReadCounter.table","NW_015090842.1:9852742",24,37,13
"SLC22A31","s1680_S_ADR_01_ASEReadCounter.table","NW_015090842.1:9853099",22,30,8
"SLC22A31","s1680_S_ADR_01_ASEReadCounter.table","NW_015090842.1:9853102",22,29,7
"SLC22A31","s1680_S_ADR_01_ASEReadCounter.table","NW_015090842.1:9853421",17,17,0
"SLC22A31","s1680_S_ADR_01_ASEReadCounter.table","NW_015090842.1:9853457",29,29,0
"SLC22A31","s1680_S_ADR_01_ASEReadCounter.table","NW_015090842.1:9853502",22,22,0
"ANKRD11","s1680_S_ADR_01_ASEReadCounter.table","NW_015090842.1:9858863",2,6,4
"ANKRD11","s1680_S_ADR_01_ASEReadCounter.table","NW_015090842.1:9859101",65,139,74
"ANKRD11","s1680_S_ADR_01_ASEReadCounter.table","NW_015090842.1:9859352",71,161,90
"ANKRD11","s1680_S_ADR_01_ASEReadCounter.table","NW_015090842.1:9859381",16,88,72
"ANKRD11","s1680_S_ADR_01_ASEReadCounter.table","NW_015090842.1:9859527",33,68,35
"ANKRD11","s1680_S_ADR_01_ASEReadCounter.table","NW_015090842.1:9859529",33,74,41
"ANKRD11","s1680_S_ADR_01_ASEReadCounter.table","NW_015090842.1:9859679",78,156,78
"ANKRD11","s1680_S_ADR_01_ASEReadCounter.table","NW_015090842.1:9861097",78,180,102
"ANKRD11","s1680_S_ADR_01_ASEReadCounter.table","NW_015090842.1:9862571",61,112,51
"ANKRD11","s1680_S_ADR_01_ASEReadCounter.table","NW_015090842.1:9866071",0,56,56
"ANKRD11","s1680_S_ADR_01_ASEReadCounter.table","NW_015090842.1:9866200",0,47,47
"ANKRD11","s1680_S_ADR_01_ASEReadCounter.table","NW_015090842.1:9867391",27,57,30
"ANKRD11","s1680_S_ADR_01_ASEReadCounter.table","NW_015090842.1:9867472",43,88,45
"ANKRD11","s1680_S_ADR_01_ASEReadCounter.table","NW_015090842.1:9867559",57,102,45
"ANKRD11","s1680_S_ADR_01_ASEReadCounter.table","NW_015090842.1:9867934",53,115,62
"ANKRD11","s1680_S_ADR_01_ASEReadCounter.table","NW_015090842.1:9868093",52,104,52
"ANKRD11","s1680_S_ADR_01_ASEReadCounter.table","NW_015090842.1:9868222",41,86,45
"ANKRD11","s1680_S_ADR_01_ASEReadCounter.table","NW_015090842.1:9868327",63,98,35
"ANKRD11","s1680_S_ADR_01_ASEReadCounter.table","NW_015090842.1:9868414",59,117,58
"ANKRD11","s1680_S_ADR_01_ASEReadCounter.table","NW_015090842.1:9868441",63,112,49
"ANKRD11","s1680_S_ADR_01_ASEReadCounter.table","NW_015090842.1:9868444",66,125,59
"ANKRD11","s1680_S_ADR_01_ASEReadCounter.table","NW_015090842.1:9868519",62,133,71
"ANKRD11","s1680_S_ADR_01_ASEReadCounter.table","NW_015090842.1:9868609",61,124,63
"ANKRD11","s1680_S_ADR_01_ASEReadCounter.table","NW_015090842.1:9868666",68,134,66
"ANKRD11","s1680_S_ADR_01_ASEReadCounter.table","NW_015090842.1:9869431",46,93,47
"ANKRD11","s1680_S_ADR_01_ASEReadCounter.table","NW_015090842.1:9869578",74,162,88
"ANKRD11","s1680_S_ADR_01_ASEReadCounter.table","NW_015090842.1:9869734",74,147,73
"ANKRD11","s1680_S_ADR_01_ASEReadCounter.table","NW_015090842.1:9870070",68,128,60
"ANKRD11","s1680_S_ADR_01_ASEReadCounter.table","NW_015090842.1:9870349",61,113,52
"ANKRD11","s1680_S_ADR_01_ASEReadCounter.table","NW_015090842.1:9870604",63,125,62
"ANKRD11","s1680_S_ADR_01_ASEReadCounter.table","NW_015090842.1:9870613",73,135,62
"ANKRD11","s1680_S_ADR_01_ASEReadCounter.table","NW_015090842.1:9870685",78,159,81
"ANKRD11","s1680_S_ADR_01_ASEReadCounter.table","NW_015090842.1:9870847",66,129,63
"ANKRD11","s1680_S_ADR_01_ASEReadCounter.table","NW_015090842.1:9871103",57,98,41
"ANKRD11","s1680_S_ADR_01_ASEReadCounter.table","NW_015090842.1:9871165",65,114,49
"ANKRD11","s1680_S_ADR_01_ASEReadCounter.table","NW_015090842.1:9871820",24,55,31
"ANKRD11","s1680_S_ADR_01_ASEReadCounter.table","NW_015090842.1:9871994",74,74,0
"ANKRD11","s1680_S_ADR_01_ASEReadCounter.table","NW_015090842.1:9872118",47,90,43
"SPG7","s1680_S_ADR_01_ASEReadCounter.table","NW_015090842.1:10051190",221,443,222
"SPG7","s1680_S_ADR_01_ASEReadCounter.table","NW_015090842.1:10051218",237,500,263
"SPG7","s1680_S_ADR_01_ASEReadCounter.table","NW_015090842.1:10052348",285,531,246
"SPG7","s1680_S_ADR_01_ASEReadCounter.table","NW_015090842.1:10052366",292,555,263
"SPG7","s1680_S_ADR_01_ASEReadCounter.table","NW_015090842.1:10065173",287,543,256
"SPG7","s1680_S_ADR_01_ASEReadCounter.table","NW_015090842.1:10065215",247,477,230
"SPG7","s1680_S_ADR_01_ASEReadCounter.table","NW_015090842.1:10066301",209,377,168
"SPG7","s1680_S_ADR_01_ASEReadCounter.table","NW_015090842.1:10066365",231,429,198
"SPG7","s1680_S_ADR_01_ASEReadCounter.table","NW_015090842.1:10069752",284,516,232
"SPG7","s1680_S_ADR_01_ASEReadCounter.table","NW_015090842.1:10069800",271,537,266
"SPG7","s1680_S_ADR_01_ASEReadCounter.table","NW_015090842.1:10071192",279,568,289
"SPG7","s1680_S_ADR_01_ASEReadCounter.table","NW_015090842.1:10071204",260,525,265
"SPG7","s1680_S_ADR_01_ASEReadCounter.table","NW_015090842.1:10071219",248,506,258
"SPG7","s1680_S_ADR_01_ASEReadCounter.table","NW_015090842.1:10071967",226,494,268
"SPG7","s1680_S_ADR_01_ASEReadCounter.table","NW_015090842.1:10075109",333,600,267
"SPG7","s1680_S_ADR_01_ASEReadCounter.table","NW_015090842.1:10075114",341,603,262
"SPG7","s1680_S_ADR_01_ASEReadCounter.table","NW_015090842.1:10075198",259,472,213
"SPG7","s1680_S_ADR_01_ASEReadCounter.table","NW_015090842.1:10075487",141,315,174
"SPG7","s1680_S_ADR_01_ASEReadCounter.table","NW_015090842.1:10075488",143,320,177
"SPG7","s1680_S_ADR_01_ASEReadCounter.table","NW_015090842.1:10075548",104,225,121
"RPL13","s1680_S_ADR_01_ASEReadCounter.table","NW_015090842.1:10076979",2,2,0
"RPL13","s1680_S_ADR_01_ASEReadCounter.table","NW_015090842.1:10077387",863,1987,1124
"RPL13","s1680_S_ADR_01_ASEReadCounter.table","NW_015090842.1:10077978",1237,2691,1454
"RPL13","s1680_S_ADR_01_ASEReadCounter.table","NW_015090842.1:10077992",1218,2575,1357
"CPNE7","s1680_S_ADR_01_ASEReadCounter.table","NW_015090842.1:10084856",0,1,1
"CPNE7","s1680_S_ADR_01_ASEReadCounter.table","NW_015090842.1:10084872",0,1,1
"CPNE7","s1680_S_ADR_01_ASEReadCounter.table","NW_015090842.1:10085096",0,1,1
"CPNE7","s1680_S_ADR_01_ASEReadCounter.table","NW_015090842.1:10088940",1,1,0
"CPNE7","s1680_S_ADR_01_ASEReadCounter.table","NW_015090842.1:10088965",1,1,0
"CPNE7","s1680_S_ADR_01_ASEReadCounter.table","NW_015090842.1:10088967",1,1,0
"CPNE7","s1680_S_ADR_01_ASEReadCounter.table","NW_015090842.1:10088973",1,1,0
"CPNE7","s1680_S_ADR_01_ASEReadCounter.table","NW_015090842.1:10090924",3,4,1
"CPNE7","s1680_S_ADR_01_ASEReadCounter.table","NW_015090842.1:10090930",3,4,1
"CPNE7","s1680_S_ADR_01_ASEReadCounter.table","NW_015090842.1:10091075",1,2,1
"CPNE7","s1680_S_ADR_01_ASEReadCounter.table","NW_015090842.1:10091389",0,1,1
"CPNE7","s1680_S_ADR_01_ASEReadCounter.table","NW_015090842.1:10091407",0,1,1
"CPNE7","s1680_S_ADR_01_ASEReadCounter.table","NW_015090842.1:10091530",0,1,1
"CPNE7","s1680_S_ADR_01_ASEReadCounter.table","NW_015090842.1:10091875",1,1,0
"LOC106888185","s1680_S_ADR_01_ASEReadCounter.table","NW_015090842.1:10094965",1,17,16
"LOC106888185","s1680_S_ADR_01_ASEReadCounter.table","NW_015090842.1:10094966",1,19,18
"LOC106888185","s1680_S_ADR_01_ASEReadCounter.table","NW_015090842.1:10094985",4,20,16
"LOC106888185","s1680_S_ADR_01_ASEReadCounter.table","NW_015090842.1:10095055",1,21,20
"LOC106888185","s1680_S_ADR_01_ASEReadCounter.table","NW_015090842.1:10095062",2,19,17
"LOC106888185","s1680_S_ADR_01_ASEReadCounter.table","NW_015090842.1:10095130",0,25,25
"LOC106888185","s1680_S_ADR_01_ASEReadCounter.table","NW_015090842.1:10095265",56,134,78
"LOC106888185","s1680_S_ADR_01_ASEReadCounter.table","NW_015090842.1:10095586",45,161,116
"LOC106888185","s1680_S_ADR_01_ASEReadCounter.table","NW_015090842.1:10095593",45,158,113
"LOC106888185","s1680_S_ADR_01_ASEReadCounter.table","NW_015090842.1:10095616",44,156,112
"LOC106888185","s1680_S_ADR_01_ASEReadCounter.table","NW_015090842.1:10095662",34,119,85
"LOC106888185","s1680_S_ADR_01_ASEReadCounter.table","NW_015090842.1:10095674",30,114,84
"LOC106888185","s1680_S_ADR_01_ASEReadCounter.table","NW_015090842.1:10095786",38,117,79
"LOC106888185","s1680_S_ADR_01_ASEReadCounter.table","NW_015090842.1:10095831",49,131,82
"LOC106888185","s1680_S_ADR_01_ASEReadCounter.table","NW_015090842.1:10096230",51,143,92
"LOC106888185","s1680_S_ADR_01_ASEReadCounter.table","NW_015090842.1:10096249",49,143,94
"LOC106888185","s1680_S_ADR_01_ASEReadCounter.table","NW_015090842.1:10096272",48,149,101
"LOC106888185","s1680_S_ADR_01_ASEReadCounter.table","NW_015090842.1:10096288",50,152,102
"LOC106888185","s1680_S_ADR_01_ASEReadCounter.table","NW_015090842.1:10097248",56,181,125
"LOC106888185","s1680_S_ADR_01_ASEReadCounter.table","NW_015090842.1:10097265",64,208,144
"LOC106888185","s1680_S_ADR_01_ASEReadCounter.table","NW_015090842.1:10097446",11,41,30
"DPEP1","s1680_S_ADR_01_ASEReadCounter.table","NW_015090842.1:10098017",0,2,2
"DPEP1","s1680_S_ADR_01_ASEReadCounter.table","NW_015090842.1:10098518",1,14,13
"DPEP1","s1680_S_ADR_01_ASEReadCounter.table","NW_015090842.1:10098595",8,25,17
"DPEP1","s1680_S_ADR_01_ASEReadCounter.table","NW_015090842.1:10098597",8,25,17
"DPEP1","s1680_S_ADR_01_ASEReadCounter.table","NW_015090842.1:10098601",8,26,18
"DPEP1","s1680_S_ADR_01_ASEReadCounter.table","NW_015090842.1:10098608",8,26,18
"DPEP1","s1680_S_ADR_01_ASEReadCounter.table","NW_015090842.1:10098630",8,28,20
"DPEP1","s1680_S_ADR_01_ASEReadCounter.table","NW_015090842.1:10098659",7,25,18
"DPEP1","s1680_S_ADR_01_ASEReadCounter.table","NW_015090842.1:10099765",9,27,18
"DPEP1","s1680_S_ADR_01_ASEReadCounter.table","NW_015090842.1:10099985",12,30,18
"DPEP1","s1680_S_ADR_01_ASEReadCounter.table","NW_015090842.1:10099986",12,30,18
"DPEP1","s1680_S_ADR_01_ASEReadCounter.table","NW_015090842.1:10099991",9,27,18
"DPEP1","s1680_S_ADR_01_ASEReadCounter.table","NW_015090842.1:10100044",9,37,28
"DPEP1","s1680_S_ADR_01_ASEReadCounter.table","NW_015090842.1:10100045",8,38,30
"DPEP1","s1680_S_ADR_01_ASEReadCounter.table","NW_015090842.1:10100084",8,35,27
"DPEP1","s1680_S_ADR_01_ASEReadCounter.table","NW_015090842.1:10100295",10,33,23
"DPEP1","s1680_S_ADR_01_ASEReadCounter.table","NW_015090842.1:10100529",8,24,16
"DPEP1","s1680_S_ADR_01_ASEReadCounter.table","NW_015090842.1:10100893",15,38,23
"DPEP1","s1680_S_ADR_01_ASEReadCounter.table","NW_015090842.1:10100902",13,36,23
"DPEP1","s1680_S_ADR_01_ASEReadCounter.table","NW_015090842.1:10101072",13,37,24
"DPEP1","s1680_S_ADR_01_ASEReadCounter.table","NW_015090842.1:10101199",14,36,22
"DPEP1","s1680_S_ADR_01_ASEReadCounter.table","NW_015090842.1:10101483",4,30,26
"DPEP1","s1680_S_ADR_01_ASEReadCounter.table","NW_015090842.1:10101497",6,29,23
"DPEP1","s1680_S_ADR_01_ASEReadCounter.table","NW_015090842.1:10101525",6,32,26
"DPEP1","s1680_S_ADR_01_ASEReadCounter.table","NW_015090842.1:10101875",9,30,21
"DPEP1","s1680_S_ADR_01_ASEReadCounter.table","NW_015090842.1:10101913",8,22,14
"DPEP1","s1680_S_ADR_01_ASEReadCounter.table","NW_015090842.1:10101996",7,17,10
"DPEP1","s1680_S_ADR_01_ASEReadCounter.table","NW_015090842.1:10102014",4,13,9
"DPEP1","s1680_S_ADR_01_ASEReadCounter.table","NW_015090842.1:10102035",4,8,4
"DPEP1","s1680_S_ADR_01_ASEReadCounter.table","NW_015090842.1:10102076",0,2,2
"DPEP1","s1680_S_ADR_01_ASEReadCounter.table","NW_015090842.1:10102077",0,3,3
"CHMP1A","s1680_S_ADR_01_ASEReadCounter.table","NW_015090842.1:10102901",54,148,94
"CHMP1A","s1680_S_ADR_01_ASEReadCounter.table","NW_015090842.1:10102961",36,149,113
"CHMP1A","s1680_S_ADR_01_ASEReadCounter.table","NW_015090842.1:10102996",43,143,100
"CHMP1A","s1680_S_ADR_01_ASEReadCounter.table","NW_015090842.1:10103004",46,146,100
"CHMP1A","s1680_S_ADR_01_ASEReadCounter.table","NW_015090842.1:10103006",46,149,103
"CHMP1A","s1680_S_ADR_01_ASEReadCounter.table","NW_015090842.1:10103052",92,205,113
"CHMP1A","s1680_S_ADR_01_ASEReadCounter.table","NW_015090842.1:10103095",94,188,94
"CHMP1A","s1680_S_ADR_01_ASEReadCounter.table","NW_015090842.1:10103096",94,187,93
"CHMP1A","s1680_S_ADR_01_ASEReadCounter.table","NW_015090842.1:10103152",78,145,67
"CHMP1A","s1680_S_ADR_01_ASEReadCounter.table","NW_015090842.1:10103334",56,135,79
"CHMP1A","s1680_S_ADR_01_ASEReadCounter.table","NW_015090842.1:10103373",35,127,92
"CHMP1A","s1680_S_ADR_01_ASEReadCounter.table","NW_015090842.1:10103408",68,159,91
"CHMP1A","s1680_S_ADR_01_ASEReadCounter.table","NW_015090842.1:10103412",74,167,93
"CHMP1A","s1680_S_ADR_01_ASEReadCounter.table","NW_015090842.1:10103512",87,196,109
"CHMP1A","s1680_S_ADR_01_ASEReadCounter.table","NW_015090842.1:10103513",87,196,109
"CHMP1A","s1680_S_ADR_01_ASEReadCounter.table","NW_015090842.1:10103583",46,126,80
"CHMP1A","s1680_S_ADR_01_ASEReadCounter.table","NW_015090842.1:10103614",48,136,88
"CHMP1A","s1680_S_ADR_01_ASEReadCounter.table","NW_015090842.1:10103657",58,146,88
"CHMP1A","s1680_S_ADR_01_ASEReadCounter.table","NW_015090842.1:10103669",54,137,83
"CHMP1A","s1680_S_ADR_01_ASEReadCounter.table","NW_015090842.1:10103674",55,132,77
"CHMP1A","s1680_S_ADR_01_ASEReadCounter.table","NW_015090842.1:10103677",55,132,77
"CHMP1A","s1680_S_ADR_01_ASEReadCounter.table","NW_015090842.1:10103729",93,167,74
"CHMP1A","s1680_S_ADR_01_ASEReadCounter.table","NW_015090842.1:10103758",93,159,66
"CHMP1A","s1680_S_ADR_01_ASEReadCounter.table","NW_015090842.1:10103761",96,162,66
"CHMP1A","s1680_S_ADR_01_ASEReadCounter.table","NW_015090842.1:10103788",98,201,103
"CHMP1A","s1680_S_ADR_01_ASEReadCounter.table","NW_015090842.1:10103789",99,204,105
"CHMP1A","s1680_S_ADR_01_ASEReadCounter.table","NW_015090842.1:10103790",98,203,105
"CHMP1A","s1680_S_ADR_01_ASEReadCounter.table","NW_015090842.1:10103950",81,182,101
"CHMP1A","s1680_S_ADR_01_ASEReadCounter.table","NW_015090842.1:10104335",55,154,99
"CHMP1A","s1680_S_ADR_01_ASEReadCounter.table","NW_015090842.1:10104429",93,199,106
"CHMP1A","s1680_S_ADR_01_ASEReadCounter.table","NW_015090842.1:10104532",118,248,130
"CHMP1A","s1680_S_ADR_01_ASEReadCounter.table","NW_015090842.1:10104633",97,187,90
"CHMP1A","s1680_S_ADR_01_ASEReadCounter.table","NW_015090842.1:10104759",93,200,107
"CHMP1A","s1680_S_ADR_01_ASEReadCounter.table","NW_015090842.1:10104794",94,206,112
"CHMP1A","s1680_S_ADR_01_ASEReadCounter.table","NW_015090842.1:10104844",59,161,102
"CHMP1A","s1680_S_ADR_01_ASEReadCounter.table","NW_015090842.1:10106290",81,169,88
"CHMP1A","s1680_S_ADR_01_ASEReadCounter.table","NW_015090842.1:10106335",96,189,93
"CHMP1A","s1680_S_ADR_01_ASEReadCounter.table","NW_015090842.1:10106383",123,261,138
"CHMP1A","s1680_S_ADR_01_ASEReadCounter.table","NW_015090842.1:10106747",111,232,121
"CHMP1A","s1680_S_ADR_01_ASEReadCounter.table","NW_015090842.1:10107404",126,262,136
"CHMP1A","s1680_S_ADR_01_ASEReadCounter.table","NW_015090842.1:10107410",125,258,133
"CHMP1A","s1680_S_ADR_01_ASEReadCounter.table","NW_015090842.1:10107876",118,230,112
"CDK10","s1680_S_ADR_01_ASEReadCounter.table","NW_015090842.1:10109030",13,14,1
"CDK10","s1680_S_ADR_01_ASEReadCounter.table","NW_015090842.1:10109963",39,106,67
"CDK10","s1680_S_ADR_01_ASEReadCounter.table","NW_015090842.1:10110887",35,103,68
"CDK10","s1680_S_ADR_01_ASEReadCounter.table","NW_015090842.1:10111254",34,84,50
"CDK10","s1680_S_ADR_01_ASEReadCounter.table","NW_015090842.1:10111380",29,86,57
"CDK10","s1680_S_ADR_01_ASEReadCounter.table","NW_015090842.1:10111395",29,87,58
"CDK10","s1680_S_ADR_01_ASEReadCounter.table","NW_015090842.1:10111437",13,67,54
"CDK10","s1680_S_ADR_01_ASEReadCounter.table","NW_015090842.1:10111798",37,97,60
"CDK10","s1680_S_ADR_01_ASEReadCounter.table","NW_015090842.1:10111840",30,89,59
"CDK10","s1680_S_ADR_01_ASEReadCounter.table","NW_015090842.1:10112031",41,118,77
"CDK10","s1680_S_ADR_01_ASEReadCounter.table","NW_015090842.1:10112285",32,90,58
"CDK10","s1680_S_ADR_01_ASEReadCounter.table","NW_015090842.1:10112398",36,87,51
"CDK10","s1680_S_ADR_01_ASEReadCounter.table","NW_015090842.1:10112455",43,87,44
"CDK10","s1680_S_ADR_01_ASEReadCounter.table","NW_015090842.1:10112461",38,78,40
"CDK10","s1680_S_ADR_01_ASEReadCounter.table","NW_015090842.1:10112497",37,89,52
"CDK10","s1680_S_ADR_01_ASEReadCounter.table","NW_015090842.1:10112508",28,82,54
"CDK10","s1680_S_ADR_01_ASEReadCounter.table","NW_015090842.1:10112518",22,75,53
"CDK10","s1680_S_ADR_01_ASEReadCounter.table","NW_015090842.1:10112540",8,64,56
"CDK10","s1680_S_ADR_01_ASEReadCounter.table","NW_015090842.1:10112556",19,73,54
"CDK10","s1680_S_ADR_01_ASEReadCounter.table","NW_015090842.1:10112561",23,78,55
"CDK10","s1680_S_ADR_01_ASEReadCounter.table","NW_015090842.1:10112596",23,81,58
"CDK10","s1680_S_ADR_01_ASEReadCounter.table","NW_015090842.1:10112630",21,70,49
"CDK10","s1680_S_ADR_01_ASEReadCounter.table","NW_015090842.1:10112656",23,71,48
"CDK10","s1680_S_ADR_01_ASEReadCounter.table","NW_015090842.1:10112665",13,49,36
"CDK10","s1680_S_ADR_01_ASEReadCounter.table","NW_015090842.1:10112668",13,50,37
"CDK10","s1680_S_ADR_01_ASEReadCounter.table","NW_015090842.1:10112781",8,27,19
"CDK10","s1680_S_ADR_01_ASEReadCounter.table","NW_015090842.1:10112782",8,27,19
"CDK10","s1680_S_ADR_01_ASEReadCounter.table","NW_015090842.1:10112795",7,24,17
"CDK10","s1680_S_ADR_01_ASEReadCounter.table","NW_015090842.1:10112841",4,8,4
"CDK10","s1680_S_ADR_01_ASEReadCounter.table","NW_015090842.1:10112861",2,6,4
"SPATA2L","s1680_S_ADR_01_ASEReadCounter.table","NW_015090842.1:10113212",8,24,16
"SPATA2L","s1680_S_ADR_01_ASEReadCounter.table","NW_015090842.1:10113280",16,46,30
"SPATA2L","s1680_S_ADR_01_ASEReadCounter.table","NW_015090842.1:10113296",15,42,27
"SPATA2L","s1680_S_ADR_01_ASEReadCounter.table","NW_015090842.1:10113321",17,46,29
"SPATA2L","s1680_S_ADR_01_ASEReadCounter.table","NW_015090842.1:10113332",19,53,34
"SPATA2L","s1680_S_ADR_01_ASEReadCounter.table","NW_015090842.1:10113380",25,59,34
"SPATA2L","s1680_S_ADR_01_ASEReadCounter.table","NW_015090842.1:10113381",25,59,34
"SPATA2L","s1680_S_ADR_01_ASEReadCounter.table","NW_015090842.1:10113412",20,51,31
"SPATA2L","s1680_S_ADR_01_ASEReadCounter.table","NW_015090842.1:10113421",24,51,27
"SPATA2L","s1680_S_ADR_01_ASEReadCounter.table","NW_015090842.1:10113465",18,43,25
"SPATA2L","s1680_S_ADR_01_ASEReadCounter.table","NW_015090842.1:10113535",27,53,26
"SPATA2L","s1680_S_ADR_01_ASEReadCounter.table","NW_015090842.1:10113645",25,70,45
"SPATA2L","s1680_S_ADR_01_ASEReadCounter.table","NW_015090842.1:10113682",30,83,53
"SPATA2L","s1680_S_ADR_01_ASEReadCounter.table","NW_015090842.1:10113696",33,75,42
"SPATA2L","s1680_S_ADR_01_ASEReadCounter.table","NW_015090842.1:10113727",41,86,45
"SPATA2L","s1680_S_ADR_01_ASEReadCounter.table","NW_015090842.1:10113729",83,83,0
"SPATA2L","s1680_S_ADR_01_ASEReadCounter.table","NW_015090842.1:10113799",48,98,50
"SPATA2L","s1680_S_ADR_01_ASEReadCounter.table","NW_015090842.1:10113809",53,105,52
"SPATA2L","s1680_S_ADR_01_ASEReadCounter.table","NW_015090842.1:10113827",49,100,51
"SPATA2L","s1680_S_ADR_01_ASEReadCounter.table","NW_015090842.1:10113831",46,100,54
"SPATA2L","s1680_S_ADR_01_ASEReadCounter.table","NW_015090842.1:10113894",40,88,48
"SPATA2L","s1680_S_ADR_01_ASEReadCounter.table","NW_015090842.1:10113905",30,77,47
"SPATA2L","s1680_S_ADR_01_ASEReadCounter.table","NW_015090842.1:10113914",33,74,41
"SPATA2L","s1680_S_ADR_01_ASEReadCounter.table","NW_015090842.1:10113920",43,78,35
"SPATA2L","s1680_S_ADR_01_ASEReadCounter.table","NW_015090842.1:10113937",45,83,38
"SPATA2L","s1680_S_ADR_01_ASEReadCounter.table","NW_015090842.1:10113971",38,75,37
"SPATA2L","s1680_S_ADR_01_ASEReadCounter.table","NW_015090842.1:10113976",33,78,45
"SPATA2L","s1680_S_ADR_01_ASEReadCounter.table","NW_015090842.1:10113985",33,66,33
"SPATA2L","s1680_S_ADR_01_ASEReadCounter.table","NW_015090842.1:10113994",37,81,44
"SPATA2L","s1680_S_ADR_01_ASEReadCounter.table","NW_015090842.1:10114063",33,82,49
"SPATA2L","s1680_S_ADR_01_ASEReadCounter.table","NW_015090842.1:10114066",30,81,51
"SPATA2L","s1680_S_ADR_01_ASEReadCounter.table","NW_015090842.1:10114069",32,83,51
"SPATA2L","s1680_S_ADR_01_ASEReadCounter.table","NW_015090842.1:10114159",25,59,34
"SPATA2L","s1680_S_ADR_01_ASEReadCounter.table","NW_015090842.1:10114262",76,76,0
"SPATA2L","s1680_S_ADR_01_ASEReadCounter.table","NW_015090842.1:10114470",30,63,33
"SPATA2L","s1680_S_ADR_01_ASEReadCounter.table","NW_015090842.1:10114524",21,45,24
"VPS9D1","s1680_S_ADR_01_ASEReadCounter.table","NW_015090842.1:10116377",20,45,25
"VPS9D1","s1680_S_ADR_01_ASEReadCounter.table","NW_015090842.1:10116415",21,52,31
"VPS9D1","s1680_S_ADR_01_ASEReadCounter.table","NW_015090842.1:10116607",26,49,23
"VPS9D1","s1680_S_ADR_01_ASEReadCounter.table","NW_015090842.1:10116821",13,36,23
"VPS9D1","s1680_S_ADR_01_ASEReadCounter.table","NW_015090842.1:10116825",14,37,23
"VPS9D1","s1680_S_ADR_01_ASEReadCounter.table","NW_015090842.1:10116882",16,34,18
"VPS9D1","s1680_S_ADR_01_ASEReadCounter.table","NW_015090842.1:10116933",18,36,18
"VPS9D1","s1680_S_ADR_01_ASEReadCounter.table","NW_015090842.1:10116942",18,34,16
"VPS9D1","s1680_S_ADR_01_ASEReadCounter.table","NW_015090842.1:10117152",13,35,22
"VPS9D1","s1680_S_ADR_01_ASEReadCounter.table","NW_015090842.1:10117480",18,31,13
"VPS9D1","s1680_S_ADR_01_ASEReadCounter.table","NW_015090842.1:10117497",13,23,10
"VPS9D1","s1680_S_ADR_01_ASEReadCounter.table","NW_015090842.1:10117499",13,26,13
"VPS9D1","s1680_S_ADR_01_ASEReadCounter.table","NW_015090842.1:10117516",14,33,19
"VPS9D1","s1680_S_ADR_01_ASEReadCounter.table","NW_015090842.1:10117525",16,36,20
"VPS9D1","s1680_S_ADR_01_ASEReadCounter.table","NW_015090842.1:10117579",15,36,21
"VPS9D1","s1680_S_ADR_01_ASEReadCounter.table","NW_015090842.1:10117627",14,37,23
"VPS9D1","s1680_S_ADR_01_ASEReadCounter.table","NW_015090842.1:10117678",8,34,26
"VPS9D1","s1680_S_ADR_01_ASEReadCounter.table","NW_015090842.1:10117773",19,47,28
"VPS9D1","s1680_S_ADR_01_ASEReadCounter.table","NW_015090842.1:10117937",29,69,40
"VPS9D1","s1680_S_ADR_01_ASEReadCounter.table","NW_015090842.1:10117961",27,61,34
"VPS9D1","s1680_S_ADR_01_ASEReadCounter.table","NW_015090842.1:10118236",36,67,31
"VPS9D1","s1680_S_ADR_01_ASEReadCounter.table","NW_015090842.1:10118414",20,42,22
"VPS9D1","s1680_S_ADR_01_ASEReadCounter.table","NW_015090842.1:10118973",30,66,36
"VPS9D1","s1680_S_ADR_01_ASEReadCounter.table","NW_015090842.1:10119500",19,43,24
"ZNF276","s1680_S_ADR_01_ASEReadCounter.table","NW_015090842.1:10121760",6,19,13
"ZNF276","s1680_S_ADR_01_ASEReadCounter.table","NW_015090842.1:10121769",6,18,12
"ZNF276","s1680_S_ADR_01_ASEReadCounter.table","NW_015090842.1:10121802",5,18,13
"ZNF276","s1680_S_ADR_01_ASEReadCounter.table","NW_015090842.1:10121971",11,25,14
"ZNF276","s1680_S_ADR_01_ASEReadCounter.table","NW_015090842.1:10122161",23,23,0
"ZNF276","s1680_S_ADR_01_ASEReadCounter.table","NW_015090842.1:10122164",24,24,0
"ZNF276","s1680_S_ADR_01_ASEReadCounter.table","NW_015090842.1:10122184",22,22,0
"ZNF276","s1680_S_ADR_01_ASEReadCounter.table","NW_015090842.1:10122883",16,30,14
"ZNF276","s1680_S_ADR_01_ASEReadCounter.table","NW_015090842.1:10122997",20,33,13
"ZNF276","s1680_S_ADR_01_ASEReadCounter.table","NW_015090842.1:10123069",24,42,18
"ZNF276","s1680_S_ADR_01_ASEReadCounter.table","NW_015090842.1:10123207",37,67,30
"ZNF276","s1680_S_ADR_01_ASEReadCounter.table","NW_015090842.1:10125787",20,42,22
"ZNF276","s1680_S_ADR_01_ASEReadCounter.table","NW_015090842.1:10126309",31,52,21
"ZNF276","s1680_S_ADR_01_ASEReadCounter.table","NW_015090842.1:10126348",19,38,19
"ZNF276","s1680_S_ADR_01_ASEReadCounter.table","NW_015090842.1:10126978",27,50,23
"ZNF276","s1680_S_ADR_01_ASEReadCounter.table","NW_015090842.1:10126991",28,50,22
"ZNF276","s1680_S_ADR_01_ASEReadCounter.table","NW_015090842.1:10127023",24,53,29
"ZNF276","s1680_S_ADR_01_ASEReadCounter.table","NW_015090842.1:10127063",18,47,29
"ZNF276","s1680_S_ADR_01_ASEReadCounter.table","NW_015090842.1:10127373",24,45,21
"ZNF276","s1680_S_ADR_01_ASEReadCounter.table","NW_015090842.1:10127931",24,50,26
"ZNF276","s1680_S_ADR_01_ASEReadCounter.table","NW_015090842.1:10128070",22,46,24
"ZNF276","s1680_S_ADR_01_ASEReadCounter.table","NW_015090842.1:10128102",23,46,23
"ZNF276","s1680_S_ADR_01_ASEReadCounter.table","NW_015090842.1:10128356",27,59,32
"ZNF276","s1680_S_ADR_01_ASEReadCounter.table","NW_015090842.1:10128497",17,32,15
"FANCA","s1680_S_ADR_01_ASEReadCounter.table","NW_015090842.1:10128743",1,1,0
"FANCA","s1680_S_ADR_01_ASEReadCounter.table","NW_015090842.1:10128822",4,4,0
"FANCA","s1680_S_ADR_01_ASEReadCounter.table","NW_015090842.1:10129383",4,5,1
"FANCA","s1680_S_ADR_01_ASEReadCounter.table","NW_015090842.1:10129390",3,4,1
"FANCA","s1680_S_ADR_01_ASEReadCounter.table","NW_015090842.1:10129422",2,3,1
"FANCA","s1680_S_ADR_01_ASEReadCounter.table","NW_015090842.1:10129969",3,3,0
"FANCA","s1680_S_ADR_01_ASEReadCounter.table","NW_015090842.1:10130399",5,5,0
"FANCA","s1680_S_ADR_01_ASEReadCounter.table","NW_015090842.1:10130857",4,5,1
"FANCA","s1680_S_ADR_01_ASEReadCounter.table","NW_015090842.1:10130878",2,3,1
"FANCA","s1680_S_ADR_01_ASEReadCounter.table","NW_015090842.1:10133530",0,1,1
"FANCA","s1680_S_ADR_01_ASEReadCounter.table","NW_015090842.1:10133533",0,1,1
"FANCA","s1680_S_ADR_01_ASEReadCounter.table","NW_015090842.1:10133536",0,1,1
"FANCA","s1680_S_ADR_01_ASEReadCounter.table","NW_015090842.1:10133601",3,5,2
"FANCA","s1680_S_ADR_01_ASEReadCounter.table","NW_015090842.1:10134492",3,5,2
"FANCA","s1680_S_ADR_01_ASEReadCounter.table","NW_015090842.1:10136957",2,2,0
"FANCA","s1680_S_ADR_01_ASEReadCounter.table","NW_015090842.1:10136982",2,3,1
"FANCA","s1680_S_ADR_01_ASEReadCounter.table","NW_015090842.1:10136999",0,1,1
"FANCA","s1680_S_ADR_01_ASEReadCounter.table","NW_015090842.1:10137019",0,1,1
"FANCA","s1680_S_ADR_01_ASEReadCounter.table","NW_015090842.1:10137673",1,2,1
"FANCA","s1680_S_ADR_01_ASEReadCounter.table","NW_015090842.1:10138618",1,1,0
"FANCA","s1680_S_ADR_01_ASEReadCounter.table","NW_015090842.1:10139140",1,1,0
"FANCA","s1680_S_ADR_01_ASEReadCounter.table","NW_015090842.1:10140699",1,2,1
"FANCA","s1680_S_ADR_01_ASEReadCounter.table","NW_015090842.1:10145030",1,1,0
"FANCA","s1680_S_ADR_01_ASEReadCounter.table","NW_015090842.1:10150518",1,1,0
"FANCA","s1680_S_ADR_01_ASEReadCounter.table","NW_015090842.1:10158162",1,2,1
"FANCA","s1680_S_ADR_01_ASEReadCounter.table","NW_015090842.1:10158957",2,3,1
"FANCA","s1680_S_ADR_01_ASEReadCounter.table","NW_015090842.1:10160177",1,1,0
"FANCA","s1680_S_ADR_01_ASEReadCounter.table","NW_015090842.1:10163667",1,1,0
"FANCA","s1680_S_ADR_01_ASEReadCounter.table","NW_015090842.1:10165331",0,1,1
"SPIRE2","s1680_S_ADR_01_ASEReadCounter.table","NW_015090842.1:10172284",1,4,3
"SPIRE2","s1680_S_ADR_01_ASEReadCounter.table","NW_015090842.1:10175262",5,8,3
"SPIRE2","s1680_S_ADR_01_ASEReadCounter.table","NW_015090842.1:10175352",5,5,0
"SPIRE2","s1680_S_ADR_01_ASEReadCounter.table","NW_015090842.1:10175400",15,31,16
"SPIRE2","s1680_S_ADR_01_ASEReadCounter.table","NW_015090842.1:10175418",18,35,17
"SPIRE2","s1680_S_ADR_01_ASEReadCounter.table","NW_015090842.1:10175704",21,37,16
"SPIRE2","s1680_S_ADR_01_ASEReadCounter.table","NW_015090842.1:10176115",22,52,30
"SPIRE2","s1680_S_ADR_01_ASEReadCounter.table","NW_015090842.1:10176561",21,58,37
"SPIRE2","s1680_S_ADR_01_ASEReadCounter.table","NW_015090842.1:10176817",22,39,17
"SPIRE2","s1680_S_ADR_01_ASEReadCounter.table","NW_015090842.1:10177084",9,22,13
"SPIRE2","s1680_S_ADR_01_ASEReadCounter.table","NW_015090842.1:10177838",23,49,26
"SPIRE2","s1680_S_ADR_01_ASEReadCounter.table","NW_015090842.1:10178000",20,38,18
"SPIRE2","s1680_S_ADR_01_ASEReadCounter.table","NW_015090842.1:10178164",17,37,20
"SPIRE2","s1680_S_ADR_01_ASEReadCounter.table","NW_015090842.1:10178216",19,35,16
"SPIRE2","s1680_S_ADR_01_ASEReadCounter.table","NW_015090842.1:10178303",14,29,15
"SPIRE2","s1680_S_ADR_01_ASEReadCounter.table","NW_015090842.1:10178403",20,31,11
"SPIRE2","s1680_S_ADR_01_ASEReadCounter.table","NW_015090842.1:10178409",20,30,10
"SPIRE2","s1680_S_ADR_01_ASEReadCounter.table","NW_015090842.1:10178524",7,20,13
"SPIRE2","s1680_S_ADR_01_ASEReadCounter.table","NW_015090842.1:10178526",7,19,12
"SPIRE2","s1680_S_ADR_01_ASEReadCounter.table","NW_015090842.1:10178531",7,20,13
"SPIRE2","s1680_S_ADR_01_ASEReadCounter.table","NW_015090842.1:10178565",10,24,14
"SPIRE2","s1680_S_ADR_01_ASEReadCounter.table","NW_015090842.1:10178587",10,25,15
"SPIRE2","s1680_S_ADR_01_ASEReadCounter.table","NW_015090842.1:10178640",5,16,11
"SPIRE2","s1680_S_ADR_01_ASEReadCounter.table","NW_015090842.1:10178651",5,16,11
"SPIRE2","s1680_S_ADR_01_ASEReadCounter.table","NW_015090842.1:10178682",6,14,8
"TCF25","s1680_S_ADR_01_ASEReadCounter.table","NW_015090842.1:10180912",45,92,47
"TCF25","s1680_S_ADR_01_ASEReadCounter.table","NW_015090842.1:10180924",42,88,46
"TCF25","s1680_S_ADR_01_ASEReadCounter.table","NW_015090842.1:10180931",41,88,47
"TCF25","s1680_S_ADR_01_ASEReadCounter.table","NW_015090842.1:10185332",128,237,109
"TCF25","s1680_S_ADR_01_ASEReadCounter.table","NW_015090842.1:10196561",103,215,112
"TCF25","s1680_S_ADR_01_ASEReadCounter.table","NW_015090842.1:10197399",300,300,0
"GAS8","s1680_S_ADR_01_ASEReadCounter.table","NW_015090842.1:10228982",30,74,44
"GAS8","s1680_S_ADR_01_ASEReadCounter.table","NW_015090842.1:10229832",24,56,32
"GAS8","s1680_S_ADR_01_ASEReadCounter.table","NW_015090842.1:10232901",16,45,29
"GAS8","s1680_S_ADR_01_ASEReadCounter.table","NW_015090842.1:10232928",29,56,27
"GAS8","s1680_S_ADR_01_ASEReadCounter.table","NW_015090842.1:10232967",30,55,25
"GAS8","s1680_S_ADR_01_ASEReadCounter.table","NW_015090842.1:10233032",18,38,20
"GAS8","s1680_S_ADR_01_ASEReadCounter.table","NW_015090842.1:10233057",16,33,17
"GAS8","s1680_S_ADR_01_ASEReadCounter.table","NW_015090842.1:10233058",15,33,18
"GAS8","s1680_S_ADR_01_ASEReadCounter.table","NW_015090842.1:10233176",8,20,12
"GAS8","s1680_S_ADR_01_ASEReadCounter.table","NW_015090842.1:10233196",12,30,18
"GAS8","s1680_S_ADR_01_ASEReadCounter.table","NW_015090842.1:10233252",9,22,13
"GAS8","s1680_S_ADR_01_ASEReadCounter.table","NW_015090842.1:10233303",3,10,7
"LOC106888094","s1680_S_ADR_01_ASEReadCounter.table","NW_015090842.1:10233334",20,55,35
"LOC106888094","s1680_S_ADR_01_ASEReadCounter.table","NW_015090842.1:10233362",49,132,83
"LOC106888094","s1680_S_ADR_01_ASEReadCounter.table","NW_015090842.1:10233373",50,140,90
"LOC106888094","s1680_S_ADR_01_ASEReadCounter.table","NW_015090842.1:10233388",60,166,106
"LOC106888094","s1680_S_ADR_01_ASEReadCounter.table","NW_015090842.1:10233402",66,168,102
"LOC106888094","s1680_S_ADR_01_ASEReadCounter.table","NW_015090842.1:10233465",59,217,158
"LOC106888094","s1680_S_ADR_01_ASEReadCounter.table","NW_015090842.1:10233803",90,304,214
"LOC106888094","s1680_S_ADR_01_ASEReadCounter.table","NW_015090842.1:10233815",87,285,198
"LOC106888094","s1680_S_ADR_01_ASEReadCounter.table","NW_015090842.1:10235484",19,31,12
"LOC106888094","s1680_S_ADR_01_ASEReadCounter.table","NW_015090842.1:10235611",24,37,13
"LOC106888094","s1680_S_ADR_01_ASEReadCounter.table","NW_015090842.1:10235977",41,41,0
"LOC106888094","s1680_S_ADR_01_ASEReadCounter.table","NW_015090842.1:10236098",33,49,16
"LOC106888094","s1680_S_ADR_01_ASEReadCounter.table","NW_015090842.1:10236161",25,49,24
"LOC106888094","s1680_S_ADR_01_ASEReadCounter.table","NW_015090842.1:10236380",9,19,10
"LOC106888094","s1680_S_ADR_01_ASEReadCounter.table","NW_015090842.1:10236388",11,24,13
"LOC106888094","s1680_S_ADR_01_ASEReadCounter.table","NW_015090842.1:10236425",20,36,16
"LOC106888094","s1680_S_ADR_01_ASEReadCounter.table","NW_015090842.1:10236426",20,35,15
"LOC106888094","s1680_S_ADR_01_ASEReadCounter.table","NW_015090842.1:10236603",17,36,19
"LOC106888173","s1680_S_ADR_01_ASEReadCounter.table","NW_015090842.1:10239596",3,7,4
"LOC106888173","s1680_S_ADR_01_ASEReadCounter.table","NW_015090842.1:10240036",2,18,16
"LOC106888173","s1680_S_ADR_01_ASEReadCounter.table","NW_015090842.1:10240095",2,15,13
"LOC106888173","s1680_S_ADR_01_ASEReadCounter.table","NW_015090842.1:10240280",5,19,14
"LOC106888173","s1680_S_ADR_01_ASEReadCounter.table","NW_015090842.1:10240557",7,32,25
"LOC106888173","s1680_S_ADR_01_ASEReadCounter.table","NW_015090842.1:10240603",9,34,25
"LOC106888173","s1680_S_ADR_01_ASEReadCounter.table","NW_015090842.1:10240609",10,36,26
"LOC106888173","s1680_S_ADR_01_ASEReadCounter.table","NW_015090842.1:10240924",10,34,24
"LOC106888173","s1680_S_ADR_01_ASEReadCounter.table","NW_015090842.1:10241037",6,31,25
"LOC106888173","s1680_S_ADR_01_ASEReadCounter.table","NW_015090842.1:10241046",6,26,20
"LOC106888173","s1680_S_ADR_01_ASEReadCounter.table","NW_015090842.1:10241058",5,22,17
"LOC106888173","s1680_S_ADR_01_ASEReadCounter.table","NW_015090842.1:10241064",7,25,18
"LOC106888173","s1680_S_ADR_01_ASEReadCounter.table","NW_015090842.1:10241163",9,31,22
"LOC106888173","s1680_S_ADR_01_ASEReadCounter.table","NW_015090842.1:10241803",12,37,25
"LOC106888173","s1680_S_ADR_01_ASEReadCounter.table","NW_015090842.1:10241827",9,30,21
"LOC106888173","s1680_S_ADR_01_ASEReadCounter.table","NW_015090842.1:10241869",11,35,24
"LOC106888173","s1680_S_ADR_01_ASEReadCounter.table","NW_015090842.1:10242079",14,40,26
"LOC106888173","s1680_S_ADR_01_ASEReadCounter.table","NW_015090842.1:10242103",9,37,28
"LOC106888173","s1680_S_ADR_01_ASEReadCounter.table","NW_015090842.1:10242157",6,27,21
"LOC106888173","s1680_S_ADR_01_ASEReadCounter.table","NW_015090842.1:10242455",3,29,26
"LOC106888173","s1680_S_ADR_01_ASEReadCounter.table","NW_015090842.1:10242481",7,28,21
"LOC106888173","s1680_S_ADR_01_ASEReadCounter.table","NW_015090842.1:10242590",6,25,19
"LOC106888173","s1680_S_ADR_01_ASEReadCounter.table","NW_015090842.1:10242794",9,36,27
"LOC106888173","s1680_S_ADR_01_ASEReadCounter.table","NW_015090842.1:10242909",8,29,21
"LOC106888173","s1680_S_ADR_01_ASEReadCounter.table","NW_015090842.1:10243094",15,43,28
"LOC106888173","s1680_S_ADR_01_ASEReadCounter.table","NW_015090842.1:10243133",10,26,16
"LOC106888173","s1680_S_ADR_01_ASEReadCounter.table","NW_015090842.1:10243273",13,33,20
"LOC106888173","s1680_S_ADR_01_ASEReadCounter.table","NW_015090842.1:10243278",13,33,20
"LOC106888173","s1680_S_ADR_01_ASEReadCounter.table","NW_015090842.1:10243281",14,34,20
"LOC106888173","s1680_S_ADR_01_ASEReadCounter.table","NW_015090842.1:10243347",22,22,0
"LOC106888173","s1680_S_ADR_01_ASEReadCounter.table","NW_015090842.1:10243353",6,20,14
"LOC106888173","s1680_S_ADR_01_ASEReadCounter.table","NW_015090842.1:10243363",7,13,6
"LOC106888173","s1680_S_ADR_01_ASEReadCounter.table","NW_015090842.1:10243365",6,16,10
"LOC106888173","s1680_S_ADR_01_ASEReadCounter.table","NW_015090842.1:10243529",9,25,16
"LOC106888173","s1680_S_ADR_01_ASEReadCounter.table","NW_015090842.1:10243566",13,36,23
"LOC106888173","s1680_S_ADR_01_ASEReadCounter.table","NW_015090842.1:10243605",9,39,30
"LOC106888173","s1680_S_ADR_01_ASEReadCounter.table","NW_015090842.1:10243614",7,35,28
"LOC106888173","s1680_S_ADR_01_ASEReadCounter.table","NW_015090842.1:10243615",7,36,29
"LOC106888173","s1680_S_ADR_01_ASEReadCounter.table","NW_015090842.1:10243640",12,33,21
"LOC106888173","s1680_S_ADR_01_ASEReadCounter.table","NW_015090842.1:10243680",6,22,16
"LOC106888173","s1680_S_ADR_01_ASEReadCounter.table","NW_015090842.1:10243742",10,23,13
"LOC106888173","s1680_S_ADR_01_ASEReadCounter.table","NW_015090842.1:10243804",8,18,10
"LOC106888173","s1680_S_ADR_01_ASEReadCounter.table","NW_015090842.1:10243913",0,5,5
"LOC106888173","s1680_S_ADR_01_ASEReadCounter.table","NW_015090842.1:10243921",0,5,5
"LOC106888384","s1680_S_ADR_01_ASEReadCounter.table","NW_015090842.1:10244714",5,6,1
"LOC106888384","s1680_S_ADR_01_ASEReadCounter.table","NW_015090842.1:10244998",13,26,13
"LOC106888384","s1680_S_ADR_01_ASEReadCounter.table","NW_015090842.1:10250743",17,37,20
"LOC106888384","s1680_S_ADR_01_ASEReadCounter.table","NW_015090842.1:10250771",16,33,17
"LOC106888384","s1680_S_ADR_01_ASEReadCounter.table","NW_015090842.1:10251343",21,21,0
"LOC106888384","s1680_S_ADR_01_ASEReadCounter.table","NW_015090842.1:10251344",22,22,0
"LOC106888384","s1680_S_ADR_01_ASEReadCounter.table","NW_015090842.1:10251349",21,21,0
"LOC106888384","s1680_S_ADR_01_ASEReadCounter.table","NW_015090842.1:10251354",19,21,2
"LOC106888384","s1680_S_ADR_01_ASEReadCounter.table","NW_015090842.1:10251358",17,20,3
"LOC106888384","s1680_S_ADR_01_ASEReadCounter.table","NW_015090842.1:10251369",9,19,10
"LOC106888384","s1680_S_ADR_01_ASEReadCounter.table","NW_015090842.1:10251370",17,20,3
"LOC106888384","s1680_S_ADR_01_ASEReadCounter.table","NW_015090842.1:10251375",19,22,3
"LOC106888384","s1680_S_ADR_01_ASEReadCounter.table","NW_015090842.1:10251388",15,18,3
"LOC106888384","s1680_S_ADR_01_ASEReadCounter.table","NW_015090842.1:10251390",15,18,3
"LOC106888384","s1680_S_ADR_01_ASEReadCounter.table","NW_015090842.1:10251393",9,12,3
"LOC106888384","s1680_S_ADR_01_ASEReadCounter.table","NW_015090842.1:10251399",10,13,3
"LOC106888384","s1680_S_ADR_01_ASEReadCounter.table","NW_015090842.1:10251492",16,16,0
"LOC106888384","s1680_S_ADR_01_ASEReadCounter.table","NW_015090842.1:10253165",23,41,18
"LOC106888384","s1680_S_ADR_01_ASEReadCounter.table","NW_015090842.1:10253284",27,47,20
"LOC106888384","s1680_S_ADR_01_ASEReadCounter.table","NW_015090842.1:10253605",25,52,27
"LOC106888384","s1680_S_ADR_01_ASEReadCounter.table","NW_015090842.1:10254028",25,56,31
"LOC106888384","s1680_S_ADR_01_ASEReadCounter.table","NW_015090842.1:10254227",17,41,24
"LOC106888384","s1680_S_ADR_01_ASEReadCounter.table","NW_015090842.1:10254233",16,40,24
"LOC106888384","s1680_S_ADR_01_ASEReadCounter.table","NW_015090842.1:10254263",19,39,20
"LOC106888384","s1680_S_ADR_01_ASEReadCounter.table","NW_015090842.1:10254293",20,34,14
"LOC106888384","s1680_S_ADR_01_ASEReadCounter.table","NW_015090842.1:10254570",22,45,23
"LOC106888384","s1680_S_ADR_01_ASEReadCounter.table","NW_015090842.1:10254647",13,32,19
"LOC106888384","s1680_S_ADR_01_ASEReadCounter.table","NW_015090842.1:10254663",12,28,16
"LOC106888384","s1680_S_ADR_01_ASEReadCounter.table","NW_015090842.1:10254840",6,19,13
"LOC106888384","s1680_S_ADR_01_ASEReadCounter.table","NW_015090842.1:10254854",22,22,0
"LOC106888384","s1680_S_ADR_01_ASEReadCounter.table","NW_015090842.1:10254891",31,32,1
"LOC106888384","s1680_S_ADR_01_ASEReadCounter.table","NW_015090842.1:10254900",11,33,22
"LOC106888384","s1680_S_ADR_01_ASEReadCounter.table","NW_015090842.1:10254915",13,35,22
"LOC106888384","s1680_S_ADR_01_ASEReadCounter.table","NW_015090842.1:10254965",18,18,0
"LOC106888384","s1680_S_ADR_01_ASEReadCounter.table","NW_015090842.1:10254975",9,19,10
"LOC106888384","s1680_S_ADR_01_ASEReadCounter.table","NW_015090842.1:10255077",11,27,16
"LOC106888384","s1680_S_ADR_01_ASEReadCounter.table","NW_015090842.1:10255117",17,32,15
"LOC106888384","s1680_S_ADR_01_ASEReadCounter.table","NW_015090842.1:10255138",17,29,12
"LOC106888384","s1680_S_ADR_01_ASEReadCounter.table","NW_015090842.1:10255139",17,29,12
"LOC106888384","s1680_S_ADR_01_ASEReadCounter.table","NW_015090842.1:10255209",20,39,19
"LOC106888384","s1680_S_ADR_01_ASEReadCounter.table","NW_015090842.1:10255211",23,40,17
"LOC106888384","s1680_S_ADR_01_ASEReadCounter.table","NW_015090842.1:10255236",22,42,20
"LOC106888384","s1680_S_ADR_01_ASEReadCounter.table","NW_015090842.1:10255262",18,36,18
"LOC106888384","s1680_S_ADR_01_ASEReadCounter.table","NW_015090842.1:10255264",18,38,20
"LOC106888384","s1680_S_ADR_01_ASEReadCounter.table","NW_015090842.1:10255306",22,46,24
"LOC106888384","s1680_S_ADR_01_ASEReadCounter.table","NW_015090842.1:10255340",33,59,26
"LOC106888384","s1680_S_ADR_01_ASEReadCounter.table","NW_015090842.1:10255410",28,52,24
"LOC106888384","s1680_S_ADR_01_ASEReadCounter.table","NW_015090842.1:10255449",23,43,20
"LOC106888384","s1680_S_ADR_01_ASEReadCounter.table","NW_015090842.1:10255496",18,41,23
"LOC106888384","s1680_S_ADR_01_ASEReadCounter.table","NW_015090842.1:10255505",19,41,22
"LOC106888384","s1680_S_ADR_01_ASEReadCounter.table","NW_015090842.1:10255531",22,46,24
"LOC106888384","s1680_S_ADR_01_ASEReadCounter.table","NW_015090842.1:10255608",26,46,20
"LOC106888384","s1680_S_ADR_01_ASEReadCounter.table","NW_015090842.1:10255614",19,39,20
"LOC106888384","s1680_S_ADR_01_ASEReadCounter.table","NW_015090842.1:10255704",15,30,15
"LOC106888384","s1680_S_ADR_01_ASEReadCounter.table","NW_015090842.1:10255731",17,28,11
"LOC106888384","s1680_S_ADR_01_ASEReadCounter.table","NW_015090842.1:10255771",13,16,3
"TANGO6","s1680_S_ADR_01_ASEReadCounter.table","NW_015090842.1:10257782",11,21,10
"TANGO6","s1680_S_ADR_01_ASEReadCounter.table","NW_015090842.1:10258162",4,19,15
"TANGO6","s1680_S_ADR_01_ASEReadCounter.table","NW_015090842.1:10258185",9,29,20
"TANGO6","s1680_S_ADR_01_ASEReadCounter.table","NW_015090842.1:10259267",12,37,25
"TANGO6","s1680_S_ADR_01_ASEReadCounter.table","NW_015090842.1:10260250",32,62,30
"TANGO6","s1680_S_ADR_01_ASEReadCounter.table","NW_015090842.1:10260979",27,52,25
"TANGO6","s1680_S_ADR_01_ASEReadCounter.table","NW_015090842.1:10261599",31,50,19
"TANGO6","s1680_S_ADR_01_ASEReadCounter.table","NW_015090842.1:10268425",49,87,38
"TANGO6","s1680_S_ADR_01_ASEReadCounter.table","NW_015090842.1:10269831",44,89,45
"TANGO6","s1680_S_ADR_01_ASEReadCounter.table","NW_015090842.1:10270813",36,68,32
"TANGO6","s1680_S_ADR_01_ASEReadCounter.table","NW_015090842.1:10273952",27,49,22
"TANGO6","s1680_S_ADR_01_ASEReadCounter.table","NW_015090842.1:10273970",29,52,23
"TANGO6","s1680_S_ADR_01_ASEReadCounter.table","NW_015090842.1:10274018",23,42,19
"TANGO6","s1680_S_ADR_01_ASEReadCounter.table","NW_015090842.1:10275974",28,47,19
"TANGO6","s1680_S_ADR_01_ASEReadCounter.table","NW_015090842.1:10275976",27,47,20
"TANGO6","s1680_S_ADR_01_ASEReadCounter.table","NW_015090842.1:10276123",34,57,23
"TANGO6","s1680_S_ADR_01_ASEReadCounter.table","NW_015090842.1:10276271",23,46,23
"TANGO6","s1680_S_ADR_01_ASEReadCounter.table","NW_015090842.1:10276272",23,47,24
"TANGO6","s1680_S_ADR_01_ASEReadCounter.table","NW_015090842.1:10276275",22,45,23
"TANGO6","s1680_S_ADR_01_ASEReadCounter.table","NW_015090842.1:10276278",22,44,22
"TANGO6","s1680_S_ADR_01_ASEReadCounter.table","NW_015090842.1:10276368",22,32,10
"TANGO6","s1680_S_ADR_01_ASEReadCounter.table","NW_015090842.1:10276373",19,29,10
"TANGO6","s1680_S_ADR_01_ASEReadCounter.table","NW_015090842.1:10276630",17,39,22
"TANGO6","s1680_S_ADR_01_ASEReadCounter.table","NW_015090842.1:10281498",19,41,22
"TANGO6","s1680_S_ADR_01_ASEReadCounter.table","NW_015090842.1:10282842",30,43,13
"TANGO6","s1680_S_ADR_01_ASEReadCounter.table","NW_015090842.1:10282863",23,36,13
"TANGO6","s1680_S_ADR_01_ASEReadCounter.table","NW_015090842.1:10282869",22,34,12
"TANGO6","s1680_S_ADR_01_ASEReadCounter.table","NW_015090842.1:10282903",19,37,18
"TANGO6","s1680_S_ADR_01_ASEReadCounter.table","NW_015090842.1:10283757",19,45,26
"TANGO6","s1680_S_ADR_01_ASEReadCounter.table","NW_015090842.1:10283785",19,47,28
"HAS3","s1680_S_ADR_01_ASEReadCounter.table","NW_015090842.1:10290927",0,1,1
"CHTF8","s1680_S_ADR_01_ASEReadCounter.table","NW_015090842.1:10291319",2,3,1
"CHTF8","s1680_S_ADR_01_ASEReadCounter.table","NW_015090842.1:10291342",2,3,1
"CHTF8","s1680_S_ADR_01_ASEReadCounter.table","NW_015090842.1:10291491",9,15,6
"CHTF8","s1680_S_ADR_01_ASEReadCounter.table","NW_015090842.1:10291520",14,22,8
"CHTF8","s1680_S_ADR_01_ASEReadCounter.table","NW_015090842.1:10291593",22,34,12
"CHTF8","s1680_S_ADR_01_ASEReadCounter.table","NW_015090842.1:10291600",19,31,12
"CHTF8","s1680_S_ADR_01_ASEReadCounter.table","NW_015090842.1:10291609",17,26,9
"CHTF8","s1680_S_ADR_01_ASEReadCounter.table","NW_015090842.1:10291639",20,29,9
"CHTF8","s1680_S_ADR_01_ASEReadCounter.table","NW_015090842.1:10291641",19,29,10
"CHTF8","s1680_S_ADR_01_ASEReadCounter.table","NW_015090842.1:10291648",22,33,11
"CHTF8","s1680_S_ADR_01_ASEReadCounter.table","NW_015090842.1:10291656",22,32,10
"CHTF8","s1680_S_ADR_01_ASEReadCounter.table","NW_015090842.1:10291675",26,36,10
"CHTF8","s1680_S_ADR_01_ASEReadCounter.table","NW_015090842.1:10291696",23,34,11
"CHTF8","s1680_S_ADR_01_ASEReadCounter.table","NW_015090842.1:10291714",25,35,10
"CHTF8","s1680_S_ADR_01_ASEReadCounter.table","NW_015090842.1:10291732",26,37,11
"CHTF8","s1680_S_ADR_01_ASEReadCounter.table","NW_015090842.1:10291755",16,22,6
"CHTF8","s1680_S_ADR_01_ASEReadCounter.table","NW_015090842.1:10291756",17,21,4
"CHTF8","s1680_S_ADR_01_ASEReadCounter.table","NW_015090842.1:10291758",17,24,7
"CHTF8","s1680_S_ADR_01_ASEReadCounter.table","NW_015090842.1:10291792",29,37,8
"CHTF8","s1680_S_ADR_01_ASEReadCounter.table","NW_015090842.1:10291895",33,39,6
"CHTF8","s1680_S_ADR_01_ASEReadCounter.table","NW_015090842.1:10292132",30,46,16
"CHTF8","s1680_S_ADR_01_ASEReadCounter.table","NW_015090842.1:10292314",22,39,17
"CHTF8","s1680_S_ADR_01_ASEReadCounter.table","NW_015090842.1:10292317",25,43,18
"CHTF8","s1680_S_ADR_01_ASEReadCounter.table","NW_015090842.1:10292928",5,6,1
"UTP4","s1680_S_ADR_01_ASEReadCounter.table","NW_015090842.1:10293146",41,99,58
"UTP4","s1680_S_ADR_01_ASEReadCounter.table","NW_015090842.1:10293151",43,100,57
"UTP4","s1680_S_ADR_01_ASEReadCounter.table","NW_015090842.1:10293191",27,67,40
"UTP4","s1680_S_ADR_01_ASEReadCounter.table","NW_015090842.1:10293362",37,93,56
"UTP4","s1680_S_ADR_01_ASEReadCounter.table","NW_015090842.1:10293430",47,97,50
"UTP4","s1680_S_ADR_01_ASEReadCounter.table","NW_015090842.1:10293625",35,70,35
"UTP4","s1680_S_ADR_01_ASEReadCounter.table","NW_015090842.1:10293684",41,80,39
"UTP4","s1680_S_ADR_01_ASEReadCounter.table","NW_015090842.1:10294093",32,62,30
"UTP4","s1680_S_ADR_01_ASEReadCounter.table","NW_015090842.1:10294568",41,93,52
"UTP4","s1680_S_ADR_01_ASEReadCounter.table","NW_015090842.1:10294622",26,70,44
"UTP4","s1680_S_ADR_01_ASEReadCounter.table","NW_015090842.1:10294632",27,69,42
"UTP4","s1680_S_ADR_01_ASEReadCounter.table","NW_015090842.1:10295238",39,79,40
"UTP4","s1680_S_ADR_01_ASEReadCounter.table","NW_015090842.1:10295880",38,80,42
"UTP4","s1680_S_ADR_01_ASEReadCounter.table","NW_015090842.1:10295884",36,77,41
"UTP4","s1680_S_ADR_01_ASEReadCounter.table","NW_015090842.1:10295903",40,78,38
"UTP4","s1680_S_ADR_01_ASEReadCounter.table","NW_015090842.1:10295906",40,80,40
"UTP4","s1680_S_ADR_01_ASEReadCounter.table","NW_015090842.1:10295915",38,83,45
"UTP4","s1680_S_ADR_01_ASEReadCounter.table","NW_015090842.1:10295938",31,73,42
"UTP4","s1680_S_ADR_01_ASEReadCounter.table","NW_015090842.1:10296175",35,76,41
"UTP4","s1680_S_ADR_01_ASEReadCounter.table","NW_015090842.1:10296660",41,76,35
"UTP4","s1680_S_ADR_01_ASEReadCounter.table","NW_015090842.1:10296679",36,74,38
"UTP4","s1680_S_ADR_01_ASEReadCounter.table","NW_015090842.1:10297193",38,69,31
"UTP4","s1680_S_ADR_01_ASEReadCounter.table","NW_015090842.1:10297220",40,70,30
"UTP4","s1680_S_ADR_01_ASEReadCounter.table","NW_015090842.1:10297307",41,95,54
"UTP4","s1680_S_ADR_01_ASEReadCounter.table","NW_015090842.1:10297558",36,86,50
"UTP4","s1680_S_ADR_01_ASEReadCounter.table","NW_015090842.1:10297943",25,54,29
"UTP4","s1680_S_ADR_01_ASEReadCounter.table","NW_015090842.1:10297979",29,59,30
"UTP4","s1680_S_ADR_01_ASEReadCounter.table","NW_015090842.1:10298022",21,46,25
"UTP4","s1680_S_ADR_01_ASEReadCounter.table","NW_015090842.1:10298079",1,5,4
"UTP4","s1680_S_ADR_01_ASEReadCounter.table","NW_015090842.1:10298081",1,5,4
"UTP4","s1680_S_ADR_01_ASEReadCounter.table","NW_015090842.1:10298082",1,5,4
"SNTB2","s1680_S_ADR_01_ASEReadCounter.table","NW_015090842.1:10298905",1,4,3
"SNTB2","s1680_S_ADR_01_ASEReadCounter.table","NW_015090842.1:10298928",1,9,8
"SNTB2","s1680_S_ADR_01_ASEReadCounter.table","NW_015090842.1:10303506",19,40,21
"SNTB2","s1680_S_ADR_01_ASEReadCounter.table","NW_015090842.1:10303524",20,40,20
"SNTB2","s1680_S_ADR_01_ASEReadCounter.table","NW_015090842.1:10304059",18,42,24
"SNTB2","s1680_S_ADR_01_ASEReadCounter.table","NW_015090842.1:10304089",18,39,21
"SNTB2","s1680_S_ADR_01_ASEReadCounter.table","NW_015090842.1:10304167",14,30,16
"SNTB2","s1680_S_ADR_01_ASEReadCounter.table","NW_015090842.1:10304176",13,29,16
"SNTB2","s1680_S_ADR_01_ASEReadCounter.table","NW_015090842.1:10305069",13,21,8
"SNTB2","s1680_S_ADR_01_ASEReadCounter.table","NW_015090842.1:10305099",16,28,12
"SNTB2","s1680_S_ADR_01_ASEReadCounter.table","NW_015090842.1:10305451",15,27,12
"SNTB2","s1680_S_ADR_01_ASEReadCounter.table","NW_015090842.1:10305547",17,30,13
"SNTB2","s1680_S_ADR_01_ASEReadCounter.table","NW_015090842.1:10305847",12,27,15
"SNTB2","s1680_S_ADR_01_ASEReadCounter.table","NW_015090842.1:10305911",16,34,18
"SNTB2","s1680_S_ADR_01_ASEReadCounter.table","NW_015090842.1:10306173",15,26,11
"SNTB2","s1680_S_ADR_01_ASEReadCounter.table","NW_015090842.1:10306275",12,25,13
"SNTB2","s1680_S_ADR_01_ASEReadCounter.table","NW_015090842.1:10306457",8,21,13
"SNTB2","s1680_S_ADR_01_ASEReadCounter.table","NW_015090842.1:10306496",10,26,16
"SNTB2","s1680_S_ADR_01_ASEReadCounter.table","NW_015090842.1:10306499",10,25,15
"VPS4A","s1680_S_ADR_01_ASEReadCounter.table","NW_015090842.1:10308566",136,306,170
"VPS4A","s1680_S_ADR_01_ASEReadCounter.table","NW_015090842.1:10308573",145,324,179
"VPS4A","s1680_S_ADR_01_ASEReadCounter.table","NW_015090842.1:10308856",175,448,273
"VPS4A","s1680_S_ADR_01_ASEReadCounter.table","NW_015090842.1:10309056",231,545,314
"VPS4A","s1680_S_ADR_01_ASEReadCounter.table","NW_015090842.1:10309089",286,643,357
"VPS4A","s1680_S_ADR_01_ASEReadCounter.table","NW_015090842.1:10309392",273,571,298
"VPS4A","s1680_S_ADR_01_ASEReadCounter.table","NW_015090842.1:10309413",291,585,294
"VPS4A","s1680_S_ADR_01_ASEReadCounter.table","NW_015090842.1:10309467",332,682,350
"VPS4A","s1680_S_ADR_01_ASEReadCounter.table","NW_015090842.1:10310230",309,678,369
"VPS4A","s1680_S_ADR_01_ASEReadCounter.table","NW_015090842.1:10310425",264,600,336
"VPS4A","s1680_S_ADR_01_ASEReadCounter.table","NW_015090842.1:10310639",301,660,359
"VPS4A","s1680_S_ADR_01_ASEReadCounter.table","NW_015090842.1:10310640",298,662,364
"VPS4A","s1680_S_ADR_01_ASEReadCounter.table","NW_015090842.1:10310687",317,654,337
"VPS4A","s1680_S_ADR_01_ASEReadCounter.table","NW_015090842.1:10310734",264,518,254
"VPS4A","s1680_S_ADR_01_ASEReadCounter.table","NW_015090842.1:10310737",270,527,257
"VPS4A","s1680_S_ADR_01_ASEReadCounter.table","NW_015090842.1:10310746",271,543,272
"VPS4A","s1680_S_ADR_01_ASEReadCounter.table","NW_015090842.1:10310767",267,551,284
"VPS4A","s1680_S_ADR_01_ASEReadCounter.table","NW_015090842.1:10310995",223,505,282
"VPS4A","s1680_S_ADR_01_ASEReadCounter.table","NW_015090842.1:10311004",217,466,249
"VPS4A","s1680_S_ADR_01_ASEReadCounter.table","NW_015090842.1:10311007",215,491,276
"VPS4A","s1680_S_ADR_01_ASEReadCounter.table","NW_015090842.1:10311013",230,506,276
"VPS4A","s1680_S_ADR_01_ASEReadCounter.table","NW_015090842.1:10311022",222,506,284
"VPS4A","s1680_S_ADR_01_ASEReadCounter.table","NW_015090842.1:10311023",222,505,283
"VPS4A","s1680_S_ADR_01_ASEReadCounter.table","NW_015090842.1:10311426",250,547,297
"VPS4A","s1680_S_ADR_01_ASEReadCounter.table","NW_015090842.1:10311489",1,13,12
"VPS4A","s1680_S_ADR_01_ASEReadCounter.table","NW_015090842.1:10311490",1,7,6
"VPS4A","s1680_S_ADR_01_ASEReadCounter.table","NW_015090842.1:10311525",6,17,11
"VPS4A","s1680_S_ADR_01_ASEReadCounter.table","NW_015090842.1:10311529",6,22,16
"VPS4A","s1680_S_ADR_01_ASEReadCounter.table","NW_015090842.1:10311530",6,23,17
"VPS4A","s1680_S_ADR_01_ASEReadCounter.table","NW_015090842.1:10311552",22,43,21
"VPS4A","s1680_S_ADR_01_ASEReadCounter.table","NW_015090842.1:10311689",33,48,15
"VPS4A","s1680_S_ADR_01_ASEReadCounter.table","NW_015090842.1:10311700",42,60,18
"VPS4A","s1680_S_ADR_01_ASEReadCounter.table","NW_015090842.1:10311701",42,61,19
"VPS4A","s1680_S_ADR_01_ASEReadCounter.table","NW_015090842.1:10311703",42,60,18
"COG8","s1680_S_ADR_01_ASEReadCounter.table","NW_015090842.1:10313487",13,50,37
"COG8","s1680_S_ADR_01_ASEReadCounter.table","NW_015090842.1:10313559",31,75,44
"COG8","s1680_S_ADR_01_ASEReadCounter.table","NW_015090842.1:10313579",30,74,44
"COG8","s1680_S_ADR_01_ASEReadCounter.table","NW_015090842.1:10313665",24,65,41
"COG8","s1680_S_ADR_01_ASEReadCounter.table","NW_015090842.1:10313681",24,71,47
"COG8","s1680_S_ADR_01_ASEReadCounter.table","NW_015090842.1:10313768",39,86,47
"COG8","s1680_S_ADR_01_ASEReadCounter.table","NW_015090842.1:10313775",40,87,47
"COG8","s1680_S_ADR_01_ASEReadCounter.table","NW_015090842.1:10313811",29,70,41
"COG8","s1680_S_ADR_01_ASEReadCounter.table","NW_015090842.1:10313858",26,64,38
"COG8","s1680_S_ADR_01_ASEReadCounter.table","NW_015090842.1:10313859",65,65,0
"COG8","s1680_S_ADR_01_ASEReadCounter.table","NW_015090842.1:10314100",30,80,50
"COG8","s1680_S_ADR_01_ASEReadCounter.table","NW_015090842.1:10314213",38,72,34
"COG8","s1680_S_ADR_01_ASEReadCounter.table","NW_015090842.1:10315093",43,77,34
"COG8","s1680_S_ADR_01_ASEReadCounter.table","NW_015090842.1:10315162",28,67,39
"COG8","s1680_S_ADR_01_ASEReadCounter.table","NW_015090842.1:10315285",39,84,45
"COG8","s1680_S_ADR_01_ASEReadCounter.table","NW_015090842.1:10315360",29,67,38
"COG8","s1680_S_ADR_01_ASEReadCounter.table","NW_015090842.1:10315369",27,67,40
"COG8","s1680_S_ADR_01_ASEReadCounter.table","NW_015090842.1:10315508",18,42,24
"COG8","s1680_S_ADR_01_ASEReadCounter.table","NW_015090842.1:10315624",25,65,40
"COG8","s1680_S_ADR_01_ASEReadCounter.table","NW_015090842.1:10315693",34,65,31
"COG8","s1680_S_ADR_01_ASEReadCounter.table","NW_015090842.1:10315698",32,62,30
"COG8","s1680_S_ADR_01_ASEReadCounter.table","NW_015090842.1:10315768",26,57,31
"COG8","s1680_S_ADR_01_ASEReadCounter.table","NW_015090842.1:10315769",27,57,30
"COG8","s1680_S_ADR_01_ASEReadCounter.table","NW_015090842.1:10315784",24,52,28
"COG8","s1680_S_ADR_01_ASEReadCounter.table","NW_015090842.1:10316093",19,48,29
"COG8","s1680_S_ADR_01_ASEReadCounter.table","NW_015090842.1:10316133",18,45,27
"NIP7","s1680_S_ADR_01_ASEReadCounter.table","NW_015090842.1:10316759",37,85,48
"NIP7","s1680_S_ADR_01_ASEReadCounter.table","NW_015090842.1:10316967",138,291,153
"NIP7","s1680_S_ADR_01_ASEReadCounter.table","NW_015090842.1:10316995",155,309,154
"NIP7","s1680_S_ADR_01_ASEReadCounter.table","NW_015090842.1:10317240",198,384,186
"NIP7","s1680_S_ADR_01_ASEReadCounter.table","NW_015090842.1:10317247",197,385,188
"NIP7","s1680_S_ADR_01_ASEReadCounter.table","NW_015090842.1:10317264",176,354,178
"NIP7","s1680_S_ADR_01_ASEReadCounter.table","NW_015090842.1:10317433",171,385,214
"NIP7","s1680_S_ADR_01_ASEReadCounter.table","NW_015090842.1:10317738",163,354,191
"NIP7","s1680_S_ADR_01_ASEReadCounter.table","NW_015090842.1:10317769",171,332,161
"NIP7","s1680_S_ADR_01_ASEReadCounter.table","NW_015090842.1:10317808",118,235,117
"NIP7","s1680_S_ADR_01_ASEReadCounter.table","NW_015090842.1:10317870",64,145,81
"NIP7","s1680_S_ADR_01_ASEReadCounter.table","NW_015090842.1:10317871",64,142,78
"NIP7","s1680_S_ADR_01_ASEReadCounter.table","NW_015090842.1:10317898",46,104,58
"NIP7","s1680_S_ADR_01_ASEReadCounter.table","NW_015090842.1:10317911",41,80,39
"TMED6","s1680_S_ADR_01_ASEReadCounter.table","NW_015090842.1:10318514",2,4,2
"TMED6","s1680_S_ADR_01_ASEReadCounter.table","NW_015090842.1:10318731",3,4,1
"TERF2","s1680_S_ADR_01_ASEReadCounter.table","NW_015090842.1:10321768",13,38,25
"TERF2","s1680_S_ADR_01_ASEReadCounter.table","NW_015090842.1:10321777",13,38,25
"TERF2","s1680_S_ADR_01_ASEReadCounter.table","NW_015090842.1:10321805",14,51,37
"TERF2","s1680_S_ADR_01_ASEReadCounter.table","NW_015090842.1:10321878",32,83,51
"TERF2","s1680_S_ADR_01_ASEReadCounter.table","NW_015090842.1:10321893",4,77,73
"TERF2","s1680_S_ADR_01_ASEReadCounter.table","NW_015090842.1:10321897",32,68,36
"TERF2","s1680_S_ADR_01_ASEReadCounter.table","NW_015090842.1:10321908",31,65,34
"TERF2","s1680_S_ADR_01_ASEReadCounter.table","NW_015090842.1:10322001",35,80,45
"TERF2","s1680_S_ADR_01_ASEReadCounter.table","NW_015090842.1:10322035",30,68,38
"TERF2","s1680_S_ADR_01_ASEReadCounter.table","NW_015090842.1:10322051",31,74,43
"TERF2","s1680_S_ADR_01_ASEReadCounter.table","NW_015090842.1:10322137",29,62,33
"TERF2","s1680_S_ADR_01_ASEReadCounter.table","NW_015090842.1:10322144",33,63,30
"TERF2","s1680_S_ADR_01_ASEReadCounter.table","NW_015090842.1:10322388",24,70,46
"TERF2","s1680_S_ADR_01_ASEReadCounter.table","NW_015090842.1:10322396",25,68,43
"TERF2","s1680_S_ADR_01_ASEReadCounter.table","NW_015090842.1:10322502",56,108,52
"TERF2","s1680_S_ADR_01_ASEReadCounter.table","NW_015090842.1:10322504",56,107,51
"TERF2","s1680_S_ADR_01_ASEReadCounter.table","NW_015090842.1:10322510",55,118,63
"TERF2","s1680_S_ADR_01_ASEReadCounter.table","NW_015090842.1:10323580",50,115,65
"TERF2","s1680_S_ADR_01_ASEReadCounter.table","NW_015090842.1:10324314",40,106,66
"TERF2","s1680_S_ADR_01_ASEReadCounter.table","NW_015090842.1:10326832",41,82,41
"TERF2","s1680_S_ADR_01_ASEReadCounter.table","NW_015090842.1:10327787",30,73,43
"TERF2","s1680_S_ADR_01_ASEReadCounter.table","NW_015090842.1:10328588",41,72,31
"TERF2","s1680_S_ADR_01_ASEReadCounter.table","NW_015090842.1:10328644",27,63,36
"TERF2","s1680_S_ADR_01_ASEReadCounter.table","NW_015090842.1:10329813",23,58,35
"TERF2","s1680_S_ADR_01_ASEReadCounter.table","NW_015090842.1:10330749",36,66,30
"TERF2","s1680_S_ADR_01_ASEReadCounter.table","NW_015090842.1:10330789",34,68,34
"CYB5B","s1680_S_ADR_01_ASEReadCounter.table","NW_015090842.1:10336595",21,51,30
"CYB5B","s1680_S_ADR_01_ASEReadCounter.table","NW_015090842.1:10336667",113,247,134
"CYB5B","s1680_S_ADR_01_ASEReadCounter.table","NW_015090842.1:10336689",173,390,217
"CYB5B","s1680_S_ADR_01_ASEReadCounter.table","NW_015090842.1:10336728",239,540,301
"CYB5B","s1680_S_ADR_01_ASEReadCounter.table","NW_015090842.1:10345068",233,516,283
"CYB5B","s1680_S_ADR_01_ASEReadCounter.table","NW_015090842.1:10348800",345,659,314
"CYB5B","s1680_S_ADR_01_ASEReadCounter.table","NW_015090842.1:10349046",243,491,248
"CYB5B","s1680_S_ADR_01_ASEReadCounter.table","NW_015090842.1:10349119",130,354,224
"CYB5B","s1680_S_ADR_01_ASEReadCounter.table","NW_015090842.1:10349146",67,301,234
"CYB5B","s1680_S_ADR_01_ASEReadCounter.table","NW_015090842.1:10349157",117,361,244
"CYB5B","s1680_S_ADR_01_ASEReadCounter.table","NW_015090842.1:10349263",332,332,0
