"gene","id","snp","ref_count","total_count","alt_count"
"CENPN","s1693_S_RAP_03_ASEReadCounter.table","NW_015090842.1:5801618",3,4,1
"CENPN","s1693_S_RAP_03_ASEReadCounter.table","NW_015090842.1:5801623",0,4,4
"CENPN","s1693_S_RAP_03_ASEReadCounter.table","NW_015090842.1:5801631",3,4,1
"CENPN","s1693_S_RAP_03_ASEReadCounter.table","NW_015090842.1:5801632",3,4,1
"CENPN","s1693_S_RAP_03_ASEReadCounter.table","NW_015090842.1:5801655",4,6,2
"CENPN","s1693_S_RAP_03_ASEReadCounter.table","NW_015090842.1:5801670",4,6,2
"CENPN","s1693_S_RAP_03_ASEReadCounter.table","NW_015090842.1:5801674",4,7,3
"CENPN","s1693_S_RAP_03_ASEReadCounter.table","NW_015090842.1:5801692",4,7,3
"CENPN","s1693_S_RAP_03_ASEReadCounter.table","NW_015090842.1:5802008",8,16,8
"CENPN","s1693_S_RAP_03_ASEReadCounter.table","NW_015090842.1:5802012",7,15,8
"CENPN","s1693_S_RAP_03_ASEReadCounter.table","NW_015090842.1:5802087",5,13,8
"CENPN","s1693_S_RAP_03_ASEReadCounter.table","NW_015090842.1:5810113",23,23,0
"CENPN","s1693_S_RAP_03_ASEReadCounter.table","NW_015090842.1:5810147",32,32,0
"CENPN","s1693_S_RAP_03_ASEReadCounter.table","NW_015090842.1:5810148",32,32,0
"ATMIN","s1693_S_RAP_03_ASEReadCounter.table","NW_015090842.1:5818789",3,5,2
"ATMIN","s1693_S_RAP_03_ASEReadCounter.table","NW_015090842.1:5819958",4,7,3
"ATMIN","s1693_S_RAP_03_ASEReadCounter.table","NW_015090842.1:5820004",3,6,3
"ATMIN","s1693_S_RAP_03_ASEReadCounter.table","NW_015090842.1:5820217",6,10,4
"ATMIN","s1693_S_RAP_03_ASEReadCounter.table","NW_015090842.1:5820250",7,10,3
"ATMIN","s1693_S_RAP_03_ASEReadCounter.table","NW_015090842.1:5820298",7,11,4
"ATMIN","s1693_S_RAP_03_ASEReadCounter.table","NW_015090842.1:5820417",3,6,3
"ATMIN","s1693_S_RAP_03_ASEReadCounter.table","NW_015090842.1:5820421",3,7,4
"ATMIN","s1693_S_RAP_03_ASEReadCounter.table","NW_015090842.1:5820448",3,7,4
"ATMIN","s1693_S_RAP_03_ASEReadCounter.table","NW_015090842.1:5820457",3,6,3
"ATMIN","s1693_S_RAP_03_ASEReadCounter.table","NW_015090842.1:5820510",4,8,4
"ATMIN","s1693_S_RAP_03_ASEReadCounter.table","NW_015090842.1:5820673",3,4,1
"ATMIN","s1693_S_RAP_03_ASEReadCounter.table","NW_015090842.1:5820754",3,3,0
"ATMIN","s1693_S_RAP_03_ASEReadCounter.table","NW_015090842.1:5820820",1,3,2
"ATMIN","s1693_S_RAP_03_ASEReadCounter.table","NW_015090842.1:5820865",4,6,2
"ATMIN","s1693_S_RAP_03_ASEReadCounter.table","NW_015090842.1:5820889",3,5,2
"ATMIN","s1693_S_RAP_03_ASEReadCounter.table","NW_015090842.1:5820891",3,6,3
"ATMIN","s1693_S_RAP_03_ASEReadCounter.table","NW_015090842.1:5820997",4,8,4
"ATMIN","s1693_S_RAP_03_ASEReadCounter.table","NW_015090842.1:5821063",3,6,3
"ATMIN","s1693_S_RAP_03_ASEReadCounter.table","NW_015090842.1:5821132",6,13,7
"ATMIN","s1693_S_RAP_03_ASEReadCounter.table","NW_015090842.1:5821645",5,10,5
"ATMIN","s1693_S_RAP_03_ASEReadCounter.table","NW_015090842.1:5825066",18,41,23
"ATMIN","s1693_S_RAP_03_ASEReadCounter.table","NW_015090842.1:5825106",15,40,25
"ATMIN","s1693_S_RAP_03_ASEReadCounter.table","NW_015090842.1:5825122",14,38,24
"ATMIN","s1693_S_RAP_03_ASEReadCounter.table","NW_015090842.1:5825178",8,28,20
"ATMIN","s1693_S_RAP_03_ASEReadCounter.table","NW_015090842.1:5825194",9,29,20
"ATMIN","s1693_S_RAP_03_ASEReadCounter.table","NW_015090842.1:5825195",8,28,20
"ATMIN","s1693_S_RAP_03_ASEReadCounter.table","NW_015090842.1:5825220",9,28,19
"ATMIN","s1693_S_RAP_03_ASEReadCounter.table","NW_015090842.1:5825240",11,31,20
"ATMIN","s1693_S_RAP_03_ASEReadCounter.table","NW_015090842.1:5825303",13,45,32
"ATMIN","s1693_S_RAP_03_ASEReadCounter.table","NW_015090842.1:5825304",13,43,30
"ATMIN","s1693_S_RAP_03_ASEReadCounter.table","NW_015090842.1:5825310",14,43,29
"ATMIN","s1693_S_RAP_03_ASEReadCounter.table","NW_015090842.1:5825406",16,38,22
"ATMIN","s1693_S_RAP_03_ASEReadCounter.table","NW_015090842.1:5825415",16,42,26
"ATMIN","s1693_S_RAP_03_ASEReadCounter.table","NW_015090842.1:5825438",20,48,28
"ATMIN","s1693_S_RAP_03_ASEReadCounter.table","NW_015090842.1:5825485",22,50,28
"ATMIN","s1693_S_RAP_03_ASEReadCounter.table","NW_015090842.1:5825524",22,52,30
"ATMIN","s1693_S_RAP_03_ASEReadCounter.table","NW_015090842.1:5825557",18,48,30
"ATMIN","s1693_S_RAP_03_ASEReadCounter.table","NW_015090842.1:5825571",20,51,31
"ATMIN","s1693_S_RAP_03_ASEReadCounter.table","NW_015090842.1:5825579",20,47,27
"ATMIN","s1693_S_RAP_03_ASEReadCounter.table","NW_015090842.1:5825590",17,40,23
"ATMIN","s1693_S_RAP_03_ASEReadCounter.table","NW_015090842.1:5825689",26,52,26
"ATMIN","s1693_S_RAP_03_ASEReadCounter.table","NW_015090842.1:5825703",32,60,28
"ATMIN","s1693_S_RAP_03_ASEReadCounter.table","NW_015090842.1:5825787",23,49,26
"ATMIN","s1693_S_RAP_03_ASEReadCounter.table","NW_015090842.1:5825833",23,56,33
"ATMIN","s1693_S_RAP_03_ASEReadCounter.table","NW_015090842.1:5825841",22,53,31
"ATMIN","s1693_S_RAP_03_ASEReadCounter.table","NW_015090842.1:5825895",28,57,29
"ATMIN","s1693_S_RAP_03_ASEReadCounter.table","NW_015090842.1:5825984",27,70,43
"ATMIN","s1693_S_RAP_03_ASEReadCounter.table","NW_015090842.1:5826162",49,86,37
"ATMIN","s1693_S_RAP_03_ASEReadCounter.table","NW_015090842.1:5826194",42,76,34
"ATMIN","s1693_S_RAP_03_ASEReadCounter.table","NW_015090842.1:5826235",48,101,53
"ATMIN","s1693_S_RAP_03_ASEReadCounter.table","NW_015090842.1:5826245",44,101,57
"ATMIN","s1693_S_RAP_03_ASEReadCounter.table","NW_015090842.1:5826335",22,48,26
"ATMIN","s1693_S_RAP_03_ASEReadCounter.table","NW_015090842.1:5826417",35,75,40
"ATMIN","s1693_S_RAP_03_ASEReadCounter.table","NW_015090842.1:5826431",29,96,67
"ATMIN","s1693_S_RAP_03_ASEReadCounter.table","NW_015090842.1:5826438",29,82,53
"ATMIN","s1693_S_RAP_03_ASEReadCounter.table","NW_015090842.1:5826463",45,109,64
"ATMIN","s1693_S_RAP_03_ASEReadCounter.table","NW_015090842.1:5826502",39,103,64
"ATMIN","s1693_S_RAP_03_ASEReadCounter.table","NW_015090842.1:5826511",35,99,64
"ATMIN","s1693_S_RAP_03_ASEReadCounter.table","NW_015090842.1:5826659",33,74,41
"ATMIN","s1693_S_RAP_03_ASEReadCounter.table","NW_015090842.1:5826701",40,89,49
"ATMIN","s1693_S_RAP_03_ASEReadCounter.table","NW_015090842.1:5826702",39,88,49
"ATMIN","s1693_S_RAP_03_ASEReadCounter.table","NW_015090842.1:5826732",46,103,57
"ATMIN","s1693_S_RAP_03_ASEReadCounter.table","NW_015090842.1:5826745",47,105,58
"ATMIN","s1693_S_RAP_03_ASEReadCounter.table","NW_015090842.1:5826835",52,104,52
"ATMIN","s1693_S_RAP_03_ASEReadCounter.table","NW_015090842.1:5826910",43,96,53
"ATMIN","s1693_S_RAP_03_ASEReadCounter.table","NW_015090842.1:5826942",33,112,79
"ATMIN","s1693_S_RAP_03_ASEReadCounter.table","NW_015090842.1:5827193",66,143,77
"ATMIN","s1693_S_RAP_03_ASEReadCounter.table","NW_015090842.1:5827196",64,142,78
"ATMIN","s1693_S_RAP_03_ASEReadCounter.table","NW_015090842.1:5827269",67,149,82
"ATMIN","s1693_S_RAP_03_ASEReadCounter.table","NW_015090842.1:5827315",56,110,54
"ATMIN","s1693_S_RAP_03_ASEReadCounter.table","NW_015090842.1:5827316",55,109,54
"ATMIN","s1693_S_RAP_03_ASEReadCounter.table","NW_015090842.1:5827333",56,107,51
"PPP1R3E","s1693_S_RAP_03_ASEReadCounter.table","NW_015090842.1:5837733",7,10,3
"PPP1R3E","s1693_S_RAP_03_ASEReadCounter.table","NW_015090842.1:5837947",11,14,3
"PKD1L2","s1693_S_RAP_03_ASEReadCounter.table","NW_015090842.1:5867509",1,2,1
"PKD1L2","s1693_S_RAP_03_ASEReadCounter.table","NW_015090842.1:5867597",2,4,2
"PKD1L2","s1693_S_RAP_03_ASEReadCounter.table","NW_015090842.1:5867600",2,4,2
"PKD1L2","s1693_S_RAP_03_ASEReadCounter.table","NW_015090842.1:5867660",3,6,3
"PKD1L2","s1693_S_RAP_03_ASEReadCounter.table","NW_015090842.1:5867675",3,6,3
"PKD1L2","s1693_S_RAP_03_ASEReadCounter.table","NW_015090842.1:5867788",3,3,0
"PKD1L2","s1693_S_RAP_03_ASEReadCounter.table","NW_015090842.1:5867843",1,1,0
"BCO1","s1693_S_RAP_03_ASEReadCounter.table","NW_015090842.1:5915610",3,4,1
"BCO1","s1693_S_RAP_03_ASEReadCounter.table","NW_015090842.1:5915646",3,5,2
"BCO1","s1693_S_RAP_03_ASEReadCounter.table","NW_015090842.1:5917836",3,5,2
"BCO1","s1693_S_RAP_03_ASEReadCounter.table","NW_015090842.1:5917912",4,7,3
"BCO1","s1693_S_RAP_03_ASEReadCounter.table","NW_015090842.1:5917941",8,14,6
"BCO1","s1693_S_RAP_03_ASEReadCounter.table","NW_015090842.1:5917971",10,18,8
"BCO1","s1693_S_RAP_03_ASEReadCounter.table","NW_015090842.1:5921679",5,10,5
"BCO1","s1693_S_RAP_03_ASEReadCounter.table","NW_015090842.1:5921726",7,14,7
"BCO1","s1693_S_RAP_03_ASEReadCounter.table","NW_015090842.1:5925669",3,7,4
"BCO1","s1693_S_RAP_03_ASEReadCounter.table","NW_015090842.1:5925753",8,10,2
"BCO1","s1693_S_RAP_03_ASEReadCounter.table","NW_015090842.1:5926937",12,15,3
"BCO1","s1693_S_RAP_03_ASEReadCounter.table","NW_015090842.1:5927921",12,14,2
"BCO1","s1693_S_RAP_03_ASEReadCounter.table","NW_015090842.1:5927948",12,16,4
"BCO1","s1693_S_RAP_03_ASEReadCounter.table","NW_015090842.1:5927968",6,10,4
"BCO1","s1693_S_RAP_03_ASEReadCounter.table","NW_015090842.1:5928052",6,8,2
"BCO1","s1693_S_RAP_03_ASEReadCounter.table","NW_015090842.1:5932726",12,20,8
"BCO1","s1693_S_RAP_03_ASEReadCounter.table","NW_015090842.1:5932801",18,26,8
"BCO1","s1693_S_RAP_03_ASEReadCounter.table","NW_015090842.1:5934558",19,27,8
"BCO1","s1693_S_RAP_03_ASEReadCounter.table","NW_015090842.1:5934575",18,25,7
"BCO1","s1693_S_RAP_03_ASEReadCounter.table","NW_015090842.1:5934608",19,25,6
"BCO1","s1693_S_RAP_03_ASEReadCounter.table","NW_015090842.1:5934647",18,20,2
"BCO1","s1693_S_RAP_03_ASEReadCounter.table","NW_015090842.1:5934725",20,25,5
"BCO1","s1693_S_RAP_03_ASEReadCounter.table","NW_015090842.1:5934726",20,25,5
"BCO1","s1693_S_RAP_03_ASEReadCounter.table","NW_015090842.1:5934733",20,25,5
"BCO1","s1693_S_RAP_03_ASEReadCounter.table","NW_015090842.1:5934821",20,31,11
"BCO1","s1693_S_RAP_03_ASEReadCounter.table","NW_015090842.1:5934826",21,31,10
"BCO1","s1693_S_RAP_03_ASEReadCounter.table","NW_015090842.1:5934844",12,19,7
"BCO1","s1693_S_RAP_03_ASEReadCounter.table","NW_015090842.1:5934958",23,33,10
"BCO1","s1693_S_RAP_03_ASEReadCounter.table","NW_015090842.1:5934976",23,33,10
"GAN","s1693_S_RAP_03_ASEReadCounter.table","NW_015090842.1:5953759",16,32,16
"GAN","s1693_S_RAP_03_ASEReadCounter.table","NW_015090842.1:5957502",12,43,31
"GAN","s1693_S_RAP_03_ASEReadCounter.table","NW_015090842.1:5957578",21,42,21
"GAN","s1693_S_RAP_03_ASEReadCounter.table","NW_015090842.1:5965028",26,58,32
"GAN","s1693_S_RAP_03_ASEReadCounter.table","NW_015090842.1:5966047",33,65,32
"GAN","s1693_S_RAP_03_ASEReadCounter.table","NW_015090842.1:5966126",20,60,40
"GAN","s1693_S_RAP_03_ASEReadCounter.table","NW_015090842.1:5966127",19,60,41
"GAN","s1693_S_RAP_03_ASEReadCounter.table","NW_015090842.1:5966162",36,82,46
"GAN","s1693_S_RAP_03_ASEReadCounter.table","NW_015090842.1:5966483",64,105,41
"CMIP","s1693_S_RAP_03_ASEReadCounter.table","NW_015090842.1:6109159",21,36,15
"CMIP","s1693_S_RAP_03_ASEReadCounter.table","NW_015090842.1:6109166",17,30,13
"CMIP","s1693_S_RAP_03_ASEReadCounter.table","NW_015090842.1:6114641",37,75,38
"CMIP","s1693_S_RAP_03_ASEReadCounter.table","NW_015090842.1:6114751",26,67,41
"CMIP","s1693_S_RAP_03_ASEReadCounter.table","NW_015090842.1:6114824",29,66,37
"CMIP","s1693_S_RAP_03_ASEReadCounter.table","NW_015090842.1:6128998",50,103,53
"CMIP","s1693_S_RAP_03_ASEReadCounter.table","NW_015090842.1:6130562",89,174,85
"CMIP","s1693_S_RAP_03_ASEReadCounter.table","NW_015090842.1:6132522",85,164,79
"CMIP","s1693_S_RAP_03_ASEReadCounter.table","NW_015090842.1:6134088",91,171,80
"CMIP","s1693_S_RAP_03_ASEReadCounter.table","NW_015090842.1:6138265",149,310,161
"CMIP","s1693_S_RAP_03_ASEReadCounter.table","NW_015090842.1:6138300",163,337,174
"CMIP","s1693_S_RAP_03_ASEReadCounter.table","NW_015090842.1:6138342",136,279,143
"CMIP","s1693_S_RAP_03_ASEReadCounter.table","NW_015090842.1:6138343",136,277,141
"CMIP","s1693_S_RAP_03_ASEReadCounter.table","NW_015090842.1:6138345",136,274,138
"CMIP","s1693_S_RAP_03_ASEReadCounter.table","NW_015090842.1:6138647",99,205,106
"CMIP","s1693_S_RAP_03_ASEReadCounter.table","NW_015090842.1:6138745",125,253,128
"CMIP","s1693_S_RAP_03_ASEReadCounter.table","NW_015090842.1:6138832",31,91,60
"CMIP","s1693_S_RAP_03_ASEReadCounter.table","NW_015090842.1:6138967",114,219,105
"CMIP","s1693_S_RAP_03_ASEReadCounter.table","NW_015090842.1:6139131",68,135,67
"CMIP","s1693_S_RAP_03_ASEReadCounter.table","NW_015090842.1:6139163",30,91,61
"CMIP","s1693_S_RAP_03_ASEReadCounter.table","NW_015090842.1:6139360",56,88,32
"CMIP","s1693_S_RAP_03_ASEReadCounter.table","NW_015090842.1:6139572",41,60,19
"CMIP","s1693_S_RAP_03_ASEReadCounter.table","NW_015090842.1:6139773",125,126,1
"PLCG2","s1693_S_RAP_03_ASEReadCounter.table","NW_015090842.1:6179613",3,5,2
"PLCG2","s1693_S_RAP_03_ASEReadCounter.table","NW_015090842.1:6179658",7,13,6
"PLCG2","s1693_S_RAP_03_ASEReadCounter.table","NW_015090842.1:6203766",1,5,4
"PLCG2","s1693_S_RAP_03_ASEReadCounter.table","NW_015090842.1:6203775",1,5,4
"PLCG2","s1693_S_RAP_03_ASEReadCounter.table","NW_015090842.1:6203787",1,4,3
"PLCG2","s1693_S_RAP_03_ASEReadCounter.table","NW_015090842.1:6205047",2,5,3
"PLCG2","s1693_S_RAP_03_ASEReadCounter.table","NW_015090842.1:6208541",2,9,7
"PLCG2","s1693_S_RAP_03_ASEReadCounter.table","NW_015090842.1:6209741",2,6,4
"PLCG2","s1693_S_RAP_03_ASEReadCounter.table","NW_015090842.1:6209798",2,4,2
"PLCG2","s1693_S_RAP_03_ASEReadCounter.table","NW_015090842.1:6209816",2,4,2
"PLCG2","s1693_S_RAP_03_ASEReadCounter.table","NW_015090842.1:6217547",1,11,10
"PLCG2","s1693_S_RAP_03_ASEReadCounter.table","NW_015090842.1:6218641",1,8,7
"PLCG2","s1693_S_RAP_03_ASEReadCounter.table","NW_015090842.1:6220552",3,15,12
"PLCG2","s1693_S_RAP_03_ASEReadCounter.table","NW_015090842.1:6221969",1,14,13
"PLCG2","s1693_S_RAP_03_ASEReadCounter.table","NW_015090842.1:6228672",3,15,12
"PLCG2","s1693_S_RAP_03_ASEReadCounter.table","NW_015090842.1:6228694",3,13,10
"PLCG2","s1693_S_RAP_03_ASEReadCounter.table","NW_015090842.1:6228722",2,15,13
"PLCG2","s1693_S_RAP_03_ASEReadCounter.table","NW_015090842.1:6228747",1,16,15
"PLCG2","s1693_S_RAP_03_ASEReadCounter.table","NW_015090842.1:6228835",1,16,15
"PLCG2","s1693_S_RAP_03_ASEReadCounter.table","NW_015090842.1:6228841",1,16,15
"PLCG2","s1693_S_RAP_03_ASEReadCounter.table","NW_015090842.1:6228865",1,17,16
"PLCG2","s1693_S_RAP_03_ASEReadCounter.table","NW_015090842.1:6228917",2,14,12
"PLCG2","s1693_S_RAP_03_ASEReadCounter.table","NW_015090842.1:6228926",2,19,17
"PLCG2","s1693_S_RAP_03_ASEReadCounter.table","NW_015090842.1:6228954",2,16,14
"PLCG2","s1693_S_RAP_03_ASEReadCounter.table","NW_015090842.1:6229002",3,17,14
"PLCG2","s1693_S_RAP_03_ASEReadCounter.table","NW_015090842.1:6229006",3,17,14
"PLCG2","s1693_S_RAP_03_ASEReadCounter.table","NW_015090842.1:6229081",3,8,5
"PLCG2","s1693_S_RAP_03_ASEReadCounter.table","NW_015090842.1:6229097",2,5,3
"PLCG2","s1693_S_RAP_03_ASEReadCounter.table","NW_015090842.1:6229160",4,10,6
"PLCG2","s1693_S_RAP_03_ASEReadCounter.table","NW_015090842.1:6229213",4,11,7
"PLCG2","s1693_S_RAP_03_ASEReadCounter.table","NW_015090842.1:6229231",4,11,7
"PLCG2","s1693_S_RAP_03_ASEReadCounter.table","NW_015090842.1:6229663",4,5,1
"PLCG2","s1693_S_RAP_03_ASEReadCounter.table","NW_015090842.1:6229748",2,5,3
"PLCG2","s1693_S_RAP_03_ASEReadCounter.table","NW_015090842.1:6229892",4,7,3
"PLCG2","s1693_S_RAP_03_ASEReadCounter.table","NW_015090842.1:6230248",5,7,2
"PLCG2","s1693_S_RAP_03_ASEReadCounter.table","NW_015090842.1:6230255",5,7,2
"PLCG2","s1693_S_RAP_03_ASEReadCounter.table","NW_015090842.1:6230296",5,9,4
"PLCG2","s1693_S_RAP_03_ASEReadCounter.table","NW_015090842.1:6230349",4,7,3
"PLCG2","s1693_S_RAP_03_ASEReadCounter.table","NW_015090842.1:6230381",4,6,2
"PLCG2","s1693_S_RAP_03_ASEReadCounter.table","NW_015090842.1:6230408",5,9,4
"PLCG2","s1693_S_RAP_03_ASEReadCounter.table","NW_015090842.1:6230439",3,6,3
"PLCG2","s1693_S_RAP_03_ASEReadCounter.table","NW_015090842.1:6230757",0,3,3
"PLCG2","s1693_S_RAP_03_ASEReadCounter.table","NW_015090842.1:6230758",0,2,2
"PLCG2","s1693_S_RAP_03_ASEReadCounter.table","NW_015090842.1:6230898",8,10,2
"PLCG2","s1693_S_RAP_03_ASEReadCounter.table","NW_015090842.1:6230976",10,16,6
"PLCG2","s1693_S_RAP_03_ASEReadCounter.table","NW_015090842.1:6231078",6,12,6
"PLCG2","s1693_S_RAP_03_ASEReadCounter.table","NW_015090842.1:6231138",7,11,4
"PLCG2","s1693_S_RAP_03_ASEReadCounter.table","NW_015090842.1:6231177",10,11,1
"PLCG2","s1693_S_RAP_03_ASEReadCounter.table","NW_015090842.1:6231263",7,9,2
"PLCG2","s1693_S_RAP_03_ASEReadCounter.table","NW_015090842.1:6231309",1,2,1
"SDR42E1","s1693_S_RAP_03_ASEReadCounter.table","NW_015090842.1:6235292",0,4,4
"SDR42E1","s1693_S_RAP_03_ASEReadCounter.table","NW_015090842.1:6235315",3,7,4
"SDR42E1","s1693_S_RAP_03_ASEReadCounter.table","NW_015090842.1:6235348",7,17,10
"SDR42E1","s1693_S_RAP_03_ASEReadCounter.table","NW_015090842.1:6235355",7,18,11
"SDR42E1","s1693_S_RAP_03_ASEReadCounter.table","NW_015090842.1:6235417",5,20,15
"SDR42E1","s1693_S_RAP_03_ASEReadCounter.table","NW_015090842.1:6235526",21,21,0
"SDR42E1","s1693_S_RAP_03_ASEReadCounter.table","NW_015090842.1:6235558",8,27,19
"SDR42E1","s1693_S_RAP_03_ASEReadCounter.table","NW_015090842.1:6235603",34,34,0
"SDR42E1","s1693_S_RAP_03_ASEReadCounter.table","NW_015090842.1:6235741",9,27,18
"SDR42E1","s1693_S_RAP_03_ASEReadCounter.table","NW_015090842.1:6235777",6,27,21
"SDR42E1","s1693_S_RAP_03_ASEReadCounter.table","NW_015090842.1:6235806",11,39,28
"SDR42E1","s1693_S_RAP_03_ASEReadCounter.table","NW_015090842.1:6235809",12,40,28
"SDR42E1","s1693_S_RAP_03_ASEReadCounter.table","NW_015090842.1:6235816",11,40,29
"SDR42E1","s1693_S_RAP_03_ASEReadCounter.table","NW_015090842.1:6235914",9,27,18
"SDR42E1","s1693_S_RAP_03_ASEReadCounter.table","NW_015090842.1:6235935",11,25,14
"SDR42E1","s1693_S_RAP_03_ASEReadCounter.table","NW_015090842.1:6235957",13,27,14
"SDR42E1","s1693_S_RAP_03_ASEReadCounter.table","NW_015090842.1:6236040",3,15,12
"SDR42E1","s1693_S_RAP_03_ASEReadCounter.table","NW_015090842.1:6236260",9,20,11
"SDR42E1","s1693_S_RAP_03_ASEReadCounter.table","NW_015090842.1:6236281",8,18,10
"SDR42E1","s1693_S_RAP_03_ASEReadCounter.table","NW_015090842.1:6236305",9,19,10
"SDR42E1","s1693_S_RAP_03_ASEReadCounter.table","NW_015090842.1:6236458",9,20,11
"SDR42E1","s1693_S_RAP_03_ASEReadCounter.table","NW_015090842.1:6236476",10,23,13
"SDR42E1","s1693_S_RAP_03_ASEReadCounter.table","NW_015090842.1:6236608",3,12,9
"SDR42E1","s1693_S_RAP_03_ASEReadCounter.table","NW_015090842.1:6238244",6,7,1
"SDR42E1","s1693_S_RAP_03_ASEReadCounter.table","NW_015090842.1:6238829",1,7,6
"HSD17B2","s1693_S_RAP_03_ASEReadCounter.table","NW_015090842.1:6257829",0,1,1
"HSD17B2","s1693_S_RAP_03_ASEReadCounter.table","NW_015090842.1:6262974",0,2,2
"HSD17B2","s1693_S_RAP_03_ASEReadCounter.table","NW_015090842.1:6266125",0,1,1
"HSD17B2","s1693_S_RAP_03_ASEReadCounter.table","NW_015090842.1:6266135",0,1,1
"HSD17B2","s1693_S_RAP_03_ASEReadCounter.table","NW_015090842.1:6266795",0,2,2
"HSD17B2","s1693_S_RAP_03_ASEReadCounter.table","NW_015090842.1:6267674",0,1,1
"HSD17B2","s1693_S_RAP_03_ASEReadCounter.table","NW_015090842.1:6268203",0,1,1
"ARY2","s1693_S_RAP_03_ASEReadCounter.table","NW_015090842.1:6303922",11,21,10
"ARY2","s1693_S_RAP_03_ASEReadCounter.table","NW_015090842.1:6303954",16,24,8
"ARY2","s1693_S_RAP_03_ASEReadCounter.table","NW_015090842.1:6303979",18,27,9
"ARY2","s1693_S_RAP_03_ASEReadCounter.table","NW_015090842.1:6305848",17,32,15
"ARY2","s1693_S_RAP_03_ASEReadCounter.table","NW_015090842.1:6305856",18,32,14
"ARY2","s1693_S_RAP_03_ASEReadCounter.table","NW_015090842.1:6305857",18,32,14
"ARY2","s1693_S_RAP_03_ASEReadCounter.table","NW_015090842.1:6306017",19,28,9
"ARY2","s1693_S_RAP_03_ASEReadCounter.table","NW_015090842.1:6306052",21,32,11
"ARY2","s1693_S_RAP_03_ASEReadCounter.table","NW_015090842.1:6306094",23,32,9
"ARY2","s1693_S_RAP_03_ASEReadCounter.table","NW_015090842.1:6306100",24,33,9
"ARY2","s1693_S_RAP_03_ASEReadCounter.table","NW_015090842.1:6306146",18,22,4
"ARY2","s1693_S_RAP_03_ASEReadCounter.table","NW_015090842.1:6306147",18,21,3
"ARY2","s1693_S_RAP_03_ASEReadCounter.table","NW_015090842.1:6306390",24,32,8
"ARY2","s1693_S_RAP_03_ASEReadCounter.table","NW_015090842.1:6306567",24,33,9
"ARY2","s1693_S_RAP_03_ASEReadCounter.table","NW_015090842.1:6306705",29,32,3
"ARY2","s1693_S_RAP_03_ASEReadCounter.table","NW_015090842.1:6306713",32,32,0
"ARY2","s1693_S_RAP_03_ASEReadCounter.table","NW_015090842.1:6306773",27,31,4
"ARY2","s1693_S_RAP_03_ASEReadCounter.table","NW_015090842.1:6307039",21,30,9
"ARY2","s1693_S_RAP_03_ASEReadCounter.table","NW_015090842.1:6307043",23,32,9
"ARY2","s1693_S_RAP_03_ASEReadCounter.table","NW_015090842.1:6307093",21,29,8
"ARY2","s1693_S_RAP_03_ASEReadCounter.table","NW_015090842.1:6307138",25,36,11
"ARY2","s1693_S_RAP_03_ASEReadCounter.table","NW_015090842.1:6307157",29,38,9
"ARY2","s1693_S_RAP_03_ASEReadCounter.table","NW_015090842.1:6307187",35,43,8
"ARY2","s1693_S_RAP_03_ASEReadCounter.table","NW_015090842.1:6307278",29,39,10
"ARY2","s1693_S_RAP_03_ASEReadCounter.table","NW_015090842.1:6307305",32,43,11
"ARY2","s1693_S_RAP_03_ASEReadCounter.table","NW_015090842.1:6307318",35,46,11
"ARY2","s1693_S_RAP_03_ASEReadCounter.table","NW_015090842.1:6307429",38,56,18
"ARY2","s1693_S_RAP_03_ASEReadCounter.table","NW_015090842.1:6307487",30,43,13
"ARY2","s1693_S_RAP_03_ASEReadCounter.table","NW_015090842.1:6307670",26,37,11
"ARYL","s1693_S_RAP_03_ASEReadCounter.table","NW_015090842.1:6313360",1,5,4
"ARYL","s1693_S_RAP_03_ASEReadCounter.table","NW_015090842.1:6313377",0,3,3
"ARYL","s1693_S_RAP_03_ASEReadCounter.table","NW_015090842.1:6313767",4,5,1
"ARY1","s1693_S_RAP_03_ASEReadCounter.table","NW_015090842.1:6313909",6,6,0
"ARY1","s1693_S_RAP_03_ASEReadCounter.table","NW_015090842.1:6314296",10,18,8
"ARY1","s1693_S_RAP_03_ASEReadCounter.table","NW_015090842.1:6314541",5,14,9
"ARY1","s1693_S_RAP_03_ASEReadCounter.table","NW_015090842.1:6314597",7,19,12
"ARY1","s1693_S_RAP_03_ASEReadCounter.table","NW_015090842.1:6314750",11,18,7
"ARY1","s1693_S_RAP_03_ASEReadCounter.table","NW_015090842.1:6314794",7,12,5
"ARY1","s1693_S_RAP_03_ASEReadCounter.table","NW_015090842.1:6314827",8,15,7
"ARY1","s1693_S_RAP_03_ASEReadCounter.table","NW_015090842.1:6314843",10,16,6
"ARY1","s1693_S_RAP_03_ASEReadCounter.table","NW_015090842.1:6314859",10,14,4
"ARY1","s1693_S_RAP_03_ASEReadCounter.table","NW_015090842.1:6314886",14,19,5
"ARY1","s1693_S_RAP_03_ASEReadCounter.table","NW_015090842.1:6314943",11,11,0
"ARY1","s1693_S_RAP_03_ASEReadCounter.table","NW_015090842.1:6314949",4,12,8
"ARY1","s1693_S_RAP_03_ASEReadCounter.table","NW_015090842.1:6315022",12,17,5
"ARY1","s1693_S_RAP_03_ASEReadCounter.table","NW_015090842.1:6315026",10,16,6
"ARY1","s1693_S_RAP_03_ASEReadCounter.table","NW_015090842.1:6315043",11,16,5
"ARY1","s1693_S_RAP_03_ASEReadCounter.table","NW_015090842.1:6315065",15,21,6
"ARY1","s1693_S_RAP_03_ASEReadCounter.table","NW_015090842.1:6315409",11,17,6
"ARY1","s1693_S_RAP_03_ASEReadCounter.table","NW_015090842.1:6315479",11,21,10
"ARY1","s1693_S_RAP_03_ASEReadCounter.table","NW_015090842.1:6318342",16,30,14
"ARY1","s1693_S_RAP_03_ASEReadCounter.table","NW_015090842.1:6318427",23,37,14
"ARY1","s1693_S_RAP_03_ASEReadCounter.table","NW_015090842.1:6318603",13,23,10
"ARY1","s1693_S_RAP_03_ASEReadCounter.table","NW_015090842.1:6318708",15,23,8
"ARY1","s1693_S_RAP_03_ASEReadCounter.table","NW_015090842.1:6318858",23,33,10
"ARY1","s1693_S_RAP_03_ASEReadCounter.table","NW_015090842.1:6318952",19,33,14
"MPHOSPH6","s1693_S_RAP_03_ASEReadCounter.table","NW_015090842.1:6324063",59,122,63
"MPHOSPH6","s1693_S_RAP_03_ASEReadCounter.table","NW_015090842.1:6324174",113,222,109
"MPHOSPH6","s1693_S_RAP_03_ASEReadCounter.table","NW_015090842.1:6324270",147,285,138
"MPHOSPH6","s1693_S_RAP_03_ASEReadCounter.table","NW_015090842.1:6324762",125,270,145
"MPHOSPH6","s1693_S_RAP_03_ASEReadCounter.table","NW_015090842.1:6324772",112,241,129
"MPHOSPH6","s1693_S_RAP_03_ASEReadCounter.table","NW_015090842.1:6324780",108,232,124
"MPHOSPH6","s1693_S_RAP_03_ASEReadCounter.table","NW_015090842.1:6324902",116,255,139
"MPHOSPH6","s1693_S_RAP_03_ASEReadCounter.table","NW_015090842.1:6324910",262,262,0
"MPHOSPH6","s1693_S_RAP_03_ASEReadCounter.table","NW_015090842.1:6325066",96,227,131
"MPHOSPH6","s1693_S_RAP_03_ASEReadCounter.table","NW_015090842.1:6325089",110,246,136
"MPHOSPH6","s1693_S_RAP_03_ASEReadCounter.table","NW_015090842.1:6325298",136,294,158
"MPHOSPH6","s1693_S_RAP_03_ASEReadCounter.table","NW_015090842.1:6325877",94,214,120
"MPHOSPH6","s1693_S_RAP_03_ASEReadCounter.table","NW_015090842.1:6326976",67,169,102
"CDH13","s1693_S_RAP_03_ASEReadCounter.table","NW_015090842.1:6662283",8,18,10
"CDH13","s1693_S_RAP_03_ASEReadCounter.table","NW_015090842.1:6693665",10,21,11
"CDH13","s1693_S_RAP_03_ASEReadCounter.table","NW_015090842.1:6693697",9,15,6
"CDH13","s1693_S_RAP_03_ASEReadCounter.table","NW_015090842.1:6693712",8,14,6
"CDH13","s1693_S_RAP_03_ASEReadCounter.table","NW_015090842.1:6693723",10,16,6
"CDH13","s1693_S_RAP_03_ASEReadCounter.table","NW_015090842.1:6693738",9,14,5
"CDH13","s1693_S_RAP_03_ASEReadCounter.table","NW_015090842.1:6823730",15,26,11
"CDH13","s1693_S_RAP_03_ASEReadCounter.table","NW_015090842.1:6889713",7,20,13
"CDH13","s1693_S_RAP_03_ASEReadCounter.table","NW_015090842.1:6955167",38,76,38
"MLYCD","s1693_S_RAP_03_ASEReadCounter.table","NW_015090842.1:7150054",86,165,79
"MLYCD","s1693_S_RAP_03_ASEReadCounter.table","NW_015090842.1:7150131",129,252,123
"MLYCD","s1693_S_RAP_03_ASEReadCounter.table","NW_015090842.1:7150585",94,191,97
"MLYCD","s1693_S_RAP_03_ASEReadCounter.table","NW_015090842.1:7150686",86,146,60
"MLYCD","s1693_S_RAP_03_ASEReadCounter.table","NW_015090842.1:7150696",100,167,67
"MLYCD","s1693_S_RAP_03_ASEReadCounter.table","NW_015090842.1:7150698",64,170,106
"MLYCD","s1693_S_RAP_03_ASEReadCounter.table","NW_015090842.1:7150869",80,139,59
"MLYCD","s1693_S_RAP_03_ASEReadCounter.table","NW_015090842.1:7151100",64,120,56
"MLYCD","s1693_S_RAP_03_ASEReadCounter.table","NW_015090842.1:7151127",73,136,63
"MLYCD","s1693_S_RAP_03_ASEReadCounter.table","NW_015090842.1:7157538",50,99,49
"MLYCD","s1693_S_RAP_03_ASEReadCounter.table","NW_015090842.1:7167662",21,39,18
"MLYCD","s1693_S_RAP_03_ASEReadCounter.table","NW_015090842.1:7167675",24,40,16
"MLYCD","s1693_S_RAP_03_ASEReadCounter.table","NW_015090842.1:7167710",20,29,9
"MLYCD","s1693_S_RAP_03_ASEReadCounter.table","NW_015090842.1:7167781",21,28,7
"MLYCD","s1693_S_RAP_03_ASEReadCounter.table","NW_015090842.1:7167803",18,23,5
"MLYCD","s1693_S_RAP_03_ASEReadCounter.table","NW_015090842.1:7167812",15,24,9
"MLYCD","s1693_S_RAP_03_ASEReadCounter.table","NW_015090842.1:7167845",14,27,13
"MLYCD","s1693_S_RAP_03_ASEReadCounter.table","NW_015090842.1:7167862",13,29,16
"MLYCD","s1693_S_RAP_03_ASEReadCounter.table","NW_015090842.1:7167929",10,24,14
"MLYCD","s1693_S_RAP_03_ASEReadCounter.table","NW_015090842.1:7167995",7,14,7
"MLYCD","s1693_S_RAP_03_ASEReadCounter.table","NW_015090842.1:7168005",8,15,7
"MLYCD","s1693_S_RAP_03_ASEReadCounter.table","NW_015090842.1:7168037",12,19,7
"HSBP1","s1693_S_RAP_03_ASEReadCounter.table","NW_015090842.1:7245192",441,754,313
"HSBP1","s1693_S_RAP_03_ASEReadCounter.table","NW_015090842.1:7245226",483,847,364
"HSBP1","s1693_S_RAP_03_ASEReadCounter.table","NW_015090842.1:7245257",410,719,309
"HSBP1","s1693_S_RAP_03_ASEReadCounter.table","NW_015090842.1:7245296",387,711,324
"HSBP1","s1693_S_RAP_03_ASEReadCounter.table","NW_015090842.1:7245389",550,954,404
"HSBP1","s1693_S_RAP_03_ASEReadCounter.table","NW_015090842.1:7245400",547,911,364
"HSBP1","s1693_S_RAP_03_ASEReadCounter.table","NW_015090842.1:7245445",523,893,370
"HSBP1","s1693_S_RAP_03_ASEReadCounter.table","NW_015090842.1:7245495",461,833,372
"HSBP1","s1693_S_RAP_03_ASEReadCounter.table","NW_015090842.1:7245515",559,967,408
"HSBP1","s1693_S_RAP_03_ASEReadCounter.table","NW_015090842.1:7245733",338,627,289
"HSBP1","s1693_S_RAP_03_ASEReadCounter.table","NW_015090842.1:7245771",367,618,251
"HSBP1","s1693_S_RAP_03_ASEReadCounter.table","NW_015090842.1:7245813",352,585,233
"HSBP1","s1693_S_RAP_03_ASEReadCounter.table","NW_015090842.1:7245926",385,661,276
"HSBP1","s1693_S_RAP_03_ASEReadCounter.table","NW_015090842.1:7245927",382,656,274
"HSBP1","s1693_S_RAP_03_ASEReadCounter.table","NW_015090842.1:7245933",379,641,262
"HSBP1","s1693_S_RAP_03_ASEReadCounter.table","NW_015090842.1:7246002",295,541,246
"HSBP1","s1693_S_RAP_03_ASEReadCounter.table","NW_015090842.1:7246094",381,622,241
"HSBP1","s1693_S_RAP_03_ASEReadCounter.table","NW_015090842.1:7246167",378,591,213
"HSBP1","s1693_S_RAP_03_ASEReadCounter.table","NW_015090842.1:7246183",360,591,231
"HSBP1","s1693_S_RAP_03_ASEReadCounter.table","NW_015090842.1:7247285",40,59,19
"HSBP1","s1693_S_RAP_03_ASEReadCounter.table","NW_015090842.1:7247651",384,814,430
"HSBP1","s1693_S_RAP_03_ASEReadCounter.table","NW_015090842.1:7247657",393,825,432
"HSBP1","s1693_S_RAP_03_ASEReadCounter.table","NW_015090842.1:7248520",271,571,300
"HSBP1","s1693_S_RAP_03_ASEReadCounter.table","NW_015090842.1:7248535",217,459,242
"KCNG4","s1693_S_RAP_03_ASEReadCounter.table","NW_015090842.1:7282481",6,9,3
"KCNG4","s1693_S_RAP_03_ASEReadCounter.table","NW_015090842.1:7282500",6,10,4
"KCNG4","s1693_S_RAP_03_ASEReadCounter.table","NW_015090842.1:7282542",4,6,2
"KCNG4","s1693_S_RAP_03_ASEReadCounter.table","NW_015090842.1:7282579",4,6,2
"KCNG4","s1693_S_RAP_03_ASEReadCounter.table","NW_015090842.1:7282630",4,7,3
"KCNG4","s1693_S_RAP_03_ASEReadCounter.table","NW_015090842.1:7282760",2,4,2
"KCNG4","s1693_S_RAP_03_ASEReadCounter.table","NW_015090842.1:7283056",2,7,5
"KCNG4","s1693_S_RAP_03_ASEReadCounter.table","NW_015090842.1:7301227",1,1,0
"KCNG4","s1693_S_RAP_03_ASEReadCounter.table","NW_015090842.1:7301240",1,1,0
"KCNG4","s1693_S_RAP_03_ASEReadCounter.table","NW_015090842.1:7301413",1,1,0
"WFDC1","s1693_S_RAP_03_ASEReadCounter.table","NW_015090842.1:7366517",3,3,0
"ATP2C2","s1693_S_RAP_03_ASEReadCounter.table","NW_015090842.1:7413747",5,12,7
"TLDC1","s1693_S_RAP_03_ASEReadCounter.table","NW_015090842.1:7421997",37,83,46
"COTL1","s1693_S_RAP_03_ASEReadCounter.table","NW_015090842.1:7490707",711,1478,767
"COTL1","s1693_S_RAP_03_ASEReadCounter.table","NW_015090842.1:7490708",710,1485,775
"COTL1","s1693_S_RAP_03_ASEReadCounter.table","NW_015090842.1:7490711",720,1493,773
"COTL1","s1693_S_RAP_03_ASEReadCounter.table","NW_015090842.1:7490739",684,1456,772
"COTL1","s1693_S_RAP_03_ASEReadCounter.table","NW_015090842.1:7490785",691,1425,734
"COTL1","s1693_S_RAP_03_ASEReadCounter.table","NW_015090842.1:7490820",74,903,829
"COTL1","s1693_S_RAP_03_ASEReadCounter.table","NW_015090842.1:7490846",671,1353,682
"KLHL36","s1693_S_RAP_03_ASEReadCounter.table","NW_015090842.1:7526337",37,37,0
"KLHL36","s1693_S_RAP_03_ASEReadCounter.table","NW_015090842.1:7537681",111,111,0
"USP10","s1693_S_RAP_03_ASEReadCounter.table","NW_015090842.1:7572213",38,85,47
"USP10","s1693_S_RAP_03_ASEReadCounter.table","NW_015090842.1:7572358",31,75,44
"CRISPLD2","s1693_S_RAP_03_ASEReadCounter.table","NW_015090842.1:7619796",0,1,1
"CRISPLD2","s1693_S_RAP_03_ASEReadCounter.table","NW_015090842.1:7630779",2,10,8
"CRISPLD2","s1693_S_RAP_03_ASEReadCounter.table","NW_015090842.1:7633611",11,11,0
"CRISPLD2","s1693_S_RAP_03_ASEReadCounter.table","NW_015090842.1:7633787",3,5,2
"CRISPLD2","s1693_S_RAP_03_ASEReadCounter.table","NW_015090842.1:7634023",3,6,3
"CRISPLD2","s1693_S_RAP_03_ASEReadCounter.table","NW_015090842.1:7634620",2,5,3
"CRISPLD2","s1693_S_RAP_03_ASEReadCounter.table","NW_015090842.1:7636315",3,7,4
"MTHFSD","s1693_S_RAP_03_ASEReadCounter.table","NW_015090842.1:8152578",21,46,25
"DUSP15","s1693_S_RAP_03_ASEReadCounter.table","NW_015090842.1:8422840",1,2,1
"DUSP15","s1693_S_RAP_03_ASEReadCounter.table","NW_015090842.1:8431988",0,3,3
"EMC8","s1693_S_RAP_03_ASEReadCounter.table","NW_015090842.1:8452385",21,44,23
"GINS2","s1693_S_RAP_03_ASEReadCounter.table","NW_015090842.1:8467469",34,34,0
"GINS2","s1693_S_RAP_03_ASEReadCounter.table","NW_015090842.1:8470290",35,81,46
"GINS2","s1693_S_RAP_03_ASEReadCounter.table","NW_015090842.1:8470305",38,81,43
"GINS2","s1693_S_RAP_03_ASEReadCounter.table","NW_015090842.1:8470376",39,85,46
"GINS2","s1693_S_RAP_03_ASEReadCounter.table","NW_015090842.1:8471057",0,9,9
"GSE1","s1693_S_RAP_03_ASEReadCounter.table","NW_015090842.1:8483570",4,4,0
"KIAA0513","s1693_S_RAP_03_ASEReadCounter.table","NW_015090842.1:8674736",134,134,0
"KIAA0513","s1693_S_RAP_03_ASEReadCounter.table","NW_015090842.1:8687268",0,1,1
"KIAA0513","s1693_S_RAP_03_ASEReadCounter.table","NW_015090842.1:8693655",8,8,0
"ZCCHC14","s1693_S_RAP_03_ASEReadCounter.table","NW_015090842.1:8750189",86,86,0
"JPH3","s1693_S_RAP_03_ASEReadCounter.table","NW_015090842.1:8872294",57,104,47
"KLHDC4","s1693_S_RAP_03_ASEReadCounter.table","NW_015090842.1:8891175",64,179,115
"KLHDC4","s1693_S_RAP_03_ASEReadCounter.table","NW_015090842.1:8905251",18,53,35
"KLHDC4","s1693_S_RAP_03_ASEReadCounter.table","NW_015090842.1:8919630",7,15,8
"SLC7A5","s1693_S_RAP_03_ASEReadCounter.table","NW_015090842.1:8940382",269,269,0
"SLC7A5","s1693_S_RAP_03_ASEReadCounter.table","NW_015090842.1:8941818",161,161,0
"SLC7A5","s1693_S_RAP_03_ASEReadCounter.table","NW_015090842.1:8944655",85,85,0
"CA5A","s1693_S_RAP_03_ASEReadCounter.table","NW_015090842.1:8989479",108,232,124
"CA5A","s1693_S_RAP_03_ASEReadCounter.table","NW_015090842.1:8989562",135,283,148
"CA5A","s1693_S_RAP_03_ASEReadCounter.table","NW_015090842.1:8989609",175,343,168
"CA5A","s1693_S_RAP_03_ASEReadCounter.table","NW_015090842.1:8989693",171,364,193
"CA5A","s1693_S_RAP_03_ASEReadCounter.table","NW_015090842.1:8989702",180,365,185
"CA5A","s1693_S_RAP_03_ASEReadCounter.table","NW_015090842.1:8989746",174,358,184
"CA5A","s1693_S_RAP_03_ASEReadCounter.table","NW_015090842.1:8989880",122,307,185
"CA5A","s1693_S_RAP_03_ASEReadCounter.table","NW_015090842.1:8989885",135,322,187
"CA5A","s1693_S_RAP_03_ASEReadCounter.table","NW_015090842.1:8989929",132,311,179
"CA5A","s1693_S_RAP_03_ASEReadCounter.table","NW_015090842.1:8990002",115,280,165
"CA5A","s1693_S_RAP_03_ASEReadCounter.table","NW_015090842.1:8990004",117,286,169
"CA5A","s1693_S_RAP_03_ASEReadCounter.table","NW_015090842.1:8990005",115,288,173
"CA5A","s1693_S_RAP_03_ASEReadCounter.table","NW_015090842.1:8990017",125,280,155
"CA5A","s1693_S_RAP_03_ASEReadCounter.table","NW_015090842.1:8990043",108,249,141
"CA5A","s1693_S_RAP_03_ASEReadCounter.table","NW_015090842.1:8990080",88,238,150
"CA5A","s1693_S_RAP_03_ASEReadCounter.table","NW_015090842.1:8990084",92,241,149
"CA5A","s1693_S_RAP_03_ASEReadCounter.table","NW_015090842.1:8990090",95,240,145
"CA5A","s1693_S_RAP_03_ASEReadCounter.table","NW_015090842.1:8990095",96,241,145
"CA5A","s1693_S_RAP_03_ASEReadCounter.table","NW_015090842.1:8990111",76,204,128
"CA5A","s1693_S_RAP_03_ASEReadCounter.table","NW_015090842.1:8990112",77,204,127
"CA5A","s1693_S_RAP_03_ASEReadCounter.table","NW_015090842.1:8990115",81,209,128
"CA5A","s1693_S_RAP_03_ASEReadCounter.table","NW_015090842.1:8990166",101,200,99
"CA5A","s1693_S_RAP_03_ASEReadCounter.table","NW_015090842.1:8990169",107,203,96
"CA5A","s1693_S_RAP_03_ASEReadCounter.table","NW_015090842.1:8990222",89,173,84
"CA5A","s1693_S_RAP_03_ASEReadCounter.table","NW_015090842.1:8990289",86,186,100
"CA5A","s1693_S_RAP_03_ASEReadCounter.table","NW_015090842.1:8990314",87,189,102
"CA5A","s1693_S_RAP_03_ASEReadCounter.table","NW_015090842.1:8990361",75,168,93
"CA5A","s1693_S_RAP_03_ASEReadCounter.table","NW_015090842.1:8990368",76,169,93
"CA5A","s1693_S_RAP_03_ASEReadCounter.table","NW_015090842.1:8990429",71,159,88
"CA5A","s1693_S_RAP_03_ASEReadCounter.table","NW_015090842.1:8990466",57,125,68
"CA5A","s1693_S_RAP_03_ASEReadCounter.table","NW_015090842.1:8990663",75,136,61
"CA5A","s1693_S_RAP_03_ASEReadCounter.table","NW_015090842.1:8990797",61,116,55
"CA5A","s1693_S_RAP_03_ASEReadCounter.table","NW_015090842.1:8990836",66,123,57
"CA5A","s1693_S_RAP_03_ASEReadCounter.table","NW_015090842.1:8990842",68,124,56
"CA5A","s1693_S_RAP_03_ASEReadCounter.table","NW_015090842.1:8990851",69,118,49
"CA5A","s1693_S_RAP_03_ASEReadCounter.table","NW_015090842.1:8990918",47,99,52
"CA5A","s1693_S_RAP_03_ASEReadCounter.table","NW_015090842.1:8990921",37,100,63
"CA5A","s1693_S_RAP_03_ASEReadCounter.table","NW_015090842.1:8990942",54,120,66
"CA5A","s1693_S_RAP_03_ASEReadCounter.table","NW_015090842.1:8991001",71,148,77
"CA5A","s1693_S_RAP_03_ASEReadCounter.table","NW_015090842.1:8991038",65,144,79
"CA5A","s1693_S_RAP_03_ASEReadCounter.table","NW_015090842.1:8991149",68,144,76
"CA5A","s1693_S_RAP_03_ASEReadCounter.table","NW_015090842.1:8991176",75,141,66
"CA5A","s1693_S_RAP_03_ASEReadCounter.table","NW_015090842.1:8991241",64,125,61
"CA5A","s1693_S_RAP_03_ASEReadCounter.table","NW_015090842.1:8991262",62,119,57
"CA5A","s1693_S_RAP_03_ASEReadCounter.table","NW_015090842.1:8991316",68,75,7
"CA5A","s1693_S_RAP_03_ASEReadCounter.table","NW_015090842.1:8991319",66,74,8
"CA5A","s1693_S_RAP_03_ASEReadCounter.table","NW_015090842.1:8991330",68,73,5
"CA5A","s1693_S_RAP_03_ASEReadCounter.table","NW_015090842.1:8991334",66,74,8
"CA5A","s1693_S_RAP_03_ASEReadCounter.table","NW_015090842.1:8991362",62,98,36
"CA5A","s1693_S_RAP_03_ASEReadCounter.table","NW_015090842.1:8991368",61,97,36
"CA5A","s1693_S_RAP_03_ASEReadCounter.table","NW_015090842.1:8991390",66,103,37
"CA5A","s1693_S_RAP_03_ASEReadCounter.table","NW_015090842.1:8991395",67,109,42
"CA5A","s1693_S_RAP_03_ASEReadCounter.table","NW_015090842.1:8991422",73,127,54
"CA5A","s1693_S_RAP_03_ASEReadCounter.table","NW_015090842.1:8991467",64,129,65
"CA5A","s1693_S_RAP_03_ASEReadCounter.table","NW_015090842.1:8991576",38,84,46
"CA5A","s1693_S_RAP_03_ASEReadCounter.table","NW_015090842.1:8991587",42,90,48
"CA5A","s1693_S_RAP_03_ASEReadCounter.table","NW_015090842.1:8991655",59,126,67
"CA5A","s1693_S_RAP_03_ASEReadCounter.table","NW_015090842.1:8991717",48,108,60
"CA5A","s1693_S_RAP_03_ASEReadCounter.table","NW_015090842.1:8991726",52,108,56
"CA5A","s1693_S_RAP_03_ASEReadCounter.table","NW_015090842.1:8991799",42,97,55
"CA5A","s1693_S_RAP_03_ASEReadCounter.table","NW_015090842.1:8991809",39,96,57
"CA5A","s1693_S_RAP_03_ASEReadCounter.table","NW_015090842.1:8991848",41,95,54
"CA5A","s1693_S_RAP_03_ASEReadCounter.table","NW_015090842.1:8991849",41,96,55
"CA5A","s1693_S_RAP_03_ASEReadCounter.table","NW_015090842.1:8991927",51,101,50
"CA5A","s1693_S_RAP_03_ASEReadCounter.table","NW_015090842.1:8991941",45,91,46
"CA5A","s1693_S_RAP_03_ASEReadCounter.table","NW_015090842.1:8992121",39,83,44
"CA5A","s1693_S_RAP_03_ASEReadCounter.table","NW_015090842.1:8992224",51,88,37
"CA5A","s1693_S_RAP_03_ASEReadCounter.table","NW_015090842.1:9002570",29,49,20
"CA5A","s1693_S_RAP_03_ASEReadCounter.table","NW_015090842.1:9002600",28,50,22
"CA5A","s1693_S_RAP_03_ASEReadCounter.table","NW_015090842.1:9004312",19,36,17
"CA5A","s1693_S_RAP_03_ASEReadCounter.table","NW_015090842.1:9004506",4,4,0
"CA5A","s1693_S_RAP_03_ASEReadCounter.table","NW_015090842.1:9004523",3,4,1
"CA5A","s1693_S_RAP_03_ASEReadCounter.table","NW_015090842.1:9004530",6,7,1
"CA5A","s1693_S_RAP_03_ASEReadCounter.table","NW_015090842.1:9004556",6,7,1
"CA5A","s1693_S_RAP_03_ASEReadCounter.table","NW_015090842.1:9004620",6,7,1
"CA5A","s1693_S_RAP_03_ASEReadCounter.table","NW_015090842.1:9005116",6,6,0
"CA5A","s1693_S_RAP_03_ASEReadCounter.table","NW_015090842.1:9005120",7,7,0
"CA5A","s1693_S_RAP_03_ASEReadCounter.table","NW_015090842.1:9005140",8,8,0
"CA5A","s1693_S_RAP_03_ASEReadCounter.table","NW_015090842.1:9005152",7,7,0
"BANP","s1693_S_RAP_03_ASEReadCounter.table","NW_015090842.1:9033407",7,12,5
"BANP","s1693_S_RAP_03_ASEReadCounter.table","NW_015090842.1:9033409",7,11,4
"BANP","s1693_S_RAP_03_ASEReadCounter.table","NW_015090842.1:9033420",8,13,5
"BANP","s1693_S_RAP_03_ASEReadCounter.table","NW_015090842.1:9055284",8,17,9
"CIDEC","s1693_S_RAP_03_ASEReadCounter.table","NW_015090842.1:9481199",0,1,1
"ZC3H18","s1693_S_RAP_03_ASEReadCounter.table","NW_015090842.1:9528933",40,67,27
"MVD","s1693_S_RAP_03_ASEReadCounter.table","NW_015090842.1:9550690",73,73,0
"MVD","s1693_S_RAP_03_ASEReadCounter.table","NW_015090842.1:9550691",70,70,0
"MVD","s1693_S_RAP_03_ASEReadCounter.table","NW_015090842.1:9550699",83,83,0
"MVD","s1693_S_RAP_03_ASEReadCounter.table","NW_015090842.1:9550701",83,83,0
"MVD","s1693_S_RAP_03_ASEReadCounter.table","NW_015090842.1:9552202",93,93,0
"MVD","s1693_S_RAP_03_ASEReadCounter.table","NW_015090842.1:9552223",88,88,0
"MVD","s1693_S_RAP_03_ASEReadCounter.table","NW_015090842.1:9552533",65,65,0
"MVD","s1693_S_RAP_03_ASEReadCounter.table","NW_015090842.1:9552644",25,59,34
"PIEZO1","s1693_S_RAP_03_ASEReadCounter.table","NW_015090842.1:9577447",7,16,9
"PIEZO1","s1693_S_RAP_03_ASEReadCounter.table","NW_015090842.1:9579101",8,14,6
"PIEZO1","s1693_S_RAP_03_ASEReadCounter.table","NW_015090842.1:9582630",9,10,1
"PIEZO1","s1693_S_RAP_03_ASEReadCounter.table","NW_015090842.1:9582976",3,3,0
"PIEZO1","s1693_S_RAP_03_ASEReadCounter.table","NW_015090842.1:9583326",5,5,0
"CDT1","s1693_S_RAP_03_ASEReadCounter.table","NW_015090842.1:9596711",2,4,2
"CDT1","s1693_S_RAP_03_ASEReadCounter.table","NW_015090842.1:9597033",10,10,0
"CDT1","s1693_S_RAP_03_ASEReadCounter.table","NW_015090842.1:9597756",4,9,5
"CDT1","s1693_S_RAP_03_ASEReadCounter.table","NW_015090842.1:9598873",18,18,0
"PABPN1L","s1693_S_RAP_03_ASEReadCounter.table","NW_015090842.1:9669510",0,1,1
"ACSF3","s1693_S_RAP_03_ASEReadCounter.table","NW_015090842.1:9776737",10,18,8
"ACSF3","s1693_S_RAP_03_ASEReadCounter.table","NW_015090842.1:9809639",113,114,1
"ACSF3","s1693_S_RAP_03_ASEReadCounter.table","NW_015090842.1:9834743",67,137,70
"ACSF3","s1693_S_RAP_03_ASEReadCounter.table","NW_015090842.1:9834762",135,135,0
"ACSF3","s1693_S_RAP_03_ASEReadCounter.table","NW_015090842.1:9834852",56,117,61
"ACSF3","s1693_S_RAP_03_ASEReadCounter.table","NW_015090842.1:9834861",44,96,52
"ACSF3","s1693_S_RAP_03_ASEReadCounter.table","NW_015090842.1:9839359",50,98,48
"ACSF3","s1693_S_RAP_03_ASEReadCounter.table","NW_015090842.1:9839378",50,93,43
"ACSF3","s1693_S_RAP_03_ASEReadCounter.table","NW_015090842.1:9839455",38,90,52
"ACSF3","s1693_S_RAP_03_ASEReadCounter.table","NW_015090842.1:9839457",39,89,50
"ACSF3","s1693_S_RAP_03_ASEReadCounter.table","NW_015090842.1:9839489",31,77,46
"ACSF3","s1693_S_RAP_03_ASEReadCounter.table","NW_015090842.1:9839500",30,70,40
"ACSF3","s1693_S_RAP_03_ASEReadCounter.table","NW_015090842.1:9839501",30,69,39
"ACSF3","s1693_S_RAP_03_ASEReadCounter.table","NW_015090842.1:9839504",32,70,38
"ACSF3","s1693_S_RAP_03_ASEReadCounter.table","NW_015090842.1:9839512",27,55,28
"ACSF3","s1693_S_RAP_03_ASEReadCounter.table","NW_015090842.1:9839527",22,47,25
"ACSF3","s1693_S_RAP_03_ASEReadCounter.table","NW_015090842.1:9839533",9,30,21
"ACSF3","s1693_S_RAP_03_ASEReadCounter.table","NW_015090842.1:9839535",9,27,18
"ACSF3","s1693_S_RAP_03_ASEReadCounter.table","NW_015090842.1:9839545",6,21,15
"ACSF3","s1693_S_RAP_03_ASEReadCounter.table","NW_015090842.1:9839550",5,19,14
"ACSF3","s1693_S_RAP_03_ASEReadCounter.table","NW_015090842.1:9839551",6,19,13
"CDH15","s1693_S_RAP_03_ASEReadCounter.table","NW_015090842.1:9847163",3,8,5
"CDH15","s1693_S_RAP_03_ASEReadCounter.table","NW_015090842.1:9847174",4,9,5
"CDH15","s1693_S_RAP_03_ASEReadCounter.table","NW_015090842.1:9848220",3,6,3
"CDH15","s1693_S_RAP_03_ASEReadCounter.table","NW_015090842.1:9848265",3,3,0
"CDH15","s1693_S_RAP_03_ASEReadCounter.table","NW_015090842.1:9848531",2,5,3
"CDH15","s1693_S_RAP_03_ASEReadCounter.table","NW_015090842.1:9848552",2,5,3
"CDH15","s1693_S_RAP_03_ASEReadCounter.table","NW_015090842.1:9848888",1,4,3
"CDH15","s1693_S_RAP_03_ASEReadCounter.table","NW_015090842.1:9849086",2,4,2
"CDH15","s1693_S_RAP_03_ASEReadCounter.table","NW_015090842.1:9849119",2,6,4
"CDH15","s1693_S_RAP_03_ASEReadCounter.table","NW_015090842.1:9849140",2,6,4
"CDH15","s1693_S_RAP_03_ASEReadCounter.table","NW_015090842.1:9849473",5,8,3
"CDH15","s1693_S_RAP_03_ASEReadCounter.table","NW_015090842.1:9850141",4,6,2
"CDH15","s1693_S_RAP_03_ASEReadCounter.table","NW_015090842.1:9850386",3,4,1
"CDH15","s1693_S_RAP_03_ASEReadCounter.table","NW_015090842.1:9850432",2,3,1
"CDH15","s1693_S_RAP_03_ASEReadCounter.table","NW_015090842.1:9850609",2,3,1
"SLC22A31","s1693_S_RAP_03_ASEReadCounter.table","NW_015090842.1:9850797",2,5,3
"SLC22A31","s1693_S_RAP_03_ASEReadCounter.table","NW_015090842.1:9850818",3,6,3
"SLC22A31","s1693_S_RAP_03_ASEReadCounter.table","NW_015090842.1:9850929",3,6,3
"SLC22A31","s1693_S_RAP_03_ASEReadCounter.table","NW_015090842.1:9850936",2,5,3
"SLC22A31","s1693_S_RAP_03_ASEReadCounter.table","NW_015090842.1:9850940",2,5,3
"SLC22A31","s1693_S_RAP_03_ASEReadCounter.table","NW_015090842.1:9850948",3,6,3
"SLC22A31","s1693_S_RAP_03_ASEReadCounter.table","NW_015090842.1:9850961",4,7,3
"SLC22A31","s1693_S_RAP_03_ASEReadCounter.table","NW_015090842.1:9850970",4,6,2
"SLC22A31","s1693_S_RAP_03_ASEReadCounter.table","NW_015090842.1:9850978",4,6,2
"SLC22A31","s1693_S_RAP_03_ASEReadCounter.table","NW_015090842.1:9850981",4,6,2
"SLC22A31","s1693_S_RAP_03_ASEReadCounter.table","NW_015090842.1:9851032",3,4,1
"SLC22A31","s1693_S_RAP_03_ASEReadCounter.table","NW_015090842.1:9851053",1,3,2
"SLC22A31","s1693_S_RAP_03_ASEReadCounter.table","NW_015090842.1:9851130",5,11,6
"SLC22A31","s1693_S_RAP_03_ASEReadCounter.table","NW_015090842.1:9851139",5,13,8
"SLC22A31","s1693_S_RAP_03_ASEReadCounter.table","NW_015090842.1:9851265",4,14,10
"SLC22A31","s1693_S_RAP_03_ASEReadCounter.table","NW_015090842.1:9851302",5,16,11
"SLC22A31","s1693_S_RAP_03_ASEReadCounter.table","NW_015090842.1:9851303",5,16,11
"SLC22A31","s1693_S_RAP_03_ASEReadCounter.table","NW_015090842.1:9851305",5,16,11
"SLC22A31","s1693_S_RAP_03_ASEReadCounter.table","NW_015090842.1:9851343",8,18,10
"SLC22A31","s1693_S_RAP_03_ASEReadCounter.table","NW_015090842.1:9851344",8,18,10
"SLC22A31","s1693_S_RAP_03_ASEReadCounter.table","NW_015090842.1:9851381",10,21,11
"SLC22A31","s1693_S_RAP_03_ASEReadCounter.table","NW_015090842.1:9851421",7,14,7
"SLC22A31","s1693_S_RAP_03_ASEReadCounter.table","NW_015090842.1:9851526",8,18,10
"SLC22A31","s1693_S_RAP_03_ASEReadCounter.table","NW_015090842.1:9851589",13,20,7
"SLC22A31","s1693_S_RAP_03_ASEReadCounter.table","NW_015090842.1:9851712",11,21,10
"SLC22A31","s1693_S_RAP_03_ASEReadCounter.table","NW_015090842.1:9851899",11,22,11
"SLC22A31","s1693_S_RAP_03_ASEReadCounter.table","NW_015090842.1:9852139",11,16,5
"SLC22A31","s1693_S_RAP_03_ASEReadCounter.table","NW_015090842.1:9852380",9,17,8
"SLC22A31","s1693_S_RAP_03_ASEReadCounter.table","NW_015090842.1:9852431",8,16,8
"SLC22A31","s1693_S_RAP_03_ASEReadCounter.table","NW_015090842.1:9852630",13,22,9
"SLC22A31","s1693_S_RAP_03_ASEReadCounter.table","NW_015090842.1:9852711",9,16,7
"SLC22A31","s1693_S_RAP_03_ASEReadCounter.table","NW_015090842.1:9852742",5,10,5
"SLC22A31","s1693_S_RAP_03_ASEReadCounter.table","NW_015090842.1:9853099",7,13,6
"SLC22A31","s1693_S_RAP_03_ASEReadCounter.table","NW_015090842.1:9853102",7,13,6
"SLC22A31","s1693_S_RAP_03_ASEReadCounter.table","NW_015090842.1:9853421",0,1,1
"SLC22A31","s1693_S_RAP_03_ASEReadCounter.table","NW_015090842.1:9853457",1,2,1
"SLC22A31","s1693_S_RAP_03_ASEReadCounter.table","NW_015090842.1:9853502",2,2,0
"ANKRD11","s1693_S_RAP_03_ASEReadCounter.table","NW_015090842.1:9858863",17,34,17
"ANKRD11","s1693_S_RAP_03_ASEReadCounter.table","NW_015090842.1:9859101",165,336,171
"ANKRD11","s1693_S_RAP_03_ASEReadCounter.table","NW_015090842.1:9859352",199,428,229
"ANKRD11","s1693_S_RAP_03_ASEReadCounter.table","NW_015090842.1:9859381",49,238,189
"ANKRD11","s1693_S_RAP_03_ASEReadCounter.table","NW_015090842.1:9859527",94,200,106
"ANKRD11","s1693_S_RAP_03_ASEReadCounter.table","NW_015090842.1:9859529",93,201,108
"ANKRD11","s1693_S_RAP_03_ASEReadCounter.table","NW_015090842.1:9859679",189,382,193
"ANKRD11","s1693_S_RAP_03_ASEReadCounter.table","NW_015090842.1:9861097",145,304,159
"ANKRD11","s1693_S_RAP_03_ASEReadCounter.table","NW_015090842.1:9862571",90,165,75
"ANKRD11","s1693_S_RAP_03_ASEReadCounter.table","NW_015090842.1:9866071",0,90,90
"ANKRD11","s1693_S_RAP_03_ASEReadCounter.table","NW_015090842.1:9866200",0,79,79
"ANKRD11","s1693_S_RAP_03_ASEReadCounter.table","NW_015090842.1:9867391",30,56,26
"ANKRD11","s1693_S_RAP_03_ASEReadCounter.table","NW_015090842.1:9867472",38,84,46
"ANKRD11","s1693_S_RAP_03_ASEReadCounter.table","NW_015090842.1:9867559",44,93,49
"ANKRD11","s1693_S_RAP_03_ASEReadCounter.table","NW_015090842.1:9867934",54,108,54
"ANKRD11","s1693_S_RAP_03_ASEReadCounter.table","NW_015090842.1:9868093",59,110,51
"ANKRD11","s1693_S_RAP_03_ASEReadCounter.table","NW_015090842.1:9868222",59,125,66
"ANKRD11","s1693_S_RAP_03_ASEReadCounter.table","NW_015090842.1:9868327",56,130,74
"ANKRD11","s1693_S_RAP_03_ASEReadCounter.table","NW_015090842.1:9868414",73,163,90
"ANKRD11","s1693_S_RAP_03_ASEReadCounter.table","NW_015090842.1:9868441",82,166,84
"ANKRD11","s1693_S_RAP_03_ASEReadCounter.table","NW_015090842.1:9868444",87,180,93
"ANKRD11","s1693_S_RAP_03_ASEReadCounter.table","NW_015090842.1:9868519",93,205,112
"ANKRD11","s1693_S_RAP_03_ASEReadCounter.table","NW_015090842.1:9868609",109,226,117
"ANKRD11","s1693_S_RAP_03_ASEReadCounter.table","NW_015090842.1:9868666",104,229,125
"ANKRD11","s1693_S_RAP_03_ASEReadCounter.table","NW_015090842.1:9869431",203,391,188
"ANKRD11","s1693_S_RAP_03_ASEReadCounter.table","NW_015090842.1:9869578",292,570,278
"ANKRD11","s1693_S_RAP_03_ASEReadCounter.table","NW_015090842.1:9869734",266,582,316
"ANKRD11","s1693_S_RAP_03_ASEReadCounter.table","NW_015090842.1:9870070",247,526,279
"ANKRD11","s1693_S_RAP_03_ASEReadCounter.table","NW_015090842.1:9870349",285,563,278
"ANKRD11","s1693_S_RAP_03_ASEReadCounter.table","NW_015090842.1:9870604",323,604,281
"ANKRD11","s1693_S_RAP_03_ASEReadCounter.table","NW_015090842.1:9870613",347,659,312
"ANKRD11","s1693_S_RAP_03_ASEReadCounter.table","NW_015090842.1:9870685",333,710,377
"ANKRD11","s1693_S_RAP_03_ASEReadCounter.table","NW_015090842.1:9870847",281,618,337
"ANKRD11","s1693_S_RAP_03_ASEReadCounter.table","NW_015090842.1:9871103",224,464,240
"ANKRD11","s1693_S_RAP_03_ASEReadCounter.table","NW_015090842.1:9871165",231,520,289
"ANKRD11","s1693_S_RAP_03_ASEReadCounter.table","NW_015090842.1:9871820",86,158,72
"ANKRD11","s1693_S_RAP_03_ASEReadCounter.table","NW_015090842.1:9871994",177,177,0
"ANKRD11","s1693_S_RAP_03_ASEReadCounter.table","NW_015090842.1:9872118",83,185,102
"SPG7","s1693_S_RAP_03_ASEReadCounter.table","NW_015090842.1:10051190",142,244,102
"SPG7","s1693_S_RAP_03_ASEReadCounter.table","NW_015090842.1:10051218",151,273,122
"SPG7","s1693_S_RAP_03_ASEReadCounter.table","NW_015090842.1:10052348",151,292,141
"SPG7","s1693_S_RAP_03_ASEReadCounter.table","NW_015090842.1:10052366",151,286,135
"SPG7","s1693_S_RAP_03_ASEReadCounter.table","NW_015090842.1:10065173",208,413,205
"SPG7","s1693_S_RAP_03_ASEReadCounter.table","NW_015090842.1:10065215",193,375,182
"SPG7","s1693_S_RAP_03_ASEReadCounter.table","NW_015090842.1:10066301",146,290,144
"SPG7","s1693_S_RAP_03_ASEReadCounter.table","NW_015090842.1:10066365",188,354,166
"SPG7","s1693_S_RAP_03_ASEReadCounter.table","NW_015090842.1:10069752",213,425,212
"SPG7","s1693_S_RAP_03_ASEReadCounter.table","NW_015090842.1:10069800",229,449,220
"SPG7","s1693_S_RAP_03_ASEReadCounter.table","NW_015090842.1:10071192",269,496,227
"SPG7","s1693_S_RAP_03_ASEReadCounter.table","NW_015090842.1:10071204",261,479,218
"SPG7","s1693_S_RAP_03_ASEReadCounter.table","NW_015090842.1:10071219",249,462,213
"SPG7","s1693_S_RAP_03_ASEReadCounter.table","NW_015090842.1:10071967",245,479,234
"SPG7","s1693_S_RAP_03_ASEReadCounter.table","NW_015090842.1:10075109",368,702,334
"SPG7","s1693_S_RAP_03_ASEReadCounter.table","NW_015090842.1:10075114",372,697,325
"SPG7","s1693_S_RAP_03_ASEReadCounter.table","NW_015090842.1:10075198",324,576,252
"SPG7","s1693_S_RAP_03_ASEReadCounter.table","NW_015090842.1:10075487",241,468,227
"SPG7","s1693_S_RAP_03_ASEReadCounter.table","NW_015090842.1:10075488",241,471,230
"SPG7","s1693_S_RAP_03_ASEReadCounter.table","NW_015090842.1:10075548",197,364,167
"RPL13","s1693_S_RAP_03_ASEReadCounter.table","NW_015090842.1:10076979",5,9,4
"RPL13","s1693_S_RAP_03_ASEReadCounter.table","NW_015090842.1:10077387",599,1271,672
"RPL13","s1693_S_RAP_03_ASEReadCounter.table","NW_015090842.1:10077978",875,1849,974
"RPL13","s1693_S_RAP_03_ASEReadCounter.table","NW_015090842.1:10077992",872,1802,930
"CPNE7","s1693_S_RAP_03_ASEReadCounter.table","NW_015090842.1:10084001",2,6,4
"CPNE7","s1693_S_RAP_03_ASEReadCounter.table","NW_015090842.1:10084856",0,3,3
"CPNE7","s1693_S_RAP_03_ASEReadCounter.table","NW_015090842.1:10084872",0,3,3
"CPNE7","s1693_S_RAP_03_ASEReadCounter.table","NW_015090842.1:10084892",2,6,4
"CPNE7","s1693_S_RAP_03_ASEReadCounter.table","NW_015090842.1:10084921",2,4,2
"CPNE7","s1693_S_RAP_03_ASEReadCounter.table","NW_015090842.1:10084935",3,5,2
"CPNE7","s1693_S_RAP_03_ASEReadCounter.table","NW_015090842.1:10085000",4,5,1
"CPNE7","s1693_S_RAP_03_ASEReadCounter.table","NW_015090842.1:10085089",2,6,4
"CPNE7","s1693_S_RAP_03_ASEReadCounter.table","NW_015090842.1:10085096",3,7,4
"CPNE7","s1693_S_RAP_03_ASEReadCounter.table","NW_015090842.1:10085126",2,6,4
"CPNE7","s1693_S_RAP_03_ASEReadCounter.table","NW_015090842.1:10085180",3,5,2
"CPNE7","s1693_S_RAP_03_ASEReadCounter.table","NW_015090842.1:10085201",2,4,2
"CPNE7","s1693_S_RAP_03_ASEReadCounter.table","NW_015090842.1:10088134",14,18,4
"CPNE7","s1693_S_RAP_03_ASEReadCounter.table","NW_015090842.1:10088146",14,16,2
"CPNE7","s1693_S_RAP_03_ASEReadCounter.table","NW_015090842.1:10088940",12,14,2
"CPNE7","s1693_S_RAP_03_ASEReadCounter.table","NW_015090842.1:10088965",12,14,2
"CPNE7","s1693_S_RAP_03_ASEReadCounter.table","NW_015090842.1:10088967",12,14,2
"CPNE7","s1693_S_RAP_03_ASEReadCounter.table","NW_015090842.1:10088973",13,16,3
"CPNE7","s1693_S_RAP_03_ASEReadCounter.table","NW_015090842.1:10090924",18,24,6
"CPNE7","s1693_S_RAP_03_ASEReadCounter.table","NW_015090842.1:10090930",17,23,6
"CPNE7","s1693_S_RAP_03_ASEReadCounter.table","NW_015090842.1:10091075",15,18,3
"CPNE7","s1693_S_RAP_03_ASEReadCounter.table","NW_015090842.1:10091389",19,28,9
"CPNE7","s1693_S_RAP_03_ASEReadCounter.table","NW_015090842.1:10091407",24,34,10
"CPNE7","s1693_S_RAP_03_ASEReadCounter.table","NW_015090842.1:10091530",23,33,10
"CPNE7","s1693_S_RAP_03_ASEReadCounter.table","NW_015090842.1:10091875",23,32,9
"CPNE7","s1693_S_RAP_03_ASEReadCounter.table","NW_015090842.1:10091983",20,28,8
"CPNE7","s1693_S_RAP_03_ASEReadCounter.table","NW_015090842.1:10091997",23,29,6
"CPNE7","s1693_S_RAP_03_ASEReadCounter.table","NW_015090842.1:10092038",14,21,7
"CPNE7","s1693_S_RAP_03_ASEReadCounter.table","NW_015090842.1:10092140",17,24,7
"CPNE7","s1693_S_RAP_03_ASEReadCounter.table","NW_015090842.1:10092183",14,17,3
"CPNE7","s1693_S_RAP_03_ASEReadCounter.table","NW_015090842.1:10092201",11,14,3
"CPNE7","s1693_S_RAP_03_ASEReadCounter.table","NW_015090842.1:10092230",8,10,2
"CPNE7","s1693_S_RAP_03_ASEReadCounter.table","NW_015090842.1:10092246",3,4,1
"LOC106888185","s1693_S_RAP_03_ASEReadCounter.table","NW_015090842.1:10094965",1,4,3
"LOC106888185","s1693_S_RAP_03_ASEReadCounter.table","NW_015090842.1:10094966",1,4,3
"LOC106888185","s1693_S_RAP_03_ASEReadCounter.table","NW_015090842.1:10094985",1,5,4
"LOC106888185","s1693_S_RAP_03_ASEReadCounter.table","NW_015090842.1:10095055",0,4,4
"LOC106888185","s1693_S_RAP_03_ASEReadCounter.table","NW_015090842.1:10095062",0,4,4
"LOC106888185","s1693_S_RAP_03_ASEReadCounter.table","NW_015090842.1:10095130",1,7,6
"LOC106888185","s1693_S_RAP_03_ASEReadCounter.table","NW_015090842.1:10095265",11,21,10
"LOC106888185","s1693_S_RAP_03_ASEReadCounter.table","NW_015090842.1:10095586",14,31,17
"LOC106888185","s1693_S_RAP_03_ASEReadCounter.table","NW_015090842.1:10095593",15,31,16
"LOC106888185","s1693_S_RAP_03_ASEReadCounter.table","NW_015090842.1:10095616",12,27,15
"LOC106888185","s1693_S_RAP_03_ASEReadCounter.table","NW_015090842.1:10095662",6,16,10
"LOC106888185","s1693_S_RAP_03_ASEReadCounter.table","NW_015090842.1:10095674",5,13,8
"LOC106888185","s1693_S_RAP_03_ASEReadCounter.table","NW_015090842.1:10095786",14,24,10
"LOC106888185","s1693_S_RAP_03_ASEReadCounter.table","NW_015090842.1:10095831",8,14,6
"LOC106888185","s1693_S_RAP_03_ASEReadCounter.table","NW_015090842.1:10096230",4,11,7
"LOC106888185","s1693_S_RAP_03_ASEReadCounter.table","NW_015090842.1:10096249",5,12,7
"LOC106888185","s1693_S_RAP_03_ASEReadCounter.table","NW_015090842.1:10096272",5,10,5
"LOC106888185","s1693_S_RAP_03_ASEReadCounter.table","NW_015090842.1:10096288",5,8,3
"LOC106888185","s1693_S_RAP_03_ASEReadCounter.table","NW_015090842.1:10097248",4,11,7
"LOC106888185","s1693_S_RAP_03_ASEReadCounter.table","NW_015090842.1:10097265",4,15,11
"LOC106888185","s1693_S_RAP_03_ASEReadCounter.table","NW_015090842.1:10097446",0,2,2
"DPEP1","s1693_S_RAP_03_ASEReadCounter.table","NW_015090842.1:10098017",0,1,1
"DPEP1","s1693_S_RAP_03_ASEReadCounter.table","NW_015090842.1:10098518",0,1,1
"DPEP1","s1693_S_RAP_03_ASEReadCounter.table","NW_015090842.1:10099765",0,1,1
"DPEP1","s1693_S_RAP_03_ASEReadCounter.table","NW_015090842.1:10100044",0,1,1
"DPEP1","s1693_S_RAP_03_ASEReadCounter.table","NW_015090842.1:10100045",0,1,1
"DPEP1","s1693_S_RAP_03_ASEReadCounter.table","NW_015090842.1:10100084",1,3,2
"DPEP1","s1693_S_RAP_03_ASEReadCounter.table","NW_015090842.1:10100295",0,1,1
"DPEP1","s1693_S_RAP_03_ASEReadCounter.table","NW_015090842.1:10100529",0,1,1
"DPEP1","s1693_S_RAP_03_ASEReadCounter.table","NW_015090842.1:10100902",0,1,1
"DPEP1","s1693_S_RAP_03_ASEReadCounter.table","NW_015090842.1:10101072",0,1,1
"DPEP1","s1693_S_RAP_03_ASEReadCounter.table","NW_015090842.1:10101483",1,2,1
"DPEP1","s1693_S_RAP_03_ASEReadCounter.table","NW_015090842.1:10101497",0,1,1
"DPEP1","s1693_S_RAP_03_ASEReadCounter.table","NW_015090842.1:10101525",0,1,1
"DPEP1","s1693_S_RAP_03_ASEReadCounter.table","NW_015090842.1:10101875",1,3,2
"DPEP1","s1693_S_RAP_03_ASEReadCounter.table","NW_015090842.1:10101913",1,1,0
"CHMP1A","s1693_S_RAP_03_ASEReadCounter.table","NW_015090842.1:10102901",89,218,129
"CHMP1A","s1693_S_RAP_03_ASEReadCounter.table","NW_015090842.1:10102961",68,225,157
"CHMP1A","s1693_S_RAP_03_ASEReadCounter.table","NW_015090842.1:10102996",66,227,161
"CHMP1A","s1693_S_RAP_03_ASEReadCounter.table","NW_015090842.1:10103004",76,231,155
"CHMP1A","s1693_S_RAP_03_ASEReadCounter.table","NW_015090842.1:10103006",75,234,159
"CHMP1A","s1693_S_RAP_03_ASEReadCounter.table","NW_015090842.1:10103052",127,303,176
"CHMP1A","s1693_S_RAP_03_ASEReadCounter.table","NW_015090842.1:10103095",131,299,168
"CHMP1A","s1693_S_RAP_03_ASEReadCounter.table","NW_015090842.1:10103096",128,291,163
"CHMP1A","s1693_S_RAP_03_ASEReadCounter.table","NW_015090842.1:10103152",114,235,121
"CHMP1A","s1693_S_RAP_03_ASEReadCounter.table","NW_015090842.1:10103334",73,179,106
"CHMP1A","s1693_S_RAP_03_ASEReadCounter.table","NW_015090842.1:10103373",45,156,111
"CHMP1A","s1693_S_RAP_03_ASEReadCounter.table","NW_015090842.1:10103408",99,210,111
"CHMP1A","s1693_S_RAP_03_ASEReadCounter.table","NW_015090842.1:10103412",106,208,102
"CHMP1A","s1693_S_RAP_03_ASEReadCounter.table","NW_015090842.1:10103512",133,256,123
"CHMP1A","s1693_S_RAP_03_ASEReadCounter.table","NW_015090842.1:10103513",133,256,123
"CHMP1A","s1693_S_RAP_03_ASEReadCounter.table","NW_015090842.1:10103583",93,172,79
"CHMP1A","s1693_S_RAP_03_ASEReadCounter.table","NW_015090842.1:10103614",92,186,94
"CHMP1A","s1693_S_RAP_03_ASEReadCounter.table","NW_015090842.1:10103657",105,203,98
"CHMP1A","s1693_S_RAP_03_ASEReadCounter.table","NW_015090842.1:10103669",92,190,98
"CHMP1A","s1693_S_RAP_03_ASEReadCounter.table","NW_015090842.1:10103674",90,184,94
"CHMP1A","s1693_S_RAP_03_ASEReadCounter.table","NW_015090842.1:10103677",87,179,92
"CHMP1A","s1693_S_RAP_03_ASEReadCounter.table","NW_015090842.1:10103729",113,211,98
"CHMP1A","s1693_S_RAP_03_ASEReadCounter.table","NW_015090842.1:10103758",100,195,95
"CHMP1A","s1693_S_RAP_03_ASEReadCounter.table","NW_015090842.1:10103761",100,200,100
"CHMP1A","s1693_S_RAP_03_ASEReadCounter.table","NW_015090842.1:10103788",131,260,129
"CHMP1A","s1693_S_RAP_03_ASEReadCounter.table","NW_015090842.1:10103789",136,261,125
"CHMP1A","s1693_S_RAP_03_ASEReadCounter.table","NW_015090842.1:10103790",134,262,128
"CHMP1A","s1693_S_RAP_03_ASEReadCounter.table","NW_015090842.1:10103950",112,218,106
"CHMP1A","s1693_S_RAP_03_ASEReadCounter.table","NW_015090842.1:10104335",85,161,76
"CHMP1A","s1693_S_RAP_03_ASEReadCounter.table","NW_015090842.1:10104429",87,183,96
"CHMP1A","s1693_S_RAP_03_ASEReadCounter.table","NW_015090842.1:10104532",96,204,108
"CHMP1A","s1693_S_RAP_03_ASEReadCounter.table","NW_015090842.1:10104633",61,149,88
"CHMP1A","s1693_S_RAP_03_ASEReadCounter.table","NW_015090842.1:10104759",59,141,82
"CHMP1A","s1693_S_RAP_03_ASEReadCounter.table","NW_015090842.1:10104794",82,176,94
"CHMP1A","s1693_S_RAP_03_ASEReadCounter.table","NW_015090842.1:10104844",50,124,74
"CHMP1A","s1693_S_RAP_03_ASEReadCounter.table","NW_015090842.1:10106290",55,130,75
"CHMP1A","s1693_S_RAP_03_ASEReadCounter.table","NW_015090842.1:10106335",77,154,77
"CHMP1A","s1693_S_RAP_03_ASEReadCounter.table","NW_015090842.1:10106383",92,170,78
"CHMP1A","s1693_S_RAP_03_ASEReadCounter.table","NW_015090842.1:10106747",64,145,81
"CHMP1A","s1693_S_RAP_03_ASEReadCounter.table","NW_015090842.1:10107404",58,136,78
"CHMP1A","s1693_S_RAP_03_ASEReadCounter.table","NW_015090842.1:10107410",62,141,79
"CHMP1A","s1693_S_RAP_03_ASEReadCounter.table","NW_015090842.1:10107876",84,153,69
"CDK10","s1693_S_RAP_03_ASEReadCounter.table","NW_015090842.1:10109030",8,8,0
"CDK10","s1693_S_RAP_03_ASEReadCounter.table","NW_015090842.1:10109963",52,162,110
"CDK10","s1693_S_RAP_03_ASEReadCounter.table","NW_015090842.1:10110887",34,126,92
"CDK10","s1693_S_RAP_03_ASEReadCounter.table","NW_015090842.1:10111254",36,125,89
"CDK10","s1693_S_RAP_03_ASEReadCounter.table","NW_015090842.1:10111380",38,148,110
"CDK10","s1693_S_RAP_03_ASEReadCounter.table","NW_015090842.1:10111395",40,143,103
"CDK10","s1693_S_RAP_03_ASEReadCounter.table","NW_015090842.1:10111437",21,113,92
"CDK10","s1693_S_RAP_03_ASEReadCounter.table","NW_015090842.1:10111798",51,149,98
"CDK10","s1693_S_RAP_03_ASEReadCounter.table","NW_015090842.1:10111840",53,156,103
"CDK10","s1693_S_RAP_03_ASEReadCounter.table","NW_015090842.1:10112031",57,191,134
"CDK10","s1693_S_RAP_03_ASEReadCounter.table","NW_015090842.1:10112285",55,180,125
"CDK10","s1693_S_RAP_03_ASEReadCounter.table","NW_015090842.1:10112398",67,185,118
"CDK10","s1693_S_RAP_03_ASEReadCounter.table","NW_015090842.1:10112455",56,175,119
"CDK10","s1693_S_RAP_03_ASEReadCounter.table","NW_015090842.1:10112461",47,156,109
"CDK10","s1693_S_RAP_03_ASEReadCounter.table","NW_015090842.1:10112497",35,122,87
"CDK10","s1693_S_RAP_03_ASEReadCounter.table","NW_015090842.1:10112508",29,117,88
"CDK10","s1693_S_RAP_03_ASEReadCounter.table","NW_015090842.1:10112518",24,104,80
"CDK10","s1693_S_RAP_03_ASEReadCounter.table","NW_015090842.1:10112540",13,100,87
"CDK10","s1693_S_RAP_03_ASEReadCounter.table","NW_015090842.1:10112556",34,121,87
"CDK10","s1693_S_RAP_03_ASEReadCounter.table","NW_015090842.1:10112561",37,143,106
"CDK10","s1693_S_RAP_03_ASEReadCounter.table","NW_015090842.1:10112596",43,158,115
"CDK10","s1693_S_RAP_03_ASEReadCounter.table","NW_015090842.1:10112630",40,148,108
"CDK10","s1693_S_RAP_03_ASEReadCounter.table","NW_015090842.1:10112656",45,155,110
"CDK10","s1693_S_RAP_03_ASEReadCounter.table","NW_015090842.1:10112665",37,120,83
"CDK10","s1693_S_RAP_03_ASEReadCounter.table","NW_015090842.1:10112668",37,121,84
"CDK10","s1693_S_RAP_03_ASEReadCounter.table","NW_015090842.1:10112781",21,67,46
"CDK10","s1693_S_RAP_03_ASEReadCounter.table","NW_015090842.1:10112782",21,67,46
"CDK10","s1693_S_RAP_03_ASEReadCounter.table","NW_015090842.1:10112795",20,62,42
"CDK10","s1693_S_RAP_03_ASEReadCounter.table","NW_015090842.1:10112841",8,20,12
"CDK10","s1693_S_RAP_03_ASEReadCounter.table","NW_015090842.1:10112861",6,16,10
"SPATA2L","s1693_S_RAP_03_ASEReadCounter.table","NW_015090842.1:10113212",26,80,54
"SPATA2L","s1693_S_RAP_03_ASEReadCounter.table","NW_015090842.1:10113280",42,140,98
"SPATA2L","s1693_S_RAP_03_ASEReadCounter.table","NW_015090842.1:10113296",45,151,106
"SPATA2L","s1693_S_RAP_03_ASEReadCounter.table","NW_015090842.1:10113321",58,172,114
"SPATA2L","s1693_S_RAP_03_ASEReadCounter.table","NW_015090842.1:10113332",61,194,133
"SPATA2L","s1693_S_RAP_03_ASEReadCounter.table","NW_015090842.1:10113380",64,186,122
"SPATA2L","s1693_S_RAP_03_ASEReadCounter.table","NW_015090842.1:10113381",64,192,128
"SPATA2L","s1693_S_RAP_03_ASEReadCounter.table","NW_015090842.1:10113412",55,194,139
"SPATA2L","s1693_S_RAP_03_ASEReadCounter.table","NW_015090842.1:10113421",54,192,138
"SPATA2L","s1693_S_RAP_03_ASEReadCounter.table","NW_015090842.1:10113465",46,183,137
"SPATA2L","s1693_S_RAP_03_ASEReadCounter.table","NW_015090842.1:10113535",68,166,98
"SPATA2L","s1693_S_RAP_03_ASEReadCounter.table","NW_015090842.1:10113645",69,209,140
"SPATA2L","s1693_S_RAP_03_ASEReadCounter.table","NW_015090842.1:10113682",91,264,173
"SPATA2L","s1693_S_RAP_03_ASEReadCounter.table","NW_015090842.1:10113696",72,224,152
"SPATA2L","s1693_S_RAP_03_ASEReadCounter.table","NW_015090842.1:10113727",108,262,154
"SPATA2L","s1693_S_RAP_03_ASEReadCounter.table","NW_015090842.1:10113729",110,260,150
"SPATA2L","s1693_S_RAP_03_ASEReadCounter.table","NW_015090842.1:10113799",114,247,133
"SPATA2L","s1693_S_RAP_03_ASEReadCounter.table","NW_015090842.1:10113809",117,263,146
"SPATA2L","s1693_S_RAP_03_ASEReadCounter.table","NW_015090842.1:10113827",105,236,131
"SPATA2L","s1693_S_RAP_03_ASEReadCounter.table","NW_015090842.1:10113831",108,249,141
"SPATA2L","s1693_S_RAP_03_ASEReadCounter.table","NW_015090842.1:10113894",97,229,132
"SPATA2L","s1693_S_RAP_03_ASEReadCounter.table","NW_015090842.1:10113905",82,212,130
"SPATA2L","s1693_S_RAP_03_ASEReadCounter.table","NW_015090842.1:10113914",81,204,123
"SPATA2L","s1693_S_RAP_03_ASEReadCounter.table","NW_015090842.1:10113920",92,226,134
"SPATA2L","s1693_S_RAP_03_ASEReadCounter.table","NW_015090842.1:10113937",100,232,132
"SPATA2L","s1693_S_RAP_03_ASEReadCounter.table","NW_015090842.1:10113971",66,187,121
"SPATA2L","s1693_S_RAP_03_ASEReadCounter.table","NW_015090842.1:10113976",61,192,131
"SPATA2L","s1693_S_RAP_03_ASEReadCounter.table","NW_015090842.1:10113985",68,173,105
"SPATA2L","s1693_S_RAP_03_ASEReadCounter.table","NW_015090842.1:10113994",76,186,110
"SPATA2L","s1693_S_RAP_03_ASEReadCounter.table","NW_015090842.1:10114063",66,164,98
"SPATA2L","s1693_S_RAP_03_ASEReadCounter.table","NW_015090842.1:10114066",63,164,101
"SPATA2L","s1693_S_RAP_03_ASEReadCounter.table","NW_015090842.1:10114069",61,162,101
"SPATA2L","s1693_S_RAP_03_ASEReadCounter.table","NW_015090842.1:10114159",42,125,83
"SPATA2L","s1693_S_RAP_03_ASEReadCounter.table","NW_015090842.1:10114262",171,172,1
"SPATA2L","s1693_S_RAP_03_ASEReadCounter.table","NW_015090842.1:10114470",50,120,70
"SPATA2L","s1693_S_RAP_03_ASEReadCounter.table","NW_015090842.1:10114524",29,86,57
"VPS9D1","s1693_S_RAP_03_ASEReadCounter.table","NW_015090842.1:10116377",45,120,75
"VPS9D1","s1693_S_RAP_03_ASEReadCounter.table","NW_015090842.1:10116415",52,135,83
"VPS9D1","s1693_S_RAP_03_ASEReadCounter.table","NW_015090842.1:10116607",47,119,72
"VPS9D1","s1693_S_RAP_03_ASEReadCounter.table","NW_015090842.1:10116821",33,91,58
"VPS9D1","s1693_S_RAP_03_ASEReadCounter.table","NW_015090842.1:10116825",37,91,54
"VPS9D1","s1693_S_RAP_03_ASEReadCounter.table","NW_015090842.1:10116882",36,95,59
"VPS9D1","s1693_S_RAP_03_ASEReadCounter.table","NW_015090842.1:10116933",37,110,73
"VPS9D1","s1693_S_RAP_03_ASEReadCounter.table","NW_015090842.1:10116942",40,114,74
"VPS9D1","s1693_S_RAP_03_ASEReadCounter.table","NW_015090842.1:10117152",36,96,60
"VPS9D1","s1693_S_RAP_03_ASEReadCounter.table","NW_015090842.1:10117480",25,70,45
"VPS9D1","s1693_S_RAP_03_ASEReadCounter.table","NW_015090842.1:10117497",27,74,47
"VPS9D1","s1693_S_RAP_03_ASEReadCounter.table","NW_015090842.1:10117499",25,75,50
"VPS9D1","s1693_S_RAP_03_ASEReadCounter.table","NW_015090842.1:10117516",32,85,53
"VPS9D1","s1693_S_RAP_03_ASEReadCounter.table","NW_015090842.1:10117525",31,82,51
"VPS9D1","s1693_S_RAP_03_ASEReadCounter.table","NW_015090842.1:10117579",22,86,64
"VPS9D1","s1693_S_RAP_03_ASEReadCounter.table","NW_015090842.1:10117627",32,99,67
"VPS9D1","s1693_S_RAP_03_ASEReadCounter.table","NW_015090842.1:10117678",21,93,72
"VPS9D1","s1693_S_RAP_03_ASEReadCounter.table","NW_015090842.1:10117773",37,125,88
"VPS9D1","s1693_S_RAP_03_ASEReadCounter.table","NW_015090842.1:10117937",47,132,85
"VPS9D1","s1693_S_RAP_03_ASEReadCounter.table","NW_015090842.1:10117961",42,121,79
"VPS9D1","s1693_S_RAP_03_ASEReadCounter.table","NW_015090842.1:10118236",31,133,102
"VPS9D1","s1693_S_RAP_03_ASEReadCounter.table","NW_015090842.1:10118414",30,115,85
"VPS9D1","s1693_S_RAP_03_ASEReadCounter.table","NW_015090842.1:10118973",42,125,83
"VPS9D1","s1693_S_RAP_03_ASEReadCounter.table","NW_015090842.1:10119500",17,85,68
"ZNF276","s1693_S_RAP_03_ASEReadCounter.table","NW_015090842.1:10121760",3,9,6
"ZNF276","s1693_S_RAP_03_ASEReadCounter.table","NW_015090842.1:10121769",4,11,7
"ZNF276","s1693_S_RAP_03_ASEReadCounter.table","NW_015090842.1:10121802",9,16,7
"ZNF276","s1693_S_RAP_03_ASEReadCounter.table","NW_015090842.1:10121971",6,17,11
"ZNF276","s1693_S_RAP_03_ASEReadCounter.table","NW_015090842.1:10122161",18,18,0
"ZNF276","s1693_S_RAP_03_ASEReadCounter.table","NW_015090842.1:10122164",18,18,0
"ZNF276","s1693_S_RAP_03_ASEReadCounter.table","NW_015090842.1:10122184",18,18,0
"ZNF276","s1693_S_RAP_03_ASEReadCounter.table","NW_015090842.1:10122883",11,20,9
"ZNF276","s1693_S_RAP_03_ASEReadCounter.table","NW_015090842.1:10122997",22,38,16
"ZNF276","s1693_S_RAP_03_ASEReadCounter.table","NW_015090842.1:10123069",15,22,7
"ZNF276","s1693_S_RAP_03_ASEReadCounter.table","NW_015090842.1:10123207",20,51,31
"ZNF276","s1693_S_RAP_03_ASEReadCounter.table","NW_015090842.1:10125787",16,60,44
"ZNF276","s1693_S_RAP_03_ASEReadCounter.table","NW_015090842.1:10126309",36,70,34
"ZNF276","s1693_S_RAP_03_ASEReadCounter.table","NW_015090842.1:10126348",34,72,38
"ZNF276","s1693_S_RAP_03_ASEReadCounter.table","NW_015090842.1:10126978",29,76,47
"ZNF276","s1693_S_RAP_03_ASEReadCounter.table","NW_015090842.1:10126991",25,70,45
"ZNF276","s1693_S_RAP_03_ASEReadCounter.table","NW_015090842.1:10127023",30,84,54
"ZNF276","s1693_S_RAP_03_ASEReadCounter.table","NW_015090842.1:10127063",32,84,52
"ZNF276","s1693_S_RAP_03_ASEReadCounter.table","NW_015090842.1:10127373",29,78,49
"ZNF276","s1693_S_RAP_03_ASEReadCounter.table","NW_015090842.1:10127931",30,81,51
"ZNF276","s1693_S_RAP_03_ASEReadCounter.table","NW_015090842.1:10128070",35,80,45
"ZNF276","s1693_S_RAP_03_ASEReadCounter.table","NW_015090842.1:10128102",32,82,50
"ZNF276","s1693_S_RAP_03_ASEReadCounter.table","NW_015090842.1:10128356",30,79,49
"ZNF276","s1693_S_RAP_03_ASEReadCounter.table","NW_015090842.1:10128497",25,56,31
"FANCA","s1693_S_RAP_03_ASEReadCounter.table","NW_015090842.1:10128743",2,6,4
"FANCA","s1693_S_RAP_03_ASEReadCounter.table","NW_015090842.1:10128822",3,5,2
"FANCA","s1693_S_RAP_03_ASEReadCounter.table","NW_015090842.1:10129383",2,3,1
"FANCA","s1693_S_RAP_03_ASEReadCounter.table","NW_015090842.1:10129390",1,2,1
"FANCA","s1693_S_RAP_03_ASEReadCounter.table","NW_015090842.1:10129422",0,3,3
"FANCA","s1693_S_RAP_03_ASEReadCounter.table","NW_015090842.1:10129969",0,1,1
"FANCA","s1693_S_RAP_03_ASEReadCounter.table","NW_015090842.1:10130399",2,3,1
"FANCA","s1693_S_RAP_03_ASEReadCounter.table","NW_015090842.1:10130857",1,2,1
"FANCA","s1693_S_RAP_03_ASEReadCounter.table","NW_015090842.1:10130878",0,1,1
"FANCA","s1693_S_RAP_03_ASEReadCounter.table","NW_015090842.1:10133530",1,3,2
"FANCA","s1693_S_RAP_03_ASEReadCounter.table","NW_015090842.1:10133533",1,3,2
"FANCA","s1693_S_RAP_03_ASEReadCounter.table","NW_015090842.1:10133536",1,3,2
"FANCA","s1693_S_RAP_03_ASEReadCounter.table","NW_015090842.1:10133601",1,1,0
"FANCA","s1693_S_RAP_03_ASEReadCounter.table","NW_015090842.1:10134492",1,1,0
"FANCA","s1693_S_RAP_03_ASEReadCounter.table","NW_015090842.1:10137673",0,3,3
"FANCA","s1693_S_RAP_03_ASEReadCounter.table","NW_015090842.1:10138618",0,3,3
"FANCA","s1693_S_RAP_03_ASEReadCounter.table","NW_015090842.1:10139140",0,1,1
"FANCA","s1693_S_RAP_03_ASEReadCounter.table","NW_015090842.1:10141234",0,1,1
"FANCA","s1693_S_RAP_03_ASEReadCounter.table","NW_015090842.1:10145030",0,1,1
"FANCA","s1693_S_RAP_03_ASEReadCounter.table","NW_015090842.1:10152863",0,1,1
"FANCA","s1693_S_RAP_03_ASEReadCounter.table","NW_015090842.1:10154490",0,1,1
"FANCA","s1693_S_RAP_03_ASEReadCounter.table","NW_015090842.1:10163667",0,1,1
"SPIRE2","s1693_S_RAP_03_ASEReadCounter.table","NW_015090842.1:10172284",27,47,20
"SPIRE2","s1693_S_RAP_03_ASEReadCounter.table","NW_015090842.1:10175262",55,103,48
"SPIRE2","s1693_S_RAP_03_ASEReadCounter.table","NW_015090842.1:10175352",23,48,25
"SPIRE2","s1693_S_RAP_03_ASEReadCounter.table","NW_015090842.1:10175400",74,155,81
"SPIRE2","s1693_S_RAP_03_ASEReadCounter.table","NW_015090842.1:10175418",83,172,89
"SPIRE2","s1693_S_RAP_03_ASEReadCounter.table","NW_015090842.1:10175704",101,214,113
"SPIRE2","s1693_S_RAP_03_ASEReadCounter.table","NW_015090842.1:10176115",121,261,140
"SPIRE2","s1693_S_RAP_03_ASEReadCounter.table","NW_015090842.1:10176561",147,314,167
"SPIRE2","s1693_S_RAP_03_ASEReadCounter.table","NW_015090842.1:10176817",146,306,160
"SPIRE2","s1693_S_RAP_03_ASEReadCounter.table","NW_015090842.1:10177084",87,182,95
"SPIRE2","s1693_S_RAP_03_ASEReadCounter.table","NW_015090842.1:10177838",137,292,155
"SPIRE2","s1693_S_RAP_03_ASEReadCounter.table","NW_015090842.1:10178000",147,289,142
"SPIRE2","s1693_S_RAP_03_ASEReadCounter.table","NW_015090842.1:10178164",146,304,158
"SPIRE2","s1693_S_RAP_03_ASEReadCounter.table","NW_015090842.1:10178216",174,357,183
"SPIRE2","s1693_S_RAP_03_ASEReadCounter.table","NW_015090842.1:10178303",157,289,132
"SPIRE2","s1693_S_RAP_03_ASEReadCounter.table","NW_015090842.1:10178403",138,302,164
"SPIRE2","s1693_S_RAP_03_ASEReadCounter.table","NW_015090842.1:10178409",136,287,151
"SPIRE2","s1693_S_RAP_03_ASEReadCounter.table","NW_015090842.1:10178524",146,304,158
"SPIRE2","s1693_S_RAP_03_ASEReadCounter.table","NW_015090842.1:10178526",144,301,157
"SPIRE2","s1693_S_RAP_03_ASEReadCounter.table","NW_015090842.1:10178531",151,303,152
"SPIRE2","s1693_S_RAP_03_ASEReadCounter.table","NW_015090842.1:10178565",124,268,144
"SPIRE2","s1693_S_RAP_03_ASEReadCounter.table","NW_015090842.1:10178587",114,243,129
"SPIRE2","s1693_S_RAP_03_ASEReadCounter.table","NW_015090842.1:10178640",79,193,114
"SPIRE2","s1693_S_RAP_03_ASEReadCounter.table","NW_015090842.1:10178651",85,206,121
"SPIRE2","s1693_S_RAP_03_ASEReadCounter.table","NW_015090842.1:10178682",83,181,98
"TCF25","s1693_S_RAP_03_ASEReadCounter.table","NW_015090842.1:10180912",54,106,52
"TCF25","s1693_S_RAP_03_ASEReadCounter.table","NW_015090842.1:10180924",58,110,52
"TCF25","s1693_S_RAP_03_ASEReadCounter.table","NW_015090842.1:10180931",64,119,55
"TCF25","s1693_S_RAP_03_ASEReadCounter.table","NW_015090842.1:10185332",172,312,140
"TCF25","s1693_S_RAP_03_ASEReadCounter.table","NW_015090842.1:10196561",101,216,115
"TCF25","s1693_S_RAP_03_ASEReadCounter.table","NW_015090842.1:10197399",302,302,0
"MC1R","s1693_S_RAP_03_ASEReadCounter.table","NW_015090842.1:10201853",2,3,1
"MC1R","s1693_S_RAP_03_ASEReadCounter.table","NW_015090842.1:10201986",1,4,3
"MC1R","s1693_S_RAP_03_ASEReadCounter.table","NW_015090842.1:10202160",1,4,3
"MC1R","s1693_S_RAP_03_ASEReadCounter.table","NW_015090842.1:10202447",1,4,3
"TUBB3","s1693_S_RAP_03_ASEReadCounter.table","NW_015090842.1:10205322",0,571,571
"GAS8","s1693_S_RAP_03_ASEReadCounter.table","NW_015090842.1:10228982",18,41,23
"GAS8","s1693_S_RAP_03_ASEReadCounter.table","NW_015090842.1:10229832",17,44,27
"GAS8","s1693_S_RAP_03_ASEReadCounter.table","NW_015090842.1:10232901",55,90,35
"GAS8","s1693_S_RAP_03_ASEReadCounter.table","NW_015090842.1:10232928",59,97,38
"GAS8","s1693_S_RAP_03_ASEReadCounter.table","NW_015090842.1:10232967",55,103,48
"GAS8","s1693_S_RAP_03_ASEReadCounter.table","NW_015090842.1:10233032",34,69,35
"GAS8","s1693_S_RAP_03_ASEReadCounter.table","NW_015090842.1:10233057",28,56,28
"GAS8","s1693_S_RAP_03_ASEReadCounter.table","NW_015090842.1:10233058",28,57,29
"GAS8","s1693_S_RAP_03_ASEReadCounter.table","NW_015090842.1:10233176",24,49,25
"GAS8","s1693_S_RAP_03_ASEReadCounter.table","NW_015090842.1:10233196",18,43,25
"GAS8","s1693_S_RAP_03_ASEReadCounter.table","NW_015090842.1:10233252",16,38,22
"GAS8","s1693_S_RAP_03_ASEReadCounter.table","NW_015090842.1:10233303",6,16,10
"LOC106888094","s1693_S_RAP_03_ASEReadCounter.table","NW_015090842.1:10233334",5,14,9
"LOC106888094","s1693_S_RAP_03_ASEReadCounter.table","NW_015090842.1:10233362",7,33,26
"LOC106888094","s1693_S_RAP_03_ASEReadCounter.table","NW_015090842.1:10233373",8,37,29
"LOC106888094","s1693_S_RAP_03_ASEReadCounter.table","NW_015090842.1:10233388",12,43,31
"LOC106888094","s1693_S_RAP_03_ASEReadCounter.table","NW_015090842.1:10233402",11,45,34
"LOC106888094","s1693_S_RAP_03_ASEReadCounter.table","NW_015090842.1:10233465",18,57,39
"LOC106888094","s1693_S_RAP_03_ASEReadCounter.table","NW_015090842.1:10233803",23,65,42
"LOC106888094","s1693_S_RAP_03_ASEReadCounter.table","NW_015090842.1:10233815",21,62,41
"LOC106888094","s1693_S_RAP_03_ASEReadCounter.table","NW_015090842.1:10235484",6,11,5
"LOC106888094","s1693_S_RAP_03_ASEReadCounter.table","NW_015090842.1:10235611",4,9,5
"LOC106888094","s1693_S_RAP_03_ASEReadCounter.table","NW_015090842.1:10235977",4,4,0
"LOC106888094","s1693_S_RAP_03_ASEReadCounter.table","NW_015090842.1:10236098",4,5,1
"LOC106888094","s1693_S_RAP_03_ASEReadCounter.table","NW_015090842.1:10236161",1,3,2
"LOC106888094","s1693_S_RAP_03_ASEReadCounter.table","NW_015090842.1:10236380",1,3,2
"LOC106888094","s1693_S_RAP_03_ASEReadCounter.table","NW_015090842.1:10236388",3,5,2
"LOC106888094","s1693_S_RAP_03_ASEReadCounter.table","NW_015090842.1:10236425",2,5,3
"LOC106888094","s1693_S_RAP_03_ASEReadCounter.table","NW_015090842.1:10236426",2,5,3
"LOC106888094","s1693_S_RAP_03_ASEReadCounter.table","NW_015090842.1:10236603",3,6,3
"LOC106888173","s1693_S_RAP_03_ASEReadCounter.table","NW_015090842.1:10239596",2,13,11
"LOC106888173","s1693_S_RAP_03_ASEReadCounter.table","NW_015090842.1:10240036",11,33,22
"LOC106888173","s1693_S_RAP_03_ASEReadCounter.table","NW_015090842.1:10240095",14,42,28
"LOC106888173","s1693_S_RAP_03_ASEReadCounter.table","NW_015090842.1:10240280",8,37,29
"LOC106888173","s1693_S_RAP_03_ASEReadCounter.table","NW_015090842.1:10240557",20,60,40
"LOC106888173","s1693_S_RAP_03_ASEReadCounter.table","NW_015090842.1:10240603",20,67,47
"LOC106888173","s1693_S_RAP_03_ASEReadCounter.table","NW_015090842.1:10240609",20,66,46
"LOC106888173","s1693_S_RAP_03_ASEReadCounter.table","NW_015090842.1:10240924",10,53,43
"LOC106888173","s1693_S_RAP_03_ASEReadCounter.table","NW_015090842.1:10241037",10,54,44
"LOC106888173","s1693_S_RAP_03_ASEReadCounter.table","NW_015090842.1:10241046",12,54,42
"LOC106888173","s1693_S_RAP_03_ASEReadCounter.table","NW_015090842.1:10241058",13,53,40
"LOC106888173","s1693_S_RAP_03_ASEReadCounter.table","NW_015090842.1:10241064",18,58,40
"LOC106888173","s1693_S_RAP_03_ASEReadCounter.table","NW_015090842.1:10241163",19,58,39
"LOC106888173","s1693_S_RAP_03_ASEReadCounter.table","NW_015090842.1:10241803",20,67,47
"LOC106888173","s1693_S_RAP_03_ASEReadCounter.table","NW_015090842.1:10241827",15,60,45
"LOC106888173","s1693_S_RAP_03_ASEReadCounter.table","NW_015090842.1:10241869",21,72,51
"LOC106888173","s1693_S_RAP_03_ASEReadCounter.table","NW_015090842.1:10242079",22,66,44
"LOC106888173","s1693_S_RAP_03_ASEReadCounter.table","NW_015090842.1:10242103",21,60,39
"LOC106888173","s1693_S_RAP_03_ASEReadCounter.table","NW_015090842.1:10242157",24,65,41
"LOC106888173","s1693_S_RAP_03_ASEReadCounter.table","NW_015090842.1:10242455",18,69,51
"LOC106888173","s1693_S_RAP_03_ASEReadCounter.table","NW_015090842.1:10242481",19,72,53
"LOC106888173","s1693_S_RAP_03_ASEReadCounter.table","NW_015090842.1:10242590",9,55,46
"LOC106888173","s1693_S_RAP_03_ASEReadCounter.table","NW_015090842.1:10242794",19,59,40
"LOC106888173","s1693_S_RAP_03_ASEReadCounter.table","NW_015090842.1:10242909",23,60,37
"LOC106888173","s1693_S_RAP_03_ASEReadCounter.table","NW_015090842.1:10243094",28,69,41
"LOC106888173","s1693_S_RAP_03_ASEReadCounter.table","NW_015090842.1:10243133",18,49,31
"LOC106888173","s1693_S_RAP_03_ASEReadCounter.table","NW_015090842.1:10243273",27,68,41
"LOC106888173","s1693_S_RAP_03_ASEReadCounter.table","NW_015090842.1:10243278",28,69,41
"LOC106888173","s1693_S_RAP_03_ASEReadCounter.table","NW_015090842.1:10243281",27,67,40
"LOC106888173","s1693_S_RAP_03_ASEReadCounter.table","NW_015090842.1:10243347",37,37,0
"LOC106888173","s1693_S_RAP_03_ASEReadCounter.table","NW_015090842.1:10243353",16,29,13
"LOC106888173","s1693_S_RAP_03_ASEReadCounter.table","NW_015090842.1:10243363",17,30,13
"LOC106888173","s1693_S_RAP_03_ASEReadCounter.table","NW_015090842.1:10243365",15,28,13
"LOC106888173","s1693_S_RAP_03_ASEReadCounter.table","NW_015090842.1:10243529",20,40,20
"LOC106888173","s1693_S_RAP_03_ASEReadCounter.table","NW_015090842.1:10243566",29,59,30
"LOC106888173","s1693_S_RAP_03_ASEReadCounter.table","NW_015090842.1:10243605",29,63,34
"LOC106888173","s1693_S_RAP_03_ASEReadCounter.table","NW_015090842.1:10243614",28,62,34
"LOC106888173","s1693_S_RAP_03_ASEReadCounter.table","NW_015090842.1:10243615",27,61,34
"LOC106888173","s1693_S_RAP_03_ASEReadCounter.table","NW_015090842.1:10243640",23,57,34
"LOC106888173","s1693_S_RAP_03_ASEReadCounter.table","NW_015090842.1:10243680",25,56,31
"LOC106888173","s1693_S_RAP_03_ASEReadCounter.table","NW_015090842.1:10243742",31,62,31
"LOC106888173","s1693_S_RAP_03_ASEReadCounter.table","NW_015090842.1:10243804",21,39,18
"LOC106888173","s1693_S_RAP_03_ASEReadCounter.table","NW_015090842.1:10243913",9,21,12
"LOC106888173","s1693_S_RAP_03_ASEReadCounter.table","NW_015090842.1:10243921",9,18,9
"LOC106888384","s1693_S_RAP_03_ASEReadCounter.table","NW_015090842.1:10244998",1,1,0
"LOC106888384","s1693_S_RAP_03_ASEReadCounter.table","NW_015090842.1:10251354",0,6,6
"LOC106888384","s1693_S_RAP_03_ASEReadCounter.table","NW_015090842.1:10251358",0,6,6
"LOC106888384","s1693_S_RAP_03_ASEReadCounter.table","NW_015090842.1:10251369",0,6,6
"LOC106888384","s1693_S_RAP_03_ASEReadCounter.table","NW_015090842.1:10251370",0,6,6
"LOC106888384","s1693_S_RAP_03_ASEReadCounter.table","NW_015090842.1:10251375",0,6,6
"LOC106888384","s1693_S_RAP_03_ASEReadCounter.table","NW_015090842.1:10251388",0,6,6
"LOC106888384","s1693_S_RAP_03_ASEReadCounter.table","NW_015090842.1:10251390",0,6,6
"LOC106888384","s1693_S_RAP_03_ASEReadCounter.table","NW_015090842.1:10251393",0,6,6
"LOC106888384","s1693_S_RAP_03_ASEReadCounter.table","NW_015090842.1:10251399",0,6,6
"LOC106888384","s1693_S_RAP_03_ASEReadCounter.table","NW_015090842.1:10251492",1,1,0
"LOC106888384","s1693_S_RAP_03_ASEReadCounter.table","NW_015090842.1:10253165",2,2,0
"LOC106888384","s1693_S_RAP_03_ASEReadCounter.table","NW_015090842.1:10253284",1,1,0
"LOC106888384","s1693_S_RAP_03_ASEReadCounter.table","NW_015090842.1:10253605",5,5,0
"LOC106888384","s1693_S_RAP_03_ASEReadCounter.table","NW_015090842.1:10254028",4,5,1
"LOC106888384","s1693_S_RAP_03_ASEReadCounter.table","NW_015090842.1:10254227",1,1,0
"LOC106888384","s1693_S_RAP_03_ASEReadCounter.table","NW_015090842.1:10254233",1,1,0
"LOC106888384","s1693_S_RAP_03_ASEReadCounter.table","NW_015090842.1:10254293",2,2,0
"LOC106888384","s1693_S_RAP_03_ASEReadCounter.table","NW_015090842.1:10254570",2,2,0
"LOC106888384","s1693_S_RAP_03_ASEReadCounter.table","NW_015090842.1:10254647",3,3,0
"LOC106888384","s1693_S_RAP_03_ASEReadCounter.table","NW_015090842.1:10254663",3,3,0
"LOC106888384","s1693_S_RAP_03_ASEReadCounter.table","NW_015090842.1:10254840",1,1,0
"LOC106888384","s1693_S_RAP_03_ASEReadCounter.table","NW_015090842.1:10254854",2,2,0
"LOC106888384","s1693_S_RAP_03_ASEReadCounter.table","NW_015090842.1:10254891",1,1,0
"LOC106888384","s1693_S_RAP_03_ASEReadCounter.table","NW_015090842.1:10254900",2,2,0
"LOC106888384","s1693_S_RAP_03_ASEReadCounter.table","NW_015090842.1:10254915",2,2,0
"LOC106888384","s1693_S_RAP_03_ASEReadCounter.table","NW_015090842.1:10254965",1,1,0
"LOC106888384","s1693_S_RAP_03_ASEReadCounter.table","NW_015090842.1:10254975",1,1,0
"LOC106888384","s1693_S_RAP_03_ASEReadCounter.table","NW_015090842.1:10255077",3,4,1
"LOC106888384","s1693_S_RAP_03_ASEReadCounter.table","NW_015090842.1:10255117",3,3,0
"LOC106888384","s1693_S_RAP_03_ASEReadCounter.table","NW_015090842.1:10255138",1,1,0
"LOC106888384","s1693_S_RAP_03_ASEReadCounter.table","NW_015090842.1:10255139",1,1,0
"LOC106888384","s1693_S_RAP_03_ASEReadCounter.table","NW_015090842.1:10255209",2,2,0
"LOC106888384","s1693_S_RAP_03_ASEReadCounter.table","NW_015090842.1:10255211",2,2,0
"LOC106888384","s1693_S_RAP_03_ASEReadCounter.table","NW_015090842.1:10255236",3,3,0
"LOC106888384","s1693_S_RAP_03_ASEReadCounter.table","NW_015090842.1:10255262",1,1,0
"LOC106888384","s1693_S_RAP_03_ASEReadCounter.table","NW_015090842.1:10255264",1,1,0
"LOC106888384","s1693_S_RAP_03_ASEReadCounter.table","NW_015090842.1:10255306",3,3,0
"LOC106888384","s1693_S_RAP_03_ASEReadCounter.table","NW_015090842.1:10255340",4,4,0
"LOC106888384","s1693_S_RAP_03_ASEReadCounter.table","NW_015090842.1:10255410",5,5,0
"LOC106888384","s1693_S_RAP_03_ASEReadCounter.table","NW_015090842.1:10255449",3,3,0
"LOC106888384","s1693_S_RAP_03_ASEReadCounter.table","NW_015090842.1:10255496",4,4,0
"LOC106888384","s1693_S_RAP_03_ASEReadCounter.table","NW_015090842.1:10255505",4,4,0
"LOC106888384","s1693_S_RAP_03_ASEReadCounter.table","NW_015090842.1:10255531",4,5,1
"LOC106888384","s1693_S_RAP_03_ASEReadCounter.table","NW_015090842.1:10255608",5,7,2
"LOC106888384","s1693_S_RAP_03_ASEReadCounter.table","NW_015090842.1:10255614",5,7,2
"LOC106888384","s1693_S_RAP_03_ASEReadCounter.table","NW_015090842.1:10255704",10,11,1
"LOC106888384","s1693_S_RAP_03_ASEReadCounter.table","NW_015090842.1:10255731",10,11,1
"LOC106888384","s1693_S_RAP_03_ASEReadCounter.table","NW_015090842.1:10255771",7,8,1
"TANGO6","s1693_S_RAP_03_ASEReadCounter.table","NW_015090842.1:10257782",18,26,8
"TANGO6","s1693_S_RAP_03_ASEReadCounter.table","NW_015090842.1:10258162",12,21,9
"TANGO6","s1693_S_RAP_03_ASEReadCounter.table","NW_015090842.1:10258185",17,26,9
"TANGO6","s1693_S_RAP_03_ASEReadCounter.table","NW_015090842.1:10259267",17,28,11
"TANGO6","s1693_S_RAP_03_ASEReadCounter.table","NW_015090842.1:10260250",29,54,25
"TANGO6","s1693_S_RAP_03_ASEReadCounter.table","NW_015090842.1:10260979",27,49,22
"TANGO6","s1693_S_RAP_03_ASEReadCounter.table","NW_015090842.1:10261599",32,56,24
"TANGO6","s1693_S_RAP_03_ASEReadCounter.table","NW_015090842.1:10268425",55,89,34
"TANGO6","s1693_S_RAP_03_ASEReadCounter.table","NW_015090842.1:10269831",45,78,33
"TANGO6","s1693_S_RAP_03_ASEReadCounter.table","NW_015090842.1:10270813",50,79,29
"TANGO6","s1693_S_RAP_03_ASEReadCounter.table","NW_015090842.1:10273952",30,55,25
"TANGO6","s1693_S_RAP_03_ASEReadCounter.table","NW_015090842.1:10273970",34,62,28
"TANGO6","s1693_S_RAP_03_ASEReadCounter.table","NW_015090842.1:10274018",29,56,27
"TANGO6","s1693_S_RAP_03_ASEReadCounter.table","NW_015090842.1:10275974",39,69,30
"TANGO6","s1693_S_RAP_03_ASEReadCounter.table","NW_015090842.1:10275976",40,69,29
"TANGO6","s1693_S_RAP_03_ASEReadCounter.table","NW_015090842.1:10276123",41,62,21
"TANGO6","s1693_S_RAP_03_ASEReadCounter.table","NW_015090842.1:10276271",50,90,40
"TANGO6","s1693_S_RAP_03_ASEReadCounter.table","NW_015090842.1:10276272",51,91,40
"TANGO6","s1693_S_RAP_03_ASEReadCounter.table","NW_015090842.1:10276275",51,90,39
"TANGO6","s1693_S_RAP_03_ASEReadCounter.table","NW_015090842.1:10276278",50,90,40
"TANGO6","s1693_S_RAP_03_ASEReadCounter.table","NW_015090842.1:10276368",41,62,21
"TANGO6","s1693_S_RAP_03_ASEReadCounter.table","NW_015090842.1:10276373",41,63,22
"TANGO6","s1693_S_RAP_03_ASEReadCounter.table","NW_015090842.1:10276630",36,61,25
"TANGO6","s1693_S_RAP_03_ASEReadCounter.table","NW_015090842.1:10281498",32,57,25
"TANGO6","s1693_S_RAP_03_ASEReadCounter.table","NW_015090842.1:10282842",41,80,39
"TANGO6","s1693_S_RAP_03_ASEReadCounter.table","NW_015090842.1:10282863",34,64,30
"TANGO6","s1693_S_RAP_03_ASEReadCounter.table","NW_015090842.1:10282869",33,67,34
"TANGO6","s1693_S_RAP_03_ASEReadCounter.table","NW_015090842.1:10282903",38,69,31
"TANGO6","s1693_S_RAP_03_ASEReadCounter.table","NW_015090842.1:10283757",56,91,35
"TANGO6","s1693_S_RAP_03_ASEReadCounter.table","NW_015090842.1:10283785",63,94,31
"HAS3","s1693_S_RAP_03_ASEReadCounter.table","NW_015090842.1:10288093",1,3,2
"HAS3","s1693_S_RAP_03_ASEReadCounter.table","NW_015090842.1:10288266",1,2,1
"HAS3","s1693_S_RAP_03_ASEReadCounter.table","NW_015090842.1:10288274",1,2,1
"HAS3","s1693_S_RAP_03_ASEReadCounter.table","NW_015090842.1:10288364",1,2,1
"HAS3","s1693_S_RAP_03_ASEReadCounter.table","NW_015090842.1:10288405",1,1,0
"HAS3","s1693_S_RAP_03_ASEReadCounter.table","NW_015090842.1:10289469",2,2,0
"HAS3","s1693_S_RAP_03_ASEReadCounter.table","NW_015090842.1:10289708",2,2,0
"HAS3","s1693_S_RAP_03_ASEReadCounter.table","NW_015090842.1:10290395",0,1,1
"HAS3","s1693_S_RAP_03_ASEReadCounter.table","NW_015090842.1:10290561",2,3,1
"HAS3","s1693_S_RAP_03_ASEReadCounter.table","NW_015090842.1:10290609",2,5,3
"HAS3","s1693_S_RAP_03_ASEReadCounter.table","NW_015090842.1:10290666",0,1,1
"HAS3","s1693_S_RAP_03_ASEReadCounter.table","NW_015090842.1:10290723",2,3,1
"HAS3","s1693_S_RAP_03_ASEReadCounter.table","NW_015090842.1:10290927",2,5,3
"HAS3","s1693_S_RAP_03_ASEReadCounter.table","NW_015090842.1:10291004",3,5,2
"CHTF8","s1693_S_RAP_03_ASEReadCounter.table","NW_015090842.1:10291319",3,7,4
"CHTF8","s1693_S_RAP_03_ASEReadCounter.table","NW_015090842.1:10291342",0,2,2
"CHTF8","s1693_S_RAP_03_ASEReadCounter.table","NW_015090842.1:10291491",15,18,3
"CHTF8","s1693_S_RAP_03_ASEReadCounter.table","NW_015090842.1:10291520",15,25,10
"CHTF8","s1693_S_RAP_03_ASEReadCounter.table","NW_015090842.1:10291593",16,30,14
"CHTF8","s1693_S_RAP_03_ASEReadCounter.table","NW_015090842.1:10291600",19,32,13
"CHTF8","s1693_S_RAP_03_ASEReadCounter.table","NW_015090842.1:10291609",17,27,10
"CHTF8","s1693_S_RAP_03_ASEReadCounter.table","NW_015090842.1:10291639",19,32,13
"CHTF8","s1693_S_RAP_03_ASEReadCounter.table","NW_015090842.1:10291641",19,32,13
"CHTF8","s1693_S_RAP_03_ASEReadCounter.table","NW_015090842.1:10291648",21,34,13
"CHTF8","s1693_S_RAP_03_ASEReadCounter.table","NW_015090842.1:10291656",20,34,14
"CHTF8","s1693_S_RAP_03_ASEReadCounter.table","NW_015090842.1:10291675",21,35,14
"CHTF8","s1693_S_RAP_03_ASEReadCounter.table","NW_015090842.1:10291696",21,35,14
"CHTF8","s1693_S_RAP_03_ASEReadCounter.table","NW_015090842.1:10291714",20,35,15
"CHTF8","s1693_S_RAP_03_ASEReadCounter.table","NW_015090842.1:10291732",21,32,11
"CHTF8","s1693_S_RAP_03_ASEReadCounter.table","NW_015090842.1:10291755",12,21,9
"CHTF8","s1693_S_RAP_03_ASEReadCounter.table","NW_015090842.1:10291756",12,20,8
"CHTF8","s1693_S_RAP_03_ASEReadCounter.table","NW_015090842.1:10291758",12,20,8
"CHTF8","s1693_S_RAP_03_ASEReadCounter.table","NW_015090842.1:10291792",14,23,9
"CHTF8","s1693_S_RAP_03_ASEReadCounter.table","NW_015090842.1:10291895",15,24,9
"CHTF8","s1693_S_RAP_03_ASEReadCounter.table","NW_015090842.1:10292132",13,18,5
"CHTF8","s1693_S_RAP_03_ASEReadCounter.table","NW_015090842.1:10292314",5,9,4
"CHTF8","s1693_S_RAP_03_ASEReadCounter.table","NW_015090842.1:10292317",6,10,4
"CHTF8","s1693_S_RAP_03_ASEReadCounter.table","NW_015090842.1:10292928",1,1,0
"UTP4","s1693_S_RAP_03_ASEReadCounter.table","NW_015090842.1:10293146",9,24,15
"UTP4","s1693_S_RAP_03_ASEReadCounter.table","NW_015090842.1:10293151",7,21,14
"UTP4","s1693_S_RAP_03_ASEReadCounter.table","NW_015090842.1:10293191",7,16,9
"UTP4","s1693_S_RAP_03_ASEReadCounter.table","NW_015090842.1:10293362",14,24,10
"UTP4","s1693_S_RAP_03_ASEReadCounter.table","NW_015090842.1:10293430",16,29,13
"UTP4","s1693_S_RAP_03_ASEReadCounter.table","NW_015090842.1:10293625",10,15,5
"UTP4","s1693_S_RAP_03_ASEReadCounter.table","NW_015090842.1:10293684",16,23,7
"UTP4","s1693_S_RAP_03_ASEReadCounter.table","NW_015090842.1:10294093",8,18,10
"UTP4","s1693_S_RAP_03_ASEReadCounter.table","NW_015090842.1:10294568",18,32,14
"UTP4","s1693_S_RAP_03_ASEReadCounter.table","NW_015090842.1:10294622",20,34,14
"UTP4","s1693_S_RAP_03_ASEReadCounter.table","NW_015090842.1:10294632",18,34,16
"UTP4","s1693_S_RAP_03_ASEReadCounter.table","NW_015090842.1:10295238",14,35,21
"UTP4","s1693_S_RAP_03_ASEReadCounter.table","NW_015090842.1:10295880",16,39,23
"UTP4","s1693_S_RAP_03_ASEReadCounter.table","NW_015090842.1:10295884",16,43,27
"UTP4","s1693_S_RAP_03_ASEReadCounter.table","NW_015090842.1:10295903",14,37,23
"UTP4","s1693_S_RAP_03_ASEReadCounter.table","NW_015090842.1:10295906",13,36,23
"UTP4","s1693_S_RAP_03_ASEReadCounter.table","NW_015090842.1:10295915",13,37,24
"UTP4","s1693_S_RAP_03_ASEReadCounter.table","NW_015090842.1:10295938",10,35,25
"UTP4","s1693_S_RAP_03_ASEReadCounter.table","NW_015090842.1:10296175",18,48,30
"UTP4","s1693_S_RAP_03_ASEReadCounter.table","NW_015090842.1:10296660",15,43,28
"UTP4","s1693_S_RAP_03_ASEReadCounter.table","NW_015090842.1:10296679",21,46,25
"UTP4","s1693_S_RAP_03_ASEReadCounter.table","NW_015090842.1:10297193",22,57,35
"UTP4","s1693_S_RAP_03_ASEReadCounter.table","NW_015090842.1:10297220",24,50,26
"UTP4","s1693_S_RAP_03_ASEReadCounter.table","NW_015090842.1:10297307",29,69,40
"UTP4","s1693_S_RAP_03_ASEReadCounter.table","NW_015090842.1:10297558",41,84,43
"UTP4","s1693_S_RAP_03_ASEReadCounter.table","NW_015090842.1:10297943",33,68,35
"UTP4","s1693_S_RAP_03_ASEReadCounter.table","NW_015090842.1:10297979",32,63,31
"UTP4","s1693_S_RAP_03_ASEReadCounter.table","NW_015090842.1:10298022",23,46,23
"UTP4","s1693_S_RAP_03_ASEReadCounter.table","NW_015090842.1:10298079",4,16,12
"UTP4","s1693_S_RAP_03_ASEReadCounter.table","NW_015090842.1:10298081",4,15,11
"UTP4","s1693_S_RAP_03_ASEReadCounter.table","NW_015090842.1:10298082",4,15,11
"SNTB2","s1693_S_RAP_03_ASEReadCounter.table","NW_015090842.1:10298905",1,1,0
"SNTB2","s1693_S_RAP_03_ASEReadCounter.table","NW_015090842.1:10298928",1,1,0
"SNTB2","s1693_S_RAP_03_ASEReadCounter.table","NW_015090842.1:10303506",2,5,3
"SNTB2","s1693_S_RAP_03_ASEReadCounter.table","NW_015090842.1:10303524",3,7,4
"SNTB2","s1693_S_RAP_03_ASEReadCounter.table","NW_015090842.1:10304059",4,9,5
"SNTB2","s1693_S_RAP_03_ASEReadCounter.table","NW_015090842.1:10304089",4,8,4
"SNTB2","s1693_S_RAP_03_ASEReadCounter.table","NW_015090842.1:10304167",1,3,2
"SNTB2","s1693_S_RAP_03_ASEReadCounter.table","NW_015090842.1:10304176",1,3,2
"SNTB2","s1693_S_RAP_03_ASEReadCounter.table","NW_015090842.1:10305069",3,7,4
"SNTB2","s1693_S_RAP_03_ASEReadCounter.table","NW_015090842.1:10305099",5,10,5
"SNTB2","s1693_S_RAP_03_ASEReadCounter.table","NW_015090842.1:10305451",2,2,0
"SNTB2","s1693_S_RAP_03_ASEReadCounter.table","NW_015090842.1:10305547",4,5,1
"SNTB2","s1693_S_RAP_03_ASEReadCounter.table","NW_015090842.1:10305847",5,7,2
"SNTB2","s1693_S_RAP_03_ASEReadCounter.table","NW_015090842.1:10305911",3,6,3
"SNTB2","s1693_S_RAP_03_ASEReadCounter.table","NW_015090842.1:10306173",6,10,4
"SNTB2","s1693_S_RAP_03_ASEReadCounter.table","NW_015090842.1:10306275",1,3,2
"SNTB2","s1693_S_RAP_03_ASEReadCounter.table","NW_015090842.1:10306457",5,7,2
"SNTB2","s1693_S_RAP_03_ASEReadCounter.table","NW_015090842.1:10306496",7,9,2
"SNTB2","s1693_S_RAP_03_ASEReadCounter.table","NW_015090842.1:10306499",7,9,2
"VPS4A","s1693_S_RAP_03_ASEReadCounter.table","NW_015090842.1:10308566",116,234,118
"VPS4A","s1693_S_RAP_03_ASEReadCounter.table","NW_015090842.1:10308573",117,238,121
"VPS4A","s1693_S_RAP_03_ASEReadCounter.table","NW_015090842.1:10308856",146,347,201
"VPS4A","s1693_S_RAP_03_ASEReadCounter.table","NW_015090842.1:10309056",168,388,220
"VPS4A","s1693_S_RAP_03_ASEReadCounter.table","NW_015090842.1:10309089",216,458,242
"VPS4A","s1693_S_RAP_03_ASEReadCounter.table","NW_015090842.1:10309392",212,450,238
"VPS4A","s1693_S_RAP_03_ASEReadCounter.table","NW_015090842.1:10309413",215,452,237
"VPS4A","s1693_S_RAP_03_ASEReadCounter.table","NW_015090842.1:10309467",219,487,268
"VPS4A","s1693_S_RAP_03_ASEReadCounter.table","NW_015090842.1:10310230",268,574,306
"VPS4A","s1693_S_RAP_03_ASEReadCounter.table","NW_015090842.1:10310425",266,540,274
"VPS4A","s1693_S_RAP_03_ASEReadCounter.table","NW_015090842.1:10310639",249,534,285
"VPS4A","s1693_S_RAP_03_ASEReadCounter.table","NW_015090842.1:10310640",527,527,0
"VPS4A","s1693_S_RAP_03_ASEReadCounter.table","NW_015090842.1:10310687",273,578,305
"VPS4A","s1693_S_RAP_03_ASEReadCounter.table","NW_015090842.1:10310734",237,484,247
"VPS4A","s1693_S_RAP_03_ASEReadCounter.table","NW_015090842.1:10310737",249,495,246
"VPS4A","s1693_S_RAP_03_ASEReadCounter.table","NW_015090842.1:10310746",258,520,262
"VPS4A","s1693_S_RAP_03_ASEReadCounter.table","NW_015090842.1:10310767",258,513,255
"VPS4A","s1693_S_RAP_03_ASEReadCounter.table","NW_015090842.1:10310995",285,552,267
"VPS4A","s1693_S_RAP_03_ASEReadCounter.table","NW_015090842.1:10311004",266,528,262
"VPS4A","s1693_S_RAP_03_ASEReadCounter.table","NW_015090842.1:10311007",262,532,270
"VPS4A","s1693_S_RAP_03_ASEReadCounter.table","NW_015090842.1:10311013",271,542,271
"VPS4A","s1693_S_RAP_03_ASEReadCounter.table","NW_015090842.1:10311022",251,526,275
"VPS4A","s1693_S_RAP_03_ASEReadCounter.table","NW_015090842.1:10311023",251,526,275
"VPS4A","s1693_S_RAP_03_ASEReadCounter.table","NW_015090842.1:10311426",264,565,301
"VPS4A","s1693_S_RAP_03_ASEReadCounter.table","NW_015090842.1:10311489",3,14,11
"VPS4A","s1693_S_RAP_03_ASEReadCounter.table","NW_015090842.1:10311490",4,11,7
"VPS4A","s1693_S_RAP_03_ASEReadCounter.table","NW_015090842.1:10311525",10,27,17
"VPS4A","s1693_S_RAP_03_ASEReadCounter.table","NW_015090842.1:10311529",10,34,24
"VPS4A","s1693_S_RAP_03_ASEReadCounter.table","NW_015090842.1:10311530",10,38,28
"VPS4A","s1693_S_RAP_03_ASEReadCounter.table","NW_015090842.1:10311552",45,82,37
"VPS4A","s1693_S_RAP_03_ASEReadCounter.table","NW_015090842.1:10311689",43,88,45
"VPS4A","s1693_S_RAP_03_ASEReadCounter.table","NW_015090842.1:10311700",62,110,48
"VPS4A","s1693_S_RAP_03_ASEReadCounter.table","NW_015090842.1:10311701",62,108,46
"VPS4A","s1693_S_RAP_03_ASEReadCounter.table","NW_015090842.1:10311703",64,111,47
"COG8","s1693_S_RAP_03_ASEReadCounter.table","NW_015090842.1:10313487",30,68,38
"COG8","s1693_S_RAP_03_ASEReadCounter.table","NW_015090842.1:10313559",43,83,40
"COG8","s1693_S_RAP_03_ASEReadCounter.table","NW_015090842.1:10313579",41,79,38
"COG8","s1693_S_RAP_03_ASEReadCounter.table","NW_015090842.1:10313665",38,66,28
"COG8","s1693_S_RAP_03_ASEReadCounter.table","NW_015090842.1:10313681",41,70,29
"COG8","s1693_S_RAP_03_ASEReadCounter.table","NW_015090842.1:10313768",46,93,47
"COG8","s1693_S_RAP_03_ASEReadCounter.table","NW_015090842.1:10313775",44,89,45
"COG8","s1693_S_RAP_03_ASEReadCounter.table","NW_015090842.1:10313811",30,65,35
"COG8","s1693_S_RAP_03_ASEReadCounter.table","NW_015090842.1:10313858",19,50,31
"COG8","s1693_S_RAP_03_ASEReadCounter.table","NW_015090842.1:10313859",49,49,0
"COG8","s1693_S_RAP_03_ASEReadCounter.table","NW_015090842.1:10314100",38,84,46
"COG8","s1693_S_RAP_03_ASEReadCounter.table","NW_015090842.1:10314213",27,53,26
"COG8","s1693_S_RAP_03_ASEReadCounter.table","NW_015090842.1:10315093",26,49,23
"COG8","s1693_S_RAP_03_ASEReadCounter.table","NW_015090842.1:10315162",26,63,37
"COG8","s1693_S_RAP_03_ASEReadCounter.table","NW_015090842.1:10315285",38,80,42
"COG8","s1693_S_RAP_03_ASEReadCounter.table","NW_015090842.1:10315360",20,54,34
"COG8","s1693_S_RAP_03_ASEReadCounter.table","NW_015090842.1:10315369",20,54,34
"COG8","s1693_S_RAP_03_ASEReadCounter.table","NW_015090842.1:10315508",16,34,18
"COG8","s1693_S_RAP_03_ASEReadCounter.table","NW_015090842.1:10315624",22,40,18
"COG8","s1693_S_RAP_03_ASEReadCounter.table","NW_015090842.1:10315693",18,39,21
"COG8","s1693_S_RAP_03_ASEReadCounter.table","NW_015090842.1:10315698",17,41,24
"COG8","s1693_S_RAP_03_ASEReadCounter.table","NW_015090842.1:10315768",15,39,24
"COG8","s1693_S_RAP_03_ASEReadCounter.table","NW_015090842.1:10315769",16,42,26
"COG8","s1693_S_RAP_03_ASEReadCounter.table","NW_015090842.1:10315784",12,35,23
"COG8","s1693_S_RAP_03_ASEReadCounter.table","NW_015090842.1:10316093",12,39,27
"COG8","s1693_S_RAP_03_ASEReadCounter.table","NW_015090842.1:10316133",14,36,22
"NIP7","s1693_S_RAP_03_ASEReadCounter.table","NW_015090842.1:10316759",21,45,24
"NIP7","s1693_S_RAP_03_ASEReadCounter.table","NW_015090842.1:10316967",122,239,117
"NIP7","s1693_S_RAP_03_ASEReadCounter.table","NW_015090842.1:10316995",149,276,127
"NIP7","s1693_S_RAP_03_ASEReadCounter.table","NW_015090842.1:10317240",237,447,210
"NIP7","s1693_S_RAP_03_ASEReadCounter.table","NW_015090842.1:10317247",229,432,203
"NIP7","s1693_S_RAP_03_ASEReadCounter.table","NW_015090842.1:10317264",223,408,185
"NIP7","s1693_S_RAP_03_ASEReadCounter.table","NW_015090842.1:10317433",241,501,260
"NIP7","s1693_S_RAP_03_ASEReadCounter.table","NW_015090842.1:10317738",192,446,254
"NIP7","s1693_S_RAP_03_ASEReadCounter.table","NW_015090842.1:10317769",212,452,240
"NIP7","s1693_S_RAP_03_ASEReadCounter.table","NW_015090842.1:10317808",127,285,158
"NIP7","s1693_S_RAP_03_ASEReadCounter.table","NW_015090842.1:10317870",83,218,135
"NIP7","s1693_S_RAP_03_ASEReadCounter.table","NW_015090842.1:10317871",85,211,126
"NIP7","s1693_S_RAP_03_ASEReadCounter.table","NW_015090842.1:10317898",55,141,86
"NIP7","s1693_S_RAP_03_ASEReadCounter.table","NW_015090842.1:10317911",55,122,67
"TMED6","s1693_S_RAP_03_ASEReadCounter.table","NW_015090842.1:10318514",1,1,0
"TMED6","s1693_S_RAP_03_ASEReadCounter.table","NW_015090842.1:10318731",0,1,1
"TERF2","s1693_S_RAP_03_ASEReadCounter.table","NW_015090842.1:10321768",34,80,46
"TERF2","s1693_S_RAP_03_ASEReadCounter.table","NW_015090842.1:10321777",36,80,44
"TERF2","s1693_S_RAP_03_ASEReadCounter.table","NW_015090842.1:10321805",38,90,52
"TERF2","s1693_S_RAP_03_ASEReadCounter.table","NW_015090842.1:10321878",48,112,64
"TERF2","s1693_S_RAP_03_ASEReadCounter.table","NW_015090842.1:10321893",43,104,61
"TERF2","s1693_S_RAP_03_ASEReadCounter.table","NW_015090842.1:10321897",45,101,56
"TERF2","s1693_S_RAP_03_ASEReadCounter.table","NW_015090842.1:10321908",38,87,49
"TERF2","s1693_S_RAP_03_ASEReadCounter.table","NW_015090842.1:10322001",60,143,83
"TERF2","s1693_S_RAP_03_ASEReadCounter.table","NW_015090842.1:10322035",47,106,59
"TERF2","s1693_S_RAP_03_ASEReadCounter.table","NW_015090842.1:10322051",50,118,68
"TERF2","s1693_S_RAP_03_ASEReadCounter.table","NW_015090842.1:10322137",37,95,58
"TERF2","s1693_S_RAP_03_ASEReadCounter.table","NW_015090842.1:10322144",39,96,57
"TERF2","s1693_S_RAP_03_ASEReadCounter.table","NW_015090842.1:10322388",36,115,79
"TERF2","s1693_S_RAP_03_ASEReadCounter.table","NW_015090842.1:10322396",37,105,68
"TERF2","s1693_S_RAP_03_ASEReadCounter.table","NW_015090842.1:10322502",53,117,64
"TERF2","s1693_S_RAP_03_ASEReadCounter.table","NW_015090842.1:10322504",54,119,65
"TERF2","s1693_S_RAP_03_ASEReadCounter.table","NW_015090842.1:10322510",59,126,67
"TERF2","s1693_S_RAP_03_ASEReadCounter.table","NW_015090842.1:10323580",48,107,59
"TERF2","s1693_S_RAP_03_ASEReadCounter.table","NW_015090842.1:10324314",38,97,59
"TERF2","s1693_S_RAP_03_ASEReadCounter.table","NW_015090842.1:10326832",29,70,41
"TERF2","s1693_S_RAP_03_ASEReadCounter.table","NW_015090842.1:10327787",24,53,29
"TERF2","s1693_S_RAP_03_ASEReadCounter.table","NW_015090842.1:10328588",25,52,27
"TERF2","s1693_S_RAP_03_ASEReadCounter.table","NW_015090842.1:10328644",21,43,22
"TERF2","s1693_S_RAP_03_ASEReadCounter.table","NW_015090842.1:10329813",15,37,22
"TERF2","s1693_S_RAP_03_ASEReadCounter.table","NW_015090842.1:10330749",14,34,20
"TERF2","s1693_S_RAP_03_ASEReadCounter.table","NW_015090842.1:10330789",14,35,21
"CYB5B","s1693_S_RAP_03_ASEReadCounter.table","NW_015090842.1:10336595",7,15,8
"CYB5B","s1693_S_RAP_03_ASEReadCounter.table","NW_015090842.1:10336667",73,138,65
"CYB5B","s1693_S_RAP_03_ASEReadCounter.table","NW_015090842.1:10336689",104,205,101
"CYB5B","s1693_S_RAP_03_ASEReadCounter.table","NW_015090842.1:10336728",136,275,139
"CYB5B","s1693_S_RAP_03_ASEReadCounter.table","NW_015090842.1:10345068",138,276,138
"CYB5B","s1693_S_RAP_03_ASEReadCounter.table","NW_015090842.1:10348800",207,419,212
"CYB5B","s1693_S_RAP_03_ASEReadCounter.table","NW_015090842.1:10349046",182,371,189
"CYB5B","s1693_S_RAP_03_ASEReadCounter.table","NW_015090842.1:10349119",90,276,186
"CYB5B","s1693_S_RAP_03_ASEReadCounter.table","NW_015090842.1:10349146",58,253,195
"CYB5B","s1693_S_RAP_03_ASEReadCounter.table","NW_015090842.1:10349157",92,288,196
"CYB5B","s1693_S_RAP_03_ASEReadCounter.table","NW_015090842.1:10349263",268,268,0
