"gene","id","snp","ref_count","total_count","alt_count"
"CENPN","s1693_S_HYP_02_ASEReadCounter.table","NW_015090842.1:5801612",1,3,2
"CENPN","s1693_S_HYP_02_ASEReadCounter.table","NW_015090842.1:5801618",1,4,3
"CENPN","s1693_S_HYP_02_ASEReadCounter.table","NW_015090842.1:5801623",0,4,4
"CENPN","s1693_S_HYP_02_ASEReadCounter.table","NW_015090842.1:5801631",1,4,3
"CENPN","s1693_S_HYP_02_ASEReadCounter.table","NW_015090842.1:5801632",1,4,3
"CENPN","s1693_S_HYP_02_ASEReadCounter.table","NW_015090842.1:5801655",1,7,6
"CENPN","s1693_S_HYP_02_ASEReadCounter.table","NW_015090842.1:5801670",1,7,6
"CENPN","s1693_S_HYP_02_ASEReadCounter.table","NW_015090842.1:5801674",1,7,6
"CENPN","s1693_S_HYP_02_ASEReadCounter.table","NW_015090842.1:5801692",0,6,6
"CENPN","s1693_S_HYP_02_ASEReadCounter.table","NW_015090842.1:5802008",1,9,8
"CENPN","s1693_S_HYP_02_ASEReadCounter.table","NW_015090842.1:5802012",0,7,7
"CENPN","s1693_S_HYP_02_ASEReadCounter.table","NW_015090842.1:5802087",1,9,8
"CENPN","s1693_S_HYP_02_ASEReadCounter.table","NW_015090842.1:5810113",11,11,0
"CENPN","s1693_S_HYP_02_ASEReadCounter.table","NW_015090842.1:5810147",13,14,1
"CENPN","s1693_S_HYP_02_ASEReadCounter.table","NW_015090842.1:5810148",13,14,1
"ATMIN","s1693_S_HYP_02_ASEReadCounter.table","NW_015090842.1:5818789",1,2,1
"ATMIN","s1693_S_HYP_02_ASEReadCounter.table","NW_015090842.1:5819958",2,3,1
"ATMIN","s1693_S_HYP_02_ASEReadCounter.table","NW_015090842.1:5820004",2,3,1
"ATMIN","s1693_S_HYP_02_ASEReadCounter.table","NW_015090842.1:5820217",1,1,0
"ATMIN","s1693_S_HYP_02_ASEReadCounter.table","NW_015090842.1:5820250",3,3,0
"ATMIN","s1693_S_HYP_02_ASEReadCounter.table","NW_015090842.1:5820298",2,3,1
"ATMIN","s1693_S_HYP_02_ASEReadCounter.table","NW_015090842.1:5820417",3,5,2
"ATMIN","s1693_S_HYP_02_ASEReadCounter.table","NW_015090842.1:5820421",3,4,1
"ATMIN","s1693_S_HYP_02_ASEReadCounter.table","NW_015090842.1:5820448",3,5,2
"ATMIN","s1693_S_HYP_02_ASEReadCounter.table","NW_015090842.1:5820457",2,5,3
"ATMIN","s1693_S_HYP_02_ASEReadCounter.table","NW_015090842.1:5820510",1,4,3
"ATMIN","s1693_S_HYP_02_ASEReadCounter.table","NW_015090842.1:5820673",1,4,3
"ATMIN","s1693_S_HYP_02_ASEReadCounter.table","NW_015090842.1:5820754",2,3,1
"ATMIN","s1693_S_HYP_02_ASEReadCounter.table","NW_015090842.1:5820820",3,6,3
"ATMIN","s1693_S_HYP_02_ASEReadCounter.table","NW_015090842.1:5820865",5,7,2
"ATMIN","s1693_S_HYP_02_ASEReadCounter.table","NW_015090842.1:5820889",3,5,2
"ATMIN","s1693_S_HYP_02_ASEReadCounter.table","NW_015090842.1:5820891",3,5,2
"ATMIN","s1693_S_HYP_02_ASEReadCounter.table","NW_015090842.1:5820997",8,10,2
"ATMIN","s1693_S_HYP_02_ASEReadCounter.table","NW_015090842.1:5821063",6,9,3
"ATMIN","s1693_S_HYP_02_ASEReadCounter.table","NW_015090842.1:5821132",8,13,5
"ATMIN","s1693_S_HYP_02_ASEReadCounter.table","NW_015090842.1:5821645",5,12,7
"ATMIN","s1693_S_HYP_02_ASEReadCounter.table","NW_015090842.1:5825066",16,27,11
"ATMIN","s1693_S_HYP_02_ASEReadCounter.table","NW_015090842.1:5825106",19,39,20
"ATMIN","s1693_S_HYP_02_ASEReadCounter.table","NW_015090842.1:5825122",12,28,16
"ATMIN","s1693_S_HYP_02_ASEReadCounter.table","NW_015090842.1:5825178",18,36,18
"ATMIN","s1693_S_HYP_02_ASEReadCounter.table","NW_015090842.1:5825194",15,33,18
"ATMIN","s1693_S_HYP_02_ASEReadCounter.table","NW_015090842.1:5825195",15,33,18
"ATMIN","s1693_S_HYP_02_ASEReadCounter.table","NW_015090842.1:5825220",14,38,24
"ATMIN","s1693_S_HYP_02_ASEReadCounter.table","NW_015090842.1:5825240",14,41,27
"ATMIN","s1693_S_HYP_02_ASEReadCounter.table","NW_015090842.1:5825303",19,52,33
"ATMIN","s1693_S_HYP_02_ASEReadCounter.table","NW_015090842.1:5825304",18,53,35
"ATMIN","s1693_S_HYP_02_ASEReadCounter.table","NW_015090842.1:5825310",18,53,35
"ATMIN","s1693_S_HYP_02_ASEReadCounter.table","NW_015090842.1:5825406",21,37,16
"ATMIN","s1693_S_HYP_02_ASEReadCounter.table","NW_015090842.1:5825415",21,39,18
"ATMIN","s1693_S_HYP_02_ASEReadCounter.table","NW_015090842.1:5825438",22,43,21
"ATMIN","s1693_S_HYP_02_ASEReadCounter.table","NW_015090842.1:5825485",19,48,29
"ATMIN","s1693_S_HYP_02_ASEReadCounter.table","NW_015090842.1:5825524",24,50,26
"ATMIN","s1693_S_HYP_02_ASEReadCounter.table","NW_015090842.1:5825557",27,53,26
"ATMIN","s1693_S_HYP_02_ASEReadCounter.table","NW_015090842.1:5825571",25,50,25
"ATMIN","s1693_S_HYP_02_ASEReadCounter.table","NW_015090842.1:5825579",24,50,26
"ATMIN","s1693_S_HYP_02_ASEReadCounter.table","NW_015090842.1:5825590",24,47,23
"ATMIN","s1693_S_HYP_02_ASEReadCounter.table","NW_015090842.1:5825689",27,45,18
"ATMIN","s1693_S_HYP_02_ASEReadCounter.table","NW_015090842.1:5825703",28,49,21
"ATMIN","s1693_S_HYP_02_ASEReadCounter.table","NW_015090842.1:5825787",25,46,21
"ATMIN","s1693_S_HYP_02_ASEReadCounter.table","NW_015090842.1:5825833",28,51,23
"ATMIN","s1693_S_HYP_02_ASEReadCounter.table","NW_015090842.1:5825841",27,51,24
"ATMIN","s1693_S_HYP_02_ASEReadCounter.table","NW_015090842.1:5825895",28,62,34
"ATMIN","s1693_S_HYP_02_ASEReadCounter.table","NW_015090842.1:5825984",23,56,33
"ATMIN","s1693_S_HYP_02_ASEReadCounter.table","NW_015090842.1:5826162",26,68,42
"ATMIN","s1693_S_HYP_02_ASEReadCounter.table","NW_015090842.1:5826194",41,87,46
"ATMIN","s1693_S_HYP_02_ASEReadCounter.table","NW_015090842.1:5826235",42,81,39
"ATMIN","s1693_S_HYP_02_ASEReadCounter.table","NW_015090842.1:5826245",39,81,42
"ATMIN","s1693_S_HYP_02_ASEReadCounter.table","NW_015090842.1:5826335",28,59,31
"ATMIN","s1693_S_HYP_02_ASEReadCounter.table","NW_015090842.1:5826417",30,59,29
"ATMIN","s1693_S_HYP_02_ASEReadCounter.table","NW_015090842.1:5826431",24,66,42
"ATMIN","s1693_S_HYP_02_ASEReadCounter.table","NW_015090842.1:5826438",29,65,36
"ATMIN","s1693_S_HYP_02_ASEReadCounter.table","NW_015090842.1:5826463",37,85,48
"ATMIN","s1693_S_HYP_02_ASEReadCounter.table","NW_015090842.1:5826502",47,93,46
"ATMIN","s1693_S_HYP_02_ASEReadCounter.table","NW_015090842.1:5826511",46,99,53
"ATMIN","s1693_S_HYP_02_ASEReadCounter.table","NW_015090842.1:5826659",42,98,56
"ATMIN","s1693_S_HYP_02_ASEReadCounter.table","NW_015090842.1:5826701",49,105,56
"ATMIN","s1693_S_HYP_02_ASEReadCounter.table","NW_015090842.1:5826702",47,102,55
"ATMIN","s1693_S_HYP_02_ASEReadCounter.table","NW_015090842.1:5826732",52,117,65
"ATMIN","s1693_S_HYP_02_ASEReadCounter.table","NW_015090842.1:5826745",59,126,67
"ATMIN","s1693_S_HYP_02_ASEReadCounter.table","NW_015090842.1:5826835",68,136,68
"ATMIN","s1693_S_HYP_02_ASEReadCounter.table","NW_015090842.1:5826910",50,102,52
"ATMIN","s1693_S_HYP_02_ASEReadCounter.table","NW_015090842.1:5826942",35,102,67
"ATMIN","s1693_S_HYP_02_ASEReadCounter.table","NW_015090842.1:5827193",89,189,100
"ATMIN","s1693_S_HYP_02_ASEReadCounter.table","NW_015090842.1:5827196",86,192,106
"ATMIN","s1693_S_HYP_02_ASEReadCounter.table","NW_015090842.1:5827269",79,164,85
"ATMIN","s1693_S_HYP_02_ASEReadCounter.table","NW_015090842.1:5827315",70,143,73
"ATMIN","s1693_S_HYP_02_ASEReadCounter.table","NW_015090842.1:5827316",72,147,75
"ATMIN","s1693_S_HYP_02_ASEReadCounter.table","NW_015090842.1:5827333",73,146,73
"PPP1R3E","s1693_S_HYP_02_ASEReadCounter.table","NW_015090842.1:5837733",2,5,3
"PPP1R3E","s1693_S_HYP_02_ASEReadCounter.table","NW_015090842.1:5837947",3,6,3
"PKD1L2","s1693_S_HYP_02_ASEReadCounter.table","NW_015090842.1:5867509",2,2,0
"PKD1L2","s1693_S_HYP_02_ASEReadCounter.table","NW_015090842.1:5867597",1,1,0
"PKD1L2","s1693_S_HYP_02_ASEReadCounter.table","NW_015090842.1:5867600",1,2,1
"PKD1L2","s1693_S_HYP_02_ASEReadCounter.table","NW_015090842.1:5867675",0,1,1
"PKD1L2","s1693_S_HYP_02_ASEReadCounter.table","NW_015090842.1:5867843",1,1,0
"BCO1","s1693_S_HYP_02_ASEReadCounter.table","NW_015090842.1:5915610",1,1,0
"BCO1","s1693_S_HYP_02_ASEReadCounter.table","NW_015090842.1:5915646",1,2,1
"BCO1","s1693_S_HYP_02_ASEReadCounter.table","NW_015090842.1:5917836",0,1,1
"BCO1","s1693_S_HYP_02_ASEReadCounter.table","NW_015090842.1:5917912",6,8,2
"BCO1","s1693_S_HYP_02_ASEReadCounter.table","NW_015090842.1:5917941",7,9,2
"BCO1","s1693_S_HYP_02_ASEReadCounter.table","NW_015090842.1:5917971",9,12,3
"BCO1","s1693_S_HYP_02_ASEReadCounter.table","NW_015090842.1:5921679",6,11,5
"BCO1","s1693_S_HYP_02_ASEReadCounter.table","NW_015090842.1:5921726",8,10,2
"BCO1","s1693_S_HYP_02_ASEReadCounter.table","NW_015090842.1:5925669",6,7,1
"BCO1","s1693_S_HYP_02_ASEReadCounter.table","NW_015090842.1:5925753",6,7,1
"BCO1","s1693_S_HYP_02_ASEReadCounter.table","NW_015090842.1:5926937",10,13,3
"BCO1","s1693_S_HYP_02_ASEReadCounter.table","NW_015090842.1:5927921",11,12,1
"BCO1","s1693_S_HYP_02_ASEReadCounter.table","NW_015090842.1:5927948",9,10,1
"BCO1","s1693_S_HYP_02_ASEReadCounter.table","NW_015090842.1:5927968",13,14,1
"BCO1","s1693_S_HYP_02_ASEReadCounter.table","NW_015090842.1:5928052",10,10,0
"BCO1","s1693_S_HYP_02_ASEReadCounter.table","NW_015090842.1:5932726",20,21,1
"BCO1","s1693_S_HYP_02_ASEReadCounter.table","NW_015090842.1:5932801",13,15,2
"BCO1","s1693_S_HYP_02_ASEReadCounter.table","NW_015090842.1:5934558",18,30,12
"BCO1","s1693_S_HYP_02_ASEReadCounter.table","NW_015090842.1:5934575",19,30,11
"BCO1","s1693_S_HYP_02_ASEReadCounter.table","NW_015090842.1:5934608",18,31,13
"BCO1","s1693_S_HYP_02_ASEReadCounter.table","NW_015090842.1:5934647",15,27,12
"BCO1","s1693_S_HYP_02_ASEReadCounter.table","NW_015090842.1:5934725",17,25,8
"BCO1","s1693_S_HYP_02_ASEReadCounter.table","NW_015090842.1:5934726",17,23,6
"BCO1","s1693_S_HYP_02_ASEReadCounter.table","NW_015090842.1:5934733",17,20,3
"BCO1","s1693_S_HYP_02_ASEReadCounter.table","NW_015090842.1:5934821",10,16,6
"BCO1","s1693_S_HYP_02_ASEReadCounter.table","NW_015090842.1:5934826",9,18,9
"BCO1","s1693_S_HYP_02_ASEReadCounter.table","NW_015090842.1:5934844",7,15,8
"BCO1","s1693_S_HYP_02_ASEReadCounter.table","NW_015090842.1:5934958",17,25,8
"BCO1","s1693_S_HYP_02_ASEReadCounter.table","NW_015090842.1:5934976",17,25,8
"GAN","s1693_S_HYP_02_ASEReadCounter.table","NW_015090842.1:5953759",12,18,6
"GAN","s1693_S_HYP_02_ASEReadCounter.table","NW_015090842.1:5957502",20,42,22
"GAN","s1693_S_HYP_02_ASEReadCounter.table","NW_015090842.1:5957578",22,43,21
"GAN","s1693_S_HYP_02_ASEReadCounter.table","NW_015090842.1:5965028",29,51,22
"GAN","s1693_S_HYP_02_ASEReadCounter.table","NW_015090842.1:5966047",23,57,34
"GAN","s1693_S_HYP_02_ASEReadCounter.table","NW_015090842.1:5966126",12,40,28
"GAN","s1693_S_HYP_02_ASEReadCounter.table","NW_015090842.1:5966127",12,39,27
"GAN","s1693_S_HYP_02_ASEReadCounter.table","NW_015090842.1:5966162",27,64,37
"GAN","s1693_S_HYP_02_ASEReadCounter.table","NW_015090842.1:5966483",48,120,72
"CMIP","s1693_S_HYP_02_ASEReadCounter.table","NW_015090842.1:6109159",14,29,15
"CMIP","s1693_S_HYP_02_ASEReadCounter.table","NW_015090842.1:6109166",12,26,14
"CMIP","s1693_S_HYP_02_ASEReadCounter.table","NW_015090842.1:6114641",20,47,27
"CMIP","s1693_S_HYP_02_ASEReadCounter.table","NW_015090842.1:6114751",25,51,26
"CMIP","s1693_S_HYP_02_ASEReadCounter.table","NW_015090842.1:6114824",31,57,26
"CMIP","s1693_S_HYP_02_ASEReadCounter.table","NW_015090842.1:6128998",32,62,30
"CMIP","s1693_S_HYP_02_ASEReadCounter.table","NW_015090842.1:6130562",74,137,63
"CMIP","s1693_S_HYP_02_ASEReadCounter.table","NW_015090842.1:6132522",63,135,72
"CMIP","s1693_S_HYP_02_ASEReadCounter.table","NW_015090842.1:6134088",59,153,94
"CMIP","s1693_S_HYP_02_ASEReadCounter.table","NW_015090842.1:6138265",117,324,207
"CMIP","s1693_S_HYP_02_ASEReadCounter.table","NW_015090842.1:6138300",123,334,211
"CMIP","s1693_S_HYP_02_ASEReadCounter.table","NW_015090842.1:6138342",124,293,169
"CMIP","s1693_S_HYP_02_ASEReadCounter.table","NW_015090842.1:6138343",124,295,171
"CMIP","s1693_S_HYP_02_ASEReadCounter.table","NW_015090842.1:6138345",125,295,170
"CMIP","s1693_S_HYP_02_ASEReadCounter.table","NW_015090842.1:6138647",94,208,114
"CMIP","s1693_S_HYP_02_ASEReadCounter.table","NW_015090842.1:6138745",114,230,116
"CMIP","s1693_S_HYP_02_ASEReadCounter.table","NW_015090842.1:6138832",25,104,79
"CMIP","s1693_S_HYP_02_ASEReadCounter.table","NW_015090842.1:6138967",104,233,129
"CMIP","s1693_S_HYP_02_ASEReadCounter.table","NW_015090842.1:6139131",66,149,83
"CMIP","s1693_S_HYP_02_ASEReadCounter.table","NW_015090842.1:6139163",35,123,88
"CMIP","s1693_S_HYP_02_ASEReadCounter.table","NW_015090842.1:6139360",55,98,43
"CMIP","s1693_S_HYP_02_ASEReadCounter.table","NW_015090842.1:6139572",40,58,18
"CMIP","s1693_S_HYP_02_ASEReadCounter.table","NW_015090842.1:6139773",127,127,0
"PLCG2","s1693_S_HYP_02_ASEReadCounter.table","NW_015090842.1:6179613",0,4,4
"PLCG2","s1693_S_HYP_02_ASEReadCounter.table","NW_015090842.1:6179658",2,9,7
"PLCG2","s1693_S_HYP_02_ASEReadCounter.table","NW_015090842.1:6203766",0,4,4
"PLCG2","s1693_S_HYP_02_ASEReadCounter.table","NW_015090842.1:6203775",0,5,5
"PLCG2","s1693_S_HYP_02_ASEReadCounter.table","NW_015090842.1:6203787",0,6,6
"PLCG2","s1693_S_HYP_02_ASEReadCounter.table","NW_015090842.1:6205047",2,6,4
"PLCG2","s1693_S_HYP_02_ASEReadCounter.table","NW_015090842.1:6208541",0,2,2
"PLCG2","s1693_S_HYP_02_ASEReadCounter.table","NW_015090842.1:6209741",0,2,2
"PLCG2","s1693_S_HYP_02_ASEReadCounter.table","NW_015090842.1:6209798",0,2,2
"PLCG2","s1693_S_HYP_02_ASEReadCounter.table","NW_015090842.1:6209816",0,3,3
"PLCG2","s1693_S_HYP_02_ASEReadCounter.table","NW_015090842.1:6217547",0,2,2
"PLCG2","s1693_S_HYP_02_ASEReadCounter.table","NW_015090842.1:6218641",2,4,2
"PLCG2","s1693_S_HYP_02_ASEReadCounter.table","NW_015090842.1:6220552",0,7,7
"PLCG2","s1693_S_HYP_02_ASEReadCounter.table","NW_015090842.1:6221969",1,3,2
"PLCG2","s1693_S_HYP_02_ASEReadCounter.table","NW_015090842.1:6228672",0,13,13
"PLCG2","s1693_S_HYP_02_ASEReadCounter.table","NW_015090842.1:6228694",0,14,14
"PLCG2","s1693_S_HYP_02_ASEReadCounter.table","NW_015090842.1:6228722",0,15,15
"PLCG2","s1693_S_HYP_02_ASEReadCounter.table","NW_015090842.1:6228747",0,17,17
"PLCG2","s1693_S_HYP_02_ASEReadCounter.table","NW_015090842.1:6228835",2,18,16
"PLCG2","s1693_S_HYP_02_ASEReadCounter.table","NW_015090842.1:6228841",2,18,16
"PLCG2","s1693_S_HYP_02_ASEReadCounter.table","NW_015090842.1:6228865",2,15,13
"PLCG2","s1693_S_HYP_02_ASEReadCounter.table","NW_015090842.1:6228917",3,17,14
"PLCG2","s1693_S_HYP_02_ASEReadCounter.table","NW_015090842.1:6228926",2,15,13
"PLCG2","s1693_S_HYP_02_ASEReadCounter.table","NW_015090842.1:6228954",2,14,12
"PLCG2","s1693_S_HYP_02_ASEReadCounter.table","NW_015090842.1:6229002",3,17,14
"PLCG2","s1693_S_HYP_02_ASEReadCounter.table","NW_015090842.1:6229006",3,17,14
"PLCG2","s1693_S_HYP_02_ASEReadCounter.table","NW_015090842.1:6229081",1,10,9
"PLCG2","s1693_S_HYP_02_ASEReadCounter.table","NW_015090842.1:6229097",1,8,7
"PLCG2","s1693_S_HYP_02_ASEReadCounter.table","NW_015090842.1:6229160",1,5,4
"PLCG2","s1693_S_HYP_02_ASEReadCounter.table","NW_015090842.1:6229213",3,12,9
"PLCG2","s1693_S_HYP_02_ASEReadCounter.table","NW_015090842.1:6229231",3,12,9
"PLCG2","s1693_S_HYP_02_ASEReadCounter.table","NW_015090842.1:6229663",2,4,2
"PLCG2","s1693_S_HYP_02_ASEReadCounter.table","NW_015090842.1:6229748",2,7,5
"PLCG2","s1693_S_HYP_02_ASEReadCounter.table","NW_015090842.1:6229892",2,7,5
"PLCG2","s1693_S_HYP_02_ASEReadCounter.table","NW_015090842.1:6230248",4,5,1
"PLCG2","s1693_S_HYP_02_ASEReadCounter.table","NW_015090842.1:6230255",4,5,1
"PLCG2","s1693_S_HYP_02_ASEReadCounter.table","NW_015090842.1:6230296",2,3,1
"PLCG2","s1693_S_HYP_02_ASEReadCounter.table","NW_015090842.1:6230349",2,2,0
"PLCG2","s1693_S_HYP_02_ASEReadCounter.table","NW_015090842.1:6230381",1,2,1
"PLCG2","s1693_S_HYP_02_ASEReadCounter.table","NW_015090842.1:6230408",1,3,2
"PLCG2","s1693_S_HYP_02_ASEReadCounter.table","NW_015090842.1:6230439",1,3,2
"PLCG2","s1693_S_HYP_02_ASEReadCounter.table","NW_015090842.1:6230757",1,1,0
"PLCG2","s1693_S_HYP_02_ASEReadCounter.table","NW_015090842.1:6230758",1,1,0
"PLCG2","s1693_S_HYP_02_ASEReadCounter.table","NW_015090842.1:6230898",5,6,1
"PLCG2","s1693_S_HYP_02_ASEReadCounter.table","NW_015090842.1:6230976",6,9,3
"PLCG2","s1693_S_HYP_02_ASEReadCounter.table","NW_015090842.1:6231078",3,6,3
"PLCG2","s1693_S_HYP_02_ASEReadCounter.table","NW_015090842.1:6231138",7,11,4
"PLCG2","s1693_S_HYP_02_ASEReadCounter.table","NW_015090842.1:6231177",5,7,2
"PLCG2","s1693_S_HYP_02_ASEReadCounter.table","NW_015090842.1:6231263",4,5,1
"PLCG2","s1693_S_HYP_02_ASEReadCounter.table","NW_015090842.1:6231309",5,5,0
"SDR42E1","s1693_S_HYP_02_ASEReadCounter.table","NW_015090842.1:6235292",0,8,8
"SDR42E1","s1693_S_HYP_02_ASEReadCounter.table","NW_015090842.1:6235315",2,9,7
"SDR42E1","s1693_S_HYP_02_ASEReadCounter.table","NW_015090842.1:6235348",5,15,10
"SDR42E1","s1693_S_HYP_02_ASEReadCounter.table","NW_015090842.1:6235355",4,14,10
"SDR42E1","s1693_S_HYP_02_ASEReadCounter.table","NW_015090842.1:6235417",7,17,10
"SDR42E1","s1693_S_HYP_02_ASEReadCounter.table","NW_015090842.1:6235526",22,22,0
"SDR42E1","s1693_S_HYP_02_ASEReadCounter.table","NW_015090842.1:6235558",7,22,15
"SDR42E1","s1693_S_HYP_02_ASEReadCounter.table","NW_015090842.1:6235603",19,19,0
"SDR42E1","s1693_S_HYP_02_ASEReadCounter.table","NW_015090842.1:6235741",4,18,14
"SDR42E1","s1693_S_HYP_02_ASEReadCounter.table","NW_015090842.1:6235777",4,18,14
"SDR42E1","s1693_S_HYP_02_ASEReadCounter.table","NW_015090842.1:6235806",8,21,13
"SDR42E1","s1693_S_HYP_02_ASEReadCounter.table","NW_015090842.1:6235809",8,20,12
"SDR42E1","s1693_S_HYP_02_ASEReadCounter.table","NW_015090842.1:6235816",6,20,14
"SDR42E1","s1693_S_HYP_02_ASEReadCounter.table","NW_015090842.1:6235914",4,19,15
"SDR42E1","s1693_S_HYP_02_ASEReadCounter.table","NW_015090842.1:6235935",5,21,16
"SDR42E1","s1693_S_HYP_02_ASEReadCounter.table","NW_015090842.1:6235957",5,20,15
"SDR42E1","s1693_S_HYP_02_ASEReadCounter.table","NW_015090842.1:6236040",4,12,8
"SDR42E1","s1693_S_HYP_02_ASEReadCounter.table","NW_015090842.1:6236260",5,15,10
"SDR42E1","s1693_S_HYP_02_ASEReadCounter.table","NW_015090842.1:6236281",4,12,8
"SDR42E1","s1693_S_HYP_02_ASEReadCounter.table","NW_015090842.1:6236305",2,10,8
"SDR42E1","s1693_S_HYP_02_ASEReadCounter.table","NW_015090842.1:6236458",2,8,6
"SDR42E1","s1693_S_HYP_02_ASEReadCounter.table","NW_015090842.1:6236476",2,6,4
"SDR42E1","s1693_S_HYP_02_ASEReadCounter.table","NW_015090842.1:6236608",3,18,15
"SDR42E1","s1693_S_HYP_02_ASEReadCounter.table","NW_015090842.1:6238244",1,10,9
"SDR42E1","s1693_S_HYP_02_ASEReadCounter.table","NW_015090842.1:6238829",1,6,5
"HSD17B2","s1693_S_HYP_02_ASEReadCounter.table","NW_015090842.1:6262974",0,2,2
"HSD17B2","s1693_S_HYP_02_ASEReadCounter.table","NW_015090842.1:6266125",0,4,4
"HSD17B2","s1693_S_HYP_02_ASEReadCounter.table","NW_015090842.1:6266135",0,4,4
"HSD17B2","s1693_S_HYP_02_ASEReadCounter.table","NW_015090842.1:6266795",0,3,3
"HSD17B2","s1693_S_HYP_02_ASEReadCounter.table","NW_015090842.1:6266918",0,2,2
"HSD17B2","s1693_S_HYP_02_ASEReadCounter.table","NW_015090842.1:6266997",0,2,2
"HSD17B2","s1693_S_HYP_02_ASEReadCounter.table","NW_015090842.1:6267053",0,2,2
"HSD17B2","s1693_S_HYP_02_ASEReadCounter.table","NW_015090842.1:6267196",0,1,1
"HSD17B2","s1693_S_HYP_02_ASEReadCounter.table","NW_015090842.1:6267273",0,1,1
"HSD17B2","s1693_S_HYP_02_ASEReadCounter.table","NW_015090842.1:6267358",0,1,1
"HSD17B2","s1693_S_HYP_02_ASEReadCounter.table","NW_015090842.1:6267674",0,2,2
"HSD17B2","s1693_S_HYP_02_ASEReadCounter.table","NW_015090842.1:6267913",0,1,1
"HSD17B2","s1693_S_HYP_02_ASEReadCounter.table","NW_015090842.1:6268180",0,2,2
"HSD17B2","s1693_S_HYP_02_ASEReadCounter.table","NW_015090842.1:6268203",0,2,2
"ARY2","s1693_S_HYP_02_ASEReadCounter.table","NW_015090842.1:6303922",20,35,15
"ARY2","s1693_S_HYP_02_ASEReadCounter.table","NW_015090842.1:6303954",20,37,17
"ARY2","s1693_S_HYP_02_ASEReadCounter.table","NW_015090842.1:6303979",21,40,19
"ARY2","s1693_S_HYP_02_ASEReadCounter.table","NW_015090842.1:6305848",22,44,22
"ARY2","s1693_S_HYP_02_ASEReadCounter.table","NW_015090842.1:6305856",20,43,23
"ARY2","s1693_S_HYP_02_ASEReadCounter.table","NW_015090842.1:6305857",20,42,22
"ARY2","s1693_S_HYP_02_ASEReadCounter.table","NW_015090842.1:6306017",30,57,27
"ARY2","s1693_S_HYP_02_ASEReadCounter.table","NW_015090842.1:6306052",26,53,27
"ARY2","s1693_S_HYP_02_ASEReadCounter.table","NW_015090842.1:6306094",30,56,26
"ARY2","s1693_S_HYP_02_ASEReadCounter.table","NW_015090842.1:6306100",33,61,28
"ARY2","s1693_S_HYP_02_ASEReadCounter.table","NW_015090842.1:6306146",32,62,30
"ARY2","s1693_S_HYP_02_ASEReadCounter.table","NW_015090842.1:6306147",30,60,30
"ARY2","s1693_S_HYP_02_ASEReadCounter.table","NW_015090842.1:6306390",32,58,26
"ARY2","s1693_S_HYP_02_ASEReadCounter.table","NW_015090842.1:6306567",28,54,26
"ARY2","s1693_S_HYP_02_ASEReadCounter.table","NW_015090842.1:6306705",39,55,16
"ARY2","s1693_S_HYP_02_ASEReadCounter.table","NW_015090842.1:6306713",53,53,0
"ARY2","s1693_S_HYP_02_ASEReadCounter.table","NW_015090842.1:6306773",41,53,12
"ARY2","s1693_S_HYP_02_ASEReadCounter.table","NW_015090842.1:6307039",54,69,15
"ARY2","s1693_S_HYP_02_ASEReadCounter.table","NW_015090842.1:6307043",57,74,17
"ARY2","s1693_S_HYP_02_ASEReadCounter.table","NW_015090842.1:6307093",56,73,17
"ARY2","s1693_S_HYP_02_ASEReadCounter.table","NW_015090842.1:6307138",40,59,19
"ARY2","s1693_S_HYP_02_ASEReadCounter.table","NW_015090842.1:6307157",48,69,21
"ARY2","s1693_S_HYP_02_ASEReadCounter.table","NW_015090842.1:6307187",50,72,22
"ARY2","s1693_S_HYP_02_ASEReadCounter.table","NW_015090842.1:6307278",44,63,19
"ARY2","s1693_S_HYP_02_ASEReadCounter.table","NW_015090842.1:6307305",52,72,20
"ARY2","s1693_S_HYP_02_ASEReadCounter.table","NW_015090842.1:6307318",54,79,25
"ARY2","s1693_S_HYP_02_ASEReadCounter.table","NW_015090842.1:6307429",63,89,26
"ARY2","s1693_S_HYP_02_ASEReadCounter.table","NW_015090842.1:6307487",48,76,28
"ARY2","s1693_S_HYP_02_ASEReadCounter.table","NW_015090842.1:6307670",54,70,16
"ARYL","s1693_S_HYP_02_ASEReadCounter.table","NW_015090842.1:6313360",2,4,2
"ARYL","s1693_S_HYP_02_ASEReadCounter.table","NW_015090842.1:6313377",1,3,2
"ARYL","s1693_S_HYP_02_ASEReadCounter.table","NW_015090842.1:6313767",1,2,1
"ARY1","s1693_S_HYP_02_ASEReadCounter.table","NW_015090842.1:6313909",2,2,0
"ARY1","s1693_S_HYP_02_ASEReadCounter.table","NW_015090842.1:6314296",4,7,3
"ARY1","s1693_S_HYP_02_ASEReadCounter.table","NW_015090842.1:6314541",6,9,3
"ARY1","s1693_S_HYP_02_ASEReadCounter.table","NW_015090842.1:6314597",8,10,2
"ARY1","s1693_S_HYP_02_ASEReadCounter.table","NW_015090842.1:6314750",4,6,2
"ARY1","s1693_S_HYP_02_ASEReadCounter.table","NW_015090842.1:6314794",4,5,1
"ARY1","s1693_S_HYP_02_ASEReadCounter.table","NW_015090842.1:6314827",2,3,1
"ARY1","s1693_S_HYP_02_ASEReadCounter.table","NW_015090842.1:6314843",2,4,2
"ARY1","s1693_S_HYP_02_ASEReadCounter.table","NW_015090842.1:6314859",5,8,3
"ARY1","s1693_S_HYP_02_ASEReadCounter.table","NW_015090842.1:6314886",6,10,4
"ARY1","s1693_S_HYP_02_ASEReadCounter.table","NW_015090842.1:6314943",9,9,0
"ARY1","s1693_S_HYP_02_ASEReadCounter.table","NW_015090842.1:6314949",2,6,4
"ARY1","s1693_S_HYP_02_ASEReadCounter.table","NW_015090842.1:6315022",5,7,2
"ARY1","s1693_S_HYP_02_ASEReadCounter.table","NW_015090842.1:6315026",6,8,2
"ARY1","s1693_S_HYP_02_ASEReadCounter.table","NW_015090842.1:6315043",5,8,3
"ARY1","s1693_S_HYP_02_ASEReadCounter.table","NW_015090842.1:6315065",3,8,5
"ARY1","s1693_S_HYP_02_ASEReadCounter.table","NW_015090842.1:6315409",6,12,6
"ARY1","s1693_S_HYP_02_ASEReadCounter.table","NW_015090842.1:6315479",8,15,7
"ARY1","s1693_S_HYP_02_ASEReadCounter.table","NW_015090842.1:6318342",12,17,5
"ARY1","s1693_S_HYP_02_ASEReadCounter.table","NW_015090842.1:6318427",18,26,8
"ARY1","s1693_S_HYP_02_ASEReadCounter.table","NW_015090842.1:6318603",12,21,9
"ARY1","s1693_S_HYP_02_ASEReadCounter.table","NW_015090842.1:6318708",9,13,4
"ARY1","s1693_S_HYP_02_ASEReadCounter.table","NW_015090842.1:6318858",17,23,6
"ARY1","s1693_S_HYP_02_ASEReadCounter.table","NW_015090842.1:6318952",9,22,13
"MPHOSPH6","s1693_S_HYP_02_ASEReadCounter.table","NW_015090842.1:6324063",63,129,66
"MPHOSPH6","s1693_S_HYP_02_ASEReadCounter.table","NW_015090842.1:6324174",91,247,156
"MPHOSPH6","s1693_S_HYP_02_ASEReadCounter.table","NW_015090842.1:6324270",122,312,190
"MPHOSPH6","s1693_S_HYP_02_ASEReadCounter.table","NW_015090842.1:6324762",97,220,123
"MPHOSPH6","s1693_S_HYP_02_ASEReadCounter.table","NW_015090842.1:6324772",88,199,111
"MPHOSPH6","s1693_S_HYP_02_ASEReadCounter.table","NW_015090842.1:6324780",81,191,110
"MPHOSPH6","s1693_S_HYP_02_ASEReadCounter.table","NW_015090842.1:6324902",85,194,109
"MPHOSPH6","s1693_S_HYP_02_ASEReadCounter.table","NW_015090842.1:6324910",198,198,0
"MPHOSPH6","s1693_S_HYP_02_ASEReadCounter.table","NW_015090842.1:6325066",92,220,128
"MPHOSPH6","s1693_S_HYP_02_ASEReadCounter.table","NW_015090842.1:6325089",105,255,150
"MPHOSPH6","s1693_S_HYP_02_ASEReadCounter.table","NW_015090842.1:6325298",105,256,151
"MPHOSPH6","s1693_S_HYP_02_ASEReadCounter.table","NW_015090842.1:6325877",77,188,111
"MPHOSPH6","s1693_S_HYP_02_ASEReadCounter.table","NW_015090842.1:6326976",60,148,88
"CDH13","s1693_S_HYP_02_ASEReadCounter.table","NW_015090842.1:6662283",10,14,4
"CDH13","s1693_S_HYP_02_ASEReadCounter.table","NW_015090842.1:6693665",5,10,5
"CDH13","s1693_S_HYP_02_ASEReadCounter.table","NW_015090842.1:6693697",6,10,4
"CDH13","s1693_S_HYP_02_ASEReadCounter.table","NW_015090842.1:6693712",5,8,3
"CDH13","s1693_S_HYP_02_ASEReadCounter.table","NW_015090842.1:6693723",4,7,3
"CDH13","s1693_S_HYP_02_ASEReadCounter.table","NW_015090842.1:6693738",5,7,2
"CDH13","s1693_S_HYP_02_ASEReadCounter.table","NW_015090842.1:6823730",3,14,11
"CDH13","s1693_S_HYP_02_ASEReadCounter.table","NW_015090842.1:6889713",11,26,15
"CDH13","s1693_S_HYP_02_ASEReadCounter.table","NW_015090842.1:6955167",21,38,17
"MLYCD","s1693_S_HYP_02_ASEReadCounter.table","NW_015090842.1:7150054",92,157,65
"MLYCD","s1693_S_HYP_02_ASEReadCounter.table","NW_015090842.1:7150131",148,256,108
"MLYCD","s1693_S_HYP_02_ASEReadCounter.table","NW_015090842.1:7150585",74,163,89
"MLYCD","s1693_S_HYP_02_ASEReadCounter.table","NW_015090842.1:7150686",73,142,69
"MLYCD","s1693_S_HYP_02_ASEReadCounter.table","NW_015090842.1:7150696",79,152,73
"MLYCD","s1693_S_HYP_02_ASEReadCounter.table","NW_015090842.1:7150698",72,154,82
"MLYCD","s1693_S_HYP_02_ASEReadCounter.table","NW_015090842.1:7150869",63,110,47
"MLYCD","s1693_S_HYP_02_ASEReadCounter.table","NW_015090842.1:7151100",52,107,55
"MLYCD","s1693_S_HYP_02_ASEReadCounter.table","NW_015090842.1:7151127",57,113,56
"MLYCD","s1693_S_HYP_02_ASEReadCounter.table","NW_015090842.1:7157538",38,67,29
"MLYCD","s1693_S_HYP_02_ASEReadCounter.table","NW_015090842.1:7167662",16,38,22
"MLYCD","s1693_S_HYP_02_ASEReadCounter.table","NW_015090842.1:7167675",14,39,25
"MLYCD","s1693_S_HYP_02_ASEReadCounter.table","NW_015090842.1:7167710",18,46,28
"MLYCD","s1693_S_HYP_02_ASEReadCounter.table","NW_015090842.1:7167781",15,37,22
"MLYCD","s1693_S_HYP_02_ASEReadCounter.table","NW_015090842.1:7167803",11,27,16
"MLYCD","s1693_S_HYP_02_ASEReadCounter.table","NW_015090842.1:7167812",9,25,16
"MLYCD","s1693_S_HYP_02_ASEReadCounter.table","NW_015090842.1:7167845",12,29,17
"MLYCD","s1693_S_HYP_02_ASEReadCounter.table","NW_015090842.1:7167862",9,21,12
"MLYCD","s1693_S_HYP_02_ASEReadCounter.table","NW_015090842.1:7167929",9,21,12
"MLYCD","s1693_S_HYP_02_ASEReadCounter.table","NW_015090842.1:7167995",10,17,7
"MLYCD","s1693_S_HYP_02_ASEReadCounter.table","NW_015090842.1:7168005",10,15,5
"MLYCD","s1693_S_HYP_02_ASEReadCounter.table","NW_015090842.1:7168037",8,14,6
"HSBP1","s1693_S_HYP_02_ASEReadCounter.table","NW_015090842.1:7245192",568,922,354
"HSBP1","s1693_S_HYP_02_ASEReadCounter.table","NW_015090842.1:7245226",591,1043,452
"HSBP1","s1693_S_HYP_02_ASEReadCounter.table","NW_015090842.1:7245257",498,894,396
"HSBP1","s1693_S_HYP_02_ASEReadCounter.table","NW_015090842.1:7245296",445,883,438
"HSBP1","s1693_S_HYP_02_ASEReadCounter.table","NW_015090842.1:7245389",664,1156,492
"HSBP1","s1693_S_HYP_02_ASEReadCounter.table","NW_015090842.1:7245400",682,1130,448
"HSBP1","s1693_S_HYP_02_ASEReadCounter.table","NW_015090842.1:7245445",649,1093,444
"HSBP1","s1693_S_HYP_02_ASEReadCounter.table","NW_015090842.1:7245495",603,1045,442
"HSBP1","s1693_S_HYP_02_ASEReadCounter.table","NW_015090842.1:7245515",656,1128,472
"HSBP1","s1693_S_HYP_02_ASEReadCounter.table","NW_015090842.1:7245733",364,705,341
"HSBP1","s1693_S_HYP_02_ASEReadCounter.table","NW_015090842.1:7245771",369,651,282
"HSBP1","s1693_S_HYP_02_ASEReadCounter.table","NW_015090842.1:7245813",357,625,268
"HSBP1","s1693_S_HYP_02_ASEReadCounter.table","NW_015090842.1:7245926",428,743,315
"HSBP1","s1693_S_HYP_02_ASEReadCounter.table","NW_015090842.1:7245927",424,733,309
"HSBP1","s1693_S_HYP_02_ASEReadCounter.table","NW_015090842.1:7245933",424,714,290
"HSBP1","s1693_S_HYP_02_ASEReadCounter.table","NW_015090842.1:7246002",316,573,257
"HSBP1","s1693_S_HYP_02_ASEReadCounter.table","NW_015090842.1:7246094",351,631,280
"HSBP1","s1693_S_HYP_02_ASEReadCounter.table","NW_015090842.1:7246167",362,608,246
"HSBP1","s1693_S_HYP_02_ASEReadCounter.table","NW_015090842.1:7246183",346,595,249
"HSBP1","s1693_S_HYP_02_ASEReadCounter.table","NW_015090842.1:7247285",34,51,17
"HSBP1","s1693_S_HYP_02_ASEReadCounter.table","NW_015090842.1:7247651",413,801,388
"HSBP1","s1693_S_HYP_02_ASEReadCounter.table","NW_015090842.1:7247657",417,822,405
"HSBP1","s1693_S_HYP_02_ASEReadCounter.table","NW_015090842.1:7248520",280,539,259
"HSBP1","s1693_S_HYP_02_ASEReadCounter.table","NW_015090842.1:7248535",224,426,202
"KCNG4","s1693_S_HYP_02_ASEReadCounter.table","NW_015090842.1:7282481",6,7,1
"KCNG4","s1693_S_HYP_02_ASEReadCounter.table","NW_015090842.1:7282500",5,6,1
"KCNG4","s1693_S_HYP_02_ASEReadCounter.table","NW_015090842.1:7282542",9,11,2
"KCNG4","s1693_S_HYP_02_ASEReadCounter.table","NW_015090842.1:7282579",6,9,3
"KCNG4","s1693_S_HYP_02_ASEReadCounter.table","NW_015090842.1:7282630",5,8,3
"KCNG4","s1693_S_HYP_02_ASEReadCounter.table","NW_015090842.1:7282760",2,4,2
"KCNG4","s1693_S_HYP_02_ASEReadCounter.table","NW_015090842.1:7283056",1,3,2
"KCNG4","s1693_S_HYP_02_ASEReadCounter.table","NW_015090842.1:7283245",3,3,0
"KCNG4","s1693_S_HYP_02_ASEReadCounter.table","NW_015090842.1:7299491",3,4,1
"KCNG4","s1693_S_HYP_02_ASEReadCounter.table","NW_015090842.1:7301413",0,1,1
"ATP2C2","s1693_S_HYP_02_ASEReadCounter.table","NW_015090842.1:7413747",3,10,7
"TLDC1","s1693_S_HYP_02_ASEReadCounter.table","NW_015090842.1:7421997",26,51,25
"COTL1","s1693_S_HYP_02_ASEReadCounter.table","NW_015090842.1:7490707",735,1498,763
"COTL1","s1693_S_HYP_02_ASEReadCounter.table","NW_015090842.1:7490708",734,1507,773
"COTL1","s1693_S_HYP_02_ASEReadCounter.table","NW_015090842.1:7490711",747,1527,780
"COTL1","s1693_S_HYP_02_ASEReadCounter.table","NW_015090842.1:7490739",704,1497,793
"COTL1","s1693_S_HYP_02_ASEReadCounter.table","NW_015090842.1:7490785",665,1401,736
"COTL1","s1693_S_HYP_02_ASEReadCounter.table","NW_015090842.1:7490820",71,926,855
"COTL1","s1693_S_HYP_02_ASEReadCounter.table","NW_015090842.1:7490846",720,1432,712
"COTL1","s1693_S_HYP_02_ASEReadCounter.table","NW_015090842.1:7505672",0,1,1
"KLHL36","s1693_S_HYP_02_ASEReadCounter.table","NW_015090842.1:7526337",44,44,0
"KLHL36","s1693_S_HYP_02_ASEReadCounter.table","NW_015090842.1:7537681",110,110,0
"USP10","s1693_S_HYP_02_ASEReadCounter.table","NW_015090842.1:7572213",30,52,22
"USP10","s1693_S_HYP_02_ASEReadCounter.table","NW_015090842.1:7572358",21,37,16
"CRISPLD2","s1693_S_HYP_02_ASEReadCounter.table","NW_015090842.1:7630779",1,2,1
"CRISPLD2","s1693_S_HYP_02_ASEReadCounter.table","NW_015090842.1:7633611",7,7,0
"CRISPLD2","s1693_S_HYP_02_ASEReadCounter.table","NW_015090842.1:7633787",3,7,4
"CRISPLD2","s1693_S_HYP_02_ASEReadCounter.table","NW_015090842.1:7634023",2,4,2
"CRISPLD2","s1693_S_HYP_02_ASEReadCounter.table","NW_015090842.1:7634620",0,2,2
"CRISPLD2","s1693_S_HYP_02_ASEReadCounter.table","NW_015090842.1:7636315",1,4,3
"MTHFSD","s1693_S_HYP_02_ASEReadCounter.table","NW_015090842.1:8152578",12,32,20
"DUSP15","s1693_S_HYP_02_ASEReadCounter.table","NW_015090842.1:8422840",0,2,2
"EMC8","s1693_S_HYP_02_ASEReadCounter.table","NW_015090842.1:8452385",37,56,19
"GINS2","s1693_S_HYP_02_ASEReadCounter.table","NW_015090842.1:8467469",22,22,0
"GINS2","s1693_S_HYP_02_ASEReadCounter.table","NW_015090842.1:8470290",31,68,37
"GINS2","s1693_S_HYP_02_ASEReadCounter.table","NW_015090842.1:8470305",32,69,37
"GINS2","s1693_S_HYP_02_ASEReadCounter.table","NW_015090842.1:8470376",25,60,35
"GINS2","s1693_S_HYP_02_ASEReadCounter.table","NW_015090842.1:8471057",0,10,10
"GSE1","s1693_S_HYP_02_ASEReadCounter.table","NW_015090842.1:8483570",8,8,0
"KIAA0513","s1693_S_HYP_02_ASEReadCounter.table","NW_015090842.1:8674736",87,87,0
"KIAA0513","s1693_S_HYP_02_ASEReadCounter.table","NW_015090842.1:8687268",1,1,0
"KIAA0513","s1693_S_HYP_02_ASEReadCounter.table","NW_015090842.1:8693655",7,7,0
"ZCCHC14","s1693_S_HYP_02_ASEReadCounter.table","NW_015090842.1:8750189",127,127,0
"JPH3","s1693_S_HYP_02_ASEReadCounter.table","NW_015090842.1:8872294",49,96,47
"KLHDC4","s1693_S_HYP_02_ASEReadCounter.table","NW_015090842.1:8891175",91,184,93
"KLHDC4","s1693_S_HYP_02_ASEReadCounter.table","NW_015090842.1:8905251",23,63,40
"KLHDC4","s1693_S_HYP_02_ASEReadCounter.table","NW_015090842.1:8919630",2,5,3
"SLC7A5","s1693_S_HYP_02_ASEReadCounter.table","NW_015090842.1:8940382",250,250,0
"SLC7A5","s1693_S_HYP_02_ASEReadCounter.table","NW_015090842.1:8941818",131,131,0
"SLC7A5","s1693_S_HYP_02_ASEReadCounter.table","NW_015090842.1:8944655",63,63,0
"CA5A","s1693_S_HYP_02_ASEReadCounter.table","NW_015090842.1:8989479",80,152,72
"CA5A","s1693_S_HYP_02_ASEReadCounter.table","NW_015090842.1:8989562",112,211,99
"CA5A","s1693_S_HYP_02_ASEReadCounter.table","NW_015090842.1:8989609",110,223,113
"CA5A","s1693_S_HYP_02_ASEReadCounter.table","NW_015090842.1:8989693",113,237,124
"CA5A","s1693_S_HYP_02_ASEReadCounter.table","NW_015090842.1:8989702",122,224,102
"CA5A","s1693_S_HYP_02_ASEReadCounter.table","NW_015090842.1:8989746",124,234,110
"CA5A","s1693_S_HYP_02_ASEReadCounter.table","NW_015090842.1:8989880",100,204,104
"CA5A","s1693_S_HYP_02_ASEReadCounter.table","NW_015090842.1:8989885",103,205,102
"CA5A","s1693_S_HYP_02_ASEReadCounter.table","NW_015090842.1:8989929",102,199,97
"CA5A","s1693_S_HYP_02_ASEReadCounter.table","NW_015090842.1:8990002",83,187,104
"CA5A","s1693_S_HYP_02_ASEReadCounter.table","NW_015090842.1:8990004",83,184,101
"CA5A","s1693_S_HYP_02_ASEReadCounter.table","NW_015090842.1:8990005",82,184,102
"CA5A","s1693_S_HYP_02_ASEReadCounter.table","NW_015090842.1:8990017",83,182,99
"CA5A","s1693_S_HYP_02_ASEReadCounter.table","NW_015090842.1:8990043",73,170,97
"CA5A","s1693_S_HYP_02_ASEReadCounter.table","NW_015090842.1:8990080",65,168,103
"CA5A","s1693_S_HYP_02_ASEReadCounter.table","NW_015090842.1:8990084",64,165,101
"CA5A","s1693_S_HYP_02_ASEReadCounter.table","NW_015090842.1:8990090",67,168,101
"CA5A","s1693_S_HYP_02_ASEReadCounter.table","NW_015090842.1:8990095",67,163,96
"CA5A","s1693_S_HYP_02_ASEReadCounter.table","NW_015090842.1:8990111",47,142,95
"CA5A","s1693_S_HYP_02_ASEReadCounter.table","NW_015090842.1:8990112",47,140,93
"CA5A","s1693_S_HYP_02_ASEReadCounter.table","NW_015090842.1:8990115",50,142,92
"CA5A","s1693_S_HYP_02_ASEReadCounter.table","NW_015090842.1:8990166",49,108,59
"CA5A","s1693_S_HYP_02_ASEReadCounter.table","NW_015090842.1:8990169",55,114,59
"CA5A","s1693_S_HYP_02_ASEReadCounter.table","NW_015090842.1:8990222",40,97,57
"CA5A","s1693_S_HYP_02_ASEReadCounter.table","NW_015090842.1:8990289",52,121,69
"CA5A","s1693_S_HYP_02_ASEReadCounter.table","NW_015090842.1:8990314",59,134,75
"CA5A","s1693_S_HYP_02_ASEReadCounter.table","NW_015090842.1:8990361",52,114,62
"CA5A","s1693_S_HYP_02_ASEReadCounter.table","NW_015090842.1:8990368",55,119,64
"CA5A","s1693_S_HYP_02_ASEReadCounter.table","NW_015090842.1:8990429",57,119,62
"CA5A","s1693_S_HYP_02_ASEReadCounter.table","NW_015090842.1:8990466",57,104,47
"CA5A","s1693_S_HYP_02_ASEReadCounter.table","NW_015090842.1:8990663",47,83,36
"CA5A","s1693_S_HYP_02_ASEReadCounter.table","NW_015090842.1:8990797",36,76,40
"CA5A","s1693_S_HYP_02_ASEReadCounter.table","NW_015090842.1:8990836",38,75,37
"CA5A","s1693_S_HYP_02_ASEReadCounter.table","NW_015090842.1:8990842",38,77,39
"CA5A","s1693_S_HYP_02_ASEReadCounter.table","NW_015090842.1:8990851",37,74,37
"CA5A","s1693_S_HYP_02_ASEReadCounter.table","NW_015090842.1:8990918",37,76,39
"CA5A","s1693_S_HYP_02_ASEReadCounter.table","NW_015090842.1:8990921",37,81,44
"CA5A","s1693_S_HYP_02_ASEReadCounter.table","NW_015090842.1:8990942",44,88,44
"CA5A","s1693_S_HYP_02_ASEReadCounter.table","NW_015090842.1:8991001",44,93,49
"CA5A","s1693_S_HYP_02_ASEReadCounter.table","NW_015090842.1:8991038",37,83,46
"CA5A","s1693_S_HYP_02_ASEReadCounter.table","NW_015090842.1:8991149",55,103,48
"CA5A","s1693_S_HYP_02_ASEReadCounter.table","NW_015090842.1:8991176",61,106,45
"CA5A","s1693_S_HYP_02_ASEReadCounter.table","NW_015090842.1:8991241",40,89,49
"CA5A","s1693_S_HYP_02_ASEReadCounter.table","NW_015090842.1:8991262",27,68,41
"CA5A","s1693_S_HYP_02_ASEReadCounter.table","NW_015090842.1:8991316",36,40,4
"CA5A","s1693_S_HYP_02_ASEReadCounter.table","NW_015090842.1:8991319",37,41,4
"CA5A","s1693_S_HYP_02_ASEReadCounter.table","NW_015090842.1:8991330",44,45,1
"CA5A","s1693_S_HYP_02_ASEReadCounter.table","NW_015090842.1:8991334",42,44,2
"CA5A","s1693_S_HYP_02_ASEReadCounter.table","NW_015090842.1:8991362",46,73,27
"CA5A","s1693_S_HYP_02_ASEReadCounter.table","NW_015090842.1:8991368",45,72,27
"CA5A","s1693_S_HYP_02_ASEReadCounter.table","NW_015090842.1:8991390",45,75,30
"CA5A","s1693_S_HYP_02_ASEReadCounter.table","NW_015090842.1:8991395",44,79,35
"CA5A","s1693_S_HYP_02_ASEReadCounter.table","NW_015090842.1:8991422",37,86,49
"CA5A","s1693_S_HYP_02_ASEReadCounter.table","NW_015090842.1:8991467",39,78,39
"CA5A","s1693_S_HYP_02_ASEReadCounter.table","NW_015090842.1:8991576",34,80,46
"CA5A","s1693_S_HYP_02_ASEReadCounter.table","NW_015090842.1:8991587",45,94,49
"CA5A","s1693_S_HYP_02_ASEReadCounter.table","NW_015090842.1:8991655",52,104,52
"CA5A","s1693_S_HYP_02_ASEReadCounter.table","NW_015090842.1:8991717",43,86,43
"CA5A","s1693_S_HYP_02_ASEReadCounter.table","NW_015090842.1:8991726",43,84,41
"CA5A","s1693_S_HYP_02_ASEReadCounter.table","NW_015090842.1:8991799",34,71,37
"CA5A","s1693_S_HYP_02_ASEReadCounter.table","NW_015090842.1:8991809",31,64,33
"CA5A","s1693_S_HYP_02_ASEReadCounter.table","NW_015090842.1:8991848",23,51,28
"CA5A","s1693_S_HYP_02_ASEReadCounter.table","NW_015090842.1:8991849",23,52,29
"CA5A","s1693_S_HYP_02_ASEReadCounter.table","NW_015090842.1:8991927",33,61,28
"CA5A","s1693_S_HYP_02_ASEReadCounter.table","NW_015090842.1:8991941",32,60,28
"CA5A","s1693_S_HYP_02_ASEReadCounter.table","NW_015090842.1:8992121",25,52,27
"CA5A","s1693_S_HYP_02_ASEReadCounter.table","NW_015090842.1:8992224",32,62,30
"CA5A","s1693_S_HYP_02_ASEReadCounter.table","NW_015090842.1:9002570",17,32,15
"CA5A","s1693_S_HYP_02_ASEReadCounter.table","NW_015090842.1:9002600",17,33,16
"CA5A","s1693_S_HYP_02_ASEReadCounter.table","NW_015090842.1:9004312",13,20,7
"CA5A","s1693_S_HYP_02_ASEReadCounter.table","NW_015090842.1:9004556",2,2,0
"CA5A","s1693_S_HYP_02_ASEReadCounter.table","NW_015090842.1:9004620",3,4,1
"CA5A","s1693_S_HYP_02_ASEReadCounter.table","NW_015090842.1:9005116",5,6,1
"CA5A","s1693_S_HYP_02_ASEReadCounter.table","NW_015090842.1:9005120",5,6,1
"CA5A","s1693_S_HYP_02_ASEReadCounter.table","NW_015090842.1:9005140",7,8,1
"CA5A","s1693_S_HYP_02_ASEReadCounter.table","NW_015090842.1:9005152",7,9,2
"BANP","s1693_S_HYP_02_ASEReadCounter.table","NW_015090842.1:9033407",5,8,3
"BANP","s1693_S_HYP_02_ASEReadCounter.table","NW_015090842.1:9033409",5,7,2
"BANP","s1693_S_HYP_02_ASEReadCounter.table","NW_015090842.1:9033420",5,10,5
"BANP","s1693_S_HYP_02_ASEReadCounter.table","NW_015090842.1:9055284",6,16,10
"ZC3H18","s1693_S_HYP_02_ASEReadCounter.table","NW_015090842.1:9528933",29,60,31
"MVD","s1693_S_HYP_02_ASEReadCounter.table","NW_015090842.1:9550690",67,67,0
"MVD","s1693_S_HYP_02_ASEReadCounter.table","NW_015090842.1:9550691",67,67,0
"MVD","s1693_S_HYP_02_ASEReadCounter.table","NW_015090842.1:9550699",74,74,0
"MVD","s1693_S_HYP_02_ASEReadCounter.table","NW_015090842.1:9550701",76,76,0
"MVD","s1693_S_HYP_02_ASEReadCounter.table","NW_015090842.1:9552202",95,95,0
"MVD","s1693_S_HYP_02_ASEReadCounter.table","NW_015090842.1:9552223",89,89,0
"MVD","s1693_S_HYP_02_ASEReadCounter.table","NW_015090842.1:9552533",78,78,0
"MVD","s1693_S_HYP_02_ASEReadCounter.table","NW_015090842.1:9552644",23,44,21
"PIEZO1","s1693_S_HYP_02_ASEReadCounter.table","NW_015090842.1:9577447",5,12,7
"PIEZO1","s1693_S_HYP_02_ASEReadCounter.table","NW_015090842.1:9579101",3,9,6
"PIEZO1","s1693_S_HYP_02_ASEReadCounter.table","NW_015090842.1:9582630",2,5,3
"PIEZO1","s1693_S_HYP_02_ASEReadCounter.table","NW_015090842.1:9582976",3,6,3
"PIEZO1","s1693_S_HYP_02_ASEReadCounter.table","NW_015090842.1:9583326",3,3,0
"CDT1","s1693_S_HYP_02_ASEReadCounter.table","NW_015090842.1:9596711",4,6,2
"CDT1","s1693_S_HYP_02_ASEReadCounter.table","NW_015090842.1:9597033",8,8,0
"CDT1","s1693_S_HYP_02_ASEReadCounter.table","NW_015090842.1:9597756",3,6,3
"CDT1","s1693_S_HYP_02_ASEReadCounter.table","NW_015090842.1:9598873",14,14,0
"PABPN1L","s1693_S_HYP_02_ASEReadCounter.table","NW_015090842.1:9669510",0,1,1
"ACSF3","s1693_S_HYP_02_ASEReadCounter.table","NW_015090842.1:9776737",6,11,5
"ACSF3","s1693_S_HYP_02_ASEReadCounter.table","NW_015090842.1:9809639",96,96,0
"ACSF3","s1693_S_HYP_02_ASEReadCounter.table","NW_015090842.1:9834743",53,108,55
"ACSF3","s1693_S_HYP_02_ASEReadCounter.table","NW_015090842.1:9834762",118,118,0
"ACSF3","s1693_S_HYP_02_ASEReadCounter.table","NW_015090842.1:9834852",80,135,55
"ACSF3","s1693_S_HYP_02_ASEReadCounter.table","NW_015090842.1:9834861",71,123,52
"ACSF3","s1693_S_HYP_02_ASEReadCounter.table","NW_015090842.1:9839359",54,101,47
"ACSF3","s1693_S_HYP_02_ASEReadCounter.table","NW_015090842.1:9839378",49,88,39
"ACSF3","s1693_S_HYP_02_ASEReadCounter.table","NW_015090842.1:9839455",49,88,39
"ACSF3","s1693_S_HYP_02_ASEReadCounter.table","NW_015090842.1:9839457",49,84,35
"ACSF3","s1693_S_HYP_02_ASEReadCounter.table","NW_015090842.1:9839489",43,71,28
"ACSF3","s1693_S_HYP_02_ASEReadCounter.table","NW_015090842.1:9839500",33,59,26
"ACSF3","s1693_S_HYP_02_ASEReadCounter.table","NW_015090842.1:9839501",33,60,27
"ACSF3","s1693_S_HYP_02_ASEReadCounter.table","NW_015090842.1:9839504",35,60,25
"ACSF3","s1693_S_HYP_02_ASEReadCounter.table","NW_015090842.1:9839512",29,50,21
"ACSF3","s1693_S_HYP_02_ASEReadCounter.table","NW_015090842.1:9839527",26,45,19
"ACSF3","s1693_S_HYP_02_ASEReadCounter.table","NW_015090842.1:9839533",10,25,15
"ACSF3","s1693_S_HYP_02_ASEReadCounter.table","NW_015090842.1:9839535",10,24,14
"ACSF3","s1693_S_HYP_02_ASEReadCounter.table","NW_015090842.1:9839545",6,20,14
"ACSF3","s1693_S_HYP_02_ASEReadCounter.table","NW_015090842.1:9839550",6,20,14
"ACSF3","s1693_S_HYP_02_ASEReadCounter.table","NW_015090842.1:9839551",6,19,13
"CDH15","s1693_S_HYP_02_ASEReadCounter.table","NW_015090842.1:9848531",1,1,0
"CDH15","s1693_S_HYP_02_ASEReadCounter.table","NW_015090842.1:9848552",1,1,0
"CDH15","s1693_S_HYP_02_ASEReadCounter.table","NW_015090842.1:9848888",2,2,0
"CDH15","s1693_S_HYP_02_ASEReadCounter.table","NW_015090842.1:9849086",3,3,0
"CDH15","s1693_S_HYP_02_ASEReadCounter.table","NW_015090842.1:9849119",3,3,0
"CDH15","s1693_S_HYP_02_ASEReadCounter.table","NW_015090842.1:9849140",1,1,0
"CDH15","s1693_S_HYP_02_ASEReadCounter.table","NW_015090842.1:9849473",5,5,0
"CDH15","s1693_S_HYP_02_ASEReadCounter.table","NW_015090842.1:9850141",1,1,0
"CDH15","s1693_S_HYP_02_ASEReadCounter.table","NW_015090842.1:9850386",2,3,1
"CDH15","s1693_S_HYP_02_ASEReadCounter.table","NW_015090842.1:9850432",2,3,1
"CDH15","s1693_S_HYP_02_ASEReadCounter.table","NW_015090842.1:9850609",1,3,2
"SLC22A31","s1693_S_HYP_02_ASEReadCounter.table","NW_015090842.1:9850797",0,4,4
"SLC22A31","s1693_S_HYP_02_ASEReadCounter.table","NW_015090842.1:9850818",1,5,4
"SLC22A31","s1693_S_HYP_02_ASEReadCounter.table","NW_015090842.1:9850929",2,2,0
"SLC22A31","s1693_S_HYP_02_ASEReadCounter.table","NW_015090842.1:9850936",2,2,0
"SLC22A31","s1693_S_HYP_02_ASEReadCounter.table","NW_015090842.1:9850940",2,2,0
"SLC22A31","s1693_S_HYP_02_ASEReadCounter.table","NW_015090842.1:9850948",2,2,0
"SLC22A31","s1693_S_HYP_02_ASEReadCounter.table","NW_015090842.1:9850961",1,2,1
"SLC22A31","s1693_S_HYP_02_ASEReadCounter.table","NW_015090842.1:9850970",0,1,1
"SLC22A31","s1693_S_HYP_02_ASEReadCounter.table","NW_015090842.1:9850978",0,2,2
"SLC22A31","s1693_S_HYP_02_ASEReadCounter.table","NW_015090842.1:9850981",0,2,2
"SLC22A31","s1693_S_HYP_02_ASEReadCounter.table","NW_015090842.1:9851032",0,2,2
"SLC22A31","s1693_S_HYP_02_ASEReadCounter.table","NW_015090842.1:9851053",0,2,2
"SLC22A31","s1693_S_HYP_02_ASEReadCounter.table","NW_015090842.1:9851130",8,18,10
"SLC22A31","s1693_S_HYP_02_ASEReadCounter.table","NW_015090842.1:9851139",8,18,10
"SLC22A31","s1693_S_HYP_02_ASEReadCounter.table","NW_015090842.1:9851265",16,32,16
"SLC22A31","s1693_S_HYP_02_ASEReadCounter.table","NW_015090842.1:9851302",11,29,18
"SLC22A31","s1693_S_HYP_02_ASEReadCounter.table","NW_015090842.1:9851303",11,29,18
"SLC22A31","s1693_S_HYP_02_ASEReadCounter.table","NW_015090842.1:9851305",11,28,17
"SLC22A31","s1693_S_HYP_02_ASEReadCounter.table","NW_015090842.1:9851343",11,25,14
"SLC22A31","s1693_S_HYP_02_ASEReadCounter.table","NW_015090842.1:9851344",11,24,13
"SLC22A31","s1693_S_HYP_02_ASEReadCounter.table","NW_015090842.1:9851381",13,27,14
"SLC22A31","s1693_S_HYP_02_ASEReadCounter.table","NW_015090842.1:9851421",10,28,18
"SLC22A31","s1693_S_HYP_02_ASEReadCounter.table","NW_015090842.1:9851526",19,31,12
"SLC22A31","s1693_S_HYP_02_ASEReadCounter.table","NW_015090842.1:9851589",20,32,12
"SLC22A31","s1693_S_HYP_02_ASEReadCounter.table","NW_015090842.1:9851712",14,22,8
"SLC22A31","s1693_S_HYP_02_ASEReadCounter.table","NW_015090842.1:9851899",8,20,12
"SLC22A31","s1693_S_HYP_02_ASEReadCounter.table","NW_015090842.1:9852139",13,27,14
"SLC22A31","s1693_S_HYP_02_ASEReadCounter.table","NW_015090842.1:9852380",6,23,17
"SLC22A31","s1693_S_HYP_02_ASEReadCounter.table","NW_015090842.1:9852431",3,11,8
"SLC22A31","s1693_S_HYP_02_ASEReadCounter.table","NW_015090842.1:9852630",7,17,10
"SLC22A31","s1693_S_HYP_02_ASEReadCounter.table","NW_015090842.1:9852711",10,23,13
"SLC22A31","s1693_S_HYP_02_ASEReadCounter.table","NW_015090842.1:9852742",9,22,13
"SLC22A31","s1693_S_HYP_02_ASEReadCounter.table","NW_015090842.1:9853099",7,20,13
"SLC22A31","s1693_S_HYP_02_ASEReadCounter.table","NW_015090842.1:9853102",7,19,12
"SLC22A31","s1693_S_HYP_02_ASEReadCounter.table","NW_015090842.1:9853421",9,11,2
"SLC22A31","s1693_S_HYP_02_ASEReadCounter.table","NW_015090842.1:9853457",8,9,1
"SLC22A31","s1693_S_HYP_02_ASEReadCounter.table","NW_015090842.1:9853502",5,6,1
"ANKRD11","s1693_S_HYP_02_ASEReadCounter.table","NW_015090842.1:9858863",14,34,20
"ANKRD11","s1693_S_HYP_02_ASEReadCounter.table","NW_015090842.1:9859101",176,373,197
"ANKRD11","s1693_S_HYP_02_ASEReadCounter.table","NW_015090842.1:9859352",211,476,265
"ANKRD11","s1693_S_HYP_02_ASEReadCounter.table","NW_015090842.1:9859381",57,267,210
"ANKRD11","s1693_S_HYP_02_ASEReadCounter.table","NW_015090842.1:9859527",100,216,116
"ANKRD11","s1693_S_HYP_02_ASEReadCounter.table","NW_015090842.1:9859529",98,217,119
"ANKRD11","s1693_S_HYP_02_ASEReadCounter.table","NW_015090842.1:9859679",207,414,207
"ANKRD11","s1693_S_HYP_02_ASEReadCounter.table","NW_015090842.1:9861097",134,275,141
"ANKRD11","s1693_S_HYP_02_ASEReadCounter.table","NW_015090842.1:9862571",96,186,90
"ANKRD11","s1693_S_HYP_02_ASEReadCounter.table","NW_015090842.1:9866071",0,89,89
"ANKRD11","s1693_S_HYP_02_ASEReadCounter.table","NW_015090842.1:9866200",0,62,62
"ANKRD11","s1693_S_HYP_02_ASEReadCounter.table","NW_015090842.1:9867391",19,36,17
"ANKRD11","s1693_S_HYP_02_ASEReadCounter.table","NW_015090842.1:9867472",28,55,27
"ANKRD11","s1693_S_HYP_02_ASEReadCounter.table","NW_015090842.1:9867559",32,62,30
"ANKRD11","s1693_S_HYP_02_ASEReadCounter.table","NW_015090842.1:9867934",33,55,22
"ANKRD11","s1693_S_HYP_02_ASEReadCounter.table","NW_015090842.1:9868093",23,64,41
"ANKRD11","s1693_S_HYP_02_ASEReadCounter.table","NW_015090842.1:9868222",29,66,37
"ANKRD11","s1693_S_HYP_02_ASEReadCounter.table","NW_015090842.1:9868327",45,80,35
"ANKRD11","s1693_S_HYP_02_ASEReadCounter.table","NW_015090842.1:9868414",64,116,52
"ANKRD11","s1693_S_HYP_02_ASEReadCounter.table","NW_015090842.1:9868441",54,104,50
"ANKRD11","s1693_S_HYP_02_ASEReadCounter.table","NW_015090842.1:9868444",52,105,53
"ANKRD11","s1693_S_HYP_02_ASEReadCounter.table","NW_015090842.1:9868519",63,123,60
"ANKRD11","s1693_S_HYP_02_ASEReadCounter.table","NW_015090842.1:9868609",82,164,82
"ANKRD11","s1693_S_HYP_02_ASEReadCounter.table","NW_015090842.1:9868666",85,177,92
"ANKRD11","s1693_S_HYP_02_ASEReadCounter.table","NW_015090842.1:9869431",189,333,144
"ANKRD11","s1693_S_HYP_02_ASEReadCounter.table","NW_015090842.1:9869578",256,480,224
"ANKRD11","s1693_S_HYP_02_ASEReadCounter.table","NW_015090842.1:9869734",257,538,281
"ANKRD11","s1693_S_HYP_02_ASEReadCounter.table","NW_015090842.1:9870070",231,519,288
"ANKRD11","s1693_S_HYP_02_ASEReadCounter.table","NW_015090842.1:9870349",284,597,313
"ANKRD11","s1693_S_HYP_02_ASEReadCounter.table","NW_015090842.1:9870604",285,590,305
"ANKRD11","s1693_S_HYP_02_ASEReadCounter.table","NW_015090842.1:9870613",307,623,316
"ANKRD11","s1693_S_HYP_02_ASEReadCounter.table","NW_015090842.1:9870685",370,796,426
"ANKRD11","s1693_S_HYP_02_ASEReadCounter.table","NW_015090842.1:9870847",314,638,324
"ANKRD11","s1693_S_HYP_02_ASEReadCounter.table","NW_015090842.1:9871103",231,452,221
"ANKRD11","s1693_S_HYP_02_ASEReadCounter.table","NW_015090842.1:9871165",231,489,258
"ANKRD11","s1693_S_HYP_02_ASEReadCounter.table","NW_015090842.1:9871820",46,118,72
"ANKRD11","s1693_S_HYP_02_ASEReadCounter.table","NW_015090842.1:9871994",112,112,0
"ANKRD11","s1693_S_HYP_02_ASEReadCounter.table","NW_015090842.1:9872118",44,102,58
"SPG7","s1693_S_HYP_02_ASEReadCounter.table","NW_015090842.1:10051190",69,159,90
"SPG7","s1693_S_HYP_02_ASEReadCounter.table","NW_015090842.1:10051218",78,173,95
"SPG7","s1693_S_HYP_02_ASEReadCounter.table","NW_015090842.1:10052348",117,211,94
"SPG7","s1693_S_HYP_02_ASEReadCounter.table","NW_015090842.1:10052366",121,219,98
"SPG7","s1693_S_HYP_02_ASEReadCounter.table","NW_015090842.1:10065173",142,322,180
"SPG7","s1693_S_HYP_02_ASEReadCounter.table","NW_015090842.1:10065215",151,310,159
"SPG7","s1693_S_HYP_02_ASEReadCounter.table","NW_015090842.1:10066301",125,252,127
"SPG7","s1693_S_HYP_02_ASEReadCounter.table","NW_015090842.1:10066365",149,285,136
"SPG7","s1693_S_HYP_02_ASEReadCounter.table","NW_015090842.1:10069752",170,335,165
"SPG7","s1693_S_HYP_02_ASEReadCounter.table","NW_015090842.1:10069800",208,393,185
"SPG7","s1693_S_HYP_02_ASEReadCounter.table","NW_015090842.1:10071192",237,447,210
"SPG7","s1693_S_HYP_02_ASEReadCounter.table","NW_015090842.1:10071204",231,435,204
"SPG7","s1693_S_HYP_02_ASEReadCounter.table","NW_015090842.1:10071219",217,408,191
"SPG7","s1693_S_HYP_02_ASEReadCounter.table","NW_015090842.1:10071967",190,402,212
"SPG7","s1693_S_HYP_02_ASEReadCounter.table","NW_015090842.1:10075109",394,755,361
"SPG7","s1693_S_HYP_02_ASEReadCounter.table","NW_015090842.1:10075114",403,754,351
"SPG7","s1693_S_HYP_02_ASEReadCounter.table","NW_015090842.1:10075198",327,578,251
"SPG7","s1693_S_HYP_02_ASEReadCounter.table","NW_015090842.1:10075487",265,541,276
"SPG7","s1693_S_HYP_02_ASEReadCounter.table","NW_015090842.1:10075488",265,539,274
"SPG7","s1693_S_HYP_02_ASEReadCounter.table","NW_015090842.1:10075548",225,429,204
"RPL13","s1693_S_HYP_02_ASEReadCounter.table","NW_015090842.1:10076979",1,5,4
"RPL13","s1693_S_HYP_02_ASEReadCounter.table","NW_015090842.1:10077387",531,1178,647
"RPL13","s1693_S_HYP_02_ASEReadCounter.table","NW_015090842.1:10077978",825,1784,959
"RPL13","s1693_S_HYP_02_ASEReadCounter.table","NW_015090842.1:10077992",822,1716,894
"CPNE7","s1693_S_HYP_02_ASEReadCounter.table","NW_015090842.1:10084001",14,18,4
"CPNE7","s1693_S_HYP_02_ASEReadCounter.table","NW_015090842.1:10084856",9,12,3
"CPNE7","s1693_S_HYP_02_ASEReadCounter.table","NW_015090842.1:10084872",10,13,3
"CPNE7","s1693_S_HYP_02_ASEReadCounter.table","NW_015090842.1:10084892",9,14,5
"CPNE7","s1693_S_HYP_02_ASEReadCounter.table","NW_015090842.1:10084921",11,17,6
"CPNE7","s1693_S_HYP_02_ASEReadCounter.table","NW_015090842.1:10084935",11,19,8
"CPNE7","s1693_S_HYP_02_ASEReadCounter.table","NW_015090842.1:10085000",15,22,7
"CPNE7","s1693_S_HYP_02_ASEReadCounter.table","NW_015090842.1:10085089",14,24,10
"CPNE7","s1693_S_HYP_02_ASEReadCounter.table","NW_015090842.1:10085096",15,26,11
"CPNE7","s1693_S_HYP_02_ASEReadCounter.table","NW_015090842.1:10085126",15,27,12
"CPNE7","s1693_S_HYP_02_ASEReadCounter.table","NW_015090842.1:10085180",11,22,11
"CPNE7","s1693_S_HYP_02_ASEReadCounter.table","NW_015090842.1:10085201",13,20,7
"CPNE7","s1693_S_HYP_02_ASEReadCounter.table","NW_015090842.1:10088134",32,41,9
"CPNE7","s1693_S_HYP_02_ASEReadCounter.table","NW_015090842.1:10088146",34,42,8
"CPNE7","s1693_S_HYP_02_ASEReadCounter.table","NW_015090842.1:10088940",34,63,29
"CPNE7","s1693_S_HYP_02_ASEReadCounter.table","NW_015090842.1:10088965",37,70,33
"CPNE7","s1693_S_HYP_02_ASEReadCounter.table","NW_015090842.1:10088967",38,70,32
"CPNE7","s1693_S_HYP_02_ASEReadCounter.table","NW_015090842.1:10088973",35,64,29
"CPNE7","s1693_S_HYP_02_ASEReadCounter.table","NW_015090842.1:10090924",72,103,31
"CPNE7","s1693_S_HYP_02_ASEReadCounter.table","NW_015090842.1:10090930",73,104,31
"CPNE7","s1693_S_HYP_02_ASEReadCounter.table","NW_015090842.1:10091075",83,124,41
"CPNE7","s1693_S_HYP_02_ASEReadCounter.table","NW_015090842.1:10091389",69,121,52
"CPNE7","s1693_S_HYP_02_ASEReadCounter.table","NW_015090842.1:10091407",71,125,54
"CPNE7","s1693_S_HYP_02_ASEReadCounter.table","NW_015090842.1:10091530",85,149,64
"CPNE7","s1693_S_HYP_02_ASEReadCounter.table","NW_015090842.1:10091875",103,166,63
"CPNE7","s1693_S_HYP_02_ASEReadCounter.table","NW_015090842.1:10091983",91,160,69
"CPNE7","s1693_S_HYP_02_ASEReadCounter.table","NW_015090842.1:10091997",96,165,69
"CPNE7","s1693_S_HYP_02_ASEReadCounter.table","NW_015090842.1:10092038",51,83,32
"CPNE7","s1693_S_HYP_02_ASEReadCounter.table","NW_015090842.1:10092140",70,117,47
"CPNE7","s1693_S_HYP_02_ASEReadCounter.table","NW_015090842.1:10092183",51,80,29
"CPNE7","s1693_S_HYP_02_ASEReadCounter.table","NW_015090842.1:10092201",43,68,25
"CPNE7","s1693_S_HYP_02_ASEReadCounter.table","NW_015090842.1:10092230",32,46,14
"CPNE7","s1693_S_HYP_02_ASEReadCounter.table","NW_015090842.1:10092246",15,28,13
"LOC106888185","s1693_S_HYP_02_ASEReadCounter.table","NW_015090842.1:10094965",0,1,1
"LOC106888185","s1693_S_HYP_02_ASEReadCounter.table","NW_015090842.1:10094966",0,1,1
"LOC106888185","s1693_S_HYP_02_ASEReadCounter.table","NW_015090842.1:10094985",0,1,1
"LOC106888185","s1693_S_HYP_02_ASEReadCounter.table","NW_015090842.1:10095055",0,6,6
"LOC106888185","s1693_S_HYP_02_ASEReadCounter.table","NW_015090842.1:10095062",0,6,6
"LOC106888185","s1693_S_HYP_02_ASEReadCounter.table","NW_015090842.1:10095130",1,8,7
"LOC106888185","s1693_S_HYP_02_ASEReadCounter.table","NW_015090842.1:10095265",8,14,6
"LOC106888185","s1693_S_HYP_02_ASEReadCounter.table","NW_015090842.1:10095586",10,19,9
"LOC106888185","s1693_S_HYP_02_ASEReadCounter.table","NW_015090842.1:10095593",8,17,9
"LOC106888185","s1693_S_HYP_02_ASEReadCounter.table","NW_015090842.1:10095616",10,20,10
"LOC106888185","s1693_S_HYP_02_ASEReadCounter.table","NW_015090842.1:10095662",9,17,8
"LOC106888185","s1693_S_HYP_02_ASEReadCounter.table","NW_015090842.1:10095674",9,18,9
"LOC106888185","s1693_S_HYP_02_ASEReadCounter.table","NW_015090842.1:10095786",7,14,7
"LOC106888185","s1693_S_HYP_02_ASEReadCounter.table","NW_015090842.1:10095831",5,9,4
"LOC106888185","s1693_S_HYP_02_ASEReadCounter.table","NW_015090842.1:10096230",4,9,5
"LOC106888185","s1693_S_HYP_02_ASEReadCounter.table","NW_015090842.1:10096249",5,9,4
"LOC106888185","s1693_S_HYP_02_ASEReadCounter.table","NW_015090842.1:10096272",6,8,2
"LOC106888185","s1693_S_HYP_02_ASEReadCounter.table","NW_015090842.1:10096288",6,8,2
"LOC106888185","s1693_S_HYP_02_ASEReadCounter.table","NW_015090842.1:10097248",5,11,6
"LOC106888185","s1693_S_HYP_02_ASEReadCounter.table","NW_015090842.1:10097265",9,16,7
"LOC106888185","s1693_S_HYP_02_ASEReadCounter.table","NW_015090842.1:10097446",1,1,0
"DPEP1","s1693_S_HYP_02_ASEReadCounter.table","NW_015090842.1:10100044",0,1,1
"DPEP1","s1693_S_HYP_02_ASEReadCounter.table","NW_015090842.1:10100045",0,1,1
"DPEP1","s1693_S_HYP_02_ASEReadCounter.table","NW_015090842.1:10100084",0,1,1
"DPEP1","s1693_S_HYP_02_ASEReadCounter.table","NW_015090842.1:10100295",0,1,1
"DPEP1","s1693_S_HYP_02_ASEReadCounter.table","NW_015090842.1:10100893",0,2,2
"DPEP1","s1693_S_HYP_02_ASEReadCounter.table","NW_015090842.1:10100902",0,2,2
"DPEP1","s1693_S_HYP_02_ASEReadCounter.table","NW_015090842.1:10101072",0,4,4
"DPEP1","s1693_S_HYP_02_ASEReadCounter.table","NW_015090842.1:10101199",0,4,4
"DPEP1","s1693_S_HYP_02_ASEReadCounter.table","NW_015090842.1:10101483",0,1,1
"DPEP1","s1693_S_HYP_02_ASEReadCounter.table","NW_015090842.1:10101497",0,1,1
"DPEP1","s1693_S_HYP_02_ASEReadCounter.table","NW_015090842.1:10101525",0,2,2
"DPEP1","s1693_S_HYP_02_ASEReadCounter.table","NW_015090842.1:10101875",0,1,1
"DPEP1","s1693_S_HYP_02_ASEReadCounter.table","NW_015090842.1:10101913",0,1,1
"CHMP1A","s1693_S_HYP_02_ASEReadCounter.table","NW_015090842.1:10102901",106,261,155
"CHMP1A","s1693_S_HYP_02_ASEReadCounter.table","NW_015090842.1:10102961",90,263,173
"CHMP1A","s1693_S_HYP_02_ASEReadCounter.table","NW_015090842.1:10102996",87,251,164
"CHMP1A","s1693_S_HYP_02_ASEReadCounter.table","NW_015090842.1:10103004",95,262,167
"CHMP1A","s1693_S_HYP_02_ASEReadCounter.table","NW_015090842.1:10103006",95,268,173
"CHMP1A","s1693_S_HYP_02_ASEReadCounter.table","NW_015090842.1:10103052",147,337,190
"CHMP1A","s1693_S_HYP_02_ASEReadCounter.table","NW_015090842.1:10103095",152,358,206
"CHMP1A","s1693_S_HYP_02_ASEReadCounter.table","NW_015090842.1:10103096",152,357,205
"CHMP1A","s1693_S_HYP_02_ASEReadCounter.table","NW_015090842.1:10103152",115,261,146
"CHMP1A","s1693_S_HYP_02_ASEReadCounter.table","NW_015090842.1:10103334",86,211,125
"CHMP1A","s1693_S_HYP_02_ASEReadCounter.table","NW_015090842.1:10103373",52,181,129
"CHMP1A","s1693_S_HYP_02_ASEReadCounter.table","NW_015090842.1:10103408",73,205,132
"CHMP1A","s1693_S_HYP_02_ASEReadCounter.table","NW_015090842.1:10103412",83,205,122
"CHMP1A","s1693_S_HYP_02_ASEReadCounter.table","NW_015090842.1:10103512",124,266,142
"CHMP1A","s1693_S_HYP_02_ASEReadCounter.table","NW_015090842.1:10103513",122,265,143
"CHMP1A","s1693_S_HYP_02_ASEReadCounter.table","NW_015090842.1:10103583",74,168,94
"CHMP1A","s1693_S_HYP_02_ASEReadCounter.table","NW_015090842.1:10103614",73,153,80
"CHMP1A","s1693_S_HYP_02_ASEReadCounter.table","NW_015090842.1:10103657",64,142,78
"CHMP1A","s1693_S_HYP_02_ASEReadCounter.table","NW_015090842.1:10103669",59,136,77
"CHMP1A","s1693_S_HYP_02_ASEReadCounter.table","NW_015090842.1:10103674",60,132,72
"CHMP1A","s1693_S_HYP_02_ASEReadCounter.table","NW_015090842.1:10103677",60,127,67
"CHMP1A","s1693_S_HYP_02_ASEReadCounter.table","NW_015090842.1:10103729",81,159,78
"CHMP1A","s1693_S_HYP_02_ASEReadCounter.table","NW_015090842.1:10103758",96,170,74
"CHMP1A","s1693_S_HYP_02_ASEReadCounter.table","NW_015090842.1:10103761",93,168,75
"CHMP1A","s1693_S_HYP_02_ASEReadCounter.table","NW_015090842.1:10103788",93,186,93
"CHMP1A","s1693_S_HYP_02_ASEReadCounter.table","NW_015090842.1:10103789",96,188,92
"CHMP1A","s1693_S_HYP_02_ASEReadCounter.table","NW_015090842.1:10103790",95,190,95
"CHMP1A","s1693_S_HYP_02_ASEReadCounter.table","NW_015090842.1:10103950",89,163,74
"CHMP1A","s1693_S_HYP_02_ASEReadCounter.table","NW_015090842.1:10104335",53,109,56
"CHMP1A","s1693_S_HYP_02_ASEReadCounter.table","NW_015090842.1:10104429",75,159,84
"CHMP1A","s1693_S_HYP_02_ASEReadCounter.table","NW_015090842.1:10104532",77,160,83
"CHMP1A","s1693_S_HYP_02_ASEReadCounter.table","NW_015090842.1:10104633",46,110,64
"CHMP1A","s1693_S_HYP_02_ASEReadCounter.table","NW_015090842.1:10104759",41,108,67
"CHMP1A","s1693_S_HYP_02_ASEReadCounter.table","NW_015090842.1:10104794",59,123,64
"CHMP1A","s1693_S_HYP_02_ASEReadCounter.table","NW_015090842.1:10104844",39,92,53
"CHMP1A","s1693_S_HYP_02_ASEReadCounter.table","NW_015090842.1:10106290",44,98,54
"CHMP1A","s1693_S_HYP_02_ASEReadCounter.table","NW_015090842.1:10106335",51,96,45
"CHMP1A","s1693_S_HYP_02_ASEReadCounter.table","NW_015090842.1:10106383",63,120,57
"CHMP1A","s1693_S_HYP_02_ASEReadCounter.table","NW_015090842.1:10106747",49,116,67
"CHMP1A","s1693_S_HYP_02_ASEReadCounter.table","NW_015090842.1:10107404",66,138,72
"CHMP1A","s1693_S_HYP_02_ASEReadCounter.table","NW_015090842.1:10107410",67,138,71
"CHMP1A","s1693_S_HYP_02_ASEReadCounter.table","NW_015090842.1:10107876",56,108,52
"CDK10","s1693_S_HYP_02_ASEReadCounter.table","NW_015090842.1:10109030",10,10,0
"CDK10","s1693_S_HYP_02_ASEReadCounter.table","NW_015090842.1:10109963",44,124,80
"CDK10","s1693_S_HYP_02_ASEReadCounter.table","NW_015090842.1:10110887",37,109,72
"CDK10","s1693_S_HYP_02_ASEReadCounter.table","NW_015090842.1:10111254",25,97,72
"CDK10","s1693_S_HYP_02_ASEReadCounter.table","NW_015090842.1:10111380",29,122,93
"CDK10","s1693_S_HYP_02_ASEReadCounter.table","NW_015090842.1:10111395",31,124,93
"CDK10","s1693_S_HYP_02_ASEReadCounter.table","NW_015090842.1:10111437",22,108,86
"CDK10","s1693_S_HYP_02_ASEReadCounter.table","NW_015090842.1:10111798",49,140,91
"CDK10","s1693_S_HYP_02_ASEReadCounter.table","NW_015090842.1:10111840",59,153,94
"CDK10","s1693_S_HYP_02_ASEReadCounter.table","NW_015090842.1:10112031",72,188,116
"CDK10","s1693_S_HYP_02_ASEReadCounter.table","NW_015090842.1:10112285",55,162,107
"CDK10","s1693_S_HYP_02_ASEReadCounter.table","NW_015090842.1:10112398",56,166,110
"CDK10","s1693_S_HYP_02_ASEReadCounter.table","NW_015090842.1:10112455",63,167,104
"CDK10","s1693_S_HYP_02_ASEReadCounter.table","NW_015090842.1:10112461",57,150,93
"CDK10","s1693_S_HYP_02_ASEReadCounter.table","NW_015090842.1:10112497",53,144,91
"CDK10","s1693_S_HYP_02_ASEReadCounter.table","NW_015090842.1:10112508",48,146,98
"CDK10","s1693_S_HYP_02_ASEReadCounter.table","NW_015090842.1:10112518",37,131,94
"CDK10","s1693_S_HYP_02_ASEReadCounter.table","NW_015090842.1:10112540",15,110,95
"CDK10","s1693_S_HYP_02_ASEReadCounter.table","NW_015090842.1:10112556",32,127,95
"CDK10","s1693_S_HYP_02_ASEReadCounter.table","NW_015090842.1:10112561",38,149,111
"CDK10","s1693_S_HYP_02_ASEReadCounter.table","NW_015090842.1:10112596",41,155,114
"CDK10","s1693_S_HYP_02_ASEReadCounter.table","NW_015090842.1:10112630",39,137,98
"CDK10","s1693_S_HYP_02_ASEReadCounter.table","NW_015090842.1:10112656",39,146,107
"CDK10","s1693_S_HYP_02_ASEReadCounter.table","NW_015090842.1:10112665",32,114,82
"CDK10","s1693_S_HYP_02_ASEReadCounter.table","NW_015090842.1:10112668",31,110,79
"CDK10","s1693_S_HYP_02_ASEReadCounter.table","NW_015090842.1:10112781",20,60,40
"CDK10","s1693_S_HYP_02_ASEReadCounter.table","NW_015090842.1:10112782",20,60,40
"CDK10","s1693_S_HYP_02_ASEReadCounter.table","NW_015090842.1:10112795",20,56,36
"CDK10","s1693_S_HYP_02_ASEReadCounter.table","NW_015090842.1:10112841",12,28,16
"CDK10","s1693_S_HYP_02_ASEReadCounter.table","NW_015090842.1:10112861",10,24,14
"SPATA2L","s1693_S_HYP_02_ASEReadCounter.table","NW_015090842.1:10113212",23,76,53
"SPATA2L","s1693_S_HYP_02_ASEReadCounter.table","NW_015090842.1:10113280",46,128,82
"SPATA2L","s1693_S_HYP_02_ASEReadCounter.table","NW_015090842.1:10113296",45,133,88
"SPATA2L","s1693_S_HYP_02_ASEReadCounter.table","NW_015090842.1:10113321",57,149,92
"SPATA2L","s1693_S_HYP_02_ASEReadCounter.table","NW_015090842.1:10113332",61,166,105
"SPATA2L","s1693_S_HYP_02_ASEReadCounter.table","NW_015090842.1:10113380",59,169,110
"SPATA2L","s1693_S_HYP_02_ASEReadCounter.table","NW_015090842.1:10113381",59,174,115
"SPATA2L","s1693_S_HYP_02_ASEReadCounter.table","NW_015090842.1:10113412",65,190,125
"SPATA2L","s1693_S_HYP_02_ASEReadCounter.table","NW_015090842.1:10113421",68,199,131
"SPATA2L","s1693_S_HYP_02_ASEReadCounter.table","NW_015090842.1:10113465",62,178,116
"SPATA2L","s1693_S_HYP_02_ASEReadCounter.table","NW_015090842.1:10113535",86,208,122
"SPATA2L","s1693_S_HYP_02_ASEReadCounter.table","NW_015090842.1:10113645",60,192,132
"SPATA2L","s1693_S_HYP_02_ASEReadCounter.table","NW_015090842.1:10113682",85,254,169
"SPATA2L","s1693_S_HYP_02_ASEReadCounter.table","NW_015090842.1:10113696",81,240,159
"SPATA2L","s1693_S_HYP_02_ASEReadCounter.table","NW_015090842.1:10113727",90,254,164
"SPATA2L","s1693_S_HYP_02_ASEReadCounter.table","NW_015090842.1:10113729",90,250,160
"SPATA2L","s1693_S_HYP_02_ASEReadCounter.table","NW_015090842.1:10113799",96,227,131
"SPATA2L","s1693_S_HYP_02_ASEReadCounter.table","NW_015090842.1:10113809",108,242,134
"SPATA2L","s1693_S_HYP_02_ASEReadCounter.table","NW_015090842.1:10113827",101,225,124
"SPATA2L","s1693_S_HYP_02_ASEReadCounter.table","NW_015090842.1:10113831",100,231,131
"SPATA2L","s1693_S_HYP_02_ASEReadCounter.table","NW_015090842.1:10113894",79,175,96
"SPATA2L","s1693_S_HYP_02_ASEReadCounter.table","NW_015090842.1:10113905",58,159,101
"SPATA2L","s1693_S_HYP_02_ASEReadCounter.table","NW_015090842.1:10113914",64,169,105
"SPATA2L","s1693_S_HYP_02_ASEReadCounter.table","NW_015090842.1:10113920",71,177,106
"SPATA2L","s1693_S_HYP_02_ASEReadCounter.table","NW_015090842.1:10113937",85,210,125
"SPATA2L","s1693_S_HYP_02_ASEReadCounter.table","NW_015090842.1:10113971",74,192,118
"SPATA2L","s1693_S_HYP_02_ASEReadCounter.table","NW_015090842.1:10113976",66,201,135
"SPATA2L","s1693_S_HYP_02_ASEReadCounter.table","NW_015090842.1:10113985",70,180,110
"SPATA2L","s1693_S_HYP_02_ASEReadCounter.table","NW_015090842.1:10113994",85,205,120
"SPATA2L","s1693_S_HYP_02_ASEReadCounter.table","NW_015090842.1:10114063",64,148,84
"SPATA2L","s1693_S_HYP_02_ASEReadCounter.table","NW_015090842.1:10114066",63,147,84
"SPATA2L","s1693_S_HYP_02_ASEReadCounter.table","NW_015090842.1:10114069",66,148,82
"SPATA2L","s1693_S_HYP_02_ASEReadCounter.table","NW_015090842.1:10114159",54,121,67
"SPATA2L","s1693_S_HYP_02_ASEReadCounter.table","NW_015090842.1:10114262",132,132,0
"SPATA2L","s1693_S_HYP_02_ASEReadCounter.table","NW_015090842.1:10114470",39,116,77
"SPATA2L","s1693_S_HYP_02_ASEReadCounter.table","NW_015090842.1:10114524",25,94,69
"VPS9D1","s1693_S_HYP_02_ASEReadCounter.table","NW_015090842.1:10116377",35,91,56
"VPS9D1","s1693_S_HYP_02_ASEReadCounter.table","NW_015090842.1:10116415",49,115,66
"VPS9D1","s1693_S_HYP_02_ASEReadCounter.table","NW_015090842.1:10116607",41,106,65
"VPS9D1","s1693_S_HYP_02_ASEReadCounter.table","NW_015090842.1:10116821",28,78,50
"VPS9D1","s1693_S_HYP_02_ASEReadCounter.table","NW_015090842.1:10116825",30,78,48
"VPS9D1","s1693_S_HYP_02_ASEReadCounter.table","NW_015090842.1:10116882",29,76,47
"VPS9D1","s1693_S_HYP_02_ASEReadCounter.table","NW_015090842.1:10116933",31,78,47
"VPS9D1","s1693_S_HYP_02_ASEReadCounter.table","NW_015090842.1:10116942",32,82,50
"VPS9D1","s1693_S_HYP_02_ASEReadCounter.table","NW_015090842.1:10117152",30,77,47
"VPS9D1","s1693_S_HYP_02_ASEReadCounter.table","NW_015090842.1:10117480",18,42,24
"VPS9D1","s1693_S_HYP_02_ASEReadCounter.table","NW_015090842.1:10117497",17,38,21
"VPS9D1","s1693_S_HYP_02_ASEReadCounter.table","NW_015090842.1:10117499",15,35,20
"VPS9D1","s1693_S_HYP_02_ASEReadCounter.table","NW_015090842.1:10117516",20,48,28
"VPS9D1","s1693_S_HYP_02_ASEReadCounter.table","NW_015090842.1:10117525",20,47,27
"VPS9D1","s1693_S_HYP_02_ASEReadCounter.table","NW_015090842.1:10117579",21,58,37
"VPS9D1","s1693_S_HYP_02_ASEReadCounter.table","NW_015090842.1:10117627",25,60,35
"VPS9D1","s1693_S_HYP_02_ASEReadCounter.table","NW_015090842.1:10117678",18,66,48
"VPS9D1","s1693_S_HYP_02_ASEReadCounter.table","NW_015090842.1:10117773",20,69,49
"VPS9D1","s1693_S_HYP_02_ASEReadCounter.table","NW_015090842.1:10117937",29,74,45
"VPS9D1","s1693_S_HYP_02_ASEReadCounter.table","NW_015090842.1:10117961",24,68,44
"VPS9D1","s1693_S_HYP_02_ASEReadCounter.table","NW_015090842.1:10118236",20,65,45
"VPS9D1","s1693_S_HYP_02_ASEReadCounter.table","NW_015090842.1:10118414",34,74,40
"VPS9D1","s1693_S_HYP_02_ASEReadCounter.table","NW_015090842.1:10118973",30,81,51
"VPS9D1","s1693_S_HYP_02_ASEReadCounter.table","NW_015090842.1:10119500",26,59,33
"ZNF276","s1693_S_HYP_02_ASEReadCounter.table","NW_015090842.1:10121760",3,7,4
"ZNF276","s1693_S_HYP_02_ASEReadCounter.table","NW_015090842.1:10121769",2,6,4
"ZNF276","s1693_S_HYP_02_ASEReadCounter.table","NW_015090842.1:10121802",4,10,6
"ZNF276","s1693_S_HYP_02_ASEReadCounter.table","NW_015090842.1:10121971",9,22,13
"ZNF276","s1693_S_HYP_02_ASEReadCounter.table","NW_015090842.1:10122161",30,30,0
"ZNF276","s1693_S_HYP_02_ASEReadCounter.table","NW_015090842.1:10122164",30,30,0
"ZNF276","s1693_S_HYP_02_ASEReadCounter.table","NW_015090842.1:10122184",30,30,0
"ZNF276","s1693_S_HYP_02_ASEReadCounter.table","NW_015090842.1:10122883",11,22,11
"ZNF276","s1693_S_HYP_02_ASEReadCounter.table","NW_015090842.1:10122997",17,25,8
"ZNF276","s1693_S_HYP_02_ASEReadCounter.table","NW_015090842.1:10123069",16,25,9
"ZNF276","s1693_S_HYP_02_ASEReadCounter.table","NW_015090842.1:10123207",13,35,22
"ZNF276","s1693_S_HYP_02_ASEReadCounter.table","NW_015090842.1:10125787",18,38,20
"ZNF276","s1693_S_HYP_02_ASEReadCounter.table","NW_015090842.1:10126309",27,61,34
"ZNF276","s1693_S_HYP_02_ASEReadCounter.table","NW_015090842.1:10126348",28,63,35
"ZNF276","s1693_S_HYP_02_ASEReadCounter.table","NW_015090842.1:10126978",34,76,42
"ZNF276","s1693_S_HYP_02_ASEReadCounter.table","NW_015090842.1:10126991",31,65,34
"ZNF276","s1693_S_HYP_02_ASEReadCounter.table","NW_015090842.1:10127023",33,73,40
"ZNF276","s1693_S_HYP_02_ASEReadCounter.table","NW_015090842.1:10127063",29,68,39
"ZNF276","s1693_S_HYP_02_ASEReadCounter.table","NW_015090842.1:10127373",35,73,38
"ZNF276","s1693_S_HYP_02_ASEReadCounter.table","NW_015090842.1:10127931",33,75,42
"ZNF276","s1693_S_HYP_02_ASEReadCounter.table","NW_015090842.1:10128070",38,65,27
"ZNF276","s1693_S_HYP_02_ASEReadCounter.table","NW_015090842.1:10128102",45,80,35
"ZNF276","s1693_S_HYP_02_ASEReadCounter.table","NW_015090842.1:10128356",33,74,41
"ZNF276","s1693_S_HYP_02_ASEReadCounter.table","NW_015090842.1:10128497",30,54,24
"FANCA","s1693_S_HYP_02_ASEReadCounter.table","NW_015090842.1:10128743",3,3,0
"FANCA","s1693_S_HYP_02_ASEReadCounter.table","NW_015090842.1:10128822",1,3,2
"FANCA","s1693_S_HYP_02_ASEReadCounter.table","NW_015090842.1:10129383",1,5,4
"FANCA","s1693_S_HYP_02_ASEReadCounter.table","NW_015090842.1:10129390",1,5,4
"FANCA","s1693_S_HYP_02_ASEReadCounter.table","NW_015090842.1:10129422",1,2,1
"FANCA","s1693_S_HYP_02_ASEReadCounter.table","NW_015090842.1:10129969",0,1,1
"FANCA","s1693_S_HYP_02_ASEReadCounter.table","NW_015090842.1:10133530",1,3,2
"FANCA","s1693_S_HYP_02_ASEReadCounter.table","NW_015090842.1:10133533",1,3,2
"FANCA","s1693_S_HYP_02_ASEReadCounter.table","NW_015090842.1:10133536",1,3,2
"FANCA","s1693_S_HYP_02_ASEReadCounter.table","NW_015090842.1:10134492",0,1,1
"FANCA","s1693_S_HYP_02_ASEReadCounter.table","NW_015090842.1:10136957",1,1,0
"FANCA","s1693_S_HYP_02_ASEReadCounter.table","NW_015090842.1:10136982",1,1,0
"FANCA","s1693_S_HYP_02_ASEReadCounter.table","NW_015090842.1:10136999",1,1,0
"FANCA","s1693_S_HYP_02_ASEReadCounter.table","NW_015090842.1:10137019",1,1,0
"FANCA","s1693_S_HYP_02_ASEReadCounter.table","NW_015090842.1:10140699",0,1,1
"FANCA","s1693_S_HYP_02_ASEReadCounter.table","NW_015090842.1:10145030",1,1,0
"FANCA","s1693_S_HYP_02_ASEReadCounter.table","NW_015090842.1:10150518",1,2,1
"FANCA","s1693_S_HYP_02_ASEReadCounter.table","NW_015090842.1:10152863",0,1,1
"FANCA","s1693_S_HYP_02_ASEReadCounter.table","NW_015090842.1:10158162",0,1,1
"FANCA","s1693_S_HYP_02_ASEReadCounter.table","NW_015090842.1:10164257",1,1,0
"FANCA","s1693_S_HYP_02_ASEReadCounter.table","NW_015090842.1:10165331",1,1,0
"SPIRE2","s1693_S_HYP_02_ASEReadCounter.table","NW_015090842.1:10172284",17,37,20
"SPIRE2","s1693_S_HYP_02_ASEReadCounter.table","NW_015090842.1:10175262",28,60,32
"SPIRE2","s1693_S_HYP_02_ASEReadCounter.table","NW_015090842.1:10175352",21,32,11
"SPIRE2","s1693_S_HYP_02_ASEReadCounter.table","NW_015090842.1:10175400",56,113,57
"SPIRE2","s1693_S_HYP_02_ASEReadCounter.table","NW_015090842.1:10175418",64,129,65
"SPIRE2","s1693_S_HYP_02_ASEReadCounter.table","NW_015090842.1:10175704",65,166,101
"SPIRE2","s1693_S_HYP_02_ASEReadCounter.table","NW_015090842.1:10176115",80,197,117
"SPIRE2","s1693_S_HYP_02_ASEReadCounter.table","NW_015090842.1:10176561",109,228,119
"SPIRE2","s1693_S_HYP_02_ASEReadCounter.table","NW_015090842.1:10176817",102,232,130
"SPIRE2","s1693_S_HYP_02_ASEReadCounter.table","NW_015090842.1:10177084",71,136,65
"SPIRE2","s1693_S_HYP_02_ASEReadCounter.table","NW_015090842.1:10177838",123,265,142
"SPIRE2","s1693_S_HYP_02_ASEReadCounter.table","NW_015090842.1:10178000",126,282,156
"SPIRE2","s1693_S_HYP_02_ASEReadCounter.table","NW_015090842.1:10178164",145,293,148
"SPIRE2","s1693_S_HYP_02_ASEReadCounter.table","NW_015090842.1:10178216",169,351,182
"SPIRE2","s1693_S_HYP_02_ASEReadCounter.table","NW_015090842.1:10178303",147,277,130
"SPIRE2","s1693_S_HYP_02_ASEReadCounter.table","NW_015090842.1:10178403",149,304,155
"SPIRE2","s1693_S_HYP_02_ASEReadCounter.table","NW_015090842.1:10178409",144,304,160
"SPIRE2","s1693_S_HYP_02_ASEReadCounter.table","NW_015090842.1:10178524",141,294,153
"SPIRE2","s1693_S_HYP_02_ASEReadCounter.table","NW_015090842.1:10178526",139,292,153
"SPIRE2","s1693_S_HYP_02_ASEReadCounter.table","NW_015090842.1:10178531",145,290,145
"SPIRE2","s1693_S_HYP_02_ASEReadCounter.table","NW_015090842.1:10178565",139,299,160
"SPIRE2","s1693_S_HYP_02_ASEReadCounter.table","NW_015090842.1:10178587",137,274,137
"SPIRE2","s1693_S_HYP_02_ASEReadCounter.table","NW_015090842.1:10178640",110,209,99
"SPIRE2","s1693_S_HYP_02_ASEReadCounter.table","NW_015090842.1:10178651",113,221,108
"SPIRE2","s1693_S_HYP_02_ASEReadCounter.table","NW_015090842.1:10178682",99,193,94
"TCF25","s1693_S_HYP_02_ASEReadCounter.table","NW_015090842.1:10180912",55,98,43
"TCF25","s1693_S_HYP_02_ASEReadCounter.table","NW_015090842.1:10180924",59,100,41
"TCF25","s1693_S_HYP_02_ASEReadCounter.table","NW_015090842.1:10180931",60,102,42
"TCF25","s1693_S_HYP_02_ASEReadCounter.table","NW_015090842.1:10185332",151,251,100
"TCF25","s1693_S_HYP_02_ASEReadCounter.table","NW_015090842.1:10196561",116,241,125
"TCF25","s1693_S_HYP_02_ASEReadCounter.table","NW_015090842.1:10197399",320,320,0
"MC1R","s1693_S_HYP_02_ASEReadCounter.table","NW_015090842.1:10201853",0,1,1
"MC1R","s1693_S_HYP_02_ASEReadCounter.table","NW_015090842.1:10201986",1,2,1
"MC1R","s1693_S_HYP_02_ASEReadCounter.table","NW_015090842.1:10202160",1,3,2
"MC1R","s1693_S_HYP_02_ASEReadCounter.table","NW_015090842.1:10202447",0,1,1
"TUBB3","s1693_S_HYP_02_ASEReadCounter.table","NW_015090842.1:10205322",1,416,415
"GAS8","s1693_S_HYP_02_ASEReadCounter.table","NW_015090842.1:10228982",20,43,23
"GAS8","s1693_S_HYP_02_ASEReadCounter.table","NW_015090842.1:10229832",16,33,17
"GAS8","s1693_S_HYP_02_ASEReadCounter.table","NW_015090842.1:10232901",50,87,37
"GAS8","s1693_S_HYP_02_ASEReadCounter.table","NW_015090842.1:10232928",49,91,42
"GAS8","s1693_S_HYP_02_ASEReadCounter.table","NW_015090842.1:10232967",44,86,42
"GAS8","s1693_S_HYP_02_ASEReadCounter.table","NW_015090842.1:10233032",43,82,39
"GAS8","s1693_S_HYP_02_ASEReadCounter.table","NW_015090842.1:10233057",38,69,31
"GAS8","s1693_S_HYP_02_ASEReadCounter.table","NW_015090842.1:10233058",38,71,33
"GAS8","s1693_S_HYP_02_ASEReadCounter.table","NW_015090842.1:10233176",28,53,25
"GAS8","s1693_S_HYP_02_ASEReadCounter.table","NW_015090842.1:10233196",23,49,26
"GAS8","s1693_S_HYP_02_ASEReadCounter.table","NW_015090842.1:10233252",23,43,20
"GAS8","s1693_S_HYP_02_ASEReadCounter.table","NW_015090842.1:10233303",15,27,12
"LOC106888094","s1693_S_HYP_02_ASEReadCounter.table","NW_015090842.1:10233334",4,17,13
"LOC106888094","s1693_S_HYP_02_ASEReadCounter.table","NW_015090842.1:10233362",7,26,19
"LOC106888094","s1693_S_HYP_02_ASEReadCounter.table","NW_015090842.1:10233373",7,28,21
"LOC106888094","s1693_S_HYP_02_ASEReadCounter.table","NW_015090842.1:10233388",11,36,25
"LOC106888094","s1693_S_HYP_02_ASEReadCounter.table","NW_015090842.1:10233402",11,32,21
"LOC106888094","s1693_S_HYP_02_ASEReadCounter.table","NW_015090842.1:10233465",20,51,31
"LOC106888094","s1693_S_HYP_02_ASEReadCounter.table","NW_015090842.1:10233803",19,48,29
"LOC106888094","s1693_S_HYP_02_ASEReadCounter.table","NW_015090842.1:10233815",15,39,24
"LOC106888094","s1693_S_HYP_02_ASEReadCounter.table","NW_015090842.1:10235484",1,3,2
"LOC106888094","s1693_S_HYP_02_ASEReadCounter.table","NW_015090842.1:10235611",4,7,3
"LOC106888094","s1693_S_HYP_02_ASEReadCounter.table","NW_015090842.1:10235977",5,5,0
"LOC106888094","s1693_S_HYP_02_ASEReadCounter.table","NW_015090842.1:10236098",2,2,0
"LOC106888094","s1693_S_HYP_02_ASEReadCounter.table","NW_015090842.1:10236161",2,2,0
"LOC106888094","s1693_S_HYP_02_ASEReadCounter.table","NW_015090842.1:10236425",1,1,0
"LOC106888094","s1693_S_HYP_02_ASEReadCounter.table","NW_015090842.1:10236426",1,1,0
"LOC106888094","s1693_S_HYP_02_ASEReadCounter.table","NW_015090842.1:10236603",1,1,0
"LOC106888173","s1693_S_HYP_02_ASEReadCounter.table","NW_015090842.1:10239596",1,19,18
"LOC106888173","s1693_S_HYP_02_ASEReadCounter.table","NW_015090842.1:10240036",3,35,32
"LOC106888173","s1693_S_HYP_02_ASEReadCounter.table","NW_015090842.1:10240095",5,32,27
"LOC106888173","s1693_S_HYP_02_ASEReadCounter.table","NW_015090842.1:10240280",3,43,40
"LOC106888173","s1693_S_HYP_02_ASEReadCounter.table","NW_015090842.1:10240557",9,40,31
"LOC106888173","s1693_S_HYP_02_ASEReadCounter.table","NW_015090842.1:10240603",5,38,33
"LOC106888173","s1693_S_HYP_02_ASEReadCounter.table","NW_015090842.1:10240609",5,37,32
"LOC106888173","s1693_S_HYP_02_ASEReadCounter.table","NW_015090842.1:10240924",9,39,30
"LOC106888173","s1693_S_HYP_02_ASEReadCounter.table","NW_015090842.1:10241037",4,34,30
"LOC106888173","s1693_S_HYP_02_ASEReadCounter.table","NW_015090842.1:10241046",4,35,31
"LOC106888173","s1693_S_HYP_02_ASEReadCounter.table","NW_015090842.1:10241058",5,36,31
"LOC106888173","s1693_S_HYP_02_ASEReadCounter.table","NW_015090842.1:10241064",6,39,33
"LOC106888173","s1693_S_HYP_02_ASEReadCounter.table","NW_015090842.1:10241163",6,35,29
"LOC106888173","s1693_S_HYP_02_ASEReadCounter.table","NW_015090842.1:10241803",5,47,42
"LOC106888173","s1693_S_HYP_02_ASEReadCounter.table","NW_015090842.1:10241827",7,50,43
"LOC106888173","s1693_S_HYP_02_ASEReadCounter.table","NW_015090842.1:10241869",10,60,50
"LOC106888173","s1693_S_HYP_02_ASEReadCounter.table","NW_015090842.1:10242079",9,44,35
"LOC106888173","s1693_S_HYP_02_ASEReadCounter.table","NW_015090842.1:10242103",9,47,38
"LOC106888173","s1693_S_HYP_02_ASEReadCounter.table","NW_015090842.1:10242157",12,53,41
"LOC106888173","s1693_S_HYP_02_ASEReadCounter.table","NW_015090842.1:10242455",10,49,39
"LOC106888173","s1693_S_HYP_02_ASEReadCounter.table","NW_015090842.1:10242481",7,49,42
"LOC106888173","s1693_S_HYP_02_ASEReadCounter.table","NW_015090842.1:10242590",7,42,35
"LOC106888173","s1693_S_HYP_02_ASEReadCounter.table","NW_015090842.1:10242794",4,53,49
"LOC106888173","s1693_S_HYP_02_ASEReadCounter.table","NW_015090842.1:10242909",8,36,28
"LOC106888173","s1693_S_HYP_02_ASEReadCounter.table","NW_015090842.1:10243094",10,45,35
"LOC106888173","s1693_S_HYP_02_ASEReadCounter.table","NW_015090842.1:10243133",6,40,34
"LOC106888173","s1693_S_HYP_02_ASEReadCounter.table","NW_015090842.1:10243273",10,63,53
"LOC106888173","s1693_S_HYP_02_ASEReadCounter.table","NW_015090842.1:10243278",11,64,53
"LOC106888173","s1693_S_HYP_02_ASEReadCounter.table","NW_015090842.1:10243281",11,65,54
"LOC106888173","s1693_S_HYP_02_ASEReadCounter.table","NW_015090842.1:10243347",37,37,0
"LOC106888173","s1693_S_HYP_02_ASEReadCounter.table","NW_015090842.1:10243353",7,33,26
"LOC106888173","s1693_S_HYP_02_ASEReadCounter.table","NW_015090842.1:10243363",6,31,25
"LOC106888173","s1693_S_HYP_02_ASEReadCounter.table","NW_015090842.1:10243365",6,30,24
"LOC106888173","s1693_S_HYP_02_ASEReadCounter.table","NW_015090842.1:10243529",10,32,22
"LOC106888173","s1693_S_HYP_02_ASEReadCounter.table","NW_015090842.1:10243566",13,51,38
"LOC106888173","s1693_S_HYP_02_ASEReadCounter.table","NW_015090842.1:10243605",12,46,34
"LOC106888173","s1693_S_HYP_02_ASEReadCounter.table","NW_015090842.1:10243614",11,43,32
"LOC106888173","s1693_S_HYP_02_ASEReadCounter.table","NW_015090842.1:10243615",12,44,32
"LOC106888173","s1693_S_HYP_02_ASEReadCounter.table","NW_015090842.1:10243640",11,40,29
"LOC106888173","s1693_S_HYP_02_ASEReadCounter.table","NW_015090842.1:10243680",6,35,29
"LOC106888173","s1693_S_HYP_02_ASEReadCounter.table","NW_015090842.1:10243742",7,42,35
"LOC106888173","s1693_S_HYP_02_ASEReadCounter.table","NW_015090842.1:10243804",2,27,25
"LOC106888173","s1693_S_HYP_02_ASEReadCounter.table","NW_015090842.1:10243913",2,15,13
"LOC106888173","s1693_S_HYP_02_ASEReadCounter.table","NW_015090842.1:10243921",2,14,12
"LOC106888384","s1693_S_HYP_02_ASEReadCounter.table","NW_015090842.1:10244714",1,1,0
"LOC106888384","s1693_S_HYP_02_ASEReadCounter.table","NW_015090842.1:10244998",1,1,0
"LOC106888384","s1693_S_HYP_02_ASEReadCounter.table","NW_015090842.1:10250743",1,1,0
"LOC106888384","s1693_S_HYP_02_ASEReadCounter.table","NW_015090842.1:10251354",0,3,3
"LOC106888384","s1693_S_HYP_02_ASEReadCounter.table","NW_015090842.1:10251358",0,3,3
"LOC106888384","s1693_S_HYP_02_ASEReadCounter.table","NW_015090842.1:10251369",0,3,3
"LOC106888384","s1693_S_HYP_02_ASEReadCounter.table","NW_015090842.1:10251370",0,3,3
"LOC106888384","s1693_S_HYP_02_ASEReadCounter.table","NW_015090842.1:10251375",0,3,3
"LOC106888384","s1693_S_HYP_02_ASEReadCounter.table","NW_015090842.1:10251388",0,3,3
"LOC106888384","s1693_S_HYP_02_ASEReadCounter.table","NW_015090842.1:10251390",0,2,2
"LOC106888384","s1693_S_HYP_02_ASEReadCounter.table","NW_015090842.1:10251393",0,3,3
"LOC106888384","s1693_S_HYP_02_ASEReadCounter.table","NW_015090842.1:10251399",0,3,3
"LOC106888384","s1693_S_HYP_02_ASEReadCounter.table","NW_015090842.1:10251492",2,2,0
"LOC106888384","s1693_S_HYP_02_ASEReadCounter.table","NW_015090842.1:10253165",1,3,2
"LOC106888384","s1693_S_HYP_02_ASEReadCounter.table","NW_015090842.1:10253284",2,3,1
"LOC106888384","s1693_S_HYP_02_ASEReadCounter.table","NW_015090842.1:10253605",1,1,0
"LOC106888384","s1693_S_HYP_02_ASEReadCounter.table","NW_015090842.1:10254227",2,2,0
"LOC106888384","s1693_S_HYP_02_ASEReadCounter.table","NW_015090842.1:10254233",2,2,0
"LOC106888384","s1693_S_HYP_02_ASEReadCounter.table","NW_015090842.1:10254263",2,2,0
"LOC106888384","s1693_S_HYP_02_ASEReadCounter.table","NW_015090842.1:10254840",2,2,0
"LOC106888384","s1693_S_HYP_02_ASEReadCounter.table","NW_015090842.1:10254854",2,2,0
"LOC106888384","s1693_S_HYP_02_ASEReadCounter.table","NW_015090842.1:10254891",1,1,0
"LOC106888384","s1693_S_HYP_02_ASEReadCounter.table","NW_015090842.1:10254900",1,2,1
"LOC106888384","s1693_S_HYP_02_ASEReadCounter.table","NW_015090842.1:10254915",1,2,1
"LOC106888384","s1693_S_HYP_02_ASEReadCounter.table","NW_015090842.1:10254965",1,1,0
"LOC106888384","s1693_S_HYP_02_ASEReadCounter.table","NW_015090842.1:10254975",0,1,1
"LOC106888384","s1693_S_HYP_02_ASEReadCounter.table","NW_015090842.1:10255209",1,1,0
"LOC106888384","s1693_S_HYP_02_ASEReadCounter.table","NW_015090842.1:10255211",1,1,0
"LOC106888384","s1693_S_HYP_02_ASEReadCounter.table","NW_015090842.1:10255236",1,2,1
"LOC106888384","s1693_S_HYP_02_ASEReadCounter.table","NW_015090842.1:10255262",0,1,1
"LOC106888384","s1693_S_HYP_02_ASEReadCounter.table","NW_015090842.1:10255264",0,1,1
"LOC106888384","s1693_S_HYP_02_ASEReadCounter.table","NW_015090842.1:10255306",0,1,1
"LOC106888384","s1693_S_HYP_02_ASEReadCounter.table","NW_015090842.1:10255340",1,2,1
"LOC106888384","s1693_S_HYP_02_ASEReadCounter.table","NW_015090842.1:10255410",1,1,0
"LOC106888384","s1693_S_HYP_02_ASEReadCounter.table","NW_015090842.1:10255449",1,1,0
"LOC106888384","s1693_S_HYP_02_ASEReadCounter.table","NW_015090842.1:10255496",3,3,0
"LOC106888384","s1693_S_HYP_02_ASEReadCounter.table","NW_015090842.1:10255505",3,3,0
"LOC106888384","s1693_S_HYP_02_ASEReadCounter.table","NW_015090842.1:10255531",3,3,0
"LOC106888384","s1693_S_HYP_02_ASEReadCounter.table","NW_015090842.1:10255608",1,2,1
"LOC106888384","s1693_S_HYP_02_ASEReadCounter.table","NW_015090842.1:10255614",1,2,1
"LOC106888384","s1693_S_HYP_02_ASEReadCounter.table","NW_015090842.1:10255704",3,4,1
"LOC106888384","s1693_S_HYP_02_ASEReadCounter.table","NW_015090842.1:10255731",4,6,2
"LOC106888384","s1693_S_HYP_02_ASEReadCounter.table","NW_015090842.1:10255771",3,4,1
"TANGO6","s1693_S_HYP_02_ASEReadCounter.table","NW_015090842.1:10257782",5,8,3
"TANGO6","s1693_S_HYP_02_ASEReadCounter.table","NW_015090842.1:10258162",11,18,7
"TANGO6","s1693_S_HYP_02_ASEReadCounter.table","NW_015090842.1:10258185",13,21,8
"TANGO6","s1693_S_HYP_02_ASEReadCounter.table","NW_015090842.1:10259267",8,16,8
"TANGO6","s1693_S_HYP_02_ASEReadCounter.table","NW_015090842.1:10260250",27,46,19
"TANGO6","s1693_S_HYP_02_ASEReadCounter.table","NW_015090842.1:10260979",20,36,16
"TANGO6","s1693_S_HYP_02_ASEReadCounter.table","NW_015090842.1:10261599",23,42,19
"TANGO6","s1693_S_HYP_02_ASEReadCounter.table","NW_015090842.1:10268425",49,62,13
"TANGO6","s1693_S_HYP_02_ASEReadCounter.table","NW_015090842.1:10269831",36,63,27
"TANGO6","s1693_S_HYP_02_ASEReadCounter.table","NW_015090842.1:10270813",34,54,20
"TANGO6","s1693_S_HYP_02_ASEReadCounter.table","NW_015090842.1:10273952",29,46,17
"TANGO6","s1693_S_HYP_02_ASEReadCounter.table","NW_015090842.1:10273970",34,52,18
"TANGO6","s1693_S_HYP_02_ASEReadCounter.table","NW_015090842.1:10274018",35,51,16
"TANGO6","s1693_S_HYP_02_ASEReadCounter.table","NW_015090842.1:10275974",28,42,14
"TANGO6","s1693_S_HYP_02_ASEReadCounter.table","NW_015090842.1:10275976",28,42,14
"TANGO6","s1693_S_HYP_02_ASEReadCounter.table","NW_015090842.1:10276123",35,50,15
"TANGO6","s1693_S_HYP_02_ASEReadCounter.table","NW_015090842.1:10276271",42,60,18
"TANGO6","s1693_S_HYP_02_ASEReadCounter.table","NW_015090842.1:10276272",40,59,19
"TANGO6","s1693_S_HYP_02_ASEReadCounter.table","NW_015090842.1:10276275",45,64,19
"TANGO6","s1693_S_HYP_02_ASEReadCounter.table","NW_015090842.1:10276278",47,66,19
"TANGO6","s1693_S_HYP_02_ASEReadCounter.table","NW_015090842.1:10276368",37,50,13
"TANGO6","s1693_S_HYP_02_ASEReadCounter.table","NW_015090842.1:10276373",37,50,13
"TANGO6","s1693_S_HYP_02_ASEReadCounter.table","NW_015090842.1:10276630",30,53,23
"TANGO6","s1693_S_HYP_02_ASEReadCounter.table","NW_015090842.1:10281498",36,64,28
"TANGO6","s1693_S_HYP_02_ASEReadCounter.table","NW_015090842.1:10282842",45,79,34
"TANGO6","s1693_S_HYP_02_ASEReadCounter.table","NW_015090842.1:10282863",37,70,33
"TANGO6","s1693_S_HYP_02_ASEReadCounter.table","NW_015090842.1:10282869",34,64,30
"TANGO6","s1693_S_HYP_02_ASEReadCounter.table","NW_015090842.1:10282903",52,82,30
"TANGO6","s1693_S_HYP_02_ASEReadCounter.table","NW_015090842.1:10283757",53,87,34
"TANGO6","s1693_S_HYP_02_ASEReadCounter.table","NW_015090842.1:10283785",54,88,34
"HAS3","s1693_S_HYP_02_ASEReadCounter.table","NW_015090842.1:10288093",1,1,0
"HAS3","s1693_S_HYP_02_ASEReadCounter.table","NW_015090842.1:10288266",2,6,4
"HAS3","s1693_S_HYP_02_ASEReadCounter.table","NW_015090842.1:10288274",1,5,4
"HAS3","s1693_S_HYP_02_ASEReadCounter.table","NW_015090842.1:10288364",3,4,1
"HAS3","s1693_S_HYP_02_ASEReadCounter.table","NW_015090842.1:10288405",4,8,4
"HAS3","s1693_S_HYP_02_ASEReadCounter.table","NW_015090842.1:10289469",1,2,1
"HAS3","s1693_S_HYP_02_ASEReadCounter.table","NW_015090842.1:10289708",2,3,1
"HAS3","s1693_S_HYP_02_ASEReadCounter.table","NW_015090842.1:10290375",0,3,3
"HAS3","s1693_S_HYP_02_ASEReadCounter.table","NW_015090842.1:10290395",0,2,2
"HAS3","s1693_S_HYP_02_ASEReadCounter.table","NW_015090842.1:10290561",0,4,4
"HAS3","s1693_S_HYP_02_ASEReadCounter.table","NW_015090842.1:10290609",0,1,1
"HAS3","s1693_S_HYP_02_ASEReadCounter.table","NW_015090842.1:10290666",1,1,0
"HAS3","s1693_S_HYP_02_ASEReadCounter.table","NW_015090842.1:10290723",2,3,1
"HAS3","s1693_S_HYP_02_ASEReadCounter.table","NW_015090842.1:10290927",3,5,2
"HAS3","s1693_S_HYP_02_ASEReadCounter.table","NW_015090842.1:10291004",4,4,0
"CHTF8","s1693_S_HYP_02_ASEReadCounter.table","NW_015090842.1:10291319",3,8,5
"CHTF8","s1693_S_HYP_02_ASEReadCounter.table","NW_015090842.1:10291342",4,11,7
"CHTF8","s1693_S_HYP_02_ASEReadCounter.table","NW_015090842.1:10291491",11,15,4
"CHTF8","s1693_S_HYP_02_ASEReadCounter.table","NW_015090842.1:10291520",14,21,7
"CHTF8","s1693_S_HYP_02_ASEReadCounter.table","NW_015090842.1:10291593",15,24,9
"CHTF8","s1693_S_HYP_02_ASEReadCounter.table","NW_015090842.1:10291600",13,21,8
"CHTF8","s1693_S_HYP_02_ASEReadCounter.table","NW_015090842.1:10291609",10,17,7
"CHTF8","s1693_S_HYP_02_ASEReadCounter.table","NW_015090842.1:10291639",13,18,5
"CHTF8","s1693_S_HYP_02_ASEReadCounter.table","NW_015090842.1:10291641",13,18,5
"CHTF8","s1693_S_HYP_02_ASEReadCounter.table","NW_015090842.1:10291648",18,24,6
"CHTF8","s1693_S_HYP_02_ASEReadCounter.table","NW_015090842.1:10291656",17,23,6
"CHTF8","s1693_S_HYP_02_ASEReadCounter.table","NW_015090842.1:10291675",18,24,6
"CHTF8","s1693_S_HYP_02_ASEReadCounter.table","NW_015090842.1:10291696",14,22,8
"CHTF8","s1693_S_HYP_02_ASEReadCounter.table","NW_015090842.1:10291714",17,24,7
"CHTF8","s1693_S_HYP_02_ASEReadCounter.table","NW_015090842.1:10291732",20,29,9
"CHTF8","s1693_S_HYP_02_ASEReadCounter.table","NW_015090842.1:10291755",17,26,9
"CHTF8","s1693_S_HYP_02_ASEReadCounter.table","NW_015090842.1:10291756",17,26,9
"CHTF8","s1693_S_HYP_02_ASEReadCounter.table","NW_015090842.1:10291758",16,25,9
"CHTF8","s1693_S_HYP_02_ASEReadCounter.table","NW_015090842.1:10291792",12,20,8
"CHTF8","s1693_S_HYP_02_ASEReadCounter.table","NW_015090842.1:10291895",12,18,6
"CHTF8","s1693_S_HYP_02_ASEReadCounter.table","NW_015090842.1:10292132",4,9,5
"CHTF8","s1693_S_HYP_02_ASEReadCounter.table","NW_015090842.1:10292314",7,14,7
"CHTF8","s1693_S_HYP_02_ASEReadCounter.table","NW_015090842.1:10292317",7,14,7
"CHTF8","s1693_S_HYP_02_ASEReadCounter.table","NW_015090842.1:10292928",1,1,0
"UTP4","s1693_S_HYP_02_ASEReadCounter.table","NW_015090842.1:10293146",11,28,17
"UTP4","s1693_S_HYP_02_ASEReadCounter.table","NW_015090842.1:10293151",10,27,17
"UTP4","s1693_S_HYP_02_ASEReadCounter.table","NW_015090842.1:10293191",8,18,10
"UTP4","s1693_S_HYP_02_ASEReadCounter.table","NW_015090842.1:10293362",8,16,8
"UTP4","s1693_S_HYP_02_ASEReadCounter.table","NW_015090842.1:10293430",9,25,16
"UTP4","s1693_S_HYP_02_ASEReadCounter.table","NW_015090842.1:10293625",7,14,7
"UTP4","s1693_S_HYP_02_ASEReadCounter.table","NW_015090842.1:10293684",10,19,9
"UTP4","s1693_S_HYP_02_ASEReadCounter.table","NW_015090842.1:10294093",10,20,10
"UTP4","s1693_S_HYP_02_ASEReadCounter.table","NW_015090842.1:10294568",14,27,13
"UTP4","s1693_S_HYP_02_ASEReadCounter.table","NW_015090842.1:10294622",9,19,10
"UTP4","s1693_S_HYP_02_ASEReadCounter.table","NW_015090842.1:10294632",9,18,9
"UTP4","s1693_S_HYP_02_ASEReadCounter.table","NW_015090842.1:10295238",15,36,21
"UTP4","s1693_S_HYP_02_ASEReadCounter.table","NW_015090842.1:10295880",15,39,24
"UTP4","s1693_S_HYP_02_ASEReadCounter.table","NW_015090842.1:10295884",16,39,23
"UTP4","s1693_S_HYP_02_ASEReadCounter.table","NW_015090842.1:10295903",14,41,27
"UTP4","s1693_S_HYP_02_ASEReadCounter.table","NW_015090842.1:10295906",14,41,27
"UTP4","s1693_S_HYP_02_ASEReadCounter.table","NW_015090842.1:10295915",12,40,28
"UTP4","s1693_S_HYP_02_ASEReadCounter.table","NW_015090842.1:10295938",10,34,24
"UTP4","s1693_S_HYP_02_ASEReadCounter.table","NW_015090842.1:10296175",15,40,25
"UTP4","s1693_S_HYP_02_ASEReadCounter.table","NW_015090842.1:10296660",15,35,20
"UTP4","s1693_S_HYP_02_ASEReadCounter.table","NW_015090842.1:10296679",17,43,26
"UTP4","s1693_S_HYP_02_ASEReadCounter.table","NW_015090842.1:10297193",26,66,40
"UTP4","s1693_S_HYP_02_ASEReadCounter.table","NW_015090842.1:10297220",35,71,36
"UTP4","s1693_S_HYP_02_ASEReadCounter.table","NW_015090842.1:10297307",43,87,44
"UTP4","s1693_S_HYP_02_ASEReadCounter.table","NW_015090842.1:10297558",35,75,40
"UTP4","s1693_S_HYP_02_ASEReadCounter.table","NW_015090842.1:10297943",39,74,35
"UTP4","s1693_S_HYP_02_ASEReadCounter.table","NW_015090842.1:10297979",33,59,26
"UTP4","s1693_S_HYP_02_ASEReadCounter.table","NW_015090842.1:10298022",21,44,23
"UTP4","s1693_S_HYP_02_ASEReadCounter.table","NW_015090842.1:10298079",2,16,14
"UTP4","s1693_S_HYP_02_ASEReadCounter.table","NW_015090842.1:10298081",2,16,14
"UTP4","s1693_S_HYP_02_ASEReadCounter.table","NW_015090842.1:10298082",1,15,14
"SNTB2","s1693_S_HYP_02_ASEReadCounter.table","NW_015090842.1:10298928",0,1,1
"SNTB2","s1693_S_HYP_02_ASEReadCounter.table","NW_015090842.1:10303506",2,2,0
"SNTB2","s1693_S_HYP_02_ASEReadCounter.table","NW_015090842.1:10303524",3,6,3
"SNTB2","s1693_S_HYP_02_ASEReadCounter.table","NW_015090842.1:10304059",6,10,4
"SNTB2","s1693_S_HYP_02_ASEReadCounter.table","NW_015090842.1:10304089",4,9,5
"SNTB2","s1693_S_HYP_02_ASEReadCounter.table","NW_015090842.1:10304167",0,4,4
"SNTB2","s1693_S_HYP_02_ASEReadCounter.table","NW_015090842.1:10304176",0,3,3
"SNTB2","s1693_S_HYP_02_ASEReadCounter.table","NW_015090842.1:10305069",5,7,2
"SNTB2","s1693_S_HYP_02_ASEReadCounter.table","NW_015090842.1:10305099",6,9,3
"SNTB2","s1693_S_HYP_02_ASEReadCounter.table","NW_015090842.1:10305451",7,8,1
"SNTB2","s1693_S_HYP_02_ASEReadCounter.table","NW_015090842.1:10305547",2,6,4
"SNTB2","s1693_S_HYP_02_ASEReadCounter.table","NW_015090842.1:10305847",6,6,0
"SNTB2","s1693_S_HYP_02_ASEReadCounter.table","NW_015090842.1:10305911",3,4,1
"SNTB2","s1693_S_HYP_02_ASEReadCounter.table","NW_015090842.1:10306173",7,9,2
"SNTB2","s1693_S_HYP_02_ASEReadCounter.table","NW_015090842.1:10306275",4,5,1
"SNTB2","s1693_S_HYP_02_ASEReadCounter.table","NW_015090842.1:10306457",6,9,3
"SNTB2","s1693_S_HYP_02_ASEReadCounter.table","NW_015090842.1:10306496",5,7,2
"SNTB2","s1693_S_HYP_02_ASEReadCounter.table","NW_015090842.1:10306499",5,7,2
"VPS4A","s1693_S_HYP_02_ASEReadCounter.table","NW_015090842.1:10308566",64,156,92
"VPS4A","s1693_S_HYP_02_ASEReadCounter.table","NW_015090842.1:10308573",71,173,102
"VPS4A","s1693_S_HYP_02_ASEReadCounter.table","NW_015090842.1:10308856",103,264,161
"VPS4A","s1693_S_HYP_02_ASEReadCounter.table","NW_015090842.1:10309056",157,342,185
"VPS4A","s1693_S_HYP_02_ASEReadCounter.table","NW_015090842.1:10309089",188,389,201
"VPS4A","s1693_S_HYP_02_ASEReadCounter.table","NW_015090842.1:10309392",176,351,175
"VPS4A","s1693_S_HYP_02_ASEReadCounter.table","NW_015090842.1:10309413",195,386,191
"VPS4A","s1693_S_HYP_02_ASEReadCounter.table","NW_015090842.1:10309467",192,423,231
"VPS4A","s1693_S_HYP_02_ASEReadCounter.table","NW_015090842.1:10310230",230,462,232
"VPS4A","s1693_S_HYP_02_ASEReadCounter.table","NW_015090842.1:10310425",196,412,216
"VPS4A","s1693_S_HYP_02_ASEReadCounter.table","NW_015090842.1:10310639",242,501,259
"VPS4A","s1693_S_HYP_02_ASEReadCounter.table","NW_015090842.1:10310640",496,496,0
"VPS4A","s1693_S_HYP_02_ASEReadCounter.table","NW_015090842.1:10310687",253,504,251
"VPS4A","s1693_S_HYP_02_ASEReadCounter.table","NW_015090842.1:10310734",215,438,223
"VPS4A","s1693_S_HYP_02_ASEReadCounter.table","NW_015090842.1:10310737",224,447,223
"VPS4A","s1693_S_HYP_02_ASEReadCounter.table","NW_015090842.1:10310746",217,446,229
"VPS4A","s1693_S_HYP_02_ASEReadCounter.table","NW_015090842.1:10310767",248,483,235
"VPS4A","s1693_S_HYP_02_ASEReadCounter.table","NW_015090842.1:10310995",240,466,226
"VPS4A","s1693_S_HYP_02_ASEReadCounter.table","NW_015090842.1:10311004",245,455,210
"VPS4A","s1693_S_HYP_02_ASEReadCounter.table","NW_015090842.1:10311007",246,470,224
"VPS4A","s1693_S_HYP_02_ASEReadCounter.table","NW_015090842.1:10311013",256,469,213
"VPS4A","s1693_S_HYP_02_ASEReadCounter.table","NW_015090842.1:10311022",242,455,213
"VPS4A","s1693_S_HYP_02_ASEReadCounter.table","NW_015090842.1:10311023",243,451,208
"VPS4A","s1693_S_HYP_02_ASEReadCounter.table","NW_015090842.1:10311426",243,524,281
"VPS4A","s1693_S_HYP_02_ASEReadCounter.table","NW_015090842.1:10311489",5,16,11
"VPS4A","s1693_S_HYP_02_ASEReadCounter.table","NW_015090842.1:10311490",6,15,9
"VPS4A","s1693_S_HYP_02_ASEReadCounter.table","NW_015090842.1:10311525",4,18,14
"VPS4A","s1693_S_HYP_02_ASEReadCounter.table","NW_015090842.1:10311529",7,25,18
"VPS4A","s1693_S_HYP_02_ASEReadCounter.table","NW_015090842.1:10311530",7,27,20
"VPS4A","s1693_S_HYP_02_ASEReadCounter.table","NW_015090842.1:10311552",39,73,34
"VPS4A","s1693_S_HYP_02_ASEReadCounter.table","NW_015090842.1:10311689",38,83,45
"VPS4A","s1693_S_HYP_02_ASEReadCounter.table","NW_015090842.1:10311700",57,105,48
"VPS4A","s1693_S_HYP_02_ASEReadCounter.table","NW_015090842.1:10311701",57,105,48
"VPS4A","s1693_S_HYP_02_ASEReadCounter.table","NW_015090842.1:10311703",57,104,47
"COG8","s1693_S_HYP_02_ASEReadCounter.table","NW_015090842.1:10313487",20,53,33
"COG8","s1693_S_HYP_02_ASEReadCounter.table","NW_015090842.1:10313559",38,79,41
"COG8","s1693_S_HYP_02_ASEReadCounter.table","NW_015090842.1:10313579",39,81,42
"COG8","s1693_S_HYP_02_ASEReadCounter.table","NW_015090842.1:10313665",31,53,22
"COG8","s1693_S_HYP_02_ASEReadCounter.table","NW_015090842.1:10313681",27,54,27
"COG8","s1693_S_HYP_02_ASEReadCounter.table","NW_015090842.1:10313768",42,73,31
"COG8","s1693_S_HYP_02_ASEReadCounter.table","NW_015090842.1:10313775",41,74,33
"COG8","s1693_S_HYP_02_ASEReadCounter.table","NW_015090842.1:10313811",30,60,30
"COG8","s1693_S_HYP_02_ASEReadCounter.table","NW_015090842.1:10313858",24,50,26
"COG8","s1693_S_HYP_02_ASEReadCounter.table","NW_015090842.1:10313859",49,49,0
"COG8","s1693_S_HYP_02_ASEReadCounter.table","NW_015090842.1:10314100",35,66,31
"COG8","s1693_S_HYP_02_ASEReadCounter.table","NW_015090842.1:10314213",30,67,37
"COG8","s1693_S_HYP_02_ASEReadCounter.table","NW_015090842.1:10315093",25,51,26
"COG8","s1693_S_HYP_02_ASEReadCounter.table","NW_015090842.1:10315162",25,54,29
"COG8","s1693_S_HYP_02_ASEReadCounter.table","NW_015090842.1:10315285",25,49,24
"COG8","s1693_S_HYP_02_ASEReadCounter.table","NW_015090842.1:10315360",20,39,19
"COG8","s1693_S_HYP_02_ASEReadCounter.table","NW_015090842.1:10315369",22,39,17
"COG8","s1693_S_HYP_02_ASEReadCounter.table","NW_015090842.1:10315508",16,24,8
"COG8","s1693_S_HYP_02_ASEReadCounter.table","NW_015090842.1:10315624",14,30,16
"COG8","s1693_S_HYP_02_ASEReadCounter.table","NW_015090842.1:10315693",13,37,24
"COG8","s1693_S_HYP_02_ASEReadCounter.table","NW_015090842.1:10315698",14,39,25
"COG8","s1693_S_HYP_02_ASEReadCounter.table","NW_015090842.1:10315768",15,37,22
"COG8","s1693_S_HYP_02_ASEReadCounter.table","NW_015090842.1:10315769",15,36,21
"COG8","s1693_S_HYP_02_ASEReadCounter.table","NW_015090842.1:10315784",17,38,21
"COG8","s1693_S_HYP_02_ASEReadCounter.table","NW_015090842.1:10316093",16,27,11
"COG8","s1693_S_HYP_02_ASEReadCounter.table","NW_015090842.1:10316133",8,22,14
"NIP7","s1693_S_HYP_02_ASEReadCounter.table","NW_015090842.1:10316759",26,49,23
"NIP7","s1693_S_HYP_02_ASEReadCounter.table","NW_015090842.1:10316967",156,301,145
"NIP7","s1693_S_HYP_02_ASEReadCounter.table","NW_015090842.1:10316995",170,334,164
"NIP7","s1693_S_HYP_02_ASEReadCounter.table","NW_015090842.1:10317240",220,436,216
"NIP7","s1693_S_HYP_02_ASEReadCounter.table","NW_015090842.1:10317247",222,437,215
"NIP7","s1693_S_HYP_02_ASEReadCounter.table","NW_015090842.1:10317264",211,407,196
"NIP7","s1693_S_HYP_02_ASEReadCounter.table","NW_015090842.1:10317433",238,520,282
"NIP7","s1693_S_HYP_02_ASEReadCounter.table","NW_015090842.1:10317738",241,484,243
"NIP7","s1693_S_HYP_02_ASEReadCounter.table","NW_015090842.1:10317769",234,484,250
"NIP7","s1693_S_HYP_02_ASEReadCounter.table","NW_015090842.1:10317808",143,312,169
"NIP7","s1693_S_HYP_02_ASEReadCounter.table","NW_015090842.1:10317870",103,251,148
"NIP7","s1693_S_HYP_02_ASEReadCounter.table","NW_015090842.1:10317871",103,241,138
"NIP7","s1693_S_HYP_02_ASEReadCounter.table","NW_015090842.1:10317898",77,179,102
"NIP7","s1693_S_HYP_02_ASEReadCounter.table","NW_015090842.1:10317911",64,148,84
"TMED6","s1693_S_HYP_02_ASEReadCounter.table","NW_015090842.1:10318514",1,1,0
"TMED6","s1693_S_HYP_02_ASEReadCounter.table","NW_015090842.1:10318731",1,1,0
"TERF2","s1693_S_HYP_02_ASEReadCounter.table","NW_015090842.1:10321768",34,80,46
"TERF2","s1693_S_HYP_02_ASEReadCounter.table","NW_015090842.1:10321777",37,85,48
"TERF2","s1693_S_HYP_02_ASEReadCounter.table","NW_015090842.1:10321805",35,97,62
"TERF2","s1693_S_HYP_02_ASEReadCounter.table","NW_015090842.1:10321878",64,130,66
"TERF2","s1693_S_HYP_02_ASEReadCounter.table","NW_015090842.1:10321893",68,129,61
"TERF2","s1693_S_HYP_02_ASEReadCounter.table","NW_015090842.1:10321897",68,129,61
"TERF2","s1693_S_HYP_02_ASEReadCounter.table","NW_015090842.1:10321908",54,104,50
"TERF2","s1693_S_HYP_02_ASEReadCounter.table","NW_015090842.1:10322001",85,167,82
"TERF2","s1693_S_HYP_02_ASEReadCounter.table","NW_015090842.1:10322035",71,135,64
"TERF2","s1693_S_HYP_02_ASEReadCounter.table","NW_015090842.1:10322051",76,143,67
"TERF2","s1693_S_HYP_02_ASEReadCounter.table","NW_015090842.1:10322137",61,118,57
"TERF2","s1693_S_HYP_02_ASEReadCounter.table","NW_015090842.1:10322144",59,109,50
"TERF2","s1693_S_HYP_02_ASEReadCounter.table","NW_015090842.1:10322388",30,110,80
"TERF2","s1693_S_HYP_02_ASEReadCounter.table","NW_015090842.1:10322396",31,109,78
"TERF2","s1693_S_HYP_02_ASEReadCounter.table","NW_015090842.1:10322502",49,111,62
"TERF2","s1693_S_HYP_02_ASEReadCounter.table","NW_015090842.1:10322504",49,114,65
"TERF2","s1693_S_HYP_02_ASEReadCounter.table","NW_015090842.1:10322510",51,118,67
"TERF2","s1693_S_HYP_02_ASEReadCounter.table","NW_015090842.1:10323580",48,104,56
"TERF2","s1693_S_HYP_02_ASEReadCounter.table","NW_015090842.1:10324314",41,87,46
"TERF2","s1693_S_HYP_02_ASEReadCounter.table","NW_015090842.1:10326832",36,72,36
"TERF2","s1693_S_HYP_02_ASEReadCounter.table","NW_015090842.1:10327787",22,66,44
"TERF2","s1693_S_HYP_02_ASEReadCounter.table","NW_015090842.1:10328588",22,49,27
"TERF2","s1693_S_HYP_02_ASEReadCounter.table","NW_015090842.1:10328644",14,39,25
"TERF2","s1693_S_HYP_02_ASEReadCounter.table","NW_015090842.1:10329813",8,32,24
"TERF2","s1693_S_HYP_02_ASEReadCounter.table","NW_015090842.1:10330749",10,27,17
"TERF2","s1693_S_HYP_02_ASEReadCounter.table","NW_015090842.1:10330789",12,30,18
"CYB5B","s1693_S_HYP_02_ASEReadCounter.table","NW_015090842.1:10336595",4,12,8
"CYB5B","s1693_S_HYP_02_ASEReadCounter.table","NW_015090842.1:10336667",57,116,59
"CYB5B","s1693_S_HYP_02_ASEReadCounter.table","NW_015090842.1:10336689",84,171,87
"CYB5B","s1693_S_HYP_02_ASEReadCounter.table","NW_015090842.1:10336728",126,245,119
"CYB5B","s1693_S_HYP_02_ASEReadCounter.table","NW_015090842.1:10345068",122,251,129
"CYB5B","s1693_S_HYP_02_ASEReadCounter.table","NW_015090842.1:10348800",196,352,156
"CYB5B","s1693_S_HYP_02_ASEReadCounter.table","NW_015090842.1:10349046",185,364,179
"CYB5B","s1693_S_HYP_02_ASEReadCounter.table","NW_015090842.1:10349119",104,292,188
"CYB5B","s1693_S_HYP_02_ASEReadCounter.table","NW_015090842.1:10349146",65,244,179
"CYB5B","s1693_S_HYP_02_ASEReadCounter.table","NW_015090842.1:10349157",115,294,179
"CYB5B","s1693_S_HYP_02_ASEReadCounter.table","NW_015090842.1:10349263",303,303,0
